user_id,date,direction,internal,operator_id,is_missed_call,calls_count,call_duration,total_call_duration,wait_time
166377,2019-08-04 00:00:00+03:00,in,False,-1,True,2,0,4,4
166377,2019-08-05 00:00:00+03:00,out,True,880022,True,3,0,5,5
166377,2019-08-05 00:00:00+03:00,out,True,880020,True,1,0,1,1
166377,2019-08-05 00:00:00+03:00,out,True,880020,False,1,10,18,8
166377,2019-08-05 00:00:00+03:00,out,False,880022,True,3,0,25,25
166377,2019-08-05 00:00:00+03:00,out,False,880020,False,2,3,29,26
166377,2019-08-05 00:00:00+03:00,out,False,880020,True,8,0,50,50
166377,2019-08-05 00:00:00+03:00,in,False,-1,True,6,0,35,35
166377,2019-08-05 00:00:00+03:00,out,False,880020,True,8,0,50,50
166377,2019-08-06 00:00:00+03:00,in,False,-1,True,4,0,62,62
166377,2019-08-06 00:00:00+03:00,out,False,881278,True,3,0,29,29
166377,2019-08-06 00:00:00+03:00,out,False,880020,True,5,0,70,70
166377,2019-08-06 00:00:00+03:00,out,True,881278,True,2,0,5,5
166377,2019-08-06 00:00:00+03:00,out,False,880020,False,5,800,819,19
166377,2019-08-07 00:00:00+03:00,out,False,880028,True,1,0,15,15
166377,2019-08-07 00:00:00+03:00,out,False,880026,False,1,21,28,7
166377,2019-08-07 00:00:00+03:00,out,False,880020,False,2,232,240,8
166377,2019-08-07 00:00:00+03:00,in,False,-1,True,2,0,24,24
166377,2019-08-07 00:00:00+03:00,out,False,880026,True,1,0,17,17
166377,2019-08-08 00:00:00+03:00,out,False,880022,False,2,558,568,10
166377,2019-08-08 00:00:00+03:00,out,False,880022,True,4,0,28,28
166377,2019-08-09 00:00:00+03:00,out,False,880028,False,17,1603,1725,122
166377,2019-08-09 00:00:00+03:00,out,False,880028,True,2,0,2,2
166377,2019-08-09 00:00:00+03:00,out,False,880022,True,2,0,10,10
166377,2019-08-12 00:00:00+03:00,out,False,880028,False,20,2074,2191,117
166377,2019-08-12 00:00:00+03:00,out,True,880028,True,1,0,26,26
166377,2019-08-12 00:00:00+03:00,in,False,880028,False,1,407,411,4
166377,2019-08-12 00:00:00+03:00,in,False,-1,True,2,0,34,34
166377,2019-08-12 00:00:00+03:00,in,False,-1,True,2,0,34,34
166377,2019-08-13 00:00:00+03:00,out,True,880026,True,2,0,23,23
166377,2019-08-13 00:00:00+03:00,in,False,-1,True,7,0,128,128
166377,2019-08-13 00:00:00+03:00,out,False,880026,False,4,258,287,29
166377,2019-08-13 00:00:00+03:00,out,True,880028,True,1,0,16,16
166377,2019-08-13 00:00:00+03:00,out,False,880028,False,10,647,788,141
166377,2019-08-13 00:00:00+03:00,in,False,880028,False,1,88,102,14
166377,2019-08-13 00:00:00+03:00,out,False,880028,True,1,0,60,60
166377,2019-08-14 00:00:00+03:00,out,False,880028,True,7,0,105,105
166377,2019-08-14 00:00:00+03:00,in,False,880026,False,2,197,218,21
166377,2019-08-14 00:00:00+03:00,in,False,-1,True,1,0,3,3
166377,2019-08-14 00:00:00+03:00,in,False,880028,False,1,33,37,4
166377,2019-08-14 00:00:00+03:00,out,True,880026,True,2,0,0,0
166377,2019-08-14 00:00:00+03:00,out,False,880028,False,18,2686,2782,96
166377,2019-08-14 00:00:00+03:00,out,False,880026,True,7,0,38,38
166377,2019-08-14 00:00:00+03:00,out,False,880026,False,10,1567,1654,87
166377,2019-08-14 00:00:00+03:00,out,False,880026,False,10,1567,1654,87
166377,2019-08-14 00:00:00+03:00,in,False,-1,True,1,0,3,3
166377,2019-08-15 00:00:00+03:00,out,False,880026,False,11,1413,1473,60
166377,2019-08-15 00:00:00+03:00,out,False,880028,True,8,0,458,458
166377,2019-08-15 00:00:00+03:00,out,False,880028,False,19,2653,2779,126
166377,2019-08-15 00:00:00+03:00,in,False,880028,False,1,23,27,4
166377,2019-08-15 00:00:00+03:00,out,False,880026,True,15,0,330,330
166377,2019-08-15 00:00:00+03:00,out,False,880026,False,11,1413,1473,60
166377,2019-08-16 00:00:00+03:00,out,False,880026,True,6,0,249,249
166377,2019-08-16 00:00:00+03:00,out,False,880026,False,15,1658,1714,56
166377,2019-08-16 00:00:00+03:00,out,False,880028,True,4,0,29,29
166377,2019-08-16 00:00:00+03:00,out,False,880028,False,15,1574,1674,100
166377,2019-08-16 00:00:00+03:00,out,True,880026,True,3,0,2,2
166377,2019-08-19 00:00:00+03:00,out,False,880026,True,13,0,142,142
166377,2019-08-19 00:00:00+03:00,out,False,880026,False,14,1519,1598,79
166377,2019-08-19 00:00:00+03:00,out,False,880028,True,5,0,170,170
166377,2019-08-19 00:00:00+03:00,in,False,880028,False,1,21,39,18
166377,2019-08-19 00:00:00+03:00,out,False,880028,False,8,904,1033,129
166377,2019-08-19 00:00:00+03:00,out,False,880026,False,14,1519,1598,79
166377,2019-08-20 00:00:00+03:00,out,False,880028,False,32,2975,3243,268
166377,2019-08-20 00:00:00+03:00,out,False,880026,False,19,2568,2758,190
166377,2019-08-20 00:00:00+03:00,out,False,880028,True,13,0,572,572
166377,2019-08-20 00:00:00+03:00,in,False,880028,False,1,30,33,3
166377,2019-08-20 00:00:00+03:00,out,False,880026,True,9,0,53,53
166377,2019-08-21 00:00:00+03:00,out,False,880026,True,8,0,174,174
166377,2019-08-21 00:00:00+03:00,out,False,880028,True,22,0,717,717
166377,2019-08-21 00:00:00+03:00,out,False,880028,False,19,3496,3613,117
166377,2019-08-21 00:00:00+03:00,out,False,880026,False,23,2692,2844,152
166377,2019-08-22 00:00:00+03:00,out,False,880026,True,6,0,55,55
166377,2019-08-22 00:00:00+03:00,out,False,880026,False,23,2979,3062,83
166377,2019-08-22 00:00:00+03:00,out,False,880028,True,18,0,710,710
166377,2019-08-22 00:00:00+03:00,out,False,880028,False,15,1866,1992,126
166377,2019-08-22 00:00:00+03:00,in,False,880020,False,1,33,49,16
166377,2019-08-22 00:00:00+03:00,in,False,-1,True,1,0,1,1
166377,2019-08-22 00:00:00+03:00,out,False,880026,True,6,0,55,55
166377,2019-08-23 00:00:00+03:00,in,False,880026,False,1,45,52,7
166377,2019-08-23 00:00:00+03:00,out,False,880026,True,11,0,54,54
166377,2019-08-23 00:00:00+03:00,in,False,-1,True,2,0,47,47
166377,2019-08-23 00:00:00+03:00,in,False,880028,False,1,41,54,13
166377,2019-08-23 00:00:00+03:00,out,False,880028,False,24,2242,2413,171
166377,2019-08-23 00:00:00+03:00,out,False,880026,False,43,3435,3654,219
166377,2019-08-23 00:00:00+03:00,out,False,880028,True,24,0,597,597
166377,2019-08-23 00:00:00+03:00,out,False,880026,False,43,3435,3654,219
166377,2019-08-23 00:00:00+03:00,in,False,880026,False,1,45,52,7
166377,2019-08-24 00:00:00+03:00,in,False,-1,True,2,0,35,35
166377,2019-08-26 00:00:00+03:00,out,True,880022,True,3,0,0,0
166377,2019-08-26 00:00:00+03:00,in,False,880028,False,2,285,302,17
166377,2019-08-26 00:00:00+03:00,out,False,880026,False,28,3298,3395,97
166377,2019-08-26 00:00:00+03:00,out,False,880028,True,4,0,241,241
166377,2019-08-26 00:00:00+03:00,out,False,880022,False,3,1079,1093,14
166377,2019-08-26 00:00:00+03:00,out,False,880028,False,5,426,487,61
166377,2019-08-26 00:00:00+03:00,out,False,880026,True,2,0,46,46
166377,2019-08-27 00:00:00+03:00,out,False,880026,False,22,3242,3329,87
166377,2019-08-27 00:00:00+03:00,out,False,880026,True,5,0,119,119
166377,2019-08-27 00:00:00+03:00,out,False,880028,True,27,0,983,983
166377,2019-08-27 00:00:00+03:00,out,False,880028,False,20,2784,2979,195
166377,2019-08-27 00:00:00+03:00,out,False,880028,False,20,2784,2979,195
166377,2019-08-28 00:00:00+03:00,out,False,880026,True,11,0,129,129
166377,2019-08-28 00:00:00+03:00,out,False,880026,False,16,1783,1868,85
166377,2019-08-28 00:00:00+03:00,out,False,880028,False,19,1485,1777,292
166377,2019-08-28 00:00:00+03:00,out,False,880028,True,29,0,993,993
166377,2019-08-29 00:00:00+03:00,out,False,880026,False,22,3244,3396,152
166377,2019-08-29 00:00:00+03:00,in,False,880026,False,1,48,52,4
166377,2019-08-29 00:00:00+03:00,out,False,880028,True,16,0,662,662
166377,2019-08-29 00:00:00+03:00,out,False,880026,True,23,0,321,321
166377,2019-08-29 00:00:00+03:00,in,False,-1,True,2,0,60,60
166377,2019-08-29 00:00:00+03:00,out,False,880028,False,25,2323,2595,272
166377,2019-08-29 00:00:00+03:00,out,False,880028,False,25,2323,2595,272
166377,2019-08-30 00:00:00+03:00,out,False,880028,True,8,0,384,384
166377,2019-08-30 00:00:00+03:00,out,False,880026,False,24,1653,1864,211
166377,2019-08-30 00:00:00+03:00,in,False,880028,False,1,45,65,20
166377,2019-08-30 00:00:00+03:00,out,False,880022,False,1,239,257,18
166377,2019-08-30 00:00:00+03:00,out,False,880028,False,14,989,1099,110
166377,2019-08-30 00:00:00+03:00,out,False,880026,True,11,0,292,292
166377,2019-09-02 00:00:00+03:00,in,False,880028,False,2,66,75,9
166377,2019-09-02 00:00:00+03:00,in,False,880026,False,1,31,34,3
166377,2019-09-02 00:00:00+03:00,out,False,880026,False,16,1853,1983,130
166377,2019-09-02 00:00:00+03:00,out,False,880026,True,6,0,168,168
166377,2019-09-02 00:00:00+03:00,out,False,880028,False,20,2529,2687,158
166377,2019-09-02 00:00:00+03:00,out,False,880028,True,29,0,1345,1345
166377,2019-09-02 00:00:00+03:00,out,True,880020,True,2,0,0,0
166377,2019-09-02 00:00:00+03:00,out,False,880020,True,2,0,3,3
166377,2019-09-03 00:00:00+03:00,out,False,880028,False,17,1573,1733,160
166377,2019-09-03 00:00:00+03:00,in,False,-1,True,1,0,20,20
166377,2019-09-03 00:00:00+03:00,out,False,880026,False,23,2054,2198,144
166377,2019-09-03 00:00:00+03:00,out,False,880028,True,18,0,416,416
166377,2019-09-03 00:00:00+03:00,out,False,880026,True,8,0,248,248
166377,2019-09-03 00:00:00+03:00,out,False,880028,True,18,0,416,416
166377,2019-09-04 00:00:00+03:00,out,True,880022,True,1,0,2,2
166377,2019-09-04 00:00:00+03:00,out,False,880026,True,7,0,164,164
166377,2019-09-04 00:00:00+03:00,in,False,-1,True,1,0,19,19
166377,2019-09-04 00:00:00+03:00,out,False,880022,False,3,360,395,35
166377,2019-09-04 00:00:00+03:00,out,False,880022,True,1,0,55,55
166377,2019-09-04 00:00:00+03:00,out,True,880028,True,1,0,1,1
166377,2019-09-04 00:00:00+03:00,out,False,880026,False,27,2176,2393,217
166377,2019-09-04 00:00:00+03:00,in,False,880028,False,1,195,208,13
166377,2019-09-04 00:00:00+03:00,out,False,880028,False,15,2539,2613,74
166377,2019-09-04 00:00:00+03:00,out,False,880028,True,19,0,230,230
166377,2019-09-05 00:00:00+03:00,out,False,880026,True,6,0,242,242
166377,2019-09-05 00:00:00+03:00,out,False,880026,False,21,2748,2928,180
166377,2019-09-05 00:00:00+03:00,in,False,880020,False,1,63,70,7
166377,2019-09-05 00:00:00+03:00,out,False,880028,False,8,983,1010,27
166377,2019-09-05 00:00:00+03:00,in,False,-1,True,2,0,23,23
166377,2019-09-05 00:00:00+03:00,out,False,880028,True,9,0,247,247
166377,2019-09-05 00:00:00+03:00,in,False,880026,False,1,63,65,2
166377,2019-09-05 00:00:00+03:00,out,True,880022,True,2,0,0,0
166377,2019-09-05 00:00:00+03:00,out,False,880022,False,6,746,760,14
166377,2019-09-05 00:00:00+03:00,out,False,880022,False,6,746,760,14
166377,2019-09-06 00:00:00+03:00,out,True,880022,True,2,0,0,0
166377,2019-09-06 00:00:00+03:00,out,False,880022,False,5,1243,1265,22
166377,2019-09-06 00:00:00+03:00,out,False,880028,True,9,0,392,392
166377,2019-09-06 00:00:00+03:00,out,False,880028,False,13,1304,1441,137
166377,2019-09-06 00:00:00+03:00,out,True,880026,True,1,0,3,3
166377,2019-09-06 00:00:00+03:00,in,False,880020,False,1,48,56,8
166377,2019-09-06 00:00:00+03:00,out,False,880022,True,4,0,112,112
166377,2019-09-06 00:00:00+03:00,out,False,880026,False,14,1045,1127,82
166377,2019-09-09 00:00:00+03:00,out,False,880026,True,5,0,114,114
166377,2019-09-09 00:00:00+03:00,out,False,880028,True,9,0,316,316
166377,2019-09-09 00:00:00+03:00,out,False,880022,False,4,234,302,68
166377,2019-09-09 00:00:00+03:00,out,False,880026,False,16,1479,1616,137
166377,2019-09-09 00:00:00+03:00,out,False,880022,True,5,0,192,192
166377,2019-09-09 00:00:00+03:00,in,False,880020,False,1,54,58,4
166377,2019-09-09 00:00:00+03:00,in,False,-1,True,1,0,29,29
166377,2019-09-09 00:00:00+03:00,in,False,880026,False,1,32,40,8
166377,2019-09-09 00:00:00+03:00,out,False,880028,False,18,1601,1806,205
166377,2019-09-10 00:00:00+03:00,in,False,-1,True,1,0,26,26
166377,2019-09-10 00:00:00+03:00,out,False,880028,True,19,0,552,552
166377,2019-09-10 00:00:00+03:00,out,False,880022,True,1,0,54,54
166377,2019-09-10 00:00:00+03:00,out,False,880028,False,29,2082,2256,174
166377,2019-09-10 00:00:00+03:00,out,False,880026,False,32,2451,2620,169
166377,2019-09-10 00:00:00+03:00,out,False,880022,False,2,88,91,3
166377,2019-09-10 00:00:00+03:00,out,False,880026,True,6,0,178,178
166377,2019-09-10 00:00:00+03:00,out,False,880022,True,1,0,54,54
166377,2019-09-11 00:00:00+03:00,in,False,-1,True,1,0,2,2
166377,2019-09-11 00:00:00+03:00,out,False,880026,False,16,1452,1529,77
166377,2019-09-11 00:00:00+03:00,out,False,880022,False,5,479,533,54
166377,2019-09-11 00:00:00+03:00,out,False,880028,False,22,2226,2423,197
166377,2019-09-11 00:00:00+03:00,out,False,880022,True,3,0,92,92
166377,2019-09-11 00:00:00+03:00,in,False,880028,False,1,152,158,6
166377,2019-09-11 00:00:00+03:00,out,True,880022,True,2,0,0,0
166377,2019-09-11 00:00:00+03:00,out,False,880028,True,6,0,144,144
166377,2019-09-11 00:00:00+03:00,out,False,880026,True,5,0,86,86
166377,2019-09-11 00:00:00+03:00,out,False,880028,True,6,0,144,144
166377,2019-09-11 00:00:00+03:00,out,False,880022,True,3,0,92,92
166377,2019-09-12 00:00:00+03:00,in,False,880028,False,1,69,73,4
166377,2019-09-12 00:00:00+03:00,out,False,880028,True,10,0,297,297
166377,2019-09-12 00:00:00+03:00,out,False,880028,False,16,1030,1161,131
166377,2019-09-12 00:00:00+03:00,in,False,880020,False,1,45,49,4
166377,2019-09-12 00:00:00+03:00,out,False,880022,True,6,0,232,232
166377,2019-09-12 00:00:00+03:00,out,False,880026,False,25,2311,2403,92
166377,2019-09-12 00:00:00+03:00,out,False,880026,True,3,0,118,118
166377,2019-09-12 00:00:00+03:00,in,False,-1,True,4,0,77,77
166377,2019-09-12 00:00:00+03:00,out,False,880022,False,1,147,150,3
166377,2019-09-12 00:00:00+03:00,in,False,880020,False,1,45,49,4
166377,2019-09-12 00:00:00+03:00,out,False,880028,False,16,1030,1161,131
166377,2019-09-13 00:00:00+03:00,out,False,880026,False,25,1906,2034,128
166377,2019-09-13 00:00:00+03:00,out,False,880028,True,3,0,63,63
166377,2019-09-13 00:00:00+03:00,out,False,880022,True,3,0,116,116
166377,2019-09-13 00:00:00+03:00,out,False,880028,False,26,2569,2861,292
166377,2019-09-13 00:00:00+03:00,out,False,880022,False,1,71,74,3
166377,2019-09-13 00:00:00+03:00,in,False,880020,False,1,39,43,4
166377,2019-09-13 00:00:00+03:00,out,False,880026,True,11,0,138,138
166377,2019-09-16 00:00:00+03:00,out,False,880026,True,7,0,99,99
166377,2019-09-16 00:00:00+03:00,out,False,880028,True,15,0,229,229
166377,2019-09-16 00:00:00+03:00,out,False,880026,False,31,2587,2797,210
166377,2019-09-16 00:00:00+03:00,in,False,880026,False,1,28,34,6
166377,2019-09-16 00:00:00+03:00,out,False,880028,False,22,3047,3224,177
166377,2019-09-16 00:00:00+03:00,in,False,-1,True,8,0,119,119
166377,2019-09-16 00:00:00+03:00,out,False,880026,True,7,0,99,99
166377,2019-09-17 00:00:00+03:00,out,False,880022,False,1,126,128,2
166377,2019-09-17 00:00:00+03:00,in,False,880028,False,1,247,250,3
166377,2019-09-17 00:00:00+03:00,out,False,880028,True,23,0,651,651
166377,2019-09-17 00:00:00+03:00,in,False,-1,True,2,0,60,60
166377,2019-09-17 00:00:00+03:00,out,False,880026,False,16,790,946,156
166377,2019-09-17 00:00:00+03:00,out,False,880028,False,35,2507,2787,280
166377,2019-09-17 00:00:00+03:00,out,False,880022,True,7,0,212,212
166377,2019-09-17 00:00:00+03:00,out,False,880026,True,2,0,0,0
166377,2019-09-18 00:00:00+03:00,out,False,880026,False,4,299,315,16
166377,2019-09-18 00:00:00+03:00,out,False,880022,True,2,0,103,103
166377,2019-09-18 00:00:00+03:00,out,False,880028,False,20,2447,2634,187
166377,2019-09-18 00:00:00+03:00,out,False,880022,False,1,71,73,2
166377,2019-09-18 00:00:00+03:00,out,False,880026,True,2,0,38,38
166377,2019-09-18 00:00:00+03:00,out,False,880028,True,7,0,201,201
166377,2019-09-19 00:00:00+03:00,in,False,880028,False,1,21,23,2
166377,2019-09-19 00:00:00+03:00,out,False,880026,True,8,0,192,192
166377,2019-09-19 00:00:00+03:00,out,False,880022,False,2,359,364,5
166377,2019-09-19 00:00:00+03:00,out,False,880022,True,8,0,251,251
166377,2019-09-19 00:00:00+03:00,out,True,880022,True,1,0,1,1
166377,2019-09-19 00:00:00+03:00,out,False,880028,True,23,0,700,700
166377,2019-09-19 00:00:00+03:00,out,False,880028,False,18,1638,1775,137
166377,2019-09-19 00:00:00+03:00,out,False,880026,False,30,2666,2808,142
166377,2019-09-20 00:00:00+03:00,out,False,880028,True,17,0,552,552
166377,2019-09-20 00:00:00+03:00,out,False,880022,False,1,219,221,2
166377,2019-09-20 00:00:00+03:00,out,False,880022,True,10,0,509,509
166377,2019-09-20 00:00:00+03:00,out,False,880026,False,28,2310,2473,163
166377,2019-09-20 00:00:00+03:00,out,False,880028,False,17,1683,1848,165
166377,2019-09-20 00:00:00+03:00,in,False,880020,False,1,17,28,11
166377,2019-09-20 00:00:00+03:00,out,False,880026,True,15,0,393,393
166377,2019-09-23 00:00:00+03:00,out,False,880028,True,24,0,509,509
166377,2019-09-23 00:00:00+03:00,out,False,880026,True,13,0,401,401
166377,2019-09-23 00:00:00+03:00,out,False,880028,False,24,2181,2368,187
166377,2019-09-23 00:00:00+03:00,out,False,880026,False,21,2375,2485,110
166377,2019-09-23 00:00:00+03:00,out,False,880022,True,2,0,13,13
166377,2019-09-23 00:00:00+03:00,out,True,880028,True,1,0,2,2
166377,2019-09-23 00:00:00+03:00,in,False,880026,False,1,43,49,6
166377,2019-09-23 00:00:00+03:00,out,False,880022,False,3,351,385,34
166377,2019-09-23 00:00:00+03:00,out,False,880026,False,21,2375,2485,110
166377,2019-09-24 00:00:00+03:00,out,False,880026,True,8,0,100,100
166377,2019-09-24 00:00:00+03:00,in,False,-1,True,2,0,4,4
166377,2019-09-24 00:00:00+03:00,in,False,880028,False,3,158,169,11
166377,2019-09-24 00:00:00+03:00,out,False,880028,True,13,0,520,520
166377,2019-09-24 00:00:00+03:00,out,False,880026,False,16,1666,1767,101
166377,2019-09-24 00:00:00+03:00,out,False,880022,False,3,353,366,13
166377,2019-09-24 00:00:00+03:00,out,False,880022,True,1,0,38,38
166377,2019-09-24 00:00:00+03:00,out,False,880028,False,26,2570,2755,185
166377,2019-09-25 00:00:00+03:00,out,False,880022,False,7,1316,1352,36
166377,2019-09-25 00:00:00+03:00,out,False,880022,True,8,0,423,423
166377,2019-09-25 00:00:00+03:00,out,False,880026,False,18,1862,1925,63
166377,2019-09-25 00:00:00+03:00,out,False,880028,True,14,0,193,193
166377,2019-09-25 00:00:00+03:00,out,False,880026,True,6,0,50,50
166377,2019-09-25 00:00:00+03:00,out,False,880028,False,22,1216,1352,136
166377,2019-09-25 00:00:00+03:00,out,False,880022,True,8,0,423,423
166377,2019-09-25 00:00:00+03:00,out,False,880026,True,6,0,50,50
166377,2019-09-26 00:00:00+03:00,out,False,880028,True,29,0,553,553
166377,2019-09-26 00:00:00+03:00,out,False,880026,False,16,1250,1308,58
166377,2019-09-26 00:00:00+03:00,out,False,880028,False,26,2303,2570,267
166377,2019-09-26 00:00:00+03:00,out,False,880022,False,3,2411,2419,8
166377,2019-09-26 00:00:00+03:00,out,False,880026,True,14,0,87,87
166377,2019-09-26 00:00:00+03:00,in,False,880028,False,1,88,96,8
166377,2019-09-26 00:00:00+03:00,out,False,880022,False,3,2411,2419,8
166377,2019-09-27 00:00:00+03:00,out,False,880026,False,11,1854,1897,43
166377,2019-09-27 00:00:00+03:00,out,False,880026,True,3,0,87,87
166377,2019-09-27 00:00:00+03:00,out,False,880022,False,1,84,86,2
166377,2019-09-27 00:00:00+03:00,out,False,880022,True,1,0,44,44
166377,2019-09-27 00:00:00+03:00,out,False,880028,False,19,921,1171,250
166377,2019-09-27 00:00:00+03:00,in,False,880026,False,1,6,12,6
166377,2019-09-27 00:00:00+03:00,out,False,880028,True,21,0,475,475
166377,2019-09-27 00:00:00+03:00,out,False,880028,False,19,921,1171,250
166377,2019-09-30 00:00:00+03:00,out,False,880020,False,4,724,749,25
166377,2019-09-30 00:00:00+03:00,out,False,880022,False,1,144,146,2
166377,2019-09-30 00:00:00+03:00,out,False,880020,True,4,0,12,12
166377,2019-10-01 00:00:00+03:00,out,False,880026,False,19,2023,2155,132
166377,2019-10-01 00:00:00+03:00,out,False,880020,False,1,106,108,2
166377,2019-10-01 00:00:00+03:00,out,False,880026,True,3,0,102,102
166377,2019-10-02 00:00:00+03:00,out,False,880026,True,3,0,69,69
166377,2019-10-02 00:00:00+03:00,in,False,880026,False,3,556,568,12
166377,2019-10-02 00:00:00+03:00,in,False,-1,True,3,0,86,86
166377,2019-10-02 00:00:00+03:00,out,False,880028,True,10,0,313,313
166377,2019-10-02 00:00:00+03:00,out,False,880028,False,19,1768,1957,189
166377,2019-10-02 00:00:00+03:00,out,False,880026,False,20,1762,1880,118
166377,2019-10-03 00:00:00+03:00,out,False,880020,False,1,71,73,2
166377,2019-10-03 00:00:00+03:00,out,False,880022,False,1,48,50,2
166377,2019-10-03 00:00:00+03:00,out,True,880026,True,2,0,0,0
166377,2019-10-03 00:00:00+03:00,out,False,880026,False,19,1367,1530,163
166377,2019-10-03 00:00:00+03:00,out,False,880028,False,19,1430,1565,135
166377,2019-10-03 00:00:00+03:00,in,False,880028,False,2,133,140,7
166377,2019-10-03 00:00:00+03:00,out,False,880028,True,24,0,680,680
166377,2019-10-03 00:00:00+03:00,in,False,-1,True,2,0,60,60
166377,2019-10-03 00:00:00+03:00,out,False,880026,True,1,0,23,23
166377,2019-10-03 00:00:00+03:00,out,False,880028,True,24,0,680,680
166377,2019-10-03 00:00:00+03:00,out,False,880026,True,1,0,23,23
166377,2019-10-04 00:00:00+03:00,out,False,880028,False,20,2393,2658,265
166377,2019-10-04 00:00:00+03:00,out,False,880028,True,19,0,447,447
166377,2019-10-04 00:00:00+03:00,out,False,880022,False,1,513,520,7
166377,2019-10-04 00:00:00+03:00,out,True,880026,True,1,0,0,0
166377,2019-10-04 00:00:00+03:00,out,False,880026,False,23,2086,2256,170
166377,2019-10-04 00:00:00+03:00,out,True,880026,True,1,0,0,0
166377,2019-10-07 00:00:00+03:00,out,False,880026,False,21,2024,2136,112
166377,2019-10-07 00:00:00+03:00,in,False,-1,True,2,0,71,71
166377,2019-10-07 00:00:00+03:00,out,False,880026,True,16,0,163,163
166377,2019-10-07 00:00:00+03:00,in,False,880028,False,1,19,31,12
166377,2019-10-07 00:00:00+03:00,out,True,880026,True,1,0,1,1
166377,2019-10-07 00:00:00+03:00,out,False,880028,True,15,0,460,460
166377,2019-10-07 00:00:00+03:00,out,False,880028,False,12,494,582,88
166377,2019-10-08 00:00:00+03:00,out,False,880026,True,6,0,21,21
166377,2019-10-08 00:00:00+03:00,in,False,880028,False,1,18,25,7
166377,2019-10-08 00:00:00+03:00,out,False,880028,False,18,2470,2570,100
166377,2019-10-08 00:00:00+03:00,out,False,880028,True,12,0,355,355
166377,2019-10-08 00:00:00+03:00,in,False,-1,True,1,0,6,6
166377,2019-10-08 00:00:00+03:00,out,False,880026,False,24,2003,2170,167
166377,2019-10-08 00:00:00+03:00,out,False,880028,False,18,2470,2570,100
166377,2019-10-09 00:00:00+03:00,out,False,880028,True,12,0,266,266
166377,2019-10-09 00:00:00+03:00,in,False,-1,True,4,0,22,22
166377,2019-10-09 00:00:00+03:00,out,False,880026,False,14,1237,1333,96
166377,2019-10-09 00:00:00+03:00,out,False,880028,False,13,658,753,95
166377,2019-10-09 00:00:00+03:00,out,False,880026,True,4,0,77,77
166377,2019-10-10 00:00:00+03:00,in,False,-1,True,4,0,32,32
166377,2019-10-10 00:00:00+03:00,out,False,880028,False,19,2020,2132,112
166377,2019-10-10 00:00:00+03:00,out,False,880026,True,6,0,83,83
166377,2019-10-10 00:00:00+03:00,out,False,880028,True,14,0,375,375
166377,2019-10-10 00:00:00+03:00,out,False,880026,False,22,1597,1710,113
166377,2019-10-10 00:00:00+03:00,in,False,-1,True,4,0,32,32
166377,2019-10-11 00:00:00+03:00,out,False,880028,True,7,0,235,235
166377,2019-10-11 00:00:00+03:00,out,True,880026,True,1,0,0,0
166377,2019-10-11 00:00:00+03:00,out,False,880028,False,32,2835,3100,265
166377,2019-10-11 00:00:00+03:00,in,False,880026,False,3,100,113,13
166377,2019-10-11 00:00:00+03:00,out,False,880026,True,1,0,46,46
166377,2019-10-11 00:00:00+03:00,in,False,880028,False,1,220,223,3
166377,2019-10-11 00:00:00+03:00,out,False,880026,False,12,963,1040,77
166377,2019-10-11 00:00:00+03:00,in,False,880028,False,1,220,223,3
166377,2019-10-11 00:00:00+03:00,out,False,880028,False,32,2835,3100,265
166377,2019-10-14 00:00:00+03:00,out,False,880026,False,9,1069,1151,82
166377,2019-10-14 00:00:00+03:00,out,False,880026,True,5,0,117,117
166377,2019-10-14 00:00:00+03:00,out,False,880028,False,17,1819,2006,187
166377,2019-10-14 00:00:00+03:00,out,False,880028,True,18,0,692,692
166377,2019-10-14 00:00:00+03:00,out,False,880028,True,18,0,692,692
166377,2019-10-15 00:00:00+03:00,out,False,880028,False,14,1087,1182,95
166377,2019-10-15 00:00:00+03:00,out,False,880026,True,7,0,114,114
166377,2019-10-15 00:00:00+03:00,out,False,880026,False,15,1270,1340,70
166377,2019-10-15 00:00:00+03:00,in,False,-1,True,1,0,1,1
166377,2019-10-15 00:00:00+03:00,out,False,880028,True,19,0,237,237
166377,2019-10-15 00:00:00+03:00,in,False,880022,False,1,13,31,18
166377,2019-10-15 00:00:00+03:00,out,False,880022,False,2,34,42,8
166377,2019-10-16 00:00:00+03:00,out,False,880026,True,6,0,101,101
166377,2019-10-16 00:00:00+03:00,out,False,880028,True,15,0,356,356
166377,2019-10-16 00:00:00+03:00,in,False,880028,False,1,23,26,3
166377,2019-10-16 00:00:00+03:00,out,False,880022,False,3,409,421,12
166377,2019-10-16 00:00:00+03:00,out,False,880026,False,14,2066,2147,81
166377,2019-10-16 00:00:00+03:00,out,False,880028,False,28,2288,2536,248
166377,2019-10-17 00:00:00+03:00,out,False,880028,False,24,2228,2404,176
166377,2019-10-17 00:00:00+03:00,out,False,880028,True,20,0,421,421
166377,2019-10-17 00:00:00+03:00,out,False,880026,True,5,0,112,112
166377,2019-10-17 00:00:00+03:00,out,False,880026,False,22,2431,2526,95
166377,2019-10-17 00:00:00+03:00,in,False,-1,True,1,0,27,27
166377,2019-10-18 00:00:00+03:00,out,False,880028,True,11,0,323,323
166377,2019-10-18 00:00:00+03:00,out,False,880028,False,20,1693,1889,196
166377,2019-10-18 00:00:00+03:00,out,False,880022,False,2,802,809,7
166377,2019-10-18 00:00:00+03:00,out,False,880026,True,4,0,139,139
166377,2019-10-18 00:00:00+03:00,out,False,880026,False,15,2146,2234,88
166377,2019-10-18 00:00:00+03:00,out,False,880028,False,20,1693,1889,196
166377,2019-10-19 00:00:00+03:00,in,False,-1,True,1,0,83,83
166377,2019-10-20 00:00:00+03:00,in,False,-1,True,1,0,66,66
166377,2019-10-21 00:00:00+03:00,out,False,880028,True,16,0,667,667
166377,2019-10-21 00:00:00+03:00,out,False,880028,False,21,1403,1633,230
166377,2019-10-21 00:00:00+03:00,in,False,880028,False,1,96,99,3
166377,2019-10-21 00:00:00+03:00,out,False,880026,True,5,0,119,119
166377,2019-10-21 00:00:00+03:00,out,False,881278,False,3,465,476,11
166377,2019-10-21 00:00:00+03:00,out,False,880026,False,24,2023,2201,178
166377,2019-10-21 00:00:00+03:00,out,True,880026,True,1,0,0,0
166377,2019-10-22 00:00:00+03:00,in,False,880028,False,3,93,101,8
166377,2019-10-22 00:00:00+03:00,out,False,880028,False,18,1738,1863,125
166377,2019-10-22 00:00:00+03:00,in,False,-1,True,1,0,3,3
166377,2019-10-22 00:00:00+03:00,out,True,880028,False,1,2,4,2
166377,2019-10-22 00:00:00+03:00,out,False,880028,True,5,0,143,143
166377,2019-10-22 00:00:00+03:00,out,False,880026,False,18,1336,1438,102
166377,2019-10-22 00:00:00+03:00,out,False,880022,True,1,0,6,6
166377,2019-10-22 00:00:00+03:00,out,False,880026,True,9,0,258,258
166377,2019-10-22 00:00:00+03:00,out,False,880022,True,1,0,6,6
166377,2019-10-22 00:00:00+03:00,out,True,880028,False,1,2,4,2
166377,2019-10-23 00:00:00+03:00,out,False,880028,False,19,1127,1347,220
166377,2019-10-23 00:00:00+03:00,out,False,880026,True,11,0,298,298
166377,2019-10-23 00:00:00+03:00,out,False,880028,True,10,0,194,194
166377,2019-10-23 00:00:00+03:00,out,False,880022,False,1,98,103,5
166377,2019-10-23 00:00:00+03:00,out,False,880026,False,23,2555,2649,94
166377,2019-10-23 00:00:00+03:00,in,False,880026,False,1,151,153,2
166377,2019-10-23 00:00:00+03:00,out,False,880028,True,10,0,194,194
166377,2019-10-23 00:00:00+03:00,out,False,880026,True,11,0,298,298
166377,2019-10-24 00:00:00+03:00,in,False,880028,False,1,231,234,3
166377,2019-10-24 00:00:00+03:00,out,False,880026,True,13,0,169,169
166377,2019-10-24 00:00:00+03:00,out,False,880026,False,31,2542,2657,115
166377,2019-10-24 00:00:00+03:00,out,False,880028,True,18,0,338,338
166377,2019-10-24 00:00:00+03:00,out,False,880028,False,24,1721,1923,202
166377,2019-10-25 00:00:00+03:00,in,False,880028,False,1,55,57,2
166377,2019-10-25 00:00:00+03:00,out,False,880028,False,21,1675,1897,222
166377,2019-10-25 00:00:00+03:00,out,False,880026,True,6,0,246,246
166377,2019-10-25 00:00:00+03:00,out,False,880028,True,6,0,102,102
166377,2019-10-25 00:00:00+03:00,out,False,880026,False,22,2127,2278,151
166377,2019-10-28 00:00:00+03:00,in,False,-1,True,2,0,0,0
166377,2019-10-28 00:00:00+03:00,out,False,880026,True,10,0,202,202
166377,2019-10-28 00:00:00+03:00,out,False,880028,False,11,522,699,177
166377,2019-10-28 00:00:00+03:00,out,False,880026,False,14,1255,1335,80
166377,2019-10-28 00:00:00+03:00,out,False,880028,True,9,0,181,181
166377,2019-10-28 00:00:00+03:00,out,False,881278,True,1,0,5,5
166377,2019-10-28 00:00:00+03:00,in,False,-1,True,2,0,0,0
166377,2019-10-28 00:00:00+03:00,out,False,880028,True,9,0,181,181
166377,2019-10-29 00:00:00+03:00,out,False,880026,False,25,2339,2563,224
166377,2019-10-29 00:00:00+03:00,out,False,880028,True,8,0,277,277
166377,2019-10-29 00:00:00+03:00,in,False,880026,False,1,24,28,4
166377,2019-10-29 00:00:00+03:00,in,False,880028,False,1,152,156,4
166377,2019-10-29 00:00:00+03:00,out,False,880026,True,7,0,135,135
166377,2019-10-29 00:00:00+03:00,out,False,880028,False,33,2036,2388,352
166377,2019-10-29 00:00:00+03:00,out,False,880026,False,25,2339,2563,224
166377,2019-10-30 00:00:00+03:00,out,False,880026,False,25,1515,1646,131
166377,2019-10-30 00:00:00+03:00,out,False,880028,False,19,2105,2245,140
166377,2019-10-30 00:00:00+03:00,out,False,880026,True,16,0,301,301
166377,2019-10-30 00:00:00+03:00,out,False,880028,True,10,0,330,330
166377,2019-10-30 00:00:00+03:00,in,False,880028,False,4,166,180,14
166377,2019-10-31 00:00:00+03:00,out,False,880026,True,5,0,107,107
166377,2019-10-31 00:00:00+03:00,in,False,880026,False,1,41,48,7
166377,2019-10-31 00:00:00+03:00,in,False,880028,False,2,66,70,4
166377,2019-10-31 00:00:00+03:00,out,False,880026,False,17,2176,2349,173
166377,2019-10-31 00:00:00+03:00,out,False,880028,True,9,0,300,300
166377,2019-10-31 00:00:00+03:00,out,False,880028,False,25,1631,1847,216
166377,2019-10-31 00:00:00+03:00,out,False,880026,False,17,2176,2349,173
166377,2019-11-01 00:00:00+03:00,out,False,880028,True,17,0,647,647
166377,2019-11-01 00:00:00+03:00,in,False,880028,False,3,134,156,22
166377,2019-11-01 00:00:00+03:00,out,False,880026,False,32,2487,2814,327
166377,2019-11-01 00:00:00+03:00,out,False,880026,True,15,0,410,410
166377,2019-11-01 00:00:00+03:00,out,False,880028,False,26,2487,2771,284
166377,2019-11-01 00:00:00+03:00,in,False,880028,False,3,134,156,22
166377,2019-11-05 00:00:00+03:00,out,False,880028,False,24,3034,3204,170
166377,2019-11-05 00:00:00+03:00,in,False,880022,False,1,56,71,15
166377,2019-11-05 00:00:00+03:00,in,False,880028,False,1,72,75,3
166377,2019-11-05 00:00:00+03:00,out,False,880026,True,5,0,124,124
166377,2019-11-05 00:00:00+03:00,out,False,880028,True,15,0,547,547
166377,2019-11-05 00:00:00+03:00,out,False,880026,False,17,1479,1557,78
166377,2019-11-05 00:00:00+03:00,out,True,880028,True,2,0,0,0
166377,2019-11-05 00:00:00+03:00,out,False,880028,False,24,3034,3204,170
166377,2019-11-05 00:00:00+03:00,out,False,880026,False,17,1479,1557,78
166377,2019-11-06 00:00:00+03:00,out,True,880026,True,1,0,5,5
166377,2019-11-06 00:00:00+03:00,out,False,880026,True,9,0,256,256
166377,2019-11-06 00:00:00+03:00,out,False,-1,True,1,0,1,1
166377,2019-11-06 00:00:00+03:00,out,False,880028,True,8,0,350,350
166377,2019-11-06 00:00:00+03:00,out,False,880026,False,19,2426,2625,199
166377,2019-11-06 00:00:00+03:00,in,False,880026,False,1,23,32,9
166377,2019-11-06 00:00:00+03:00,out,False,880028,False,29,2680,2906,226
166377,2019-11-07 00:00:00+03:00,in,False,880028,False,1,139,142,3
166377,2019-11-07 00:00:00+03:00,out,False,880028,True,18,0,531,531
166377,2019-11-07 00:00:00+03:00,in,False,880022,False,1,16,29,13
166377,2019-11-07 00:00:00+03:00,in,False,-1,True,3,0,86,86
166377,2019-11-07 00:00:00+03:00,out,False,880028,False,29,2364,2729,365
166377,2019-11-07 00:00:00+03:00,out,True,880028,False,1,120,122,2
166377,2019-11-07 00:00:00+03:00,out,True,881278,True,2,0,0,0
166377,2019-11-07 00:00:00+03:00,out,False,880026,True,19,0,546,546
166377,2019-11-07 00:00:00+03:00,in,False,880026,False,2,62,80,18
166377,2019-11-07 00:00:00+03:00,out,False,880026,False,26,2415,2548,133
166377,2019-11-07 00:00:00+03:00,out,False,881278,True,4,0,17,17
166377,2019-11-08 00:00:00+03:00,in,False,880028,False,1,66,69,3
166377,2019-11-08 00:00:00+03:00,out,False,880026,True,2,0,68,68
166377,2019-11-08 00:00:00+03:00,out,False,880028,False,18,1925,2074,149
166377,2019-11-08 00:00:00+03:00,out,False,880026,False,17,1900,2002,102
166377,2019-11-08 00:00:00+03:00,in,False,880022,False,1,106,123,17
166377,2019-11-08 00:00:00+03:00,out,False,880028,True,4,0,119,119
166377,2019-11-11 00:00:00+03:00,out,False,880026,False,29,2028,2181,153
166377,2019-11-11 00:00:00+03:00,out,False,880028,False,25,1527,1815,288
166377,2019-11-11 00:00:00+03:00,out,False,880028,True,14,0,562,562
166377,2019-11-11 00:00:00+03:00,out,False,880026,True,11,0,64,64
166377,2019-11-11 00:00:00+03:00,in,False,880022,False,1,23,26,3
166377,2019-11-11 00:00:00+03:00,in,False,880026,False,1,67,71,4
166377,2019-11-12 00:00:00+03:00,in,False,880028,False,2,174,188,14
166377,2019-11-12 00:00:00+03:00,out,False,880026,True,11,0,132,132
166377,2019-11-12 00:00:00+03:00,out,False,880026,False,27,2054,2221,167
166377,2019-11-12 00:00:00+03:00,out,False,880028,False,32,2657,2951,294
166377,2019-11-12 00:00:00+03:00,out,False,880028,True,14,0,420,420
166377,2019-11-12 00:00:00+03:00,in,False,880028,False,2,174,188,14
166377,2019-11-12 00:00:00+03:00,out,False,880028,False,32,2657,2951,294
166377,2019-11-13 00:00:00+03:00,out,False,880028,True,7,0,180,180
166377,2019-11-13 00:00:00+03:00,in,False,880028,False,2,56,62,6
166377,2019-11-13 00:00:00+03:00,out,False,880026,True,11,0,215,215
166377,2019-11-13 00:00:00+03:00,out,False,880028,False,14,1113,1254,141
166377,2019-11-13 00:00:00+03:00,out,False,880026,False,17,1216,1375,159
166377,2019-11-13 00:00:00+03:00,out,False,880028,True,7,0,180,180
166377,2019-11-14 00:00:00+03:00,out,False,880026,False,25,2427,2636,209
166377,2019-11-14 00:00:00+03:00,out,False,880028,False,14,1926,2024,98
166377,2019-11-14 00:00:00+03:00,out,False,880028,True,2,0,58,58
166377,2019-11-14 00:00:00+03:00,out,False,880026,True,14,0,395,395
166377,2019-11-15 00:00:00+03:00,out,False,880028,False,10,1733,1838,105
166377,2019-11-15 00:00:00+03:00,out,False,880028,True,3,0,59,59
166377,2019-11-15 00:00:00+03:00,out,False,880026,True,12,0,188,188
166377,2019-11-15 00:00:00+03:00,out,False,880022,False,2,267,273,6
166377,2019-11-15 00:00:00+03:00,out,False,880026,False,30,2223,2387,164
166377,2019-11-18 00:00:00+03:00,out,False,880026,True,12,0,243,243
166377,2019-11-18 00:00:00+03:00,out,False,880022,False,2,149,156,7
166377,2019-11-18 00:00:00+03:00,out,True,880022,True,1,0,0,0
166377,2019-11-18 00:00:00+03:00,out,False,880026,False,23,2418,2592,174
166377,2019-11-18 00:00:00+03:00,out,False,880028,False,14,1325,1494,169
166377,2019-11-18 00:00:00+03:00,out,False,880028,True,4,0,199,199
166377,2019-11-19 00:00:00+03:00,out,False,880026,False,23,2501,2626,125
166377,2019-11-19 00:00:00+03:00,out,False,880022,False,6,706,763,57
166377,2019-11-19 00:00:00+03:00,in,False,880022,False,1,140,158,18
166377,2019-11-19 00:00:00+03:00,out,False,880028,True,12,0,312,312
166377,2019-11-19 00:00:00+03:00,out,False,880022,True,11,0,424,424
166377,2019-11-19 00:00:00+03:00,out,False,880028,False,17,1723,1909,186
166377,2019-11-19 00:00:00+03:00,out,False,880026,True,10,0,206,206
166377,2019-11-20 00:00:00+03:00,out,False,880028,True,6,0,93,93
166377,2019-11-20 00:00:00+03:00,out,False,880022,False,1,54,62,8
166377,2019-11-20 00:00:00+03:00,in,False,880028,False,2,62,70,8
166377,2019-11-20 00:00:00+03:00,out,False,880026,False,21,3323,3479,156
166377,2019-11-20 00:00:00+03:00,out,False,880028,False,8,959,1020,61
166377,2019-11-20 00:00:00+03:00,out,False,880026,True,16,0,230,230
166377,2019-11-20 00:00:00+03:00,out,False,880026,True,16,0,230,230
166377,2019-11-21 00:00:00+03:00,out,False,880028,False,33,3619,3852,233
166377,2019-11-21 00:00:00+03:00,in,False,880028,False,2,349,354,5
166377,2019-11-21 00:00:00+03:00,out,False,880026,False,6,391,428,37
166377,2019-11-21 00:00:00+03:00,out,False,880028,True,17,0,427,427
166377,2019-11-21 00:00:00+03:00,out,False,880026,True,2,0,14,14
166377,2019-11-21 00:00:00+03:00,in,False,880026,False,1,70,81,11
166377,2019-11-21 00:00:00+03:00,out,False,880028,True,17,0,427,427
166377,2019-11-22 00:00:00+03:00,out,False,880022,True,7,0,163,163
166377,2019-11-22 00:00:00+03:00,out,False,880028,True,8,0,186,186
166377,2019-11-22 00:00:00+03:00,out,False,880028,False,15,1486,1594,108
166377,2019-11-22 00:00:00+03:00,out,False,880026,False,28,3064,3209,145
166377,2019-11-22 00:00:00+03:00,in,False,880028,False,5,525,541,16
166377,2019-11-22 00:00:00+03:00,out,False,880022,False,5,653,736,83
166377,2019-11-22 00:00:00+03:00,out,False,880026,True,21,0,301,301
166377,2019-11-22 00:00:00+03:00,out,False,880028,True,8,0,186,186
166377,2019-11-22 00:00:00+03:00,out,False,880028,False,15,1486,1594,108
166377,2019-11-25 00:00:00+03:00,in,False,880028,False,1,89,105,16
166377,2019-11-25 00:00:00+03:00,out,False,880026,False,18,1633,1742,109
166377,2019-11-25 00:00:00+03:00,out,False,880028,False,7,478,540,62
166377,2019-11-25 00:00:00+03:00,out,False,880028,True,11,0,430,430
166377,2019-11-25 00:00:00+03:00,out,True,881278,True,4,0,0,0
166377,2019-11-25 00:00:00+03:00,out,False,881278,True,1,0,11,11
166377,2019-11-25 00:00:00+03:00,out,True,880026,True,1,0,0,0
166377,2019-11-25 00:00:00+03:00,out,False,880026,True,10,0,230,230
166377,2019-11-25 00:00:00+03:00,in,False,880028,False,1,89,105,16
166377,2019-11-26 00:00:00+03:00,out,False,880028,True,19,0,398,398
166377,2019-11-26 00:00:00+03:00,in,False,880022,False,1,24,28,4
166377,2019-11-26 00:00:00+03:00,out,False,880026,True,10,0,244,244
166377,2019-11-26 00:00:00+03:00,out,False,880026,False,23,2748,2896,148
166377,2019-11-26 00:00:00+03:00,in,False,880028,False,2,79,93,14
166377,2019-11-26 00:00:00+03:00,in,False,-1,True,8,0,6,6
166377,2019-11-26 00:00:00+03:00,out,True,880026,True,2,0,0,0
166377,2019-11-26 00:00:00+03:00,out,False,880028,False,24,1812,2053,241
166377,2019-11-27 00:00:00+03:00,out,False,880022,False,2,224,228,4
166377,2019-11-27 00:00:00+03:00,out,False,880026,True,15,0,289,289
166377,2019-11-27 00:00:00+03:00,out,False,880028,True,8,0,77,77
166377,2019-11-27 00:00:00+03:00,out,False,880026,False,31,2707,2905,198
166377,2019-11-27 00:00:00+03:00,out,False,880028,False,12,926,1050,124
166377,2019-11-27 00:00:00+03:00,out,True,880026,True,2,0,0,0
166377,2019-11-28 00:00:00+03:00,out,False,880028,True,7,0,119,119
166377,2019-11-28 00:00:00+03:00,in,False,-1,True,6,0,80,80
166377,2019-11-28 00:00:00+03:00,in,False,880022,False,1,134,158,24
166377,2019-11-28 00:00:00+03:00,out,False,880026,False,19,1923,2100,177
166377,2019-11-28 00:00:00+03:00,out,False,880026,True,11,0,160,160
166377,2019-11-28 00:00:00+03:00,in,False,880028,False,1,52,62,10
166377,2019-11-28 00:00:00+03:00,out,False,880028,False,12,1053,1120,67
166391,2019-08-06 00:00:00+03:00,in,False,882476,False,1,175,186,11
166391,2019-08-06 00:00:00+03:00,in,False,-1,True,3,0,163,163
166391,2019-08-07 00:00:00+03:00,in,True,882478,False,2,11,74,63
166391,2019-08-07 00:00:00+03:00,in,False,882478,False,1,57,70,13
166391,2019-08-07 00:00:00+03:00,out,True,882478,True,1,0,7,7
166391,2019-08-07 00:00:00+03:00,in,False,-1,True,2,0,71,71
166391,2019-08-08 00:00:00+03:00,in,False,-1,True,1,0,20,20
166391,2019-08-09 00:00:00+03:00,in,False,-1,True,1,0,33,33
166391,2019-08-10 00:00:00+03:00,in,False,-1,True,1,0,38,38
166391,2019-08-15 00:00:00+03:00,in,False,-1,True,2,0,77,77
166391,2019-08-16 00:00:00+03:00,in,False,-1,True,3,0,67,67
166391,2019-09-18 00:00:00+03:00,in,False,-1,True,1,0,9,9
166391,2019-09-20 00:00:00+03:00,in,False,-1,True,1,0,1,1
166391,2019-09-23 00:00:00+03:00,in,False,882476,False,1,4,24,20
166391,2019-09-27 00:00:00+03:00,in,False,-1,True,1,0,2,2
166391,2019-10-04 00:00:00+03:00,in,False,-1,True,1,0,1,1
166391,2019-10-12 00:00:00+03:00,in,False,-1,True,1,0,1,1
166391,2019-11-01 00:00:00+03:00,in,False,-1,True,1,0,7,7
166391,2019-11-13 00:00:00+03:00,in,False,-1,True,1,0,1,1
166391,2019-11-22 00:00:00+03:00,in,False,882476,False,1,13,77,64
166392,2019-08-02 00:00:00+03:00,in,False,-1,True,1,0,2,2
166392,2019-08-06 00:00:00+03:00,in,False,-1,True,1,0,3,3
166392,2019-08-12 00:00:00+03:00,in,False,-1,True,3,0,7,7
166392,2019-08-12 00:00:00+03:00,in,False,-1,True,3,0,7,7
166392,2019-08-13 00:00:00+03:00,in,False,-1,True,3,0,17,17
166392,2019-08-14 00:00:00+03:00,in,False,-1,True,1,0,6,6
166392,2019-08-14 00:00:00+03:00,in,False,-1,True,1,0,6,6
166392,2019-08-19 00:00:00+03:00,in,False,-1,True,4,0,10,10
166392,2019-08-20 00:00:00+03:00,in,False,-1,True,3,0,14,14
166392,2019-08-20 00:00:00+03:00,in,False,886892,False,2,72,130,58
166392,2019-08-21 00:00:00+03:00,in,False,-1,True,6,0,14,14
166392,2019-08-21 00:00:00+03:00,in,False,-1,True,6,0,14,14
166392,2019-08-26 00:00:00+03:00,in,False,-1,True,1,0,13,13
166392,2019-08-28 00:00:00+03:00,in,False,-1,True,4,0,9,9
166392,2019-08-29 00:00:00+03:00,in,False,-1,True,1,0,6,6
166392,2019-08-29 00:00:00+03:00,in,False,891900,False,1,4,46,42
166392,2019-09-03 00:00:00+03:00,in,False,-1,True,9,0,19,19
166392,2019-09-04 00:00:00+03:00,in,False,-1,True,3,0,17,17
166392,2019-09-05 00:00:00+03:00,in,False,891906,False,1,7,32,25
166392,2019-09-11 00:00:00+03:00,in,False,891906,False,1,86,117,31
166392,2019-09-11 00:00:00+03:00,in,False,-1,True,1,0,3,3
166392,2019-09-12 00:00:00+03:00,in,False,891906,False,1,568,594,26
166392,2019-09-14 00:00:00+03:00,in,False,-1,True,1,0,2,2
166392,2019-09-17 00:00:00+03:00,in,False,-1,True,1,0,2,2
166392,2019-09-18 00:00:00+03:00,in,False,891906,False,1,94,123,29
166392,2019-09-19 00:00:00+03:00,in,False,891900,False,2,551,632,81
166392,2019-09-20 00:00:00+03:00,in,False,891906,False,2,134,183,49
166392,2019-09-23 00:00:00+03:00,in,False,891906,False,4,615,723,108
166392,2019-09-26 00:00:00+03:00,in,False,891906,False,1,188,214,26
166392,2019-09-26 00:00:00+03:00,in,False,891900,False,1,43,93,50
166392,2019-09-27 00:00:00+03:00,in,False,-1,True,2,0,4,4
166392,2019-09-27 00:00:00+03:00,in,False,-1,True,2,0,4,4
166392,2019-09-28 00:00:00+03:00,in,False,-1,True,4,0,9,9
166392,2019-09-30 00:00:00+03:00,in,False,-1,True,1,0,46,46
166392,2019-10-01 00:00:00+03:00,in,False,891906,False,2,85,134,49
166392,2019-10-01 00:00:00+03:00,in,False,-1,True,3,0,6,6
166392,2019-10-02 00:00:00+03:00,in,False,891906,False,2,701,755,54
166392,2019-10-03 00:00:00+03:00,in,False,891906,False,3,545,621,76
166392,2019-10-04 00:00:00+03:00,in,False,891906,False,3,351,433,82
166392,2019-10-05 00:00:00+03:00,in,False,-1,True,5,0,11,11
166392,2019-10-06 00:00:00+03:00,in,False,-1,True,2,0,5,5
166392,2019-10-06 00:00:00+03:00,in,False,-1,True,2,0,5,5
166392,2019-10-07 00:00:00+03:00,in,False,-1,True,1,0,7,7
166392,2019-10-07 00:00:00+03:00,in,False,891900,False,1,53,84,31
166392,2019-10-07 00:00:00+03:00,in,False,-1,True,1,0,26,26
166392,2019-10-08 00:00:00+03:00,in,False,891900,False,1,14,58,44
166392,2019-10-08 00:00:00+03:00,in,False,-1,True,3,0,14,14
166392,2019-10-08 00:00:00+03:00,in,False,891906,False,5,1196,1340,144
166392,2019-10-08 00:00:00+03:00,in,False,-1,True,3,0,14,14
166392,2019-10-09 00:00:00+03:00,in,False,-1,True,1,0,2,2
166392,2019-10-10 00:00:00+03:00,in,False,-1,True,1,0,4,4
166392,2019-10-11 00:00:00+03:00,in,False,891906,False,2,464,516,52
166392,2019-10-11 00:00:00+03:00,in,False,-1,True,1,0,52,52
166392,2019-10-14 00:00:00+03:00,in,False,891900,False,2,352,417,65
166392,2019-10-14 00:00:00+03:00,in,False,891900,False,2,352,417,65
166392,2019-10-16 00:00:00+03:00,in,False,891906,False,1,103,134,31
166392,2019-10-17 00:00:00+03:00,in,False,891906,False,1,279,304,25
166392,2019-10-18 00:00:00+03:00,in,False,891906,False,1,21,44,23
166392,2019-10-21 00:00:00+03:00,in,False,891900,False,6,734,952,218
166392,2019-10-21 00:00:00+03:00,in,False,-1,True,3,0,6,6
166392,2019-10-21 00:00:00+03:00,in,False,891906,False,1,315,340,25
166392,2019-10-22 00:00:00+03:00,in,False,891900,False,3,237,337,100
166392,2019-10-22 00:00:00+03:00,in,False,-1,True,2,0,4,4
166392,2019-10-24 00:00:00+03:00,in,False,891900,False,1,76,109,33
166392,2019-10-24 00:00:00+03:00,in,False,891900,False,1,76,109,33
166392,2019-10-25 00:00:00+03:00,in,False,-1,True,3,0,48,48
166392,2019-10-26 00:00:00+03:00,in,False,-1,True,1,0,3,3
166392,2019-10-28 00:00:00+03:00,in,False,-1,True,1,0,16,16
166392,2019-10-28 00:00:00+03:00,in,False,891900,False,2,229,298,69
166392,2019-10-29 00:00:00+03:00,in,False,891900,False,5,368,539,171
166392,2019-10-29 00:00:00+03:00,in,False,-1,True,1,0,2,2
166392,2019-10-29 00:00:00+03:00,in,False,-1,True,1,0,2,2
166392,2019-11-01 00:00:00+03:00,in,False,891900,False,1,75,112,37
166392,2019-11-01 00:00:00+03:00,in,False,-1,True,2,0,59,59
166392,2019-11-05 00:00:00+03:00,in,False,-1,True,1,0,6,6
166392,2019-11-05 00:00:00+03:00,in,False,891906,False,3,961,1035,74
166392,2019-11-06 00:00:00+03:00,in,False,891900,False,1,326,368,42
166392,2019-11-06 00:00:00+03:00,in,False,-1,True,5,0,123,123
166392,2019-11-06 00:00:00+03:00,in,False,891906,False,3,596,677,81
166392,2019-11-07 00:00:00+03:00,in,False,891900,False,1,269,320,51
166392,2019-11-07 00:00:00+03:00,in,False,891906,False,1,573,603,30
166392,2019-11-08 00:00:00+03:00,in,False,891906,False,3,228,309,81
166392,2019-11-10 00:00:00+03:00,in,False,-1,True,3,0,6,6
166392,2019-11-10 00:00:00+03:00,in,False,-1,True,3,0,6,6
166392,2019-11-11 00:00:00+03:00,in,False,891906,False,2,430,484,54
166392,2019-11-11 00:00:00+03:00,in,False,891906,False,2,430,484,54
166392,2019-11-12 00:00:00+03:00,in,False,-1,True,1,0,2,2
166392,2019-11-14 00:00:00+03:00,in,False,891900,False,1,300,342,42
166392,2019-11-17 00:00:00+03:00,in,False,-1,True,4,0,8,8
166392,2019-11-18 00:00:00+03:00,in,False,-1,True,1,0,4,4
166392,2019-11-18 00:00:00+03:00,in,False,891906,False,4,806,912,106
166392,2019-11-18 00:00:00+03:00,in,False,891906,False,4,806,912,106
166392,2019-11-19 00:00:00+03:00,in,False,891906,False,2,239,292,53
166392,2019-11-20 00:00:00+03:00,in,False,-1,True,3,0,6,6
166392,2019-11-20 00:00:00+03:00,in,False,891906,False,5,708,836,128
166392,2019-11-22 00:00:00+03:00,in,False,891906,False,2,481,533,52
166392,2019-11-22 00:00:00+03:00,in,False,891906,False,2,481,533,52
166392,2019-11-24 00:00:00+03:00,in,False,-1,True,1,0,2,2
166392,2019-11-25 00:00:00+03:00,in,False,891906,False,6,547,715,168
166392,2019-11-25 00:00:00+03:00,in,False,891900,False,2,171,253,82
166392,2019-11-25 00:00:00+03:00,in,False,-1,True,3,0,14,14
166392,2019-11-26 00:00:00+03:00,in,False,891906,False,2,625,676,51
166392,2019-11-26 00:00:00+03:00,in,False,-1,True,2,0,6,6
166392,2019-11-27 00:00:00+03:00,in,False,891900,False,2,185,267,82
166392,2019-11-27 00:00:00+03:00,in,False,-1,True,2,0,5,5
166392,2019-11-28 00:00:00+03:00,in,False,891906,False,2,647,696,49
166392,2019-11-28 00:00:00+03:00,in,False,891906,False,2,647,696,49
166399,2019-08-12 00:00:00+03:00,in,False,-1,False,1,10,55,45
166399,2019-08-12 00:00:00+03:00,in,False,-1,True,1,0,56,56
166399,2019-08-15 00:00:00+03:00,in,False,886674,False,2,74,93,19
166399,2019-08-20 00:00:00+03:00,in,False,-1,True,1,0,28,28
166399,2019-08-23 00:00:00+03:00,in,False,886674,False,1,8,12,4
166399,2019-09-02 00:00:00+03:00,in,False,886674,False,1,35,115,80
166399,2019-09-02 00:00:00+03:00,in,False,-1,False,1,68,115,47
166399,2019-10-01 00:00:00+03:00,in,False,-1,True,1,0,23,23
166399,2019-10-02 00:00:00+03:00,in,False,886674,False,1,1,12,11
166399,2019-10-02 00:00:00+03:00,in,False,-1,True,1,0,17,17
166399,2019-10-02 00:00:00+03:00,in,False,886674,False,1,1,12,11
166399,2019-10-02 00:00:00+03:00,in,False,-1,True,1,0,17,17
166399,2019-10-07 00:00:00+03:00,in,False,-1,True,1,0,17,17
166399,2019-10-07 00:00:00+03:00,in,False,886674,False,1,12,17,5
166399,2019-10-08 00:00:00+03:00,in,False,886674,False,2,18,32,14
166399,2019-10-08 00:00:00+03:00,in,False,886674,False,2,18,32,14
166399,2019-10-10 00:00:00+03:00,in,False,-1,True,1,0,29,29
166399,2019-10-10 00:00:00+03:00,in,False,886674,False,1,15,19,4
166399,2019-10-17 00:00:00+03:00,in,False,-1,True,2,0,60,60
166399,2019-10-21 00:00:00+03:00,in,False,-1,True,2,0,40,40
166399,2019-10-21 00:00:00+03:00,in,False,886674,False,1,1,22,21
166399,2019-10-22 00:00:00+03:00,in,False,-1,True,1,0,15,15
166399,2019-10-23 00:00:00+03:00,in,False,886674,False,1,2,12,10
166405,2019-08-03 00:00:00+03:00,in,False,-1,True,1,0,2,2
166405,2019-08-06 00:00:00+03:00,in,False,-1,True,35,0,18,18
166405,2019-08-06 00:00:00+03:00,out,False,882684,False,1,11,24,13
166405,2019-08-06 00:00:00+03:00,out,False,882684,True,1,0,8,8
166405,2019-08-12 00:00:00+03:00,in,False,-1,True,46,0,2,2
166405,2019-08-12 00:00:00+03:00,out,False,882684,True,1,0,74,74
166405,2019-08-13 00:00:00+03:00,in,False,-1,True,52,0,0,0
166405,2019-08-14 00:00:00+03:00,in,False,-1,True,44,0,0,0
166405,2019-08-15 00:00:00+03:00,out,False,882684,False,1,151,153,2
166405,2019-08-15 00:00:00+03:00,out,False,882686,True,2,0,61,61
166405,2019-08-15 00:00:00+03:00,out,False,882686,False,1,33,34,1
166405,2019-08-15 00:00:00+03:00,out,False,882684,False,1,151,153,2
166405,2019-08-16 00:00:00+03:00,out,False,882684,False,2,271,343,72
166405,2019-08-16 00:00:00+03:00,out,False,882686,True,1,0,22,22
166405,2019-08-16 00:00:00+03:00,in,False,-1,True,14,0,309,309
166405,2019-08-16 00:00:00+03:00,out,False,882686,False,3,79,152,73
166405,2019-08-16 00:00:00+03:00,out,False,882684,True,1,0,14,14
166405,2019-08-16 00:00:00+03:00,in,False,882686,False,1,250,287,37
166405,2019-08-17 00:00:00+03:00,out,False,882686,False,5,862,945,83
166405,2019-08-17 00:00:00+03:00,in,False,-1,True,12,0,135,135
166405,2019-08-17 00:00:00+03:00,out,False,882684,True,4,0,131,131
166405,2019-08-17 00:00:00+03:00,in,False,882686,False,2,292,314,22
166405,2019-08-17 00:00:00+03:00,out,False,882684,False,4,971,1050,79
166405,2019-08-17 00:00:00+03:00,out,False,882686,True,3,0,48,48
166405,2019-08-17 00:00:00+03:00,in,False,882684,False,1,259,270,11
166405,2019-08-18 00:00:00+03:00,in,False,882684,False,5,665,739,74
166405,2019-08-18 00:00:00+03:00,in,False,-1,True,13,0,21,21
166405,2019-08-18 00:00:00+03:00,out,False,882684,False,8,821,939,118
166405,2019-08-18 00:00:00+03:00,in,False,882686,False,1,2,28,26
166405,2019-08-18 00:00:00+03:00,out,True,882684,True,1,0,3,3
166405,2019-08-18 00:00:00+03:00,out,False,882686,True,5,0,10,10
166405,2019-08-18 00:00:00+03:00,out,False,882684,True,9,0,12,12
166405,2019-08-18 00:00:00+03:00,out,False,882686,False,3,151,180,29
166405,2019-08-18 00:00:00+03:00,in,False,882684,False,5,665,739,74
166405,2019-08-19 00:00:00+03:00,out,False,882686,False,17,4475,4770,295
166405,2019-08-19 00:00:00+03:00,in,False,882686,False,32,6617,6910,293
166405,2019-08-19 00:00:00+03:00,out,False,882686,True,12,0,179,179
166405,2019-08-19 00:00:00+03:00,out,False,882684,True,14,0,228,228
166405,2019-08-19 00:00:00+03:00,in,False,-1,True,16,0,183,183
166405,2019-08-19 00:00:00+03:00,out,False,882684,False,23,2602,2844,242
166405,2019-08-19 00:00:00+03:00,in,False,882684,True,1,0,7,7
166405,2019-08-19 00:00:00+03:00,in,False,882686,True,1,0,5,5
166405,2019-08-19 00:00:00+03:00,in,False,882684,False,19,1832,2039,207
166405,2019-08-20 00:00:00+03:00,out,False,882684,False,16,2213,2465,252
166405,2019-08-20 00:00:00+03:00,in,False,-1,True,2,0,17,17
166405,2019-08-20 00:00:00+03:00,out,False,882684,True,6,0,100,100
166405,2019-08-20 00:00:00+03:00,out,False,882686,False,16,2626,2828,202
166405,2019-08-20 00:00:00+03:00,in,False,882686,False,27,5800,6194,394
166405,2019-08-20 00:00:00+03:00,out,False,882686,True,3,0,32,32
166405,2019-08-20 00:00:00+03:00,in,False,882684,False,24,3215,3489,274
166405,2019-08-21 00:00:00+03:00,out,False,882684,False,19,2987,3199,212
166405,2019-08-21 00:00:00+03:00,out,False,882686,False,11,1647,1779,132
166405,2019-08-21 00:00:00+03:00,in,False,882686,False,16,2779,2899,120
166405,2019-08-21 00:00:00+03:00,in,False,882684,False,10,1915,2170,255
166405,2019-08-21 00:00:00+03:00,out,False,882684,True,9,0,205,205
166405,2019-08-21 00:00:00+03:00,in,False,-1,True,4,0,63,63
166405,2019-08-21 00:00:00+03:00,out,False,882686,True,9,0,123,123
166405,2019-08-21 00:00:00+03:00,out,False,882684,False,19,2987,3199,212
166405,2019-08-22 00:00:00+03:00,out,False,882686,True,2,0,31,31
166405,2019-08-22 00:00:00+03:00,out,False,882684,True,1,0,58,58
166405,2019-08-22 00:00:00+03:00,in,False,882686,False,13,3090,3233,143
166405,2019-08-22 00:00:00+03:00,in,False,-1,True,12,0,1,1
166405,2019-08-22 00:00:00+03:00,out,False,882684,False,4,920,972,52
166405,2019-08-22 00:00:00+03:00,in,False,882684,False,13,2730,2882,152
166405,2019-08-22 00:00:00+03:00,out,False,882686,False,7,735,816,81
166405,2019-08-23 00:00:00+03:00,out,False,882684,False,15,2795,2994,199
166405,2019-08-23 00:00:00+03:00,in,False,882684,False,27,5765,6256,491
166405,2019-08-23 00:00:00+03:00,out,False,882684,True,4,0,155,155
166405,2019-08-23 00:00:00+03:00,in,False,-1,True,12,0,83,83
166405,2019-08-24 00:00:00+03:00,in,False,-1,True,14,0,106,106
166405,2019-08-24 00:00:00+03:00,in,False,882684,True,1,0,14,14
166405,2019-08-24 00:00:00+03:00,out,False,882684,False,14,3124,3334,210
166405,2019-08-24 00:00:00+03:00,in,False,882684,False,7,1984,2128,144
166405,2019-08-24 00:00:00+03:00,out,False,882684,True,4,0,58,58
166405,2019-08-25 00:00:00+03:00,out,False,882684,True,4,0,63,63
166405,2019-08-25 00:00:00+03:00,in,False,882684,False,1,24,47,23
166405,2019-08-26 00:00:00+03:00,out,False,882684,True,3,0,74,74
166405,2019-08-26 00:00:00+03:00,out,False,882686,True,9,0,129,129
166405,2019-08-26 00:00:00+03:00,in,False,-1,True,22,0,210,210
166405,2019-08-26 00:00:00+03:00,in,False,882684,False,20,4198,4463,265
166405,2019-08-26 00:00:00+03:00,out,False,882686,False,15,2308,2483,175
166405,2019-08-26 00:00:00+03:00,in,False,882686,False,21,3202,3780,578
166405,2019-08-26 00:00:00+03:00,out,False,882684,False,13,1203,1342,139
166405,2019-08-26 00:00:00+03:00,in,False,-1,True,22,0,210,210
166405,2019-08-27 00:00:00+03:00,in,False,882684,False,12,1985,2118,133
166405,2019-08-27 00:00:00+03:00,in,False,-1,True,20,0,64,64
166405,2019-08-27 00:00:00+03:00,out,False,882686,True,5,0,36,36
166405,2019-08-27 00:00:00+03:00,in,False,882686,False,12,1549,1709,160
166405,2019-08-27 00:00:00+03:00,out,False,882686,False,5,1034,1105,71
166405,2019-08-27 00:00:00+03:00,out,False,882684,True,2,0,55,55
166405,2019-08-27 00:00:00+03:00,out,False,882684,False,7,904,989,85
166405,2019-08-28 00:00:00+03:00,in,False,882686,True,2,0,50,50
166405,2019-08-28 00:00:00+03:00,in,False,-1,True,6,0,142,142
166405,2019-08-28 00:00:00+03:00,out,False,882684,True,5,0,134,134
166405,2019-08-28 00:00:00+03:00,out,False,882684,False,13,1959,2161,202
166405,2019-08-28 00:00:00+03:00,in,False,882686,False,23,4266,4540,274
166405,2019-08-28 00:00:00+03:00,in,False,882684,False,24,4494,4745,251
166405,2019-08-28 00:00:00+03:00,out,False,882686,False,10,907,1044,137
166405,2019-08-28 00:00:00+03:00,out,False,882686,True,1,0,34,34
166405,2019-08-29 00:00:00+03:00,out,False,882684,False,13,2630,2793,163
166405,2019-08-29 00:00:00+03:00,in,False,-1,True,4,0,1,1
166405,2019-08-29 00:00:00+03:00,in,False,882684,False,11,1955,2055,100
166405,2019-08-29 00:00:00+03:00,out,False,882686,False,9,1670,1834,164
166405,2019-08-29 00:00:00+03:00,out,False,882684,True,10,0,325,325
166405,2019-08-29 00:00:00+03:00,in,False,882686,False,14,1725,1968,243
166405,2019-08-30 00:00:00+03:00,in,False,882686,False,6,1118,1196,78
166405,2019-08-30 00:00:00+03:00,out,False,882686,True,1,0,26,26
166405,2019-08-30 00:00:00+03:00,in,False,-1,True,27,0,22,22
166405,2019-08-30 00:00:00+03:00,out,False,882684,False,8,1253,1378,125
166405,2019-08-30 00:00:00+03:00,out,False,882684,True,6,0,106,106
166405,2019-08-30 00:00:00+03:00,out,False,882686,False,6,480,515,35
166405,2019-08-30 00:00:00+03:00,in,False,882684,False,9,1215,1332,117
166405,2019-08-30 00:00:00+03:00,out,False,882684,False,8,1253,1378,125
166405,2019-08-31 00:00:00+03:00,in,False,882686,False,7,1386,1455,69
166405,2019-08-31 00:00:00+03:00,in,False,-1,True,22,0,9,9
166405,2019-08-31 00:00:00+03:00,out,False,882684,False,12,2193,2358,165
166405,2019-08-31 00:00:00+03:00,out,False,882684,True,5,0,136,136
166405,2019-08-31 00:00:00+03:00,in,False,882684,False,12,3180,3354,174
166405,2019-08-31 00:00:00+03:00,out,False,882686,False,1,24,46,22
166405,2019-08-31 00:00:00+03:00,out,False,882686,True,3,0,31,31
166405,2019-08-31 00:00:00+03:00,out,False,882686,True,3,0,31,31
166405,2019-09-01 00:00:00+03:00,out,False,882684,False,11,3062,3211,149
166405,2019-09-01 00:00:00+03:00,out,False,882684,True,4,0,107,107
166405,2019-09-01 00:00:00+03:00,in,False,-1,True,42,0,9,9
166405,2019-09-01 00:00:00+03:00,in,False,882684,False,7,1956,2085,129
166405,2019-09-01 00:00:00+03:00,in,False,882686,False,5,909,1022,113
166405,2019-09-02 00:00:00+03:00,in,False,-1,True,8,0,163,163
166405,2019-09-02 00:00:00+03:00,in,False,882684,False,24,4937,5279,342
166405,2019-09-02 00:00:00+03:00,in,False,882686,False,12,2652,2762,110
166405,2019-09-02 00:00:00+03:00,out,False,882684,True,2,0,38,38
166405,2019-09-02 00:00:00+03:00,out,False,882686,True,3,0,54,54
166405,2019-09-02 00:00:00+03:00,out,False,882684,False,15,1903,2092,189
166405,2019-09-02 00:00:00+03:00,out,False,882686,False,11,2374,2504,130
166405,2019-09-03 00:00:00+03:00,out,False,882686,True,5,0,27,27
166405,2019-09-03 00:00:00+03:00,in,False,882684,False,16,3178,3409,231
166405,2019-09-03 00:00:00+03:00,out,False,902510,False,2,123,127,4
166405,2019-09-03 00:00:00+03:00,out,False,882684,False,6,1173,1243,70
166405,2019-09-03 00:00:00+03:00,in,False,902532,False,1,35,48,13
166405,2019-09-03 00:00:00+03:00,out,False,902532,False,1,69,71,2
166405,2019-09-03 00:00:00+03:00,in,False,882686,False,20,4502,4780,278
166405,2019-09-03 00:00:00+03:00,in,False,-1,True,6,0,223,223
166405,2019-09-03 00:00:00+03:00,out,False,882686,False,9,2000,2116,116
166405,2019-09-03 00:00:00+03:00,out,False,902510,False,2,123,127,4
166405,2019-09-03 00:00:00+03:00,in,False,882686,False,20,4502,4780,278
166405,2019-09-04 00:00:00+03:00,in,False,882686,False,10,1827,1993,166
166405,2019-09-04 00:00:00+03:00,out,False,882684,False,7,1571,1655,84
166405,2019-09-04 00:00:00+03:00,out,False,882684,True,3,0,43,43
166405,2019-09-04 00:00:00+03:00,out,False,882686,False,13,2567,2736,169
166405,2019-09-04 00:00:00+03:00,in,False,882684,False,4,1340,1397,57
166405,2019-09-04 00:00:00+03:00,in,False,-1,True,10,0,47,47
166405,2019-09-04 00:00:00+03:00,out,False,882686,True,3,0,33,33
166405,2019-09-04 00:00:00+03:00,in,False,-1,True,10,0,47,47
166405,2019-09-05 00:00:00+03:00,out,False,902510,False,19,2230,2444,214
166405,2019-09-05 00:00:00+03:00,out,False,882686,True,2,0,46,46
166405,2019-09-05 00:00:00+03:00,in,False,902532,False,5,516,619,103
166405,2019-09-05 00:00:00+03:00,out,False,902510,True,1,0,1,1
166405,2019-09-05 00:00:00+03:00,in,False,902510,False,3,335,468,133
166405,2019-09-05 00:00:00+03:00,out,False,882686,False,17,3204,3462,258
166405,2019-09-05 00:00:00+03:00,out,False,882684,True,6,0,116,116
166405,2019-09-05 00:00:00+03:00,out,False,882684,False,15,3733,3969,236
166405,2019-09-05 00:00:00+03:00,in,False,-1,True,19,0,306,306
166405,2019-09-05 00:00:00+03:00,out,False,902532,False,6,426,500,74
166405,2019-09-05 00:00:00+03:00,in,False,882684,False,17,4856,5041,185
166405,2019-09-05 00:00:00+03:00,out,False,902532,True,4,0,42,42
166405,2019-09-05 00:00:00+03:00,in,False,882686,False,8,1384,1461,77
166405,2019-09-05 00:00:00+03:00,out,False,882686,False,17,3204,3462,258
166405,2019-09-06 00:00:00+03:00,in,False,882684,False,25,6567,6937,370
166405,2019-09-06 00:00:00+03:00,out,False,882684,False,25,6213,6522,309
166405,2019-09-06 00:00:00+03:00,in,False,882686,False,19,3273,3552,279
166405,2019-09-06 00:00:00+03:00,out,False,902532,False,8,828,961,133
166405,2019-09-06 00:00:00+03:00,in,False,902532,False,8,821,947,126
166405,2019-09-06 00:00:00+03:00,out,False,902532,True,13,0,142,142
166405,2019-09-06 00:00:00+03:00,in,False,-1,True,41,0,221,221
166405,2019-09-06 00:00:00+03:00,out,False,882686,True,4,0,90,90
166405,2019-09-06 00:00:00+03:00,out,False,882686,False,3,316,354,38
166405,2019-09-06 00:00:00+03:00,out,False,882684,True,13,0,192,192
166405,2019-09-06 00:00:00+03:00,out,False,902510,False,32,3103,3653,550
166405,2019-09-06 00:00:00+03:00,out,False,902510,True,25,0,611,611
166405,2019-09-06 00:00:00+03:00,out,False,902510,True,25,0,611,611
166405,2019-09-06 00:00:00+03:00,in,False,882684,False,25,6567,6937,370
166405,2019-09-06 00:00:00+03:00,out,False,902532,False,8,828,961,133
166405,2019-09-07 00:00:00+03:00,in,False,882684,False,8,1696,1826,130
166405,2019-09-07 00:00:00+03:00,out,False,882686,False,1,366,392,26
166405,2019-09-07 00:00:00+03:00,out,False,902510,True,1,0,5,5
166405,2019-09-07 00:00:00+03:00,out,False,882684,False,8,1697,1803,106
166405,2019-09-07 00:00:00+03:00,out,False,902510,False,6,1164,1226,62
166405,2019-09-07 00:00:00+03:00,out,False,882686,True,1,0,9,9
166405,2019-09-07 00:00:00+03:00,in,False,-1,True,11,0,166,166
166405,2019-09-07 00:00:00+03:00,out,False,882684,True,5,0,98,98
166405,2019-09-07 00:00:00+03:00,in,False,882686,False,4,1137,1181,44
166405,2019-09-07 00:00:00+03:00,out,False,902510,True,1,0,5,5
166405,2019-09-08 00:00:00+03:00,out,False,882686,True,1,0,4,4
166405,2019-09-08 00:00:00+03:00,in,False,-1,True,12,0,390,390
166405,2019-09-08 00:00:00+03:00,out,False,882684,False,4,305,352,47
166405,2019-09-08 00:00:00+03:00,in,False,882686,False,1,300,327,27
166405,2019-09-08 00:00:00+03:00,out,False,882686,False,1,39,50,11
166405,2019-09-08 00:00:00+03:00,in,False,882684,False,6,1572,1632,60
166405,2019-09-08 00:00:00+03:00,out,False,882684,True,2,0,50,50
166405,2019-09-09 00:00:00+03:00,out,False,882684,False,11,971,1132,161
166405,2019-09-09 00:00:00+03:00,out,False,902510,True,5,0,125,125
166405,2019-09-09 00:00:00+03:00,in,False,882684,False,23,5242,5686,444
166405,2019-09-09 00:00:00+03:00,in,False,902510,False,5,442,543,101
166405,2019-09-09 00:00:00+03:00,out,False,882686,True,5,0,152,152
166405,2019-09-09 00:00:00+03:00,in,False,-1,True,11,0,265,265
166405,2019-09-09 00:00:00+03:00,in,False,882686,False,19,4794,5348,554
166405,2019-09-09 00:00:00+03:00,out,False,902510,False,7,682,787,105
166405,2019-09-09 00:00:00+03:00,out,False,882686,False,17,2705,2980,275
166405,2019-09-09 00:00:00+03:00,out,False,882684,True,11,0,187,187
166405,2019-09-09 00:00:00+03:00,in,False,882686,True,1,0,8,8
166405,2019-09-10 00:00:00+03:00,in,False,-1,True,20,0,596,596
166405,2019-09-10 00:00:00+03:00,in,False,882684,False,15,3647,3947,300
166405,2019-09-10 00:00:00+03:00,out,False,882686,True,1,0,39,39
166405,2019-09-10 00:00:00+03:00,in,False,902510,False,12,1415,1568,153
166405,2019-09-10 00:00:00+03:00,out,False,902510,False,35,3864,4388,524
166405,2019-09-10 00:00:00+03:00,out,False,882686,False,8,191,285,94
166405,2019-09-10 00:00:00+03:00,out,False,902510,True,9,0,164,164
166405,2019-09-10 00:00:00+03:00,in,False,882686,False,18,4170,4464,294
166405,2019-09-10 00:00:00+03:00,out,False,882684,False,11,1870,2017,147
166405,2019-09-10 00:00:00+03:00,out,False,882684,True,3,0,34,34
166405,2019-09-10 00:00:00+03:00,in,False,882686,False,18,4170,4464,294
166405,2019-09-11 00:00:00+03:00,in,False,882684,True,1,0,29,29
166405,2019-09-11 00:00:00+03:00,in,False,-1,True,20,0,48,48
166405,2019-09-11 00:00:00+03:00,out,False,902510,False,7,888,1056,168
166405,2019-09-11 00:00:00+03:00,out,False,882686,False,9,601,745,144
166405,2019-09-11 00:00:00+03:00,out,False,882684,True,4,0,107,107
166405,2019-09-11 00:00:00+03:00,in,False,902532,False,1,154,171,17
166405,2019-09-11 00:00:00+03:00,out,False,882686,True,1,0,60,60
166405,2019-09-11 00:00:00+03:00,in,False,882686,False,16,2495,2714,219
166405,2019-09-11 00:00:00+03:00,in,False,882684,False,18,4342,4648,306
166405,2019-09-11 00:00:00+03:00,out,False,882684,False,7,637,742,105
166405,2019-09-11 00:00:00+03:00,out,False,902510,True,2,0,66,66
166405,2019-09-11 00:00:00+03:00,in,False,-1,True,20,0,48,48
166405,2019-09-11 00:00:00+03:00,out,False,882684,False,7,637,742,105
166405,2019-09-12 00:00:00+03:00,out,False,882686,False,5,412,491,79
166405,2019-09-12 00:00:00+03:00,out,False,882686,True,6,0,124,124
166405,2019-09-12 00:00:00+03:00,in,False,-1,True,51,0,271,271
166405,2019-09-12 00:00:00+03:00,out,False,882684,True,2,0,47,47
166405,2019-09-12 00:00:00+03:00,in,False,882684,False,19,5299,5607,308
166405,2019-09-12 00:00:00+03:00,in,False,882686,False,13,2997,3257,260
166405,2019-09-12 00:00:00+03:00,out,False,882684,False,8,1397,1484,87
166405,2019-09-12 00:00:00+03:00,in,False,-1,True,51,0,271,271
166405,2019-09-13 00:00:00+03:00,in,False,902532,False,1,179,200,21
166405,2019-09-13 00:00:00+03:00,out,False,882684,True,8,0,157,157
166405,2019-09-13 00:00:00+03:00,out,False,902510,False,1,52,67,15
166405,2019-09-13 00:00:00+03:00,in,False,882686,False,11,2845,3143,298
166405,2019-09-13 00:00:00+03:00,in,False,882684,False,26,6593,7108,515
166405,2019-09-13 00:00:00+03:00,out,False,882684,False,13,1945,2223,278
166405,2019-09-13 00:00:00+03:00,out,False,882686,True,1,0,15,15
166405,2019-09-13 00:00:00+03:00,out,False,882686,False,4,287,333,46
166405,2019-09-13 00:00:00+03:00,in,False,-1,True,29,0,771,771
166405,2019-09-13 00:00:00+03:00,in,False,902510,False,2,311,350,39
166405,2019-09-14 00:00:00+03:00,in,False,-1,True,22,0,94,94
166405,2019-09-14 00:00:00+03:00,out,False,882684,False,8,1933,2034,101
166405,2019-09-14 00:00:00+03:00,in,False,902510,False,1,1,28,27
166405,2019-09-14 00:00:00+03:00,out,False,882684,True,3,0,46,46
166405,2019-09-14 00:00:00+03:00,in,False,882684,False,7,2016,2176,160
166405,2019-09-14 00:00:00+03:00,in,False,882686,False,7,2042,2173,131
166405,2019-09-15 00:00:00+03:00,in,False,882686,False,1,180,206,26
166405,2019-09-15 00:00:00+03:00,in,False,882684,False,1,285,297,12
166405,2019-09-15 00:00:00+03:00,out,False,882686,False,1,540,563,23
166405,2019-09-15 00:00:00+03:00,out,False,882684,True,2,0,83,83
166405,2019-09-15 00:00:00+03:00,out,False,882684,False,5,1831,1905,74
166405,2019-09-15 00:00:00+03:00,in,False,-1,True,2,0,102,102
166405,2019-09-15 00:00:00+03:00,out,False,882686,True,4,0,82,82
166405,2019-09-16 00:00:00+03:00,out,False,882686,False,14,2044,2290,246
166405,2019-09-16 00:00:00+03:00,in,False,882684,False,22,6445,6766,321
166405,2019-09-16 00:00:00+03:00,out,False,882686,True,7,0,177,177
166405,2019-09-16 00:00:00+03:00,in,False,-1,True,21,0,791,791
166405,2019-09-16 00:00:00+03:00,in,False,882686,False,23,6761,7134,373
166405,2019-09-16 00:00:00+03:00,out,False,882684,False,28,6248,6734,486
166405,2019-09-16 00:00:00+03:00,out,False,902510,False,2,455,485,30
166405,2019-09-16 00:00:00+03:00,out,False,882684,True,10,0,280,280
166405,2019-09-16 00:00:00+03:00,in,False,902510,False,2,83,114,31
166405,2019-09-17 00:00:00+03:00,in,False,882684,False,15,3013,3285,272
166405,2019-09-17 00:00:00+03:00,out,False,882684,True,2,0,61,61
166405,2019-09-17 00:00:00+03:00,in,False,-1,True,24,0,10,10
166405,2019-09-17 00:00:00+03:00,out,False,882686,False,11,1481,1624,143
166405,2019-09-17 00:00:00+03:00,out,False,902510,False,3,416,461,45
166405,2019-09-17 00:00:00+03:00,out,False,882686,True,3,0,98,98
166405,2019-09-17 00:00:00+03:00,out,False,882684,False,11,3171,3373,202
166405,2019-09-17 00:00:00+03:00,in,False,882686,False,14,4426,4601,175
166405,2019-09-17 00:00:00+03:00,out,False,882684,False,11,3171,3373,202
166405,2019-09-17 00:00:00+03:00,out,False,882684,True,2,0,61,61
166405,2019-09-17 00:00:00+03:00,out,False,902510,False,3,416,461,45
166405,2019-09-18 00:00:00+03:00,in,False,882684,False,19,3548,3934,386
166405,2019-09-18 00:00:00+03:00,in,False,882686,False,19,4313,4619,306
166405,2019-09-18 00:00:00+03:00,in,False,-1,True,1,0,59,59
166405,2019-09-18 00:00:00+03:00,out,False,882686,False,8,1197,1306,109
166405,2019-09-18 00:00:00+03:00,out,False,882684,False,8,1916,2022,106
166405,2019-09-18 00:00:00+03:00,out,False,882684,True,3,0,67,67
166405,2019-09-18 00:00:00+03:00,in,False,-1,True,22,0,764,764
166405,2019-09-18 00:00:00+03:00,out,False,882686,True,2,0,78,78
166405,2019-09-18 00:00:00+03:00,out,False,882684,False,8,1916,2022,106
166405,2019-09-19 00:00:00+03:00,in,False,882684,False,32,5812,6287,475
166405,2019-09-19 00:00:00+03:00,out,False,882684,True,3,0,68,68
166405,2019-09-19 00:00:00+03:00,in,False,-1,True,16,0,1702,1702
166405,2019-09-19 00:00:00+03:00,out,False,882686,False,6,1932,2032,100
166405,2019-09-19 00:00:00+03:00,in,False,882686,False,22,5901,6224,323
166405,2019-09-19 00:00:00+03:00,out,False,882684,False,18,5536,5786,250
166405,2019-09-19 00:00:00+03:00,out,False,882686,True,1,0,10,10
166405,2019-09-20 00:00:00+03:00,in,False,882684,False,11,3484,3656,172
166405,2019-09-20 00:00:00+03:00,out,False,882686,True,6,0,66,66
166405,2019-09-20 00:00:00+03:00,in,False,882686,False,21,5251,5676,425
166405,2019-09-20 00:00:00+03:00,in,False,-1,True,26,0,429,429
166405,2019-09-20 00:00:00+03:00,out,False,882686,False,14,2595,2770,175
166405,2019-09-21 00:00:00+03:00,out,False,882686,False,4,395,451,56
166405,2019-09-21 00:00:00+03:00,in,False,882686,False,7,1110,1237,127
166405,2019-09-21 00:00:00+03:00,in,False,-1,True,14,0,4,4
166405,2019-09-21 00:00:00+03:00,in,False,882684,False,1,173,184,11
166405,2019-09-22 00:00:00+03:00,out,False,882686,True,2,0,55,55
166405,2019-09-22 00:00:00+03:00,in,False,882686,False,5,455,549,94
166405,2019-09-22 00:00:00+03:00,out,False,882686,False,4,681,749,68
166405,2019-09-22 00:00:00+03:00,in,False,-1,True,15,0,218,218
166405,2019-09-23 00:00:00+03:00,out,False,882686,False,13,2636,2784,148
166405,2019-09-23 00:00:00+03:00,in,False,882686,False,25,6399,6820,421
166405,2019-09-23 00:00:00+03:00,in,False,882684,False,13,4019,4198,179
166405,2019-09-23 00:00:00+03:00,out,False,882684,False,1,387,406,19
166405,2019-09-23 00:00:00+03:00,in,False,-1,True,68,0,324,324
166405,2019-09-23 00:00:00+03:00,out,False,882686,True,2,0,77,77
166405,2019-09-24 00:00:00+03:00,out,False,882686,True,2,0,18,18
166405,2019-09-24 00:00:00+03:00,in,False,882686,False,32,6211,6753,542
166405,2019-09-24 00:00:00+03:00,in,False,-1,True,42,0,907,907
166405,2019-09-24 00:00:00+03:00,out,False,882686,False,12,5046,5219,173
166405,2019-09-24 00:00:00+03:00,out,False,882684,False,1,91,103,12
166405,2019-09-24 00:00:00+03:00,in,False,882684,False,23,3999,4344,345
166405,2019-09-24 00:00:00+03:00,out,False,882686,False,12,5046,5219,173
166405,2019-09-24 00:00:00+03:00,out,False,882686,True,2,0,18,18
166405,2019-09-25 00:00:00+03:00,in,False,-1,True,21,0,276,276
166405,2019-09-25 00:00:00+03:00,out,False,882684,False,2,1006,1022,16
166405,2019-09-25 00:00:00+03:00,in,False,882684,False,17,3413,3718,305
166405,2019-09-25 00:00:00+03:00,out,False,882686,False,15,3441,3649,208
166405,2019-09-25 00:00:00+03:00,in,False,882686,False,26,4436,4773,337
166405,2019-09-25 00:00:00+03:00,out,False,882686,True,4,0,69,69
166405,2019-09-26 00:00:00+03:00,in,False,882686,False,23,5790,6187,397
166405,2019-09-26 00:00:00+03:00,out,False,882684,True,3,0,83,83
166405,2019-09-26 00:00:00+03:00,in,False,-1,True,89,0,481,481
166405,2019-09-26 00:00:00+03:00,out,False,882684,False,4,1728,1761,33
166405,2019-09-26 00:00:00+03:00,out,False,882686,True,2,0,29,29
166405,2019-09-26 00:00:00+03:00,out,False,882686,False,16,1960,2194,234
166405,2019-09-26 00:00:00+03:00,in,False,882684,False,20,5083,5390,307
166405,2019-09-27 00:00:00+03:00,in,False,882684,False,9,1565,1765,200
166405,2019-09-27 00:00:00+03:00,in,False,882684,True,1,0,16,16
166405,2019-09-27 00:00:00+03:00,in,False,882686,False,21,1808,2420,612
166405,2019-09-27 00:00:00+03:00,in,False,-1,True,284,0,818,818
166405,2019-09-27 00:00:00+03:00,out,False,882686,False,11,2393,2550,157
166405,2019-09-27 00:00:00+03:00,out,False,882684,False,3,98,130,32
166405,2019-09-27 00:00:00+03:00,out,False,882686,True,1,0,22,22
166405,2019-09-28 00:00:00+03:00,out,False,882686,False,1,31,46,15
166405,2019-09-28 00:00:00+03:00,in,False,882686,False,2,32,58,26
166405,2019-09-28 00:00:00+03:00,out,False,882686,True,2,0,30,30
166405,2019-09-28 00:00:00+03:00,in,False,-1,True,263,0,342,342
166405,2019-09-28 00:00:00+03:00,in,False,-1,True,263,0,342,342
166405,2019-09-29 00:00:00+03:00,in,False,-1,True,19,0,4,4
166405,2019-09-30 00:00:00+03:00,in,False,882686,False,2,383,459,76
166405,2019-09-30 00:00:00+03:00,out,False,902510,True,1,0,13,13
166405,2019-09-30 00:00:00+03:00,out,False,902532,False,8,859,988,129
166405,2019-09-30 00:00:00+03:00,in,False,902532,False,1,106,130,24
166405,2019-09-30 00:00:00+03:00,in,False,-1,True,598,0,352,352
166405,2019-09-30 00:00:00+03:00,out,False,902532,True,1,0,13,13
166405,2019-09-30 00:00:00+03:00,out,False,902510,False,2,584,623,39
166405,2019-09-30 00:00:00+03:00,in,False,882684,False,1,378,399,21
166405,2019-10-01 00:00:00+03:00,out,True,902532,False,5,213,253,40
166405,2019-10-01 00:00:00+03:00,out,False,902532,False,22,5819,6145,326
166405,2019-10-01 00:00:00+03:00,out,False,902510,False,8,1311,1408,97
166405,2019-10-01 00:00:00+03:00,in,False,-1,True,714,0,467,467
166405,2019-10-01 00:00:00+03:00,in,False,902532,False,9,658,810,152
166405,2019-10-01 00:00:00+03:00,in,False,902510,False,3,127,320,193
166405,2019-10-01 00:00:00+03:00,out,False,902532,True,11,0,152,152
166405,2019-10-01 00:00:00+03:00,out,False,902510,True,1,0,50,50
166405,2019-10-01 00:00:00+03:00,in,False,-1,True,1,0,1,1
166405,2019-10-02 00:00:00+03:00,out,False,882688,False,6,785,883,98
166405,2019-10-02 00:00:00+03:00,out,False,902510,False,2,192,209,17
166405,2019-10-02 00:00:00+03:00,in,False,882686,False,3,539,586,47
166405,2019-10-02 00:00:00+03:00,in,False,-1,True,357,0,3940,3940
166405,2019-10-02 00:00:00+03:00,out,False,902532,False,19,3091,3353,262
166405,2019-10-02 00:00:00+03:00,in,False,882688,False,10,832,1325,493
166405,2019-10-02 00:00:00+03:00,out,False,882688,True,8,0,184,184
166405,2019-10-02 00:00:00+03:00,out,True,882686,True,2,0,86,86
166405,2019-10-02 00:00:00+03:00,out,False,882684,False,1,108,139,31
166405,2019-10-02 00:00:00+03:00,in,False,902510,False,2,217,296,79
166405,2019-10-02 00:00:00+03:00,in,False,902532,False,3,169,259,90
166405,2019-10-02 00:00:00+03:00,out,False,882686,True,1,0,4,4
166405,2019-10-02 00:00:00+03:00,out,False,902510,True,2,0,63,63
166405,2019-10-02 00:00:00+03:00,out,False,882684,True,1,0,1,1
166405,2019-10-02 00:00:00+03:00,out,True,882686,False,1,23,33,10
166405,2019-10-02 00:00:00+03:00,in,False,902532,True,1,0,111,111
166405,2019-10-02 00:00:00+03:00,out,True,902532,False,1,24,36,12
166405,2019-10-02 00:00:00+03:00,out,True,882686,True,2,0,86,86
166405,2019-10-02 00:00:00+03:00,in,False,902532,False,3,169,259,90
166405,2019-10-03 00:00:00+03:00,out,False,882684,True,1,0,1,1
166405,2019-10-03 00:00:00+03:00,in,False,-1,True,76,0,236,236
166405,2019-10-03 00:00:00+03:00,out,False,882684,False,2,96,117,21
166405,2019-10-04 00:00:00+03:00,out,False,902510,False,1,69,85,16
166405,2019-10-04 00:00:00+03:00,in,False,-1,True,40,0,88,88
166405,2019-10-05 00:00:00+03:00,out,False,902532,True,2,0,37,37
166405,2019-10-05 00:00:00+03:00,out,False,902510,False,2,147,174,27
166405,2019-10-05 00:00:00+03:00,out,False,902532,False,19,1598,1919,321
166405,2019-10-05 00:00:00+03:00,in,False,-1,True,27,0,24,24
166405,2019-10-05 00:00:00+03:00,in,False,902532,False,1,58,84,26
166405,2019-10-06 00:00:00+03:00,in,False,-1,True,5,0,10,10
166405,2019-10-07 00:00:00+03:00,in,False,902510,False,3,170,257,87
166405,2019-10-07 00:00:00+03:00,in,False,902532,False,2,186,291,105
166405,2019-10-07 00:00:00+03:00,out,False,882684,True,1,0,1,1
166405,2019-10-07 00:00:00+03:00,in,False,882684,False,12,549,688,139
166405,2019-10-07 00:00:00+03:00,in,False,-1,True,14,0,45,45
166405,2019-10-07 00:00:00+03:00,out,False,882684,False,4,1660,1675,15
166405,2019-10-07 00:00:00+03:00,out,False,902510,False,17,2343,2576,233
166405,2019-10-07 00:00:00+03:00,out,False,902532,False,45,5253,5974,721
166405,2019-10-07 00:00:00+03:00,out,False,902532,True,31,0,876,876
166405,2019-10-07 00:00:00+03:00,out,False,902510,True,4,0,132,132
166405,2019-10-07 00:00:00+03:00,in,False,-1,True,14,0,45,45
166405,2019-10-07 00:00:00+03:00,in,False,902510,False,3,170,257,87
166405,2019-10-08 00:00:00+03:00,out,False,882684,False,2,292,296,4
166405,2019-10-08 00:00:00+03:00,out,False,902532,False,28,3323,3787,464
166405,2019-10-08 00:00:00+03:00,in,False,-1,True,10,0,84,84
166405,2019-10-08 00:00:00+03:00,out,False,882690,True,10,0,376,376
166405,2019-10-08 00:00:00+03:00,out,False,882686,False,1,14,31,17
166405,2019-10-08 00:00:00+03:00,out,False,902510,True,1,0,13,13
166405,2019-10-08 00:00:00+03:00,out,False,902532,True,10,0,333,333
166405,2019-10-08 00:00:00+03:00,out,False,902510,False,6,754,828,74
166405,2019-10-08 00:00:00+03:00,out,False,882690,False,30,3854,4375,521
166405,2019-10-08 00:00:00+03:00,in,False,902532,False,4,908,1106,198
166405,2019-10-09 00:00:00+03:00,in,False,-1,True,21,0,861,861
166405,2019-10-09 00:00:00+03:00,out,False,902532,False,17,2244,2545,301
166405,2019-10-09 00:00:00+03:00,out,False,882690,True,21,0,443,443
166405,2019-10-09 00:00:00+03:00,out,False,902510,True,13,0,285,285
166405,2019-10-09 00:00:00+03:00,out,False,902510,False,19,1668,2064,396
166405,2019-10-09 00:00:00+03:00,out,False,902532,True,3,0,142,142
166405,2019-10-09 00:00:00+03:00,in,False,882690,False,4,296,384,88
166405,2019-10-09 00:00:00+03:00,in,False,902510,False,2,456,506,50
166405,2019-10-09 00:00:00+03:00,out,False,882690,False,60,7132,8160,1028
166405,2019-10-09 00:00:00+03:00,in,False,902532,False,7,670,777,107
166405,2019-10-09 00:00:00+03:00,in,False,882690,False,4,296,384,88
166405,2019-10-09 00:00:00+03:00,out,False,902532,True,3,0,142,142
166405,2019-10-10 00:00:00+03:00,out,False,902510,False,42,5220,5945,725
166405,2019-10-10 00:00:00+03:00,out,False,902532,True,7,0,158,158
166405,2019-10-10 00:00:00+03:00,in,False,902532,False,10,1817,2011,194
166405,2019-10-10 00:00:00+03:00,out,False,882684,False,3,542,607,65
166405,2019-10-10 00:00:00+03:00,out,False,882690,True,25,0,534,534
166405,2019-10-10 00:00:00+03:00,in,False,882690,False,5,362,426,64
166405,2019-10-10 00:00:00+03:00,in,False,-1,True,26,0,344,344
166405,2019-10-10 00:00:00+03:00,out,False,902510,True,31,0,389,389
166405,2019-10-10 00:00:00+03:00,out,False,902532,False,12,880,1112,232
166405,2019-10-10 00:00:00+03:00,out,False,882690,False,46,4629,5439,810
166405,2019-10-10 00:00:00+03:00,out,False,882684,False,3,542,607,65
166405,2019-10-11 00:00:00+03:00,out,False,882688,True,1,0,14,14
166405,2019-10-11 00:00:00+03:00,out,False,882690,False,35,5800,6535,735
166405,2019-10-11 00:00:00+03:00,in,False,-1,True,24,0,602,602
166405,2019-10-11 00:00:00+03:00,in,False,882690,False,7,1039,1167,128
166405,2019-10-11 00:00:00+03:00,out,False,902532,False,3,217,259,42
166405,2019-10-11 00:00:00+03:00,out,True,882684,True,1,0,0,0
166405,2019-10-11 00:00:00+03:00,out,True,902510,True,1,0,1,1
166405,2019-10-11 00:00:00+03:00,out,False,882684,False,4,325,393,68
166405,2019-10-11 00:00:00+03:00,in,False,902532,False,5,507,676,169
166405,2019-10-11 00:00:00+03:00,out,False,902510,False,74,8167,9428,1261
166405,2019-10-11 00:00:00+03:00,out,False,882688,False,2,254,281,27
166405,2019-10-11 00:00:00+03:00,out,False,882690,True,22,0,409,409
166405,2019-10-11 00:00:00+03:00,out,False,902532,True,2,0,66,66
166405,2019-10-11 00:00:00+03:00,in,False,902510,False,5,266,391,125
166405,2019-10-11 00:00:00+03:00,out,False,902510,True,47,0,813,813
166405,2019-10-12 00:00:00+03:00,in,False,-1,True,11,0,4,4
166405,2019-10-13 00:00:00+03:00,in,False,-1,True,2,0,4,4
166405,2019-10-14 00:00:00+03:00,in,False,882684,False,1,81,91,10
166405,2019-10-14 00:00:00+03:00,out,False,902510,True,3,0,136,136
166405,2019-10-14 00:00:00+03:00,in,False,-1,True,34,0,1094,1094
166405,2019-10-14 00:00:00+03:00,out,False,882684,False,1,46,61,15
166405,2019-10-14 00:00:00+03:00,in,False,882690,False,9,1072,1329,257
166405,2019-10-14 00:00:00+03:00,out,False,882690,True,23,0,537,537
166405,2019-10-14 00:00:00+03:00,out,False,882690,False,51,5361,6325,964
166405,2019-10-14 00:00:00+03:00,out,False,882684,True,2,0,27,27
166405,2019-10-14 00:00:00+03:00,out,False,902510,False,6,359,458,99
166405,2019-10-14 00:00:00+03:00,out,False,882686,True,32,0,683,683
166405,2019-10-14 00:00:00+03:00,out,False,882686,False,58,5077,6016,939
166405,2019-10-14 00:00:00+03:00,in,False,902510,False,2,613,695,82
166405,2019-10-14 00:00:00+03:00,out,False,882684,False,1,46,61,15
166405,2019-10-15 00:00:00+03:00,in,False,902510,False,12,1427,1694,267
166405,2019-10-15 00:00:00+03:00,out,False,882690,False,64,7462,8531,1069
166405,2019-10-15 00:00:00+03:00,out,False,882686,True,20,0,464,464
166405,2019-10-15 00:00:00+03:00,out,False,902510,False,31,3467,3946,479
166405,2019-10-15 00:00:00+03:00,out,False,882684,True,2,0,82,82
166405,2019-10-15 00:00:00+03:00,out,False,882686,False,50,6091,6843,752
166405,2019-10-15 00:00:00+03:00,out,False,902510,True,17,0,441,441
166405,2019-10-15 00:00:00+03:00,in,False,-1,True,34,0,712,712
166405,2019-10-15 00:00:00+03:00,in,False,882690,False,13,1243,1597,354
166405,2019-10-15 00:00:00+03:00,out,False,882690,True,25,0,694,694
166405,2019-10-15 00:00:00+03:00,in,False,902510,False,12,1427,1694,267
166405,2019-10-16 00:00:00+03:00,out,False,882690,False,78,11795,13169,1374
166405,2019-10-16 00:00:00+03:00,in,False,-1,True,54,0,971,971
166405,2019-10-16 00:00:00+03:00,in,False,902510,False,1,55,107,52
166405,2019-10-16 00:00:00+03:00,out,False,882686,True,28,0,579,579
166405,2019-10-16 00:00:00+03:00,out,False,882690,True,36,0,979,979
166405,2019-10-16 00:00:00+03:00,out,False,882686,False,63,8000,8914,914
166405,2019-10-16 00:00:00+03:00,out,False,882688,False,1,146,154,8
166405,2019-10-16 00:00:00+03:00,in,False,882690,False,13,1572,2241,669
166405,2019-10-16 00:00:00+03:00,out,False,882690,True,36,0,979,979
166405,2019-10-16 00:00:00+03:00,out,False,882686,True,28,0,579,579
166405,2019-10-17 00:00:00+03:00,out,False,939470,True,1,0,1,1
166405,2019-10-17 00:00:00+03:00,out,False,882688,False,19,3152,3462,310
166405,2019-10-17 00:00:00+03:00,out,False,902510,True,29,0,605,605
166405,2019-10-17 00:00:00+03:00,out,True,939470,True,1,0,60,60
166405,2019-10-17 00:00:00+03:00,out,False,882690,True,5,0,189,189
166405,2019-10-17 00:00:00+03:00,out,False,902510,False,33,3566,4205,639
166405,2019-10-17 00:00:00+03:00,in,False,882688,False,5,651,831,180
166405,2019-10-17 00:00:00+03:00,out,False,882684,False,6,2264,2273,9
166405,2019-10-17 00:00:00+03:00,out,True,882684,True,8,0,252,252
166405,2019-10-17 00:00:00+03:00,in,False,-1,True,34,0,1004,1004
166405,2019-10-17 00:00:00+03:00,out,False,882684,True,6,0,4,4
166405,2019-10-17 00:00:00+03:00,out,False,882688,True,6,0,100,100
166405,2019-10-17 00:00:00+03:00,out,False,882690,False,17,1181,1483,302
166405,2019-10-17 00:00:00+03:00,in,False,882690,False,3,129,199,70
166405,2019-10-17 00:00:00+03:00,in,False,902510,False,10,3448,3702,254
166405,2019-10-17 00:00:00+03:00,out,False,939474,True,2,0,2,2
166405,2019-10-17 00:00:00+03:00,out,False,882686,True,23,0,445,445
166405,2019-10-17 00:00:00+03:00,out,False,882686,False,66,7829,8751,922
166405,2019-10-17 00:00:00+03:00,in,False,882686,False,3,197,295,98
166405,2019-10-17 00:00:00+03:00,in,False,939474,False,1,134,148,14
166405,2019-10-17 00:00:00+03:00,in,False,-1,True,34,0,1004,1004
166405,2019-10-17 00:00:00+03:00,out,False,882688,False,19,3152,3462,310
166405,2019-10-17 00:00:00+03:00,in,False,882688,False,5,651,831,180
166405,2019-10-17 00:00:00+03:00,out,False,902510,False,33,3566,4205,639
166405,2019-10-18 00:00:00+03:00,out,False,882684,True,3,0,22,22
166405,2019-10-18 00:00:00+03:00,out,False,902510,False,13,465,745,280
166405,2019-10-18 00:00:00+03:00,out,False,902510,True,13,0,451,451
166405,2019-10-18 00:00:00+03:00,out,False,882686,True,34,0,587,587
166405,2019-10-18 00:00:00+03:00,out,False,882684,False,5,878,912,34
166405,2019-10-18 00:00:00+03:00,in,False,882690,False,12,1152,1733,581
166405,2019-10-18 00:00:00+03:00,out,False,939470,True,7,0,23,23
166405,2019-10-18 00:00:00+03:00,in,False,882686,False,1,94,99,5
166405,2019-10-18 00:00:00+03:00,out,False,882690,False,51,4929,5938,1009
166405,2019-10-18 00:00:00+03:00,out,False,902532,False,39,5179,5849,670
166405,2019-10-18 00:00:00+03:00,out,False,882686,False,76,7764,8891,1127
166405,2019-10-18 00:00:00+03:00,in,False,902532,False,11,1268,1598,330
166405,2019-10-18 00:00:00+03:00,out,False,882690,True,39,0,1043,1043
166405,2019-10-18 00:00:00+03:00,in,False,-1,True,18,0,948,948
166405,2019-10-18 00:00:00+03:00,out,False,939474,True,2,0,9,9
166405,2019-10-18 00:00:00+03:00,out,False,902532,True,16,0,215,215
166405,2019-10-18 00:00:00+03:00,out,False,882686,False,76,7764,8891,1127
166405,2019-10-19 00:00:00+03:00,in,False,-1,True,11,0,95,95
166405,2019-10-20 00:00:00+03:00,in,False,-1,True,1,0,56,56
166405,2019-10-21 00:00:00+03:00,out,False,882690,False,61,8053,9141,1088
166405,2019-10-21 00:00:00+03:00,out,False,882686,True,38,0,528,528
166405,2019-10-21 00:00:00+03:00,out,False,882684,True,7,0,0,0
166405,2019-10-21 00:00:00+03:00,out,False,882690,True,28,0,738,738
166405,2019-10-21 00:00:00+03:00,in,False,882690,True,1,0,11,11
166405,2019-10-21 00:00:00+03:00,out,False,882684,False,6,617,648,31
166405,2019-10-21 00:00:00+03:00,out,False,939474,True,4,0,1,1
166405,2019-10-21 00:00:00+03:00,in,False,-1,True,36,0,2285,2285
166405,2019-10-21 00:00:00+03:00,out,False,882686,False,64,6827,7755,928
166405,2019-10-21 00:00:00+03:00,in,False,882684,False,1,185,242,57
166405,2019-10-21 00:00:00+03:00,in,False,882690,False,24,2080,3406,1326
166405,2019-10-21 00:00:00+03:00,out,False,882690,True,28,0,738,738
166405,2019-10-22 00:00:00+03:00,out,False,882684,True,1,0,0,0
166405,2019-10-22 00:00:00+03:00,out,False,882690,True,40,0,1025,1025
166405,2019-10-22 00:00:00+03:00,in,False,882690,False,11,1221,1711,490
166405,2019-10-22 00:00:00+03:00,out,False,902510,False,9,1055,1195,140
166405,2019-10-22 00:00:00+03:00,out,False,882686,True,29,0,600,600
166405,2019-10-22 00:00:00+03:00,out,False,902532,False,59,7844,8844,1000
166405,2019-10-22 00:00:00+03:00,in,False,-1,True,40,0,2148,2148
166405,2019-10-22 00:00:00+03:00,out,False,882690,False,60,5931,6873,942
166405,2019-10-22 00:00:00+03:00,in,False,902532,False,18,3355,4039,684
166405,2019-10-22 00:00:00+03:00,out,False,902510,True,3,0,128,128
166405,2019-10-22 00:00:00+03:00,out,False,902532,True,32,0,982,982
166405,2019-10-22 00:00:00+03:00,out,False,882686,False,67,7613,8647,1034
166405,2019-10-22 00:00:00+03:00,out,False,882690,True,40,0,1025,1025
166405,2019-10-23 00:00:00+03:00,out,False,882686,False,55,4867,5662,795
166405,2019-10-23 00:00:00+03:00,out,False,902510,False,65,7794,9092,1298
166405,2019-10-23 00:00:00+03:00,out,False,902532,False,1,156,174,18
166405,2019-10-23 00:00:00+03:00,in,False,902510,False,12,1537,2063,526
166405,2019-10-23 00:00:00+03:00,in,False,882690,False,6,451,569,118
166405,2019-10-23 00:00:00+03:00,out,False,902532,True,4,0,182,182
166405,2019-10-23 00:00:00+03:00,out,False,882686,True,27,0,536,536
166405,2019-10-23 00:00:00+03:00,out,False,882690,True,26,0,590,590
166405,2019-10-23 00:00:00+03:00,out,False,882684,False,1,45,52,7
166405,2019-10-23 00:00:00+03:00,in,False,902532,False,1,285,322,37
166405,2019-10-23 00:00:00+03:00,in,False,-1,True,10,0,365,365
166405,2019-10-23 00:00:00+03:00,in,False,882684,False,1,14,54,40
166405,2019-10-23 00:00:00+03:00,out,False,882690,False,37,1706,2357,651
166405,2019-10-23 00:00:00+03:00,out,False,902510,True,41,0,1382,1382
166405,2019-10-23 00:00:00+03:00,in,False,902532,False,1,285,322,37
166405,2019-10-24 00:00:00+03:00,out,False,882690,True,41,0,1441,1441
166405,2019-10-24 00:00:00+03:00,out,False,882684,False,6,614,724,110
166405,2019-10-24 00:00:00+03:00,out,False,882690,False,90,10346,12026,1680
166405,2019-10-24 00:00:00+03:00,out,False,882684,True,4,0,27,27
166405,2019-10-24 00:00:00+03:00,in,False,882690,False,14,914,1587,673
166405,2019-10-24 00:00:00+03:00,out,False,902510,False,42,4186,4941,755
166405,2019-10-24 00:00:00+03:00,out,False,882686,True,12,0,280,280
166405,2019-10-24 00:00:00+03:00,out,False,882686,False,54,5453,6406,953
166405,2019-10-24 00:00:00+03:00,in,False,902510,False,2,97,159,62
166405,2019-10-24 00:00:00+03:00,in,False,-1,True,30,0,1557,1557
166405,2019-10-24 00:00:00+03:00,out,False,902510,True,17,0,582,582
166405,2019-10-24 00:00:00+03:00,in,False,-1,True,30,0,1557,1557
166405,2019-10-24 00:00:00+03:00,out,False,882686,True,12,0,280,280
166405,2019-10-24 00:00:00+03:00,out,False,902510,True,17,0,582,582
166405,2019-10-25 00:00:00+03:00,out,False,882686,False,21,1921,2203,282
166405,2019-10-25 00:00:00+03:00,out,False,882686,True,5,0,70,70
166405,2019-10-25 00:00:00+03:00,out,False,902532,True,5,0,129,129
166405,2019-10-25 00:00:00+03:00,out,False,902510,True,15,0,432,432
166405,2019-10-25 00:00:00+03:00,out,False,902510,False,36,4648,5290,642
166405,2019-10-25 00:00:00+03:00,in,False,902510,False,14,1651,1962,311
166405,2019-10-25 00:00:00+03:00,out,False,882690,True,18,0,339,339
166405,2019-10-25 00:00:00+03:00,out,False,902532,False,22,1352,1774,422
166405,2019-10-25 00:00:00+03:00,out,False,882690,False,60,10099,11120,1021
166405,2019-10-25 00:00:00+03:00,in,False,902510,True,1,0,12,12
166405,2019-10-25 00:00:00+03:00,in,False,882690,False,13,1210,1560,350
166405,2019-10-25 00:00:00+03:00,in,False,-1,True,18,0,974,974
166405,2019-10-26 00:00:00+03:00,in,False,-1,True,34,0,696,696
166405,2019-10-27 00:00:00+03:00,in,False,-1,True,20,0,234,234
166405,2019-10-27 00:00:00+03:00,out,False,902510,True,10,0,265,265
166405,2019-10-27 00:00:00+03:00,out,False,902510,False,31,3675,4267,592
166405,2019-10-28 00:00:00+03:00,out,False,902510,False,19,3044,3353,309
166405,2019-10-28 00:00:00+03:00,in,False,939474,False,3,356,400,44
166405,2019-10-28 00:00:00+03:00,out,False,902532,False,18,1335,1617,282
166405,2019-10-28 00:00:00+03:00,out,False,939474,False,5,374,473,99
166405,2019-10-28 00:00:00+03:00,out,False,882690,True,24,0,601,601
166405,2019-10-28 00:00:00+03:00,in,False,939470,False,2,46,95,49
166405,2019-10-28 00:00:00+03:00,in,False,-1,True,104,0,6113,6113
166405,2019-10-28 00:00:00+03:00,in,False,882690,False,6,516,1472,956
166405,2019-10-28 00:00:00+03:00,out,False,882690,False,48,5167,6029,862
166405,2019-10-28 00:00:00+03:00,in,False,882690,True,1,0,109,109
166405,2019-10-28 00:00:00+03:00,out,False,939470,True,2,0,0,0
166405,2019-10-28 00:00:00+03:00,out,False,902510,True,23,0,316,316
166405,2019-10-28 00:00:00+03:00,out,False,882686,False,36,2256,2806,550
166405,2019-10-28 00:00:00+03:00,out,False,939474,True,5,0,46,46
166405,2019-10-28 00:00:00+03:00,out,False,882686,True,20,0,416,416
166405,2019-10-28 00:00:00+03:00,in,False,902510,False,7,2027,2444,417
166405,2019-10-28 00:00:00+03:00,in,False,882686,False,2,58,153,95
166405,2019-10-28 00:00:00+03:00,out,False,902532,True,4,0,69,69
166405,2019-10-28 00:00:00+03:00,out,False,939474,True,5,0,46,46
166405,2019-10-29 00:00:00+03:00,out,True,882686,False,1,6,18,12
166405,2019-10-29 00:00:00+03:00,out,False,882686,True,3,0,89,89
166405,2019-10-29 00:00:00+03:00,out,True,882686,True,2,0,16,16
166405,2019-10-29 00:00:00+03:00,out,True,902532,True,1,0,10,10
166405,2019-10-29 00:00:00+03:00,in,False,939470,False,1,12,34,22
166405,2019-10-29 00:00:00+03:00,in,False,902510,False,6,1044,1288,244
166405,2019-10-29 00:00:00+03:00,out,False,939478,True,6,0,9,9
166405,2019-10-29 00:00:00+03:00,out,False,939470,False,2,14,43,29
166405,2019-10-29 00:00:00+03:00,out,False,902510,True,5,0,58,58
166405,2019-10-29 00:00:00+03:00,out,False,939474,False,1,36,51,15
166405,2019-10-29 00:00:00+03:00,out,False,902510,False,15,2054,2302,248
166405,2019-10-29 00:00:00+03:00,out,False,882684,False,1,1104,1105,1
166405,2019-10-29 00:00:00+03:00,in,False,882690,False,4,527,779,252
166405,2019-10-29 00:00:00+03:00,out,False,939476,False,4,412,478,66
166405,2019-10-29 00:00:00+03:00,out,False,939474,True,2,0,38,38
166405,2019-10-29 00:00:00+03:00,out,False,882690,False,50,8998,9840,842
166405,2019-10-29 00:00:00+03:00,in,False,882686,False,7,1345,1448,103
166405,2019-10-29 00:00:00+03:00,out,False,882686,False,8,724,850,126
166405,2019-10-29 00:00:00+03:00,out,False,882690,True,21,0,704,704
166405,2019-10-29 00:00:00+03:00,out,False,939478,False,2,34,50,16
166405,2019-10-29 00:00:00+03:00,out,False,902532,False,5,600,672,72
166405,2019-10-29 00:00:00+03:00,in,False,-1,True,55,0,2058,2058
166405,2019-10-29 00:00:00+03:00,in,False,-1,True,55,0,2058,2058
166405,2019-10-29 00:00:00+03:00,out,False,902510,True,5,0,58,58
166405,2019-10-30 00:00:00+03:00,in,False,882686,False,2,394,416,22
166405,2019-10-30 00:00:00+03:00,out,False,882686,True,24,0,608,608
166405,2019-10-30 00:00:00+03:00,out,False,902510,True,28,0,597,597
166405,2019-10-30 00:00:00+03:00,out,False,902510,False,31,3471,3930,459
166405,2019-10-30 00:00:00+03:00,out,False,902532,True,6,0,232,232
166405,2019-10-30 00:00:00+03:00,out,False,882690,False,69,9158,10450,1292
166405,2019-10-30 00:00:00+03:00,in,False,902510,False,7,990,1473,483
166405,2019-10-30 00:00:00+03:00,in,False,902510,True,1,0,54,54
166405,2019-10-30 00:00:00+03:00,out,False,902532,False,24,3442,3885,443
166405,2019-10-30 00:00:00+03:00,out,False,882690,True,27,0,1001,1001
166405,2019-10-30 00:00:00+03:00,in,False,902532,False,1,259,294,35
166405,2019-10-30 00:00:00+03:00,in,False,-1,True,31,0,1615,1615
166405,2019-10-30 00:00:00+03:00,in,False,882690,False,1,67,104,37
166405,2019-10-30 00:00:00+03:00,out,False,882686,False,51,5852,6653,801
166405,2019-10-30 00:00:00+03:00,out,False,882690,False,69,9158,10450,1292
166405,2019-10-31 00:00:00+03:00,out,False,882686,False,22,3720,4101,381
166405,2019-10-31 00:00:00+03:00,in,False,882686,False,3,244,321,77
166405,2019-10-31 00:00:00+03:00,in,False,-1,True,46,0,1348,1348
166405,2019-10-31 00:00:00+03:00,out,False,939478,True,1,0,32,32
166405,2019-10-31 00:00:00+03:00,out,False,902510,False,19,1960,2297,337
166405,2019-10-31 00:00:00+03:00,in,False,902510,False,5,879,1180,301
166405,2019-10-31 00:00:00+03:00,out,False,902510,True,15,0,358,358
166405,2019-10-31 00:00:00+03:00,out,False,882686,True,10,0,201,201
166405,2019-10-31 00:00:00+03:00,out,False,939478,False,3,93,129,36
166405,2019-10-31 00:00:00+03:00,out,False,882690,False,20,3162,3528,366
166405,2019-10-31 00:00:00+03:00,out,False,939476,False,1,671,673,2
166405,2019-10-31 00:00:00+03:00,out,False,882690,True,11,0,204,204
166405,2019-10-31 00:00:00+03:00,out,False,939476,True,2,0,32,32
166405,2019-10-31 00:00:00+03:00,out,True,882690,False,1,5,13,8
166405,2019-10-31 00:00:00+03:00,in,False,882690,False,8,553,881,328
166405,2019-10-31 00:00:00+03:00,in,False,-1,True,46,0,1348,1348
166405,2019-10-31 00:00:00+03:00,out,False,882686,False,22,3720,4101,381
166405,2019-11-01 00:00:00+03:00,in,False,882690,False,13,158,363,205
166405,2019-11-01 00:00:00+03:00,out,False,902532,True,7,0,171,171
166405,2019-11-01 00:00:00+03:00,out,False,939478,True,1,0,60,60
166405,2019-11-01 00:00:00+03:00,out,False,882686,True,3,0,80,80
166405,2019-11-01 00:00:00+03:00,out,False,902532,False,20,1243,1595,352
166405,2019-11-01 00:00:00+03:00,in,False,-1,True,108,0,5369,5369
166405,2019-11-01 00:00:00+03:00,out,True,902532,True,1,0,0,0
166405,2019-11-01 00:00:00+03:00,out,False,939476,False,1,213,214,1
166405,2019-11-01 00:00:00+03:00,in,False,939478,False,1,106,111,5
166405,2019-11-01 00:00:00+03:00,out,False,882690,True,19,0,667,667
166405,2019-11-01 00:00:00+03:00,in,False,882686,False,3,84,127,43
166405,2019-11-01 00:00:00+03:00,out,False,882686,False,2,43,72,29
166405,2019-11-01 00:00:00+03:00,out,False,902510,False,1,24,37,13
166405,2019-11-01 00:00:00+03:00,out,False,902510,True,1,0,42,42
166405,2019-11-01 00:00:00+03:00,out,False,882690,False,23,3162,3573,411
166405,2019-11-01 00:00:00+03:00,out,False,939478,False,6,170,233,63
166405,2019-11-02 00:00:00+03:00,in,False,-1,True,35,0,1440,1440
166405,2019-11-03 00:00:00+03:00,in,False,-1,True,22,0,6,6
166405,2019-11-04 00:00:00+03:00,out,False,902510,False,6,935,1032,97
166405,2019-11-04 00:00:00+03:00,out,False,939478,True,2,0,15,15
166405,2019-11-04 00:00:00+03:00,out,False,882686,True,5,0,123,123
166405,2019-11-04 00:00:00+03:00,out,False,902532,True,11,0,342,342
166405,2019-11-04 00:00:00+03:00,out,False,882686,False,12,1528,1754,226
166405,2019-11-04 00:00:00+03:00,out,False,902510,True,4,0,167,167
166405,2019-11-04 00:00:00+03:00,out,False,939478,False,2,146,147,1
166405,2019-11-04 00:00:00+03:00,in,False,-1,True,86,0,2902,2902
166405,2019-11-04 00:00:00+03:00,out,False,902532,False,20,2153,2548,395
166405,2019-11-04 00:00:00+03:00,out,False,902532,False,20,2153,2548,395
166405,2019-11-05 00:00:00+03:00,out,False,939478,False,8,4290,4382,92
166405,2019-11-05 00:00:00+03:00,in,False,939478,False,1,6,18,12
166405,2019-11-05 00:00:00+03:00,in,False,939470,False,3,583,620,37
166405,2019-11-05 00:00:00+03:00,out,False,902510,True,16,0,528,528
166405,2019-11-05 00:00:00+03:00,out,False,902510,False,10,839,1027,188
166405,2019-11-05 00:00:00+03:00,in,False,939474,False,4,3700,3727,27
166405,2019-11-05 00:00:00+03:00,out,False,939478,True,3,0,65,65
166405,2019-11-05 00:00:00+03:00,in,False,-1,True,209,0,12359,12359
166405,2019-11-05 00:00:00+03:00,in,False,902510,False,1,11,16,5
166405,2019-11-06 00:00:00+03:00,out,False,902510,False,15,1681,1936,255
166405,2019-11-06 00:00:00+03:00,out,False,902510,True,19,0,506,506
166405,2019-11-06 00:00:00+03:00,in,False,-1,True,131,0,68,68
166405,2019-11-07 00:00:00+03:00,in,False,-1,True,61,0,21,21
166405,2019-11-08 00:00:00+03:00,in,False,902532,False,3,201,237,36
166405,2019-11-08 00:00:00+03:00,in,False,-1,True,73,0,667,667
166405,2019-11-08 00:00:00+03:00,out,False,882686,True,2,0,72,72
166405,2019-11-08 00:00:00+03:00,out,False,939476,True,2,0,64,64
166405,2019-11-08 00:00:00+03:00,out,False,902510,True,2,0,55,55
166405,2019-11-08 00:00:00+03:00,out,False,939478,False,4,440,463,23
166405,2019-11-08 00:00:00+03:00,out,False,902510,False,1,81,119,38
166405,2019-11-08 00:00:00+03:00,out,False,882686,False,13,1479,1664,185
166405,2019-11-08 00:00:00+03:00,out,False,902532,False,1,111,148,37
166405,2019-11-08 00:00:00+03:00,out,False,939474,True,2,0,24,24
166405,2019-11-08 00:00:00+03:00,out,False,939478,True,7,0,26,26
166405,2019-11-09 00:00:00+03:00,out,False,939476,False,12,2124,2307,183
166405,2019-11-09 00:00:00+03:00,in,False,882686,False,1,121,136,15
166405,2019-11-09 00:00:00+03:00,out,False,882686,True,10,0,439,439
166405,2019-11-09 00:00:00+03:00,out,False,882686,False,24,2248,2711,463
166405,2019-11-09 00:00:00+03:00,in,False,902532,False,2,357,375,18
166405,2019-11-09 00:00:00+03:00,out,False,939476,True,4,0,169,169
166405,2019-11-09 00:00:00+03:00,in,False,-1,True,17,0,34,34
166405,2019-11-09 00:00:00+03:00,out,False,902532,True,11,0,383,383
166405,2019-11-09 00:00:00+03:00,out,False,902532,False,19,1524,1904,380
166405,2019-11-10 00:00:00+03:00,in,False,-1,True,6,0,1,1
166405,2019-11-10 00:00:00+03:00,out,False,882686,False,14,1602,1810,208
166405,2019-11-10 00:00:00+03:00,in,False,882686,False,7,1096,1162,66
166405,2019-11-10 00:00:00+03:00,out,False,882686,True,5,0,100,100
166405,2019-11-11 00:00:00+03:00,out,False,939478,False,2,37,66,29
166405,2019-11-11 00:00:00+03:00,out,False,939476,False,25,1721,2176,455
166405,2019-11-11 00:00:00+03:00,out,False,882686,False,22,2470,2799,329
166405,2019-11-11 00:00:00+03:00,in,False,882686,False,4,596,625,29
166405,2019-11-11 00:00:00+03:00,in,False,-1,True,60,0,52,52
166405,2019-11-11 00:00:00+03:00,out,False,939476,True,14,0,223,223
166405,2019-11-11 00:00:00+03:00,in,False,939474,False,6,301,366,65
166405,2019-11-11 00:00:00+03:00,out,False,882686,True,8,0,168,168
166405,2019-11-11 00:00:00+03:00,out,False,939474,True,6,0,115,115
166405,2019-11-11 00:00:00+03:00,in,False,939476,False,1,20,33,13
166405,2019-11-11 00:00:00+03:00,out,False,939474,False,1,100,122,22
166405,2019-11-11 00:00:00+03:00,out,False,939476,True,14,0,223,223
166405,2019-11-12 00:00:00+03:00,in,False,-1,True,35,0,215,215
166405,2019-11-12 00:00:00+03:00,in,False,902532,False,5,1199,1279,80
166405,2019-11-12 00:00:00+03:00,out,False,902532,True,11,0,269,269
166405,2019-11-12 00:00:00+03:00,out,False,902510,True,17,0,417,417
166405,2019-11-12 00:00:00+03:00,out,False,882686,True,15,0,423,423
166405,2019-11-12 00:00:00+03:00,out,False,939476,False,9,1582,1707,125
166405,2019-11-12 00:00:00+03:00,out,False,939476,True,6,0,103,103
166405,2019-11-12 00:00:00+03:00,in,False,882686,False,1,50,61,11
166405,2019-11-12 00:00:00+03:00,out,False,902510,False,27,3093,3474,381
166405,2019-11-12 00:00:00+03:00,in,False,939474,False,3,245,271,26
166405,2019-11-12 00:00:00+03:00,out,False,939478,True,2,0,44,44
166405,2019-11-12 00:00:00+03:00,in,False,939478,False,1,9,18,9
166405,2019-11-12 00:00:00+03:00,out,False,902532,False,19,2027,2334,307
166405,2019-11-12 00:00:00+03:00,in,False,939476,False,2,91,126,35
166405,2019-11-12 00:00:00+03:00,out,False,939478,False,1,307,308,1
166405,2019-11-12 00:00:00+03:00,out,False,939474,True,17,0,379,379
166405,2019-11-12 00:00:00+03:00,out,False,939474,False,17,1716,1971,255
166405,2019-11-12 00:00:00+03:00,out,False,882686,False,29,2563,3106,543
166405,2019-11-13 00:00:00+03:00,out,False,939476,True,9,0,276,276
166405,2019-11-13 00:00:00+03:00,out,False,939476,False,19,1716,2000,284
166405,2019-11-13 00:00:00+03:00,out,False,902510,False,63,6704,7854,1150
166405,2019-11-13 00:00:00+03:00,out,False,939474,False,12,1575,1764,189
166405,2019-11-13 00:00:00+03:00,out,False,939474,True,11,0,216,216
166405,2019-11-13 00:00:00+03:00,out,False,882686,False,21,1674,2071,397
166405,2019-11-13 00:00:00+03:00,out,False,882686,True,20,0,604,604
166405,2019-11-13 00:00:00+03:00,out,False,902510,True,24,0,664,664
166405,2019-11-13 00:00:00+03:00,out,True,902532,True,1,0,0,0
166405,2019-11-13 00:00:00+03:00,out,False,902532,False,16,1225,1512,287
166405,2019-11-13 00:00:00+03:00,out,False,902532,True,13,0,200,200
166405,2019-11-13 00:00:00+03:00,in,False,-1,True,33,0,351,351
166405,2019-11-13 00:00:00+03:00,out,True,902532,False,1,17,26,9
166405,2019-11-13 00:00:00+03:00,in,False,902532,False,11,1240,1405,165
166405,2019-11-13 00:00:00+03:00,in,False,939474,False,4,1194,1254,60
166405,2019-11-13 00:00:00+03:00,out,False,939474,True,11,0,216,216
166405,2019-11-14 00:00:00+03:00,in,False,-1,True,23,0,328,328
166405,2019-11-14 00:00:00+03:00,out,False,939474,True,7,0,230,230
166405,2019-11-14 00:00:00+03:00,in,False,902532,False,13,1540,1661,121
166405,2019-11-14 00:00:00+03:00,out,False,939476,True,72,0,1350,1350
166405,2019-11-14 00:00:00+03:00,out,False,882686,False,29,3660,4062,402
166405,2019-11-14 00:00:00+03:00,out,False,939476,False,55,4000,5011,1011
166405,2019-11-14 00:00:00+03:00,out,False,902510,True,45,0,1075,1075
166405,2019-11-14 00:00:00+03:00,out,False,939474,False,21,3267,3546,279
166405,2019-11-14 00:00:00+03:00,out,False,902532,True,3,0,76,76
166405,2019-11-14 00:00:00+03:00,in,False,939478,False,2,33,88,55
166405,2019-11-14 00:00:00+03:00,out,False,882686,True,23,0,340,340
166405,2019-11-14 00:00:00+03:00,in,False,939474,False,6,1450,1543,93
166405,2019-11-14 00:00:00+03:00,out,False,939478,False,2,373,397,24
166405,2019-11-14 00:00:00+03:00,out,False,902510,False,46,4328,5139,811
166405,2019-11-14 00:00:00+03:00,out,False,902532,False,9,1219,1351,132
166405,2019-11-14 00:00:00+03:00,out,False,902532,True,3,0,76,76
166405,2019-11-14 00:00:00+03:00,in,False,939478,False,2,33,88,55
166405,2019-11-15 00:00:00+03:00,out,False,902510,True,18,0,568,568
166405,2019-11-15 00:00:00+03:00,out,False,902510,False,52,6402,7275,873
166405,2019-11-15 00:00:00+03:00,in,False,902532,False,11,1633,1791,158
166405,2019-11-15 00:00:00+03:00,out,False,882686,False,41,3896,4614,718
166405,2019-11-15 00:00:00+03:00,out,False,939474,False,19,2412,2787,375
166405,2019-11-15 00:00:00+03:00,in,False,-1,True,15,0,218,218
166405,2019-11-15 00:00:00+03:00,out,False,902532,False,7,703,827,124
166405,2019-11-15 00:00:00+03:00,in,False,939474,False,9,1176,1284,108
166405,2019-11-15 00:00:00+03:00,out,False,939474,True,9,0,145,145
166405,2019-11-15 00:00:00+03:00,out,False,902532,True,1,0,29,29
166405,2019-11-15 00:00:00+03:00,out,False,939476,False,82,7916,9351,1435
166405,2019-11-15 00:00:00+03:00,out,False,939478,False,1,117,133,16
166405,2019-11-15 00:00:00+03:00,in,False,939478,False,1,16,231,215
166405,2019-11-15 00:00:00+03:00,out,False,882686,True,31,0,670,670
166405,2019-11-15 00:00:00+03:00,out,False,939476,True,55,0,1379,1379
166405,2019-11-15 00:00:00+03:00,in,False,-1,True,15,0,218,218
166405,2019-11-15 00:00:00+03:00,out,False,902510,False,52,6402,7275,873
166405,2019-11-15 00:00:00+03:00,out,False,902532,False,7,703,827,124
166405,2019-11-16 00:00:00+03:00,out,False,939474,True,8,0,121,121
166405,2019-11-16 00:00:00+03:00,out,False,902532,False,1,0,27,27
166405,2019-11-16 00:00:00+03:00,in,False,939474,False,6,467,530,63
166405,2019-11-16 00:00:00+03:00,in,False,-1,True,23,0,70,70
166405,2019-11-16 00:00:00+03:00,out,False,939474,False,18,1334,1641,307
166405,2019-11-16 00:00:00+03:00,out,False,882686,True,23,0,621,621
166405,2019-11-16 00:00:00+03:00,in,False,902532,False,6,646,743,97
166405,2019-11-16 00:00:00+03:00,out,False,882686,False,44,3618,4352,734
166405,2019-11-16 00:00:00+03:00,out,False,902510,False,2,51,111,60
166405,2019-11-16 00:00:00+03:00,out,False,902532,False,1,0,27,27
166405,2019-11-16 00:00:00+03:00,in,False,939474,False,6,467,530,63
166405,2019-11-17 00:00:00+03:00,in,False,-1,True,7,0,169,169
166405,2019-11-18 00:00:00+03:00,out,False,902532,True,26,0,195,195
166405,2019-11-18 00:00:00+03:00,out,False,902532,False,47,7394,8149,755
166405,2019-11-18 00:00:00+03:00,in,False,-1,True,58,0,740,740
166405,2019-11-18 00:00:00+03:00,out,False,939474,True,24,0,537,537
166405,2019-11-18 00:00:00+03:00,out,False,882686,True,28,0,859,859
166405,2019-11-18 00:00:00+03:00,out,False,939470,False,77,6661,7937,1276
166405,2019-11-18 00:00:00+03:00,out,True,882686,True,1,0,0,0
166405,2019-11-18 00:00:00+03:00,out,False,902510,True,30,0,975,975
166405,2019-11-18 00:00:00+03:00,out,False,939478,True,1,0,9,9
166405,2019-11-18 00:00:00+03:00,in,False,939474,False,17,1843,2040,197
166405,2019-11-18 00:00:00+03:00,out,False,939478,False,1,4,5,1
166405,2019-11-18 00:00:00+03:00,out,False,939476,False,60,5339,6428,1089
166405,2019-11-18 00:00:00+03:00,out,False,902510,False,68,7689,8821,1132
166405,2019-11-18 00:00:00+03:00,out,False,939476,True,23,0,785,785
166405,2019-11-18 00:00:00+03:00,out,False,939474,False,29,3275,3779,504
166405,2019-11-18 00:00:00+03:00,out,False,882686,False,36,2572,3339,767
166405,2019-11-18 00:00:00+03:00,in,False,902532,False,34,5013,5295,282
166405,2019-11-18 00:00:00+03:00,out,False,939470,True,35,0,772,772
166405,2019-11-18 00:00:00+03:00,in,False,902532,False,34,5013,5295,282
166405,2019-11-18 00:00:00+03:00,out,False,939476,True,23,0,785,785
166405,2019-11-18 00:00:00+03:00,out,False,882686,False,36,2572,3339,767
166405,2019-11-19 00:00:00+03:00,in,False,939474,False,4,1180,1231,51
166405,2019-11-19 00:00:00+03:00,out,False,939474,False,7,869,963,94
166405,2019-11-19 00:00:00+03:00,out,False,902510,False,38,3521,4213,692
166405,2019-11-19 00:00:00+03:00,out,False,939476,True,11,0,325,325
166405,2019-11-19 00:00:00+03:00,in,False,902532,False,12,2013,2100,87
166405,2019-11-19 00:00:00+03:00,out,False,902532,True,9,0,171,171
166405,2019-11-19 00:00:00+03:00,out,False,902510,True,11,0,342,342
166405,2019-11-19 00:00:00+03:00,out,False,939470,True,47,0,1179,1179
166405,2019-11-19 00:00:00+03:00,in,False,-1,True,20,0,440,440
166405,2019-11-19 00:00:00+03:00,out,True,939478,True,1,0,35,35
166405,2019-11-19 00:00:00+03:00,out,False,939470,False,93,5815,7371,1556
166405,2019-11-19 00:00:00+03:00,out,False,882686,True,18,0,354,354
166405,2019-11-19 00:00:00+03:00,in,False,882686,False,9,1096,1159,63
166405,2019-11-19 00:00:00+03:00,out,True,902532,False,1,3,7,4
166405,2019-11-19 00:00:00+03:00,out,False,939478,False,7,1365,1416,51
166405,2019-11-19 00:00:00+03:00,out,False,882686,False,18,3251,3612,361
166405,2019-11-19 00:00:00+03:00,out,False,939478,True,1,0,11,11
166405,2019-11-19 00:00:00+03:00,in,False,939476,False,8,293,361,68
166405,2019-11-19 00:00:00+03:00,out,False,939476,False,26,3233,3735,502
166405,2019-11-19 00:00:00+03:00,out,False,902532,False,26,4928,5490,562
166405,2019-11-19 00:00:00+03:00,out,False,939474,True,3,0,96,96
166405,2019-11-19 00:00:00+03:00,in,False,939478,False,1,40,47,7
166405,2019-11-19 00:00:00+03:00,in,False,939478,True,1,165,173,8
166405,2019-11-19 00:00:00+03:00,out,True,939478,False,2,15,47,32
166405,2019-11-20 00:00:00+03:00,in,False,939474,False,6,894,972,78
166405,2019-11-20 00:00:00+03:00,out,False,902510,True,19,0,754,754
166405,2019-11-20 00:00:00+03:00,out,False,902510,False,58,7190,8244,1054
166405,2019-11-20 00:00:00+03:00,in,False,939476,True,1,0,5,5
166405,2019-11-20 00:00:00+03:00,out,False,939478,False,5,1430,1450,20
166405,2019-11-20 00:00:00+03:00,in,False,-1,True,33,0,337,337
166405,2019-11-20 00:00:00+03:00,in,False,939470,False,1,103,111,8
166405,2019-11-20 00:00:00+03:00,in,False,902510,False,1,41,60,19
166405,2019-11-20 00:00:00+03:00,in,False,939476,False,9,594,670,76
166405,2019-11-20 00:00:00+03:00,out,False,939474,False,9,1032,1152,120
166405,2019-11-20 00:00:00+03:00,out,False,882686,False,64,6176,7283,1107
166405,2019-11-20 00:00:00+03:00,out,False,882686,True,37,0,887,887
166405,2019-11-20 00:00:00+03:00,out,False,939474,True,4,0,151,151
166405,2019-11-20 00:00:00+03:00,in,False,882686,False,33,3023,3246,223
166405,2019-11-20 00:00:00+03:00,out,False,939476,True,20,0,520,520
166405,2019-11-20 00:00:00+03:00,in,False,939478,False,1,59,86,27
166405,2019-11-20 00:00:00+03:00,out,False,939470,True,64,0,1503,1503
166405,2019-11-20 00:00:00+03:00,out,False,939470,False,91,5747,7337,1590
166405,2019-11-20 00:00:00+03:00,out,False,939476,False,27,2470,3002,532
166405,2019-11-20 00:00:00+03:00,out,False,939474,True,4,0,151,151
166405,2019-11-20 00:00:00+03:00,in,False,882686,False,33,3023,3246,223
166405,2019-11-21 00:00:00+03:00,out,False,939478,True,12,0,50,50
166405,2019-11-21 00:00:00+03:00,in,False,882686,False,13,2656,2736,80
166405,2019-11-21 00:00:00+03:00,out,False,939474,False,16,2498,2698,200
166405,2019-11-21 00:00:00+03:00,out,False,939474,True,3,0,58,58
166405,2019-11-21 00:00:00+03:00,out,False,939470,True,54,0,1079,1079
166405,2019-11-21 00:00:00+03:00,in,False,939476,False,14,1353,1478,125
166405,2019-11-21 00:00:00+03:00,in,False,882686,True,1,1,5,4
166405,2019-11-21 00:00:00+03:00,in,False,939478,False,3,18,42,24
166405,2019-11-21 00:00:00+03:00,in,False,-1,True,30,0,244,244
166405,2019-11-21 00:00:00+03:00,out,False,902532,False,1,6,11,5
166405,2019-11-21 00:00:00+03:00,in,False,939474,False,7,1237,1335,98
166405,2019-11-21 00:00:00+03:00,out,False,939470,False,92,7119,8648,1529
166405,2019-11-21 00:00:00+03:00,out,False,939476,False,73,6407,7774,1367
166405,2019-11-21 00:00:00+03:00,out,False,882686,True,56,0,1307,1307
166405,2019-11-21 00:00:00+03:00,out,False,882686,False,51,4848,5671,823
166405,2019-11-21 00:00:00+03:00,out,False,939476,True,52,0,1405,1405
166405,2019-11-21 00:00:00+03:00,in,False,939476,False,14,1353,1478,125
166405,2019-11-21 00:00:00+03:00,out,False,939476,False,73,6407,7774,1367
166405,2019-11-22 00:00:00+03:00,out,False,902510,True,9,0,260,260
166405,2019-11-22 00:00:00+03:00,in,False,939474,False,14,2450,2628,178
166405,2019-11-22 00:00:00+03:00,out,False,939476,False,27,3443,3969,526
166405,2019-11-22 00:00:00+03:00,in,False,882686,False,21,2396,2523,127
166405,2019-11-22 00:00:00+03:00,out,False,939478,True,1,0,12,12
166405,2019-11-22 00:00:00+03:00,out,False,939476,True,24,0,626,626
166405,2019-11-22 00:00:00+03:00,out,False,939470,True,18,0,337,337
166405,2019-11-22 00:00:00+03:00,out,False,939474,True,16,0,232,232
166405,2019-11-22 00:00:00+03:00,out,False,902510,False,46,4361,5140,779
166405,2019-11-22 00:00:00+03:00,out,False,939478,False,1,998,999,1
166405,2019-11-22 00:00:00+03:00,in,False,882686,True,1,1,5,4
166405,2019-11-22 00:00:00+03:00,out,False,902532,True,1,0,8,8
166405,2019-11-22 00:00:00+03:00,out,False,939470,False,49,3527,4334,807
166405,2019-11-22 00:00:00+03:00,out,True,939470,True,1,0,0,0
166405,2019-11-22 00:00:00+03:00,out,False,902532,False,2,708,738,30
166405,2019-11-22 00:00:00+03:00,in,False,-1,True,35,0,448,448
166405,2019-11-22 00:00:00+03:00,out,False,882686,False,66,8084,9322,1238
166405,2019-11-22 00:00:00+03:00,out,False,882686,True,32,0,769,769
166405,2019-11-22 00:00:00+03:00,in,False,939476,False,5,342,391,49
166405,2019-11-22 00:00:00+03:00,in,False,939478,False,1,45,66,21
166405,2019-11-22 00:00:00+03:00,out,False,939474,False,41,5414,6025,611
166405,2019-11-22 00:00:00+03:00,out,False,939476,False,27,3443,3969,526
166405,2019-11-22 00:00:00+03:00,in,False,939478,False,1,45,66,21
166405,2019-11-22 00:00:00+03:00,out,False,939476,True,24,0,626,626
166405,2019-11-23 00:00:00+03:00,in,False,902532,False,1,103,118,15
166405,2019-11-23 00:00:00+03:00,out,False,939474,True,6,0,78,78
166405,2019-11-23 00:00:00+03:00,out,False,902510,False,32,2911,3576,665
166405,2019-11-23 00:00:00+03:00,out,False,902532,False,2,145,178,33
166405,2019-11-23 00:00:00+03:00,out,False,902510,True,23,0,561,561
166405,2019-11-23 00:00:00+03:00,in,False,939474,False,3,791,835,44
166405,2019-11-23 00:00:00+03:00,out,False,882686,False,97,6862,8767,1905
166405,2019-11-23 00:00:00+03:00,in,False,-1,True,32,0,192,192
166405,2019-11-23 00:00:00+03:00,out,False,939474,False,17,2843,3103,260
166405,2019-11-23 00:00:00+03:00,in,False,882686,False,7,932,995,63
166405,2019-11-23 00:00:00+03:00,out,False,902532,True,1,0,36,36
166405,2019-11-23 00:00:00+03:00,out,False,882686,True,30,0,806,806
166405,2019-11-23 00:00:00+03:00,in,False,882690,False,2,31,61,30
166405,2019-11-23 00:00:00+03:00,out,False,902532,True,1,0,36,36
166405,2019-11-23 00:00:00+03:00,out,False,939474,False,17,2843,3103,260
166405,2019-11-24 00:00:00+03:00,out,False,939474,True,5,0,110,110
166405,2019-11-24 00:00:00+03:00,in,False,902532,False,1,188,200,12
166405,2019-11-24 00:00:00+03:00,in,False,-1,True,23,0,562,562
166405,2019-11-24 00:00:00+03:00,in,False,939474,False,1,137,141,4
166405,2019-11-24 00:00:00+03:00,out,False,902532,False,1,31,49,18
166405,2019-11-24 00:00:00+03:00,out,False,939474,False,11,1007,1196,189
166405,2019-11-24 00:00:00+03:00,out,False,939474,True,5,0,110,110
166405,2019-11-25 00:00:00+03:00,out,False,902510,False,1,67,82,15
166405,2019-11-25 00:00:00+03:00,in,False,939474,False,24,4275,4697,422
166405,2019-11-25 00:00:00+03:00,in,False,-1,True,42,0,735,735
166405,2019-11-25 00:00:00+03:00,out,False,882686,True,32,0,899,899
166405,2019-11-25 00:00:00+03:00,out,False,882686,False,80,8182,9733,1551
166405,2019-11-25 00:00:00+03:00,out,False,939478,False,6,363,389,26
166405,2019-11-25 00:00:00+03:00,out,False,939470,True,2,0,35,35
166405,2019-11-25 00:00:00+03:00,out,False,902532,True,1,0,9,9
166405,2019-11-25 00:00:00+03:00,in,False,939478,False,2,55,70,15
166405,2019-11-25 00:00:00+03:00,in,False,882686,False,10,1926,2006,80
166405,2019-11-25 00:00:00+03:00,out,False,939474,True,12,0,229,229
166405,2019-11-25 00:00:00+03:00,in,False,902532,False,5,602,658,56
166405,2019-11-25 00:00:00+03:00,out,False,902532,False,2,157,188,31
166405,2019-11-25 00:00:00+03:00,out,False,939478,True,9,0,195,195
166405,2019-11-25 00:00:00+03:00,out,False,939474,False,40,5154,5711,557
166405,2019-11-25 00:00:00+03:00,in,False,939474,False,24,4275,4697,422
166405,2019-11-26 00:00:00+03:00,in,False,882686,False,20,2397,2564,167
166405,2019-11-26 00:00:00+03:00,in,False,939474,False,18,3235,3745,510
166405,2019-11-26 00:00:00+03:00,in,False,939478,False,4,141,280,139
166405,2019-11-26 00:00:00+03:00,out,False,939478,False,2,842,869,27
166405,2019-11-26 00:00:00+03:00,out,False,902532,True,10,0,205,205
166405,2019-11-26 00:00:00+03:00,out,False,939470,True,16,0,328,328
166405,2019-11-26 00:00:00+03:00,out,False,882686,False,93,11639,13400,1761
166405,2019-11-26 00:00:00+03:00,in,False,902532,False,4,835,900,65
166405,2019-11-26 00:00:00+03:00,out,False,882686,True,57,0,1659,1659
166405,2019-11-26 00:00:00+03:00,in,False,939470,False,3,213,246,33
166405,2019-11-26 00:00:00+03:00,out,False,902532,False,7,993,1106,113
166405,2019-11-26 00:00:00+03:00,in,False,-1,True,20,0,554,554
166405,2019-11-26 00:00:00+03:00,out,False,939474,False,25,3843,4193,350
166405,2019-11-26 00:00:00+03:00,out,False,939474,True,5,0,172,172
166405,2019-11-26 00:00:00+03:00,out,False,939470,False,16,588,892,304
166405,2019-11-27 00:00:00+03:00,out,False,882690,True,4,0,39,39
166405,2019-11-27 00:00:00+03:00,in,False,882686,False,16,1782,1931,149
166405,2019-11-27 00:00:00+03:00,out,False,939470,False,16,1413,1622,209
166405,2019-11-27 00:00:00+03:00,out,False,939470,True,13,0,159,159
166405,2019-11-27 00:00:00+03:00,out,False,902532,False,19,2432,2711,279
166405,2019-11-27 00:00:00+03:00,in,False,939474,False,22,4301,4527,226
166405,2019-11-27 00:00:00+03:00,in,False,902532,False,15,2501,2593,92
166405,2019-11-27 00:00:00+03:00,out,False,902510,False,49,4140,4970,830
166405,2019-11-27 00:00:00+03:00,out,False,939478,True,3,0,41,41
166405,2019-11-27 00:00:00+03:00,out,False,882686,True,41,0,955,955
166405,2019-11-27 00:00:00+03:00,out,False,902510,True,26,0,639,639
166405,2019-11-27 00:00:00+03:00,out,False,939474,True,15,0,299,299
166405,2019-11-27 00:00:00+03:00,out,False,939474,False,39,5206,5750,544
166405,2019-11-27 00:00:00+03:00,in,False,-1,True,52,0,614,614
166405,2019-11-27 00:00:00+03:00,out,False,939476,True,1,0,11,11
166405,2019-11-27 00:00:00+03:00,out,False,902532,True,10,0,441,441
166405,2019-11-27 00:00:00+03:00,out,False,882686,False,76,7589,9018,1429
166405,2019-11-27 00:00:00+03:00,in,False,939470,False,4,385,428,43
166405,2019-11-27 00:00:00+03:00,out,False,902532,False,19,2432,2711,279
166405,2019-11-27 00:00:00+03:00,out,False,902532,True,10,0,441,441
166405,2019-11-28 00:00:00+03:00,out,False,902532,False,13,1729,1978,249
166405,2019-11-28 00:00:00+03:00,out,False,939474,False,47,6841,7497,656
166405,2019-11-28 00:00:00+03:00,out,True,882686,True,1,0,0,0
166405,2019-11-28 00:00:00+03:00,out,False,902510,False,45,5651,6385,734
166405,2019-11-28 00:00:00+03:00,in,False,902532,False,26,5099,5343,244
166405,2019-11-28 00:00:00+03:00,out,False,902510,True,18,0,537,537
166405,2019-11-28 00:00:00+03:00,out,False,939470,True,11,0,301,301
166405,2019-11-28 00:00:00+03:00,out,False,882690,True,1,0,21,21
166405,2019-11-28 00:00:00+03:00,in,False,939474,False,29,3250,3659,409
166405,2019-11-28 00:00:00+03:00,out,False,882686,False,74,5961,7395,1434
166405,2019-11-28 00:00:00+03:00,in,False,882686,False,13,2083,2173,90
166405,2019-11-28 00:00:00+03:00,out,False,902532,True,2,0,86,86
166405,2019-11-28 00:00:00+03:00,out,False,939470,False,21,1669,1963,294
166405,2019-11-28 00:00:00+03:00,out,False,939474,True,18,0,299,299
166405,2019-11-28 00:00:00+03:00,out,False,882686,True,32,0,965,965
166405,2019-11-28 00:00:00+03:00,in,False,939470,False,5,548,613,65
166405,2019-11-28 00:00:00+03:00,in,False,-1,True,88,0,1231,1231
166405,2019-11-28 00:00:00+03:00,in,False,882690,False,1,45,51,6
166405,2019-11-28 00:00:00+03:00,in,False,882690,False,1,45,51,6
166406,2019-08-02 00:00:00+03:00,out,False,879898,True,4,0,53,53
166406,2019-08-02 00:00:00+03:00,in,False,-1,True,1,0,4,4
166406,2019-08-02 00:00:00+03:00,out,False,879896,True,8,0,139,139
166406,2019-08-02 00:00:00+03:00,out,False,879898,False,1,132,145,13
166406,2019-08-02 00:00:00+03:00,out,True,879896,False,2,24,36,12
166406,2019-08-02 00:00:00+03:00,out,False,879896,False,3,7,110,103
166406,2019-08-02 00:00:00+03:00,out,True,880240,True,1,0,4,4
166406,2019-08-03 00:00:00+03:00,out,False,879898,False,14,898,1048,150
166406,2019-08-03 00:00:00+03:00,out,False,879896,False,3,48,113,65
166406,2019-08-03 00:00:00+03:00,in,False,-1,True,1,0,14,14
166406,2019-08-03 00:00:00+03:00,in,False,879896,False,1,6,15,9
166406,2019-08-03 00:00:00+03:00,out,False,879896,True,7,0,189,189
166406,2019-08-03 00:00:00+03:00,out,True,879898,False,1,10,15,5
166406,2019-08-03 00:00:00+03:00,out,False,879898,True,1,0,44,44
166406,2019-08-03 00:00:00+03:00,in,False,-1,True,1,0,14,14
166406,2019-08-04 00:00:00+03:00,out,False,879896,False,1,114,124,10
166406,2019-08-04 00:00:00+03:00,out,False,879896,True,1,0,16,16
166406,2019-08-04 00:00:00+03:00,out,True,880240,True,2,0,9,9
166406,2019-08-05 00:00:00+03:00,in,False,879896,False,1,110,120,10
166406,2019-08-05 00:00:00+03:00,out,False,879896,True,1,0,9,9
166406,2019-08-05 00:00:00+03:00,out,False,879896,False,25,1785,1998,213
166406,2019-08-05 00:00:00+03:00,in,False,879898,False,2,181,190,9
166406,2019-08-05 00:00:00+03:00,out,False,879898,True,31,0,819,819
166406,2019-08-05 00:00:00+03:00,in,False,-1,True,1,0,14,14
166406,2019-08-05 00:00:00+03:00,out,False,879898,False,103,5445,6198,753
166406,2019-08-05 00:00:00+03:00,out,True,879896,False,2,14,30,16
166406,2019-08-06 00:00:00+03:00,in,False,879896,False,6,806,845,39
166406,2019-08-06 00:00:00+03:00,out,False,879896,True,7,0,162,162
166406,2019-08-06 00:00:00+03:00,out,False,879898,True,30,0,519,519
166406,2019-08-06 00:00:00+03:00,out,False,879898,False,82,4910,5441,531
166406,2019-08-06 00:00:00+03:00,out,False,880240,False,2,341,357,16
166406,2019-08-06 00:00:00+03:00,out,True,879896,False,3,235,261,26
166406,2019-08-06 00:00:00+03:00,out,True,879896,True,1,0,0,0
166406,2019-08-06 00:00:00+03:00,out,False,879896,False,35,4119,4489,370
166406,2019-08-06 00:00:00+03:00,in,False,-1,True,1,0,91,91
166406,2019-08-06 00:00:00+03:00,out,False,879896,False,35,4119,4489,370
166406,2019-08-07 00:00:00+03:00,out,False,879898,False,120,6983,7706,723
166406,2019-08-07 00:00:00+03:00,in,False,-1,True,1,0,4,4
166406,2019-08-07 00:00:00+03:00,in,False,879898,False,1,40,55,15
166406,2019-08-07 00:00:00+03:00,out,False,879896,True,8,0,214,214
166406,2019-08-07 00:00:00+03:00,out,False,879898,True,17,0,410,410
166406,2019-08-07 00:00:00+03:00,out,False,879896,False,15,2838,2966,128
166406,2019-08-07 00:00:00+03:00,out,False,879898,True,17,0,410,410
166406,2019-08-08 00:00:00+03:00,out,False,879896,True,5,0,187,187
166406,2019-08-08 00:00:00+03:00,in,False,879896,False,1,21,27,6
166406,2019-08-08 00:00:00+03:00,out,False,879898,False,156,8480,9530,1050
166406,2019-08-08 00:00:00+03:00,out,False,879898,True,37,0,675,675
166406,2019-08-08 00:00:00+03:00,out,False,879896,False,19,1132,1345,213
166406,2019-08-08 00:00:00+03:00,out,False,880240,False,1,15,20,5
166406,2019-08-08 00:00:00+03:00,in,False,879898,False,1,5,17,12
166406,2019-08-08 00:00:00+03:00,in,False,879898,False,1,5,17,12
166406,2019-08-08 00:00:00+03:00,in,False,879896,False,1,21,27,6
166406,2019-08-08 00:00:00+03:00,out,False,880240,False,1,15,20,5
166406,2019-08-09 00:00:00+03:00,out,False,880240,True,2,0,101,101
166406,2019-08-09 00:00:00+03:00,out,False,879896,False,18,1090,1313,223
166406,2019-08-09 00:00:00+03:00,in,False,879898,False,2,92,109,17
166406,2019-08-09 00:00:00+03:00,out,False,879898,True,24,0,558,558
166406,2019-08-09 00:00:00+03:00,in,False,879896,False,1,464,469,5
166406,2019-08-09 00:00:00+03:00,out,False,879898,False,103,5178,5993,815
166406,2019-08-09 00:00:00+03:00,out,True,879896,False,1,446,450,4
166406,2019-08-09 00:00:00+03:00,out,False,880240,False,1,80,88,8
166406,2019-08-09 00:00:00+03:00,out,True,880240,True,1,0,0,0
166406,2019-08-09 00:00:00+03:00,out,False,879896,True,19,0,684,684
166406,2019-08-09 00:00:00+03:00,out,True,880240,True,1,0,0,0
166406,2019-08-10 00:00:00+03:00,out,False,879896,True,1,0,66,66
166406,2019-08-10 00:00:00+03:00,out,False,879896,False,1,75,79,4
166406,2019-08-12 00:00:00+03:00,out,False,879898,False,50,2782,3175,393
166406,2019-08-12 00:00:00+03:00,in,False,-1,True,1,0,3,3
166406,2019-08-12 00:00:00+03:00,out,False,879896,False,24,3838,4106,268
166406,2019-08-12 00:00:00+03:00,out,False,879898,True,11,0,296,296
166406,2019-08-12 00:00:00+03:00,out,False,879896,True,12,0,326,326
166406,2019-08-12 00:00:00+03:00,out,False,879896,False,24,3838,4106,268
166406,2019-08-13 00:00:00+03:00,out,False,879896,False,18,1933,2040,107
166406,2019-08-13 00:00:00+03:00,out,False,879898,False,51,3803,4271,468
166406,2019-08-13 00:00:00+03:00,out,False,879896,True,1,0,63,63
166406,2019-08-13 00:00:00+03:00,out,False,879898,True,13,0,374,374
166406,2019-08-13 00:00:00+03:00,out,False,879898,False,51,3803,4271,468
166406,2019-08-14 00:00:00+03:00,out,False,879896,True,8,0,329,329
166406,2019-08-14 00:00:00+03:00,out,False,879898,True,19,0,382,382
166406,2019-08-14 00:00:00+03:00,in,False,-1,True,1,0,48,48
166406,2019-08-14 00:00:00+03:00,in,False,879898,False,1,165,177,12
166406,2019-08-14 00:00:00+03:00,in,False,879896,False,3,538,561,23
166406,2019-08-14 00:00:00+03:00,out,False,879896,False,13,2023,2179,156
166406,2019-08-14 00:00:00+03:00,out,False,879898,False,72,5360,5836,476
166406,2019-08-15 00:00:00+03:00,out,False,879898,True,14,0,248,248
166406,2019-08-15 00:00:00+03:00,out,False,879896,False,9,442,533,91
166406,2019-08-15 00:00:00+03:00,out,False,879898,False,65,3815,4342,527
166406,2019-08-15 00:00:00+03:00,in,False,879898,False,1,100,117,17
166406,2019-08-15 00:00:00+03:00,out,False,879896,True,2,0,92,92
166406,2019-08-15 00:00:00+03:00,out,False,879898,False,65,3815,4342,527
166406,2019-08-16 00:00:00+03:00,in,False,879896,False,2,45,55,10
166406,2019-08-16 00:00:00+03:00,out,False,879898,False,55,3356,3707,351
166406,2019-08-16 00:00:00+03:00,out,False,879896,False,8,421,481,60
166406,2019-08-16 00:00:00+03:00,in,False,-1,True,1,0,21,21
166406,2019-08-16 00:00:00+03:00,out,False,879898,True,21,0,472,472
166406,2019-08-19 00:00:00+03:00,out,False,879896,False,1,6,48,42
166406,2019-08-19 00:00:00+03:00,out,False,879896,True,1,0,61,61
166406,2019-08-19 00:00:00+03:00,out,True,879896,True,1,0,3,3
166406,2019-08-19 00:00:00+03:00,out,False,879898,False,85,5219,6023,804
166406,2019-08-19 00:00:00+03:00,out,False,879898,True,24,0,648,648
166406,2019-08-20 00:00:00+03:00,in,False,-1,True,1,0,38,38
166406,2019-08-20 00:00:00+03:00,in,False,-1,True,1,0,36,36
166406,2019-08-20 00:00:00+03:00,in,False,879898,False,2,388,403,15
166406,2019-08-20 00:00:00+03:00,out,False,879898,False,89,6354,7093,739
166406,2019-08-20 00:00:00+03:00,out,False,879898,True,14,0,275,275
166406,2019-08-21 00:00:00+03:00,out,False,879898,True,8,0,228,228
166406,2019-08-21 00:00:00+03:00,in,False,-1,True,1,0,65,65
166406,2019-08-21 00:00:00+03:00,in,False,879898,False,2,78,102,24
166406,2019-08-21 00:00:00+03:00,out,False,879898,False,61,4501,4917,416
166406,2019-08-21 00:00:00+03:00,in,False,-1,True,1,0,65,65
166406,2019-08-22 00:00:00+03:00,in,False,879896,False,2,140,157,17
166406,2019-08-22 00:00:00+03:00,out,False,879898,False,78,5700,6270,570
166406,2019-08-22 00:00:00+03:00,out,False,879898,True,17,0,252,252
166406,2019-08-22 00:00:00+03:00,out,False,879896,True,2,0,14,14
166406,2019-08-22 00:00:00+03:00,out,False,879896,False,2,139,172,33
166406,2019-08-23 00:00:00+03:00,in,False,879898,False,1,62,73,11
166406,2019-08-23 00:00:00+03:00,in,False,879896,False,1,28,32,4
166406,2019-08-23 00:00:00+03:00,out,False,879898,True,12,0,255,255
166406,2019-08-23 00:00:00+03:00,out,False,879896,False,5,331,410,79
166406,2019-08-23 00:00:00+03:00,out,False,879898,False,45,2922,3293,371
166406,2019-08-23 00:00:00+03:00,out,False,879896,True,4,0,53,53
166406,2019-08-26 00:00:00+03:00,out,False,879898,True,3,0,33,33
166406,2019-08-26 00:00:00+03:00,out,False,879898,False,6,236,264,28
166406,2019-08-26 00:00:00+03:00,out,False,879896,False,2,284,311,27
166406,2019-08-27 00:00:00+03:00,out,False,879898,True,28,0,840,840
166406,2019-08-27 00:00:00+03:00,in,False,879898,False,2,101,126,25
166406,2019-08-27 00:00:00+03:00,in,False,-1,True,1,0,47,47
166406,2019-08-27 00:00:00+03:00,out,False,879898,False,89,5195,5915,720
166406,2019-08-27 00:00:00+03:00,in,False,879896,False,1,25,64,39
166406,2019-08-27 00:00:00+03:00,in,False,879896,False,1,25,64,39
166406,2019-08-28 00:00:00+03:00,out,False,879896,True,29,0,756,756
166406,2019-08-28 00:00:00+03:00,in,False,879896,False,4,218,289,71
166406,2019-08-28 00:00:00+03:00,in,False,-1,True,1,0,32,32
166406,2019-08-28 00:00:00+03:00,out,False,879896,False,89,5702,6517,815
166406,2019-08-28 00:00:00+03:00,out,True,879896,True,1,0,0,0
166406,2019-08-29 00:00:00+03:00,out,False,880240,False,3,515,543,28
166406,2019-08-29 00:00:00+03:00,out,True,879896,True,2,0,2,2
166406,2019-08-29 00:00:00+03:00,out,False,879896,True,29,0,663,663
166406,2019-08-29 00:00:00+03:00,out,True,880240,True,1,0,0,0
166406,2019-08-29 00:00:00+03:00,in,False,-1,True,6,0,233,233
166406,2019-08-29 00:00:00+03:00,out,False,879896,False,83,5705,6375,670
166406,2019-08-29 00:00:00+03:00,in,False,879896,False,19,672,819,147
166406,2019-08-30 00:00:00+03:00,out,False,879896,False,130,10616,11714,1098
166406,2019-08-30 00:00:00+03:00,out,False,880240,True,9,0,196,196
166406,2019-08-30 00:00:00+03:00,in,False,879896,False,4,209,233,24
166406,2019-08-30 00:00:00+03:00,out,False,879896,True,30,0,787,787
166406,2019-08-30 00:00:00+03:00,out,True,880240,True,1,0,5,5
166406,2019-08-30 00:00:00+03:00,in,False,-1,True,1,0,42,42
166406,2019-08-30 00:00:00+03:00,out,False,880240,False,23,2897,3093,196
166406,2019-08-30 00:00:00+03:00,out,False,879896,False,130,10616,11714,1098
166406,2019-08-31 00:00:00+03:00,out,True,879898,True,1,0,3,3
166406,2019-08-31 00:00:00+03:00,out,False,879896,True,1,0,52,52
166406,2019-08-31 00:00:00+03:00,out,False,879896,False,2,536,574,38
166406,2019-08-31 00:00:00+03:00,out,True,879896,True,2,0,23,23
166406,2019-09-01 00:00:00+03:00,out,True,879898,True,1,0,3,3
166406,2019-09-01 00:00:00+03:00,out,True,879898,True,1,0,3,3
166406,2019-09-02 00:00:00+03:00,out,False,879898,False,121,5895,6853,958
166406,2019-09-02 00:00:00+03:00,in,False,-1,True,2,0,50,50
166406,2019-09-02 00:00:00+03:00,out,True,879898,True,1,0,1,1
166406,2019-09-02 00:00:00+03:00,in,False,879898,False,2,81,102,21
166406,2019-09-02 00:00:00+03:00,out,False,879898,True,25,0,518,518
166406,2019-09-02 00:00:00+03:00,out,False,879898,False,121,5895,6853,958
166406,2019-09-03 00:00:00+03:00,out,False,879898,False,126,9035,9959,924
166406,2019-09-03 00:00:00+03:00,out,False,879896,True,2,0,19,19
166406,2019-09-03 00:00:00+03:00,in,False,-1,True,7,0,447,447
166406,2019-09-03 00:00:00+03:00,out,False,879896,False,2,202,234,32
166406,2019-09-03 00:00:00+03:00,out,False,879898,True,33,0,666,666
166406,2019-09-03 00:00:00+03:00,in,False,879898,False,4,189,455,266
166406,2019-09-03 00:00:00+03:00,in,False,-1,True,7,0,447,447
166406,2019-09-03 00:00:00+03:00,out,False,879896,False,2,202,234,32
166406,2019-09-04 00:00:00+03:00,in,False,-1,True,3,0,89,89
166406,2019-09-04 00:00:00+03:00,out,False,879896,True,8,0,149,149
166406,2019-09-04 00:00:00+03:00,out,False,879896,False,7,802,853,51
166406,2019-09-04 00:00:00+03:00,out,False,879898,True,19,0,396,396
166406,2019-09-04 00:00:00+03:00,out,False,879898,False,28,1472,1766,294
166406,2019-09-05 00:00:00+03:00,in,False,879898,False,1,26,66,40
166406,2019-09-05 00:00:00+03:00,out,False,879896,False,1,10,29,19
166406,2019-09-05 00:00:00+03:00,out,False,879898,True,12,0,168,168
166406,2019-09-05 00:00:00+03:00,out,False,879896,True,1,0,17,17
166406,2019-09-05 00:00:00+03:00,out,False,879898,False,56,3666,4087,421
166406,2019-09-05 00:00:00+03:00,out,True,879898,True,1,0,0,0
166406,2019-09-05 00:00:00+03:00,out,False,879898,True,12,0,168,168
166406,2019-09-06 00:00:00+03:00,in,False,-1,True,1,0,24,24
166406,2019-09-06 00:00:00+03:00,out,False,879898,False,110,6582,7885,1303
166406,2019-09-06 00:00:00+03:00,in,False,879896,False,2,177,188,11
166406,2019-09-06 00:00:00+03:00,out,False,879896,True,11,0,252,252
166406,2019-09-06 00:00:00+03:00,out,False,879896,False,13,875,986,111
166406,2019-09-06 00:00:00+03:00,out,False,879898,True,47,0,983,983
166406,2019-09-08 00:00:00+03:00,in,False,879898,False,1,9,23,14
166406,2019-09-08 00:00:00+03:00,out,False,879896,True,1,0,3,3
166406,2019-09-08 00:00:00+03:00,in,False,879898,False,1,9,23,14
166406,2019-09-09 00:00:00+03:00,in,False,879896,False,3,350,361,11
166406,2019-09-09 00:00:00+03:00,out,False,879896,True,2,0,12,12
166406,2019-09-09 00:00:00+03:00,out,False,879898,True,37,0,930,930
166406,2019-09-09 00:00:00+03:00,in,False,879898,False,4,273,302,29
166406,2019-09-09 00:00:00+03:00,out,False,879898,False,104,6167,7498,1331
166406,2019-09-09 00:00:00+03:00,out,False,879896,False,17,3539,3626,87
166406,2019-09-10 00:00:00+03:00,out,False,879898,False,100,4808,6003,1195
166406,2019-09-10 00:00:00+03:00,out,False,879896,False,1,140,154,14
166406,2019-09-10 00:00:00+03:00,out,False,879898,True,60,0,1340,1340
166406,2019-09-10 00:00:00+03:00,in,False,879898,False,1,52,57,5
166406,2019-09-10 00:00:00+03:00,out,False,879896,True,2,0,67,67
166406,2019-09-10 00:00:00+03:00,in,False,-1,True,1,0,16,16
166406,2019-09-10 00:00:00+03:00,in,False,879896,False,1,19,95,76
166406,2019-09-11 00:00:00+03:00,out,False,879898,True,56,0,1239,1239
166406,2019-09-11 00:00:00+03:00,out,False,879898,False,56,2739,3447,708
166406,2019-09-11 00:00:00+03:00,in,False,879896,False,1,79,89,10
166406,2019-09-11 00:00:00+03:00,in,False,-1,True,1,0,11,11
166406,2019-09-11 00:00:00+03:00,out,False,879896,False,10,1303,1407,104
166406,2019-09-11 00:00:00+03:00,out,False,879896,True,1,0,1,1
166406,2019-09-12 00:00:00+03:00,in,False,-1,True,1,0,50,50
166406,2019-09-12 00:00:00+03:00,in,False,879896,False,2,192,208,16
166406,2019-09-12 00:00:00+03:00,out,True,879898,True,1,0,1,1
166406,2019-09-12 00:00:00+03:00,out,True,879896,True,2,0,5,5
166406,2019-09-12 00:00:00+03:00,in,False,879898,False,1,20,27,7
166406,2019-09-12 00:00:00+03:00,out,False,879896,False,3,127,152,25
166406,2019-09-12 00:00:00+03:00,out,False,879898,True,70,0,1579,1579
166406,2019-09-12 00:00:00+03:00,out,False,879898,False,65,3233,4099,866
166406,2019-09-12 00:00:00+03:00,out,False,879896,True,1,0,8,8
166406,2019-09-12 00:00:00+03:00,out,True,879896,True,2,0,5,5
166406,2019-09-12 00:00:00+03:00,out,False,879896,True,1,0,8,8
166406,2019-09-13 00:00:00+03:00,out,False,879898,True,37,0,784,784
166406,2019-09-13 00:00:00+03:00,out,False,879898,False,41,1677,2229,552
166406,2019-09-13 00:00:00+03:00,in,False,879898,False,1,160,166,6
166406,2019-09-14 00:00:00+03:00,out,False,879896,True,1,0,6,6
166406,2019-09-14 00:00:00+03:00,in,False,-1,True,1,0,2,2
166406,2019-09-16 00:00:00+03:00,in,False,-1,True,1,0,23,23
166406,2019-09-16 00:00:00+03:00,out,False,879896,False,1,26,41,15
166406,2019-09-16 00:00:00+03:00,out,True,879896,True,1,0,12,12
166406,2019-09-16 00:00:00+03:00,out,False,879898,False,63,2506,3242,736
166406,2019-09-16 00:00:00+03:00,out,False,879898,True,47,0,1025,1025
166406,2019-09-16 00:00:00+03:00,in,False,879898,False,1,97,109,12
166406,2019-09-17 00:00:00+03:00,out,False,879898,False,4,142,190,48
166406,2019-09-17 00:00:00+03:00,out,False,879898,False,4,142,190,48
166406,2019-09-18 00:00:00+03:00,in,False,-1,True,2,0,54,54
166406,2019-09-18 00:00:00+03:00,out,False,879898,False,50,1902,2604,702
166406,2019-09-18 00:00:00+03:00,out,False,879896,False,4,2992,3033,41
166406,2019-09-18 00:00:00+03:00,out,False,879898,True,60,0,1275,1275
166406,2019-09-19 00:00:00+03:00,out,False,879896,True,1,0,33,33
166406,2019-09-19 00:00:00+03:00,out,False,879898,True,32,0,679,679
166406,2019-09-19 00:00:00+03:00,in,False,879898,False,2,76,92,16
166406,2019-09-19 00:00:00+03:00,out,False,879896,False,2,557,566,9
166406,2019-09-19 00:00:00+03:00,out,False,879898,False,45,2284,2868,584
166406,2019-09-19 00:00:00+03:00,out,False,879898,True,32,0,679,679
166406,2019-09-20 00:00:00+03:00,out,False,879898,False,28,1414,1765,351
166406,2019-09-20 00:00:00+03:00,out,False,879898,True,10,0,155,155
166406,2019-09-23 00:00:00+03:00,out,False,879896,False,1,34,57,23
166406,2019-09-23 00:00:00+03:00,out,False,879898,False,45,1667,2240,573
166406,2019-09-23 00:00:00+03:00,in,False,879898,False,2,115,147,32
166406,2019-09-23 00:00:00+03:00,out,False,879898,True,41,0,886,886
166406,2019-09-23 00:00:00+03:00,in,False,879898,False,2,115,147,32
166406,2019-09-23 00:00:00+03:00,out,False,879896,False,1,34,57,23
166406,2019-09-24 00:00:00+03:00,out,False,879898,False,54,2697,3338,641
166406,2019-09-24 00:00:00+03:00,in,False,-1,True,2,0,4,4
166406,2019-09-24 00:00:00+03:00,out,False,879898,True,34,0,767,767
166406,2019-09-24 00:00:00+03:00,in,False,879898,False,1,45,50,5
166406,2019-09-25 00:00:00+03:00,in,False,879896,False,1,1422,1427,5
166406,2019-09-25 00:00:00+03:00,out,False,879898,True,24,0,562,562
166406,2019-09-25 00:00:00+03:00,out,False,879898,False,11,216,422,206
166406,2019-09-25 00:00:00+03:00,in,False,-1,True,1,0,7,7
166406,2019-09-25 00:00:00+03:00,in,False,879898,False,1,356,369,13
166406,2019-09-25 00:00:00+03:00,out,False,879896,False,2,573,597,24
166406,2019-09-26 00:00:00+03:00,out,True,879898,True,1,0,0,0
166406,2019-09-26 00:00:00+03:00,out,False,879898,False,66,3053,3805,752
166406,2019-09-26 00:00:00+03:00,out,False,879898,True,45,0,864,864
166406,2019-09-27 00:00:00+03:00,in,False,879898,False,2,133,142,9
166406,2019-09-27 00:00:00+03:00,out,False,879898,False,48,3192,3860,668
166406,2019-09-27 00:00:00+03:00,in,False,-1,True,1,0,33,33
166406,2019-09-27 00:00:00+03:00,out,False,879898,True,47,0,1026,1026
166406,2019-09-27 00:00:00+03:00,in,False,879898,False,2,133,142,9
166406,2019-09-30 00:00:00+03:00,in,False,879898,False,1,15,21,6
166406,2019-09-30 00:00:00+03:00,out,False,879896,True,1,0,26,26
166406,2019-09-30 00:00:00+03:00,out,False,879896,False,1,474,511,37
166406,2019-09-30 00:00:00+03:00,out,False,879898,False,66,2796,3634,838
166406,2019-09-30 00:00:00+03:00,in,False,-1,True,4,0,35,35
166406,2019-09-30 00:00:00+03:00,out,True,879898,True,1,0,6,6
166406,2019-09-30 00:00:00+03:00,out,False,879898,True,53,0,1014,1014
166406,2019-09-30 00:00:00+03:00,in,False,879898,False,1,15,21,6
166406,2019-09-30 00:00:00+03:00,out,False,879898,False,66,2796,3634,838
166406,2019-10-01 00:00:00+03:00,in,False,-1,True,1,0,33,33
166406,2019-10-01 00:00:00+03:00,out,False,879896,False,2,260,285,25
166406,2019-10-01 00:00:00+03:00,out,False,879898,False,109,4913,6173,1260
166406,2019-10-01 00:00:00+03:00,in,False,879898,False,2,199,217,18
166406,2019-10-01 00:00:00+03:00,out,False,879898,True,56,0,902,902
166406,2019-10-02 00:00:00+03:00,out,False,879896,False,3,544,582,38
166406,2019-10-02 00:00:00+03:00,in,False,879898,False,2,143,158,15
166406,2019-10-02 00:00:00+03:00,out,False,879896,True,1,0,1,1
166406,2019-10-02 00:00:00+03:00,out,False,879898,True,35,0,694,694
166406,2019-10-02 00:00:00+03:00,out,False,879898,False,95,5454,6581,1127
166406,2019-10-02 00:00:00+03:00,out,False,879896,False,3,544,582,38
166406,2019-10-03 00:00:00+03:00,out,False,879898,True,50,0,1148,1148
166406,2019-10-03 00:00:00+03:00,in,False,879898,False,5,370,428,58
166406,2019-10-03 00:00:00+03:00,out,True,879898,True,3,0,4,4
166406,2019-10-03 00:00:00+03:00,in,False,-1,True,2,0,96,96
166406,2019-10-03 00:00:00+03:00,out,False,879896,False,1,128,137,9
166406,2019-10-03 00:00:00+03:00,out,False,879898,False,76,3203,4249,1046
166406,2019-10-04 00:00:00+03:00,out,False,879898,False,68,3238,4155,917
166406,2019-10-04 00:00:00+03:00,in,False,879898,False,1,46,50,4
166406,2019-10-04 00:00:00+03:00,out,False,879898,True,35,0,663,663
166406,2019-10-04 00:00:00+03:00,out,True,879898,True,1,0,1,1
166406,2019-10-06 00:00:00+03:00,out,True,879898,True,1,0,6,6
166406,2019-10-07 00:00:00+03:00,in,False,879898,False,1,30,44,14
166406,2019-10-07 00:00:00+03:00,out,False,879898,True,20,0,441,441
166406,2019-10-07 00:00:00+03:00,out,False,879898,False,66,3508,4330,822
166406,2019-10-08 00:00:00+03:00,in,False,-1,True,2,0,55,55
166406,2019-10-08 00:00:00+03:00,in,False,879898,False,2,108,134,26
166406,2019-10-08 00:00:00+03:00,out,False,879898,False,81,3085,4165,1080
166406,2019-10-08 00:00:00+03:00,out,False,879898,True,50,0,1170,1170
166406,2019-10-10 00:00:00+03:00,in,False,-1,True,2,0,111,111
166406,2019-10-10 00:00:00+03:00,out,False,879898,True,30,0,722,722
166406,2019-10-10 00:00:00+03:00,in,False,879898,False,2,79,100,21
166406,2019-10-10 00:00:00+03:00,out,False,879898,False,95,3349,4601,1252
166406,2019-10-10 00:00:00+03:00,out,False,879898,True,30,0,722,722
166406,2019-10-11 00:00:00+03:00,in,False,879898,False,1,107,131,24
166406,2019-10-11 00:00:00+03:00,out,False,879898,False,84,2862,3958,1096
166406,2019-10-11 00:00:00+03:00,out,False,879898,True,44,0,946,946
166406,2019-10-11 00:00:00+03:00,in,False,-1,True,2,0,34,34
166406,2019-10-11 00:00:00+03:00,out,False,879898,True,44,0,946,946
166406,2019-10-14 00:00:00+03:00,in,False,879898,False,1,58,69,11
166406,2019-10-14 00:00:00+03:00,out,False,879896,True,1,0,2,2
166406,2019-10-14 00:00:00+03:00,out,False,879898,False,106,4334,5599,1265
166406,2019-10-14 00:00:00+03:00,in,False,879896,False,1,86,104,18
166406,2019-10-14 00:00:00+03:00,in,False,-1,True,5,0,207,207
166406,2019-10-14 00:00:00+03:00,out,False,879898,True,54,0,1213,1213
166406,2019-10-14 00:00:00+03:00,out,False,879898,False,106,4334,5599,1265
166406,2019-10-15 00:00:00+03:00,in,False,879898,False,5,130,165,35
166406,2019-10-15 00:00:00+03:00,out,False,879898,True,41,0,852,852
166406,2019-10-15 00:00:00+03:00,out,False,879898,False,74,3321,4345,1024
166406,2019-10-16 00:00:00+03:00,in,False,879898,False,2,156,356,200
166406,2019-10-16 00:00:00+03:00,out,False,879898,False,39,2066,2645,579
166406,2019-10-16 00:00:00+03:00,out,False,879896,False,1,185,188,3
166406,2019-10-16 00:00:00+03:00,out,False,879898,True,18,0,515,515
166406,2019-10-16 00:00:00+03:00,out,True,879898,True,1,0,1,1
166406,2019-10-16 00:00:00+03:00,in,False,-1,True,2,0,375,375
166406,2019-10-16 00:00:00+03:00,out,False,879898,True,18,0,515,515
166406,2019-10-17 00:00:00+03:00,in,False,-1,True,4,0,100,100
166406,2019-10-17 00:00:00+03:00,in,False,879898,False,6,269,330,61
166406,2019-10-17 00:00:00+03:00,out,False,879898,False,105,4122,5437,1315
166406,2019-10-17 00:00:00+03:00,out,False,879898,True,73,0,1772,1772
166406,2019-10-18 00:00:00+03:00,in,False,879898,False,1,136,146,10
166406,2019-10-18 00:00:00+03:00,out,False,879898,True,45,0,887,887
166406,2019-10-18 00:00:00+03:00,out,False,879898,False,89,4809,5801,992
166406,2019-10-18 00:00:00+03:00,in,False,-1,True,2,0,29,29
166406,2019-10-19 00:00:00+03:00,out,False,879896,True,6,0,138,138
166406,2019-10-19 00:00:00+03:00,out,True,879896,True,14,0,22,22
166406,2019-10-19 00:00:00+03:00,out,False,879896,False,12,505,743,238
166406,2019-10-19 00:00:00+03:00,in,False,879896,False,1,9,32,23
166406,2019-10-20 00:00:00+03:00,out,True,879898,False,2,28,51,23
166406,2019-10-20 00:00:00+03:00,out,True,879898,True,1,0,6,6
166406,2019-10-20 00:00:00+03:00,out,True,879896,False,17,555,678,123
166406,2019-10-20 00:00:00+03:00,out,True,879896,True,6,0,42,42
166406,2019-10-20 00:00:00+03:00,out,False,879898,False,1,58,67,9
166406,2019-10-20 00:00:00+03:00,in,False,-1,True,1,0,4,4
166406,2019-10-21 00:00:00+03:00,out,False,879898,False,95,4567,5715,1148
166406,2019-10-21 00:00:00+03:00,in,False,-1,True,2,0,40,40
166406,2019-10-21 00:00:00+03:00,in,False,879898,False,1,25,36,11
166406,2019-10-21 00:00:00+03:00,out,False,879898,True,37,0,785,785
166406,2019-10-21 00:00:00+03:00,in,False,-1,True,2,0,40,40
166406,2019-10-22 00:00:00+03:00,in,False,-1,True,1,0,71,71
166406,2019-10-22 00:00:00+03:00,out,True,879898,True,1,0,1,1
166406,2019-10-22 00:00:00+03:00,out,False,879898,False,35,2335,2738,403
166406,2019-10-22 00:00:00+03:00,out,False,879898,True,15,0,272,272
166406,2019-10-23 00:00:00+03:00,out,False,879898,False,73,3103,4036,933
166406,2019-10-23 00:00:00+03:00,out,False,879898,True,39,0,879,879
166406,2019-10-23 00:00:00+03:00,in,False,-1,True,2,0,82,82
166406,2019-10-23 00:00:00+03:00,in,False,879898,False,4,120,411,291
166406,2019-10-24 00:00:00+03:00,out,False,879898,False,48,2236,2887,651
166406,2019-10-24 00:00:00+03:00,out,False,879898,True,19,0,407,407
166406,2019-10-25 00:00:00+03:00,in,False,879898,False,1,74,80,6
166406,2019-10-25 00:00:00+03:00,out,False,879898,True,13,0,309,309
166406,2019-10-25 00:00:00+03:00,out,False,879898,False,40,1961,2367,406
166406,2019-10-25 00:00:00+03:00,out,True,879896,True,1,0,2,2
166406,2019-10-25 00:00:00+03:00,out,False,879896,False,1,25,35,10
166406,2019-10-28 00:00:00+03:00,out,False,879898,False,61,2697,3522,825
166406,2019-10-28 00:00:00+03:00,out,False,879898,True,44,0,1024,1024
166406,2019-10-28 00:00:00+03:00,in,False,879898,False,1,84,87,3
166406,2019-10-29 00:00:00+03:00,in,False,879898,False,4,44,82,38
166406,2019-10-29 00:00:00+03:00,out,False,879898,False,63,2731,3570,839
166406,2019-10-29 00:00:00+03:00,in,False,-1,True,2,0,50,50
166406,2019-10-29 00:00:00+03:00,out,False,879898,True,32,0,649,649
166406,2019-10-30 00:00:00+03:00,in,False,-1,True,2,0,45,45
166406,2019-10-30 00:00:00+03:00,out,False,879898,True,30,0,651,651
166406,2019-10-30 00:00:00+03:00,in,False,879898,False,2,122,141,19
166406,2019-10-30 00:00:00+03:00,out,False,879898,False,62,2965,3869,904
166406,2019-10-31 00:00:00+03:00,out,False,879898,False,27,613,929,316
166406,2019-10-31 00:00:00+03:00,out,False,879898,True,25,0,596,596
166406,2019-10-31 00:00:00+03:00,in,False,-1,True,1,0,81,81
166406,2019-10-31 00:00:00+03:00,out,False,879898,True,25,0,596,596
166406,2019-11-01 00:00:00+03:00,out,False,879898,True,16,0,352,352
166406,2019-11-01 00:00:00+03:00,out,False,879898,False,7,292,385,93
166406,2019-11-01 00:00:00+03:00,out,False,879896,False,3,439,443,4
166406,2019-11-01 00:00:00+03:00,out,False,879896,True,1,0,4,4
166406,2019-11-01 00:00:00+03:00,out,False,879896,True,1,0,4,4
166406,2019-11-05 00:00:00+03:00,out,False,879898,False,79,4183,5056,873
166406,2019-11-05 00:00:00+03:00,out,False,879898,True,43,0,913,913
166406,2019-11-05 00:00:00+03:00,in,False,-1,True,3,0,68,68
166406,2019-11-05 00:00:00+03:00,in,False,879898,False,2,63,76,13
166406,2019-11-05 00:00:00+03:00,in,False,879898,False,2,63,76,13
166406,2019-11-05 00:00:00+03:00,in,False,-1,True,3,0,68,68
166406,2019-11-06 00:00:00+03:00,in,False,879898,False,1,68,80,12
166406,2019-11-06 00:00:00+03:00,out,False,879898,False,44,2355,2920,565
166406,2019-11-06 00:00:00+03:00,in,False,-1,True,1,0,0,0
166406,2019-11-06 00:00:00+03:00,out,False,879896,False,2,48,99,51
166406,2019-11-06 00:00:00+03:00,out,False,879898,True,19,0,325,325
166406,2019-11-07 00:00:00+03:00,out,False,879898,True,28,0,574,574
166406,2019-11-07 00:00:00+03:00,out,False,879898,False,69,2466,3235,769
166406,2019-11-07 00:00:00+03:00,in,False,879898,False,1,39,55,16
166406,2019-11-08 00:00:00+03:00,out,False,879898,False,24,1270,1591,321
166406,2019-11-08 00:00:00+03:00,in,False,879898,False,1,27,30,3
166406,2019-11-08 00:00:00+03:00,out,False,879898,True,11,0,188,188
166406,2019-11-08 00:00:00+03:00,out,False,879898,True,11,0,188,188
166406,2019-11-11 00:00:00+03:00,in,False,-1,True,2,0,99,99
166406,2019-11-11 00:00:00+03:00,out,False,879898,True,31,0,441,441
166406,2019-11-11 00:00:00+03:00,out,False,879898,False,26,798,1160,362
166406,2019-11-11 00:00:00+03:00,out,False,879898,True,31,0,441,441
166406,2019-11-12 00:00:00+03:00,out,False,879898,False,12,653,780,127
166406,2019-11-12 00:00:00+03:00,out,False,879898,True,13,0,178,178
166406,2019-11-12 00:00:00+03:00,out,False,879898,True,13,0,178,178
166406,2019-11-13 00:00:00+03:00,in,False,-1,True,1,0,26,26
166406,2019-11-13 00:00:00+03:00,out,False,879898,False,35,1671,2101,430
166406,2019-11-13 00:00:00+03:00,in,False,879898,False,2,298,311,13
166406,2019-11-13 00:00:00+03:00,out,False,879898,True,17,0,206,206
166406,2019-11-14 00:00:00+03:00,out,False,879898,False,2,78,94,16
166406,2019-11-15 00:00:00+03:00,in,False,879898,False,5,362,401,39
166406,2019-11-15 00:00:00+03:00,out,False,879898,False,53,2230,2824,594
166406,2019-11-15 00:00:00+03:00,in,False,-1,True,1,0,64,64
166406,2019-11-15 00:00:00+03:00,out,False,879898,True,57,0,1170,1170
166406,2019-11-15 00:00:00+03:00,in,False,879898,False,5,362,401,39
166406,2019-11-18 00:00:00+03:00,out,False,879898,False,66,3617,4388,771
166406,2019-11-18 00:00:00+03:00,out,False,879898,True,31,0,582,582
166406,2019-11-18 00:00:00+03:00,in,False,879898,False,1,63,78,15
166406,2019-11-19 00:00:00+03:00,in,False,-1,True,1,0,57,57
166406,2019-11-19 00:00:00+03:00,in,False,879898,False,1,59,67,8
166406,2019-11-19 00:00:00+03:00,out,False,879898,True,18,0,393,393
166406,2019-11-19 00:00:00+03:00,out,False,879898,False,28,1586,1908,322
166406,2019-11-20 00:00:00+03:00,in,False,879898,False,1,66,76,10
166406,2019-11-20 00:00:00+03:00,out,False,879898,False,33,1731,2110,379
166406,2019-11-20 00:00:00+03:00,out,False,879898,True,21,0,525,525
166406,2019-11-20 00:00:00+03:00,in,False,-1,True,1,0,4,4
166406,2019-11-25 00:00:00+03:00,out,False,879898,True,70,0,1262,1262
166406,2019-11-25 00:00:00+03:00,out,False,879896,True,3,0,26,26
166406,2019-11-25 00:00:00+03:00,in,False,-1,True,3,0,56,56
166406,2019-11-25 00:00:00+03:00,in,False,879898,False,2,70,83,13
166406,2019-11-25 00:00:00+03:00,out,False,879898,False,104,5198,6591,1393
166406,2019-11-25 00:00:00+03:00,in,False,-1,True,3,0,56,56
166406,2019-11-26 00:00:00+03:00,in,False,879898,False,1,76,92,16
166406,2019-11-27 00:00:00+03:00,out,False,879898,False,28,1080,1397,317
166406,2019-11-27 00:00:00+03:00,in,False,879898,False,1,1,13,12
166406,2019-11-27 00:00:00+03:00,out,False,879898,True,28,0,479,479
166406,2019-11-27 00:00:00+03:00,in,False,-1,True,1,0,23,23
166406,2019-11-28 00:00:00+03:00,in,False,-1,True,1,0,5,5
166406,2019-11-28 00:00:00+03:00,out,False,879898,False,32,1850,2215,365
166406,2019-11-28 00:00:00+03:00,out,False,879898,True,20,0,379,379
166407,2019-08-14 00:00:00+03:00,out,False,888534,False,2,20,44,24
166407,2019-08-14 00:00:00+03:00,in,False,-1,True,3,0,15,15
166407,2019-08-20 00:00:00+03:00,out,False,888532,True,1,0,1,1
166407,2019-08-20 00:00:00+03:00,out,True,888532,True,1,0,15,15
166407,2019-08-26 00:00:00+03:00,in,True,888532,False,1,3,22,19
166407,2019-09-03 00:00:00+03:00,in,False,-1,True,1,0,32,32
166407,2019-09-09 00:00:00+03:00,out,True,888532,True,6,0,22,22
166407,2019-09-10 00:00:00+03:00,in,False,888532,False,2,223,242,19
166407,2019-09-10 00:00:00+03:00,out,True,888536,False,1,8,18,10
166407,2019-09-10 00:00:00+03:00,in,False,-1,True,1,0,17,17
166407,2019-09-10 00:00:00+03:00,out,True,888536,True,1,0,4,4
166407,2019-09-11 00:00:00+03:00,out,True,907440,False,2,16,51,35
166407,2019-09-11 00:00:00+03:00,out,True,907442,False,1,34,42,8
166407,2019-09-11 00:00:00+03:00,out,True,907440,True,1,0,7,7
166407,2019-09-11 00:00:00+03:00,out,False,888534,False,3,173,195,22
166407,2019-09-11 00:00:00+03:00,in,False,888534,False,1,59,72,13
166407,2019-09-11 00:00:00+03:00,out,True,888534,False,3,56,77,21
166407,2019-09-11 00:00:00+03:00,in,False,888532,True,1,0,39,39
166407,2019-09-11 00:00:00+03:00,out,False,888534,True,1,0,31,31
166407,2019-09-11 00:00:00+03:00,out,True,907442,True,1,0,9,9
166407,2019-09-11 00:00:00+03:00,out,True,888532,False,7,129,162,33
166407,2019-09-12 00:00:00+03:00,out,True,888534,False,4,58,93,35
166407,2019-09-12 00:00:00+03:00,in,True,888534,False,1,49,66,17
166407,2019-09-12 00:00:00+03:00,in,False,-1,True,2,0,8,8
166407,2019-09-12 00:00:00+03:00,out,True,907440,False,1,23,29,6
166407,2019-09-12 00:00:00+03:00,in,False,888534,False,1,78,93,15
166407,2019-09-13 00:00:00+03:00,out,True,888532,True,1,0,16,16
166407,2019-09-13 00:00:00+03:00,in,False,-1,True,2,0,15,15
166407,2019-09-13 00:00:00+03:00,in,False,-1,True,5,0,120,120
166407,2019-09-13 00:00:00+03:00,out,True,888532,False,1,29,34,5
166407,2019-09-13 00:00:00+03:00,out,True,888534,False,1,20,28,8
166407,2019-09-13 00:00:00+03:00,out,True,907440,True,1,0,10,10
166407,2019-09-13 00:00:00+03:00,in,False,888534,False,1,85,107,22
166407,2019-09-16 00:00:00+03:00,out,True,907442,False,1,49,58,9
166407,2019-09-16 00:00:00+03:00,in,False,888534,False,1,239,263,24
166407,2019-09-16 00:00:00+03:00,in,False,-1,True,2,0,57,57
166407,2019-09-16 00:00:00+03:00,in,True,888534,False,1,21,41,20
166407,2019-09-16 00:00:00+03:00,out,True,888534,False,2,13,37,24
166407,2019-09-16 00:00:00+03:00,out,True,888532,True,2,0,58,58
166407,2019-09-16 00:00:00+03:00,in,False,-1,True,3,0,40,40
166407,2019-09-16 00:00:00+03:00,out,True,888532,False,1,13,21,8
166407,2019-09-17 00:00:00+03:00,out,True,888532,False,1,9,19,10
166407,2019-09-17 00:00:00+03:00,out,True,888534,False,2,21,35,14
166407,2019-09-18 00:00:00+03:00,out,True,888532,True,4,0,83,83
166407,2019-09-18 00:00:00+03:00,out,True,907440,False,4,81,115,34
166407,2019-09-18 00:00:00+03:00,in,False,888534,False,2,55,93,38
166407,2019-09-18 00:00:00+03:00,in,False,-1,True,6,0,109,109
166407,2019-09-18 00:00:00+03:00,out,True,888536,False,3,93,114,21
166407,2019-09-18 00:00:00+03:00,out,False,888534,False,1,201,202,1
166407,2019-09-18 00:00:00+03:00,out,True,888534,True,2,0,34,34
166407,2019-09-18 00:00:00+03:00,out,True,888532,False,6,500,540,40
166407,2019-09-18 00:00:00+03:00,out,True,888536,True,2,0,55,55
166407,2019-09-18 00:00:00+03:00,out,True,907440,False,4,81,115,34
166407,2019-09-19 00:00:00+03:00,in,False,888534,False,1,75,97,22
166407,2019-09-19 00:00:00+03:00,in,False,-1,True,1,0,23,23
166407,2019-09-19 00:00:00+03:00,out,True,888532,False,1,7,11,4
166407,2019-09-19 00:00:00+03:00,out,True,888532,False,1,7,11,4
166407,2019-09-20 00:00:00+03:00,out,True,888532,False,1,22,27,5
166407,2019-09-20 00:00:00+03:00,out,True,888534,False,1,13,22,9
166407,2019-09-20 00:00:00+03:00,in,False,888534,False,2,83,133,50
166407,2019-09-20 00:00:00+03:00,in,False,-1,True,1,0,32,32
166407,2019-09-23 00:00:00+03:00,out,False,888538,False,1,224,246,22
166407,2019-09-23 00:00:00+03:00,in,False,888536,False,1,25,50,25
166407,2019-09-23 00:00:00+03:00,out,True,907442,False,2,33,44,11
166407,2019-09-23 00:00:00+03:00,out,False,907440,True,1,0,3,3
166407,2019-09-23 00:00:00+03:00,in,False,-1,True,1,0,84,84
166407,2019-09-23 00:00:00+03:00,in,False,888534,True,1,133,156,23
166407,2019-09-23 00:00:00+03:00,out,False,888534,False,5,814,838,24
166407,2019-09-23 00:00:00+03:00,in,False,888538,False,1,566,590,24
166407,2019-09-23 00:00:00+03:00,out,False,888534,True,3,0,89,89
166407,2019-09-23 00:00:00+03:00,out,True,888536,False,1,16,21,5
166407,2019-09-23 00:00:00+03:00,in,False,888534,False,4,168,434,266
166407,2019-09-23 00:00:00+03:00,out,True,907440,False,2,163,214,51
166407,2019-09-23 00:00:00+03:00,out,True,888534,False,2,100,118,18
166407,2019-09-23 00:00:00+03:00,out,True,888532,True,1,0,30,30
166407,2019-09-23 00:00:00+03:00,out,True,888532,False,4,70,110,40
166407,2019-09-23 00:00:00+03:00,out,True,888534,False,2,100,118,18
166407,2019-09-23 00:00:00+03:00,out,False,907440,True,1,0,3,3
166407,2019-09-24 00:00:00+03:00,out,True,888532,False,3,220,244,24
166407,2019-09-24 00:00:00+03:00,out,True,907442,False,2,197,209,12
166407,2019-09-24 00:00:00+03:00,out,True,888532,True,1,0,14,14
166407,2019-09-24 00:00:00+03:00,in,False,888534,False,1,22,108,86
166407,2019-09-24 00:00:00+03:00,out,False,888534,False,1,141,143,2
166407,2019-09-24 00:00:00+03:00,out,True,888534,False,1,8,26,18
166407,2019-09-24 00:00:00+03:00,in,False,-1,True,1,0,11,11
166407,2019-09-24 00:00:00+03:00,out,True,888540,False,2,16,42,26
166407,2019-09-24 00:00:00+03:00,out,True,888536,False,1,22,27,5
166407,2019-09-25 00:00:00+03:00,in,False,888534,False,1,74,174,100
166407,2019-09-25 00:00:00+03:00,in,False,-1,True,5,0,231,231
166407,2019-09-25 00:00:00+03:00,out,False,888534,False,2,338,342,4
166407,2019-09-25 00:00:00+03:00,in,False,-1,True,2,0,103,103
166407,2019-09-25 00:00:00+03:00,out,True,888532,False,1,9,19,10
166407,2019-09-25 00:00:00+03:00,out,True,907440,False,1,22,30,8
166407,2019-09-25 00:00:00+03:00,in,False,-1,True,2,0,103,103
166407,2019-09-26 00:00:00+03:00,out,True,888540,True,1,0,12,12
166407,2019-09-26 00:00:00+03:00,in,False,-1,True,1,0,20,20
166407,2019-09-26 00:00:00+03:00,out,True,907440,False,6,225,264,39
166407,2019-09-26 00:00:00+03:00,out,True,888532,False,4,108,139,31
166407,2019-09-26 00:00:00+03:00,in,False,888534,False,1,70,93,23
166407,2019-09-26 00:00:00+03:00,out,True,888534,False,3,64,98,34
166407,2019-09-26 00:00:00+03:00,out,True,888540,False,1,187,193,6
166407,2019-09-26 00:00:00+03:00,out,True,888536,False,3,97,133,36
166407,2019-09-26 00:00:00+03:00,in,True,888534,False,1,56,80,24
166407,2019-09-26 00:00:00+03:00,in,False,888540,False,1,173,195,22
166407,2019-09-27 00:00:00+03:00,out,True,907440,True,1,0,33,33
166407,2019-09-27 00:00:00+03:00,in,False,-1,True,3,0,48,48
166407,2019-09-27 00:00:00+03:00,out,False,888534,False,2,95,128,33
166407,2019-09-27 00:00:00+03:00,out,True,907440,False,1,12,20,8
166407,2019-09-27 00:00:00+03:00,out,True,888532,False,3,645,663,18
166407,2019-09-27 00:00:00+03:00,out,True,888536,False,1,8,14,6
166407,2019-09-27 00:00:00+03:00,out,True,907440,True,1,0,33,33
166407,2019-09-28 00:00:00+03:00,in,False,-1,True,1,0,32,32
166407,2019-09-30 00:00:00+03:00,out,True,888536,True,2,0,39,39
166407,2019-09-30 00:00:00+03:00,out,False,907440,True,1,0,9,9
166407,2019-09-30 00:00:00+03:00,out,True,888532,False,4,371,398,27
166407,2019-09-30 00:00:00+03:00,out,True,907442,False,2,187,199,12
166407,2019-09-30 00:00:00+03:00,out,True,888534,False,1,17,25,8
166407,2019-09-30 00:00:00+03:00,out,False,888534,False,1,81,87,6
166407,2019-09-30 00:00:00+03:00,out,True,888536,False,5,60,139,79
166407,2019-09-30 00:00:00+03:00,out,False,888534,True,1,0,37,37
166407,2019-09-30 00:00:00+03:00,in,False,888534,False,1,85,107,22
166407,2019-09-30 00:00:00+03:00,out,True,888536,False,5,60,139,79
166407,2019-09-30 00:00:00+03:00,out,True,888532,False,4,371,398,27
166407,2019-10-01 00:00:00+03:00,out,True,888532,False,1,6,12,6
166407,2019-10-01 00:00:00+03:00,in,False,-1,True,1,0,23,23
166407,2019-10-01 00:00:00+03:00,out,True,907440,False,1,30,37,7
166407,2019-10-01 00:00:00+03:00,out,True,888534,False,1,20,30,10
166407,2019-10-01 00:00:00+03:00,in,False,-1,True,3,0,55,55
166407,2019-10-01 00:00:00+03:00,in,False,-1,True,1,0,23,23
166407,2019-10-02 00:00:00+03:00,out,True,888540,True,1,0,28,28
166407,2019-10-02 00:00:00+03:00,out,True,888534,False,2,14,38,24
166407,2019-10-02 00:00:00+03:00,in,False,-1,True,1,0,20,20
166407,2019-10-02 00:00:00+03:00,out,False,888534,False,1,64,74,10
166407,2019-10-02 00:00:00+03:00,out,True,888532,False,2,115,126,11
166407,2019-10-02 00:00:00+03:00,out,True,907440,False,1,20,31,11
166407,2019-10-02 00:00:00+03:00,out,True,907442,False,1,41,49,8
166407,2019-10-02 00:00:00+03:00,out,True,907442,False,1,41,49,8
166407,2019-10-03 00:00:00+03:00,out,True,907440,False,1,44,50,6
166407,2019-10-03 00:00:00+03:00,out,True,888532,True,2,0,30,30
166407,2019-10-03 00:00:00+03:00,out,False,888534,False,3,124,176,52
166407,2019-10-03 00:00:00+03:00,in,True,888534,True,1,0,23,23
166407,2019-10-03 00:00:00+03:00,out,False,907440,False,2,99,104,5
166407,2019-10-03 00:00:00+03:00,in,False,-1,True,2,0,37,37
166407,2019-10-03 00:00:00+03:00,out,True,888532,False,1,29,37,8
166407,2019-10-03 00:00:00+03:00,out,True,907440,True,1,0,25,25
166407,2019-10-03 00:00:00+03:00,out,True,888534,False,3,30,50,20
166407,2019-10-03 00:00:00+03:00,out,False,888534,False,3,124,176,52
166407,2019-10-04 00:00:00+03:00,in,False,907440,False,1,235,255,20
166407,2019-10-04 00:00:00+03:00,out,False,907440,False,1,163,169,6
166407,2019-10-04 00:00:00+03:00,out,True,888536,False,4,135,166,31
166407,2019-10-04 00:00:00+03:00,out,True,888532,False,5,654,681,27
166407,2019-10-04 00:00:00+03:00,out,True,888540,False,1,606,613,7
166407,2019-10-04 00:00:00+03:00,out,True,907440,False,1,60,66,6
166407,2019-10-04 00:00:00+03:00,out,True,907440,False,1,60,66,6
166407,2019-10-04 00:00:00+03:00,out,True,888540,False,1,606,613,7
166407,2019-10-05 00:00:00+03:00,in,False,-1,True,1,0,7,7
166407,2019-10-06 00:00:00+03:00,in,False,-1,True,1,0,8,8
166407,2019-10-07 00:00:00+03:00,out,True,888536,False,1,6,11,5
166407,2019-10-07 00:00:00+03:00,out,False,907440,False,1,405,409,4
166407,2019-10-07 00:00:00+03:00,out,True,907440,True,1,0,20,20
166407,2019-10-07 00:00:00+03:00,out,False,888534,False,1,178,180,2
166407,2019-10-07 00:00:00+03:00,out,True,888534,True,1,0,38,38
166407,2019-10-07 00:00:00+03:00,out,True,907440,False,3,130,151,21
166407,2019-10-07 00:00:00+03:00,in,False,888534,False,1,106,125,19
166407,2019-10-07 00:00:00+03:00,out,True,888540,False,1,11,19,8
166407,2019-10-07 00:00:00+03:00,out,True,888540,True,2,0,42,42
166407,2019-10-08 00:00:00+03:00,out,True,907440,True,2,0,18,18
166407,2019-10-08 00:00:00+03:00,out,True,888532,False,1,42,50,8
166407,2019-10-08 00:00:00+03:00,out,True,907440,False,5,193,223,30
166407,2019-10-08 00:00:00+03:00,in,False,888534,False,2,88,127,39
166407,2019-10-08 00:00:00+03:00,out,False,888534,False,2,609,614,5
166407,2019-10-08 00:00:00+03:00,in,False,888532,False,1,782,802,20
166407,2019-10-08 00:00:00+03:00,out,True,888534,False,1,65,72,7
166407,2019-10-08 00:00:00+03:00,out,False,888534,True,29,0,92,92
166407,2019-10-08 00:00:00+03:00,out,True,907442,False,2,24,40,16
166407,2019-10-09 00:00:00+03:00,out,True,907442,True,1,0,22,22
166407,2019-10-09 00:00:00+03:00,out,False,907440,False,1,56,74,18
166407,2019-10-09 00:00:00+03:00,out,True,888534,False,4,66,95,29
166407,2019-10-09 00:00:00+03:00,out,True,907442,False,1,36,44,8
166407,2019-10-09 00:00:00+03:00,out,False,888534,False,1,187,204,17
166407,2019-10-09 00:00:00+03:00,out,True,907440,False,7,156,220,64
166407,2019-10-09 00:00:00+03:00,out,True,888534,True,1,0,16,16
166407,2019-10-09 00:00:00+03:00,out,True,907440,True,1,0,5,5
166407,2019-10-09 00:00:00+03:00,out,True,888532,False,5,250,288,38
166407,2019-10-09 00:00:00+03:00,out,True,907440,False,7,156,220,64
166407,2019-10-10 00:00:00+03:00,out,False,-1,True,1,0,0,0
166407,2019-10-10 00:00:00+03:00,out,True,907440,True,1,0,14,14
166407,2019-10-10 00:00:00+03:00,in,False,888534,False,1,107,134,27
166407,2019-10-10 00:00:00+03:00,out,True,888532,False,3,345,377,32
166407,2019-10-10 00:00:00+03:00,out,True,888536,False,1,8,14,6
166407,2019-10-10 00:00:00+03:00,out,True,907440,False,2,96,111,15
166407,2019-10-11 00:00:00+03:00,out,True,907442,True,1,0,40,40
166407,2019-10-11 00:00:00+03:00,out,True,888532,False,1,8,15,7
166407,2019-10-11 00:00:00+03:00,out,True,907442,False,2,67,81,14
166407,2019-10-11 00:00:00+03:00,in,False,888534,False,1,75,97,22
166407,2019-10-11 00:00:00+03:00,out,True,888536,False,1,10,17,7
166407,2019-10-11 00:00:00+03:00,out,True,907440,False,2,35,48,13
166407,2019-10-11 00:00:00+03:00,out,True,888532,True,2,0,33,33
166407,2019-10-11 00:00:00+03:00,in,False,888540,False,1,248,266,18
166407,2019-10-11 00:00:00+03:00,out,False,888534,False,1,71,90,19
166407,2019-10-11 00:00:00+03:00,out,True,907440,False,2,35,48,13
166407,2019-10-12 00:00:00+03:00,in,False,-1,True,1,0,22,22
166407,2019-10-14 00:00:00+03:00,out,True,907442,False,3,135,172,37
166407,2019-10-14 00:00:00+03:00,out,True,888532,False,8,271,320,49
166407,2019-10-14 00:00:00+03:00,out,False,907440,False,4,722,771,49
166407,2019-10-14 00:00:00+03:00,out,True,888536,False,2,27,39,12
166407,2019-10-14 00:00:00+03:00,out,False,888540,False,1,210,222,12
166407,2019-10-14 00:00:00+03:00,out,False,888538,False,1,125,149,24
166407,2019-10-14 00:00:00+03:00,out,True,907440,False,5,208,246,38
166407,2019-10-14 00:00:00+03:00,out,True,888532,True,2,0,41,41
166407,2019-10-14 00:00:00+03:00,out,True,888540,False,1,7,15,8
166407,2019-10-14 00:00:00+03:00,in,False,888534,False,2,1036,1080,44
166407,2019-10-15 00:00:00+03:00,out,True,907440,False,5,81,112,31
166407,2019-10-15 00:00:00+03:00,out,True,888532,False,3,135,151,16
166407,2019-10-15 00:00:00+03:00,out,False,888534,True,1,0,48,48
166407,2019-10-15 00:00:00+03:00,out,True,888534,False,3,105,140,35
166407,2019-10-15 00:00:00+03:00,out,False,888534,False,3,315,321,6
166407,2019-10-15 00:00:00+03:00,out,True,888534,True,1,0,22,22
166407,2019-10-15 00:00:00+03:00,in,False,888534,False,1,35,57,22
166407,2019-10-16 00:00:00+03:00,out,False,888534,False,11,405,533,128
166407,2019-10-16 00:00:00+03:00,out,True,907442,False,1,58,64,6
166407,2019-10-16 00:00:00+03:00,out,False,888534,True,88,0,1019,1019
166407,2019-10-16 00:00:00+03:00,out,True,907440,False,2,48,68,20
166407,2019-10-16 00:00:00+03:00,in,False,888532,False,1,310,330,20
166407,2019-10-16 00:00:00+03:00,out,True,888532,False,1,10,16,6
166407,2019-10-16 00:00:00+03:00,in,False,888534,False,2,118,171,53
166407,2019-10-17 00:00:00+03:00,out,True,907440,False,3,32,57,25
166407,2019-10-17 00:00:00+03:00,out,True,888532,True,1,0,20,20
166407,2019-10-17 00:00:00+03:00,in,False,888532,False,2,818,861,43
166407,2019-10-17 00:00:00+03:00,out,True,888536,False,1,7,12,5
166407,2019-10-17 00:00:00+03:00,out,True,888534,False,2,25,34,9
166407,2019-10-17 00:00:00+03:00,out,False,907442,False,1,152,163,11
166407,2019-10-17 00:00:00+03:00,out,True,888532,False,1,15,21,6
166407,2019-10-17 00:00:00+03:00,out,True,907440,True,1,0,17,17
166407,2019-10-17 00:00:00+03:00,in,False,888534,False,2,69,111,42
166407,2019-10-17 00:00:00+03:00,out,False,888534,False,1,90,131,41
166407,2019-10-17 00:00:00+03:00,out,True,888536,False,1,7,12,5
166407,2019-10-18 00:00:00+03:00,out,False,888534,True,2,0,4,4
166407,2019-10-18 00:00:00+03:00,in,False,-1,True,1,0,49,49
166407,2019-10-18 00:00:00+03:00,out,False,888534,False,1,353,355,2
166407,2019-10-18 00:00:00+03:00,in,False,888534,False,1,71,89,18
166407,2019-10-21 00:00:00+03:00,out,False,888534,False,1,152,165,13
166407,2019-10-21 00:00:00+03:00,out,True,888534,False,1,6,12,6
166407,2019-10-21 00:00:00+03:00,in,False,888534,False,4,279,370,91
166407,2019-10-21 00:00:00+03:00,out,True,888532,False,2,80,89,9
166407,2019-10-21 00:00:00+03:00,out,True,907442,False,1,11,18,7
166407,2019-10-21 00:00:00+03:00,out,True,888536,True,3,0,61,61
166407,2019-10-21 00:00:00+03:00,out,True,888536,False,2,15,28,13
166407,2019-10-21 00:00:00+03:00,out,True,888532,True,1,0,22,22
166407,2019-10-21 00:00:00+03:00,out,False,907442,False,3,588,632,44
166407,2019-10-21 00:00:00+03:00,in,False,-1,True,1,0,73,73
166407,2019-10-21 00:00:00+03:00,in,False,888532,False,2,147,187,40
166407,2019-10-21 00:00:00+03:00,out,True,888532,True,1,0,22,22
166407,2019-10-22 00:00:00+03:00,in,False,907440,False,1,93,113,20
166407,2019-10-22 00:00:00+03:00,out,True,888532,True,2,0,59,59
166407,2019-10-22 00:00:00+03:00,out,False,907442,True,4,0,123,123
166407,2019-10-22 00:00:00+03:00,out,False,888534,True,3,0,153,153
166407,2019-10-22 00:00:00+03:00,out,True,888534,False,2,12,27,15
166407,2019-10-22 00:00:00+03:00,out,False,907440,False,1,978,990,12
166407,2019-10-22 00:00:00+03:00,out,True,888536,False,1,16,22,6
166407,2019-10-22 00:00:00+03:00,out,False,888534,False,1,56,64,8
166407,2019-10-22 00:00:00+03:00,in,False,888534,False,5,413,578,165
166407,2019-10-22 00:00:00+03:00,in,False,888532,False,1,67,89,22
166407,2019-10-22 00:00:00+03:00,out,True,888532,False,4,1201,1224,23
166407,2019-10-22 00:00:00+03:00,out,True,907440,False,2,44,58,14
166407,2019-10-23 00:00:00+03:00,in,False,-1,True,1,0,54,54
166407,2019-10-23 00:00:00+03:00,out,True,888536,False,1,1,29,28
166407,2019-10-23 00:00:00+03:00,out,True,888534,False,3,31,65,34
166407,2019-10-23 00:00:00+03:00,out,True,888532,True,1,0,6,6
166407,2019-10-23 00:00:00+03:00,out,True,907440,False,3,54,74,20
166407,2019-10-23 00:00:00+03:00,out,False,907442,False,4,195,255,60
166407,2019-10-23 00:00:00+03:00,out,False,888534,True,2,0,26,26
166407,2019-10-23 00:00:00+03:00,out,False,907442,True,3,0,158,158
166407,2019-10-23 00:00:00+03:00,out,True,888532,False,2,41,65,24
166407,2019-10-23 00:00:00+03:00,out,True,888534,True,1,0,38,38
166407,2019-10-23 00:00:00+03:00,out,False,888534,False,1,73,102,29
166407,2019-10-24 00:00:00+03:00,out,True,888534,True,1,0,33,33
166407,2019-10-24 00:00:00+03:00,out,True,888534,False,1,7,12,5
166407,2019-10-24 00:00:00+03:00,out,True,888532,False,2,21,32,11
166407,2019-10-24 00:00:00+03:00,in,False,888534,False,2,79,119,40
166407,2019-10-24 00:00:00+03:00,out,True,907440,False,4,106,133,27
166407,2019-10-24 00:00:00+03:00,out,False,907442,False,1,25,33,8
166407,2019-10-24 00:00:00+03:00,in,False,888540,False,1,450,469,19
166407,2019-10-24 00:00:00+03:00,out,False,907442,True,9,0,331,331
166407,2019-10-24 00:00:00+03:00,out,True,907440,False,4,106,133,27
166407,2019-10-24 00:00:00+03:00,out,True,888534,True,1,0,33,33
166407,2019-10-24 00:00:00+03:00,out,True,888532,False,2,21,32,11
166407,2019-10-25 00:00:00+03:00,in,False,888532,True,1,0,67,67
166407,2019-10-25 00:00:00+03:00,in,False,-1,True,3,0,64,64
166407,2019-10-28 00:00:00+03:00,out,True,888538,True,1,0,10,10
166407,2019-10-28 00:00:00+03:00,in,False,888534,False,1,24,81,57
166407,2019-10-28 00:00:00+03:00,out,True,907442,False,1,120,128,8
166407,2019-10-28 00:00:00+03:00,out,True,888532,False,2,106,141,35
166407,2019-10-28 00:00:00+03:00,out,True,888534,False,5,52,81,29
166407,2019-10-28 00:00:00+03:00,out,True,907440,False,3,114,136,22
166407,2019-10-28 00:00:00+03:00,in,False,-1,True,2,0,48,48
166407,2019-10-28 00:00:00+03:00,out,True,888532,True,2,0,39,39
166407,2019-10-28 00:00:00+03:00,out,True,907440,True,1,0,36,36
166407,2019-10-28 00:00:00+03:00,out,True,907442,True,2,0,40,40
166407,2019-10-29 00:00:00+03:00,out,False,888534,False,9,3897,3960,63
166407,2019-10-29 00:00:00+03:00,in,False,907440,False,1,94,117,23
166407,2019-10-29 00:00:00+03:00,out,False,888534,True,5,0,24,24
166407,2019-10-29 00:00:00+03:00,out,True,907440,False,1,15,22,7
166407,2019-10-29 00:00:00+03:00,out,True,888532,False,1,85,90,5
166407,2019-10-29 00:00:00+03:00,out,True,888534,False,2,20,34,14
166407,2019-10-29 00:00:00+03:00,out,True,907442,False,1,37,46,9
166407,2019-10-29 00:00:00+03:00,out,False,888534,False,9,3897,3960,63
166407,2019-10-29 00:00:00+03:00,out,True,907440,False,1,15,22,7
166407,2019-10-30 00:00:00+03:00,out,True,907440,False,1,111,118,7
166407,2019-10-30 00:00:00+03:00,out,True,888534,True,1,0,1,1
166407,2019-10-30 00:00:00+03:00,out,True,888540,True,1,0,19,19
166407,2019-10-30 00:00:00+03:00,out,True,888534,False,2,51,63,12
166407,2019-10-30 00:00:00+03:00,out,True,888540,False,1,46,54,8
166407,2019-10-30 00:00:00+03:00,out,True,888532,False,4,264,297,33
166407,2019-10-30 00:00:00+03:00,out,True,907440,True,1,0,19,19
166407,2019-10-30 00:00:00+03:00,out,True,888540,False,1,46,54,8
166407,2019-10-30 00:00:00+03:00,out,True,888534,False,2,51,63,12
166407,2019-10-30 00:00:00+03:00,out,True,907440,False,1,111,118,7
166407,2019-10-30 00:00:00+03:00,out,True,888540,True,1,0,19,19
166407,2019-10-31 00:00:00+03:00,out,True,907440,False,3,208,231,23
166407,2019-10-31 00:00:00+03:00,out,False,907440,False,1,149,156,7
166407,2019-10-31 00:00:00+03:00,out,False,907440,False,1,149,156,7
166407,2019-11-01 00:00:00+03:00,out,True,888532,False,5,93,130,37
166407,2019-11-01 00:00:00+03:00,out,True,888540,False,1,7,12,5
166407,2019-11-01 00:00:00+03:00,out,True,907440,False,2,45,57,12
166407,2019-11-01 00:00:00+03:00,out,False,907440,False,1,37,45,8
166407,2019-11-01 00:00:00+03:00,out,True,888532,True,2,0,58,58
166407,2019-11-01 00:00:00+03:00,out,False,888534,False,1,42,62,20
166407,2019-11-01 00:00:00+03:00,out,False,888532,False,1,18,24,6
166407,2019-11-01 00:00:00+03:00,out,True,907442,False,2,29,40,11
166407,2019-11-05 00:00:00+03:00,out,True,888532,True,1,0,30,30
166407,2019-11-05 00:00:00+03:00,out,False,888534,True,2,0,83,83
166407,2019-11-05 00:00:00+03:00,out,True,888532,False,2,26,37,11
166407,2019-11-05 00:00:00+03:00,out,True,907440,False,2,64,75,11
166407,2019-11-05 00:00:00+03:00,in,False,888534,False,1,71,97,26
166407,2019-11-06 00:00:00+03:00,out,False,888534,True,1,0,39,39
166407,2019-11-06 00:00:00+03:00,in,False,888536,False,1,274,292,18
166407,2019-11-06 00:00:00+03:00,out,True,907442,True,1,0,38,38
166407,2019-11-06 00:00:00+03:00,out,False,907440,False,2,393,403,10
166407,2019-11-06 00:00:00+03:00,out,False,888534,False,1,55,64,9
166407,2019-11-06 00:00:00+03:00,out,True,888532,True,1,0,19,19
166407,2019-11-06 00:00:00+03:00,in,False,888534,False,2,105,154,49
166407,2019-11-06 00:00:00+03:00,out,True,907440,False,2,37,51,14
166407,2019-11-06 00:00:00+03:00,in,False,-1,True,1,0,63,63
166407,2019-11-06 00:00:00+03:00,out,True,907440,True,2,0,41,41
166407,2019-11-06 00:00:00+03:00,out,True,888536,True,1,0,21,21
166407,2019-11-06 00:00:00+03:00,out,True,888534,False,2,21,31,10
166407,2019-11-06 00:00:00+03:00,out,True,888536,False,2,47,58,11
166407,2019-11-06 00:00:00+03:00,out,True,888532,False,1,414,419,5
166407,2019-11-07 00:00:00+03:00,out,True,907442,False,1,6,12,6
166407,2019-11-07 00:00:00+03:00,out,False,907440,False,1,8,10,2
166407,2019-11-07 00:00:00+03:00,in,False,888534,False,3,247,305,58
166407,2019-11-07 00:00:00+03:00,out,True,907440,False,3,60,82,22
166407,2019-11-07 00:00:00+03:00,out,True,907442,True,1,0,20,20
166407,2019-11-07 00:00:00+03:00,out,False,888534,False,1,38,52,14
166407,2019-11-07 00:00:00+03:00,out,False,907442,False,1,35,53,18
166407,2019-11-07 00:00:00+03:00,in,False,907440,False,1,38,60,22
166407,2019-11-07 00:00:00+03:00,in,False,-1,True,2,0,72,72
166407,2019-11-07 00:00:00+03:00,out,True,907442,True,1,0,20,20
166407,2019-11-08 00:00:00+03:00,out,True,907440,True,6,0,112,112
166407,2019-11-08 00:00:00+03:00,out,True,888534,False,1,8,13,5
166407,2019-11-08 00:00:00+03:00,out,True,888534,True,1,0,13,13
166407,2019-11-08 00:00:00+03:00,out,False,888534,False,2,266,279,13
166407,2019-11-08 00:00:00+03:00,out,True,888532,False,8,264,310,46
166407,2019-11-08 00:00:00+03:00,in,False,907440,False,1,67,87,20
166407,2019-11-08 00:00:00+03:00,out,True,888532,True,3,0,26,26
166407,2019-11-08 00:00:00+03:00,out,True,907440,False,4,101,138,37
166407,2019-11-08 00:00:00+03:00,in,False,-1,True,1,0,13,13
166407,2019-11-08 00:00:00+03:00,out,False,888534,True,2,0,5,5
166407,2019-11-08 00:00:00+03:00,out,False,888534,True,2,0,5,5
166407,2019-11-08 00:00:00+03:00,out,True,888532,False,8,264,310,46
166407,2019-11-11 00:00:00+03:00,out,True,888534,False,2,27,39,12
166407,2019-11-11 00:00:00+03:00,out,True,888532,True,2,0,44,44
166407,2019-11-11 00:00:00+03:00,out,True,888536,True,3,0,40,40
166407,2019-11-11 00:00:00+03:00,out,True,907440,False,1,12,17,5
166407,2019-11-11 00:00:00+03:00,out,True,888536,False,3,184,201,17
166407,2019-11-11 00:00:00+03:00,out,True,907442,False,1,24,30,6
166407,2019-11-11 00:00:00+03:00,out,True,888532,False,7,128,178,50
166407,2019-11-12 00:00:00+03:00,out,True,907442,False,1,86,91,5
166407,2019-11-12 00:00:00+03:00,out,False,888534,True,7,0,13,13
166407,2019-11-12 00:00:00+03:00,out,False,907440,True,1,0,51,51
166407,2019-11-12 00:00:00+03:00,out,False,907440,False,2,403,427,24
166407,2019-11-12 00:00:00+03:00,out,True,907440,False,5,85,118,33
166407,2019-11-12 00:00:00+03:00,out,False,888534,False,2,430,432,2
166407,2019-11-12 00:00:00+03:00,out,True,888534,False,3,13,31,18
166407,2019-11-12 00:00:00+03:00,out,True,888532,False,2,107,125,18
166407,2019-11-12 00:00:00+03:00,out,False,888534,False,2,430,432,2
166407,2019-11-13 00:00:00+03:00,out,True,907442,False,1,13,18,5
166407,2019-11-13 00:00:00+03:00,out,True,888536,True,1,0,5,5
166407,2019-11-13 00:00:00+03:00,out,True,888538,False,1,1,17,16
166407,2019-11-13 00:00:00+03:00,out,True,888532,True,1,0,22,22
166407,2019-11-13 00:00:00+03:00,out,True,888532,False,4,82,111,29
166407,2019-11-13 00:00:00+03:00,out,False,888534,False,1,59,60,1
166407,2019-11-13 00:00:00+03:00,out,True,888538,False,1,1,17,16
166407,2019-11-14 00:00:00+03:00,out,True,907442,False,1,35,49,14
166407,2019-11-14 00:00:00+03:00,out,False,907440,True,4,0,45,45
166407,2019-11-14 00:00:00+03:00,out,True,907440,False,5,131,169,38
166407,2019-11-14 00:00:00+03:00,out,True,888534,False,4,56,90,34
166407,2019-11-14 00:00:00+03:00,out,True,960950,False,1,8,23,15
166407,2019-11-14 00:00:00+03:00,out,False,907442,True,7,0,173,173
166407,2019-11-14 00:00:00+03:00,out,False,888534,False,3,486,508,22
166407,2019-11-14 00:00:00+03:00,out,True,888532,False,1,39,43,4
166407,2019-11-14 00:00:00+03:00,out,False,907442,False,4,261,292,31
166407,2019-11-14 00:00:00+03:00,out,True,960950,True,3,0,82,82
166407,2019-11-14 00:00:00+03:00,out,True,960950,True,3,0,82,82
166407,2019-11-14 00:00:00+03:00,out,True,960950,False,1,8,23,15
166407,2019-11-15 00:00:00+03:00,out,True,888532,False,1,53,58,5
166407,2019-11-15 00:00:00+03:00,out,False,907442,False,2,252,271,19
166407,2019-11-15 00:00:00+03:00,out,True,888532,True,3,0,63,63
166407,2019-11-15 00:00:00+03:00,out,True,888534,False,2,82,96,14
166407,2019-11-15 00:00:00+03:00,out,True,960950,False,2,27,38,11
166407,2019-11-15 00:00:00+03:00,out,True,907440,False,2,15,30,15
166407,2019-11-15 00:00:00+03:00,out,False,888534,False,1,166,171,5
166407,2019-11-18 00:00:00+03:00,out,False,888534,True,1,0,46,46
166407,2019-11-18 00:00:00+03:00,out,True,888534,False,1,6,12,6
166407,2019-11-18 00:00:00+03:00,out,False,888534,False,2,126,137,11
166407,2019-11-18 00:00:00+03:00,out,True,960950,True,1,0,28,28
166407,2019-11-18 00:00:00+03:00,out,False,888534,True,1,0,46,46
166407,2019-11-19 00:00:00+03:00,out,True,888538,True,1,0,5,5
166407,2019-11-19 00:00:00+03:00,out,True,888534,False,1,7,12,5
166407,2019-11-19 00:00:00+03:00,out,True,960950,True,1,0,18,18
166407,2019-11-19 00:00:00+03:00,out,True,888532,False,4,47,73,26
166407,2019-11-19 00:00:00+03:00,out,True,888536,True,1,0,5,5
166407,2019-11-19 00:00:00+03:00,out,True,907440,True,1,0,12,12
166407,2019-11-19 00:00:00+03:00,out,True,960950,True,1,0,18,18
166407,2019-11-20 00:00:00+03:00,out,True,907440,False,1,84,90,6
166407,2019-11-20 00:00:00+03:00,out,True,888532,False,1,34,38,4
166407,2019-11-20 00:00:00+03:00,out,True,888534,False,1,8,14,6
166407,2019-11-20 00:00:00+03:00,out,False,888534,False,2,253,262,9
166407,2019-11-20 00:00:00+03:00,out,True,907442,False,2,20,32,12
166407,2019-11-20 00:00:00+03:00,out,True,888536,False,1,27,32,5
166407,2019-11-20 00:00:00+03:00,out,True,888532,False,1,34,38,4
166407,2019-11-21 00:00:00+03:00,out,True,888532,True,1,0,23,23
166407,2019-11-21 00:00:00+03:00,out,True,907440,True,1,0,10,10
166407,2019-11-21 00:00:00+03:00,out,True,907442,False,2,82,92,10
166407,2019-11-21 00:00:00+03:00,out,True,907440,False,4,111,137,26
166407,2019-11-21 00:00:00+03:00,out,True,888532,False,1,25,30,5
166407,2019-11-21 00:00:00+03:00,out,False,888534,False,1,112,115,3
166407,2019-11-21 00:00:00+03:00,out,True,888534,False,2,34,49,15
166407,2019-11-21 00:00:00+03:00,out,True,907442,True,1,0,18,18
166407,2019-11-21 00:00:00+03:00,out,False,907440,False,3,170,193,23
166407,2019-11-21 00:00:00+03:00,in,False,-1,True,1,0,74,74
166407,2019-11-21 00:00:00+03:00,in,False,888534,False,3,92,150,58
166407,2019-11-21 00:00:00+03:00,out,True,907440,True,1,0,10,10
166407,2019-11-22 00:00:00+03:00,out,True,888532,False,1,7,26,19
166407,2019-11-22 00:00:00+03:00,in,False,888534,False,2,130,174,44
166407,2019-11-22 00:00:00+03:00,out,True,907440,False,3,110,129,19
166407,2019-11-22 00:00:00+03:00,out,True,960950,False,2,227,238,11
166407,2019-11-22 00:00:00+03:00,out,True,907440,True,1,0,17,17
166407,2019-11-22 00:00:00+03:00,out,True,888534,True,1,0,4,4
166407,2019-11-22 00:00:00+03:00,out,True,907442,False,2,158,174,16
166407,2019-11-22 00:00:00+03:00,out,True,888532,False,1,7,26,19
166407,2019-11-25 00:00:00+03:00,out,True,907442,False,1,10,17,7
166407,2019-11-25 00:00:00+03:00,out,True,960950,False,2,82,98,16
166407,2019-11-25 00:00:00+03:00,out,True,907440,False,1,42,46,4
166407,2019-11-25 00:00:00+03:00,out,False,907440,False,3,332,362,30
166407,2019-11-25 00:00:00+03:00,out,True,888532,False,3,144,157,13
166407,2019-11-25 00:00:00+03:00,out,True,907442,True,1,0,0,0
166407,2019-11-25 00:00:00+03:00,out,True,888536,False,2,48,61,13
166407,2019-11-26 00:00:00+03:00,in,False,-1,True,1,0,58,58
166407,2019-11-26 00:00:00+03:00,out,True,888532,False,1,21,26,5
166407,2019-11-26 00:00:00+03:00,out,True,907440,False,1,24,35,11
166407,2019-11-26 00:00:00+03:00,out,True,888534,True,1,0,0,0
166407,2019-11-26 00:00:00+03:00,out,True,888534,False,1,38,43,5
166407,2019-11-26 00:00:00+03:00,out,False,888534,False,4,626,644,18
166407,2019-11-26 00:00:00+03:00,out,False,907440,False,1,553,561,8
166407,2019-11-27 00:00:00+03:00,out,True,888532,True,2,0,52,52
166407,2019-11-27 00:00:00+03:00,out,False,907442,True,2,0,64,64
166407,2019-11-27 00:00:00+03:00,out,True,907440,False,2,53,62,9
166407,2019-11-27 00:00:00+03:00,in,False,907440,False,1,629,667,38
166407,2019-11-27 00:00:00+03:00,in,False,888534,False,3,164,258,94
166407,2019-11-27 00:00:00+03:00,out,True,960950,False,2,742,755,13
166407,2019-11-27 00:00:00+03:00,out,True,888532,False,11,344,404,60
166407,2019-11-27 00:00:00+03:00,out,True,888534,False,4,65,94,29
166407,2019-11-27 00:00:00+03:00,out,False,907442,False,2,234,252,18
166407,2019-11-27 00:00:00+03:00,out,True,888534,True,1,0,18,18
166407,2019-11-27 00:00:00+03:00,out,False,888536,False,1,104,114,10
166407,2019-11-27 00:00:00+03:00,out,False,907442,False,2,234,252,18
166407,2019-11-28 00:00:00+03:00,out,False,907442,False,1,4,6,2
166407,2019-11-28 00:00:00+03:00,in,False,-1,True,1,0,21,21
166407,2019-11-28 00:00:00+03:00,out,True,888534,False,2,13,24,11
166407,2019-11-28 00:00:00+03:00,out,False,888534,False,2,1067,1077,10
166407,2019-11-28 00:00:00+03:00,out,True,907440,False,3,228,245,17
166407,2019-11-28 00:00:00+03:00,out,True,907442,False,1,13,17,4
166407,2019-11-28 00:00:00+03:00,out,True,888532,False,1,16,23,7
166407,2019-11-28 00:00:00+03:00,out,True,888532,True,1,0,33,33
166428,2019-08-05 00:00:00+03:00,in,False,-1,True,2,0,59,59
166428,2019-08-06 00:00:00+03:00,in,False,-1,True,1,0,52,52
166428,2019-08-07 00:00:00+03:00,in,False,882680,False,2,41,92,51
166428,2019-08-08 00:00:00+03:00,in,False,882680,False,2,92,122,30
166428,2019-08-09 00:00:00+03:00,in,False,882680,False,2,71,102,31
166428,2019-08-10 00:00:00+03:00,in,False,882680,False,2,110,147,37
166428,2019-08-12 00:00:00+03:00,in,False,882680,False,2,305,328,23
166428,2019-08-13 00:00:00+03:00,in,False,-1,True,1,0,20,20
166428,2019-08-13 00:00:00+03:00,in,False,882680,False,5,466,568,102
166428,2019-08-15 00:00:00+03:00,in,False,882680,False,1,38,53,15
166428,2019-08-17 00:00:00+03:00,in,False,-1,True,1,0,1,1
166428,2019-08-19 00:00:00+03:00,in,False,882680,False,1,2,47,45
166428,2019-08-19 00:00:00+03:00,in,False,-1,True,1,0,42,42
166428,2019-08-21 00:00:00+03:00,in,False,882680,False,3,77,110,33
166428,2019-08-23 00:00:00+03:00,in,False,882680,False,3,73,110,37
166428,2019-08-25 00:00:00+03:00,in,False,-1,True,1,0,0,0
166428,2019-08-26 00:00:00+03:00,in,False,882680,False,4,61,163,102
166428,2019-08-28 00:00:00+03:00,in,False,-1,True,1,0,5,5
166428,2019-08-28 00:00:00+03:00,in,True,882680,False,1,57,76,19
166428,2019-08-28 00:00:00+03:00,in,False,882680,False,3,140,173,33
166428,2019-08-29 00:00:00+03:00,in,False,882680,False,3,389,434,45
166428,2019-08-29 00:00:00+03:00,in,False,-1,True,1,0,32,32
166428,2019-09-01 00:00:00+03:00,in,False,882680,False,1,42,52,10
166428,2019-09-03 00:00:00+03:00,in,False,882680,False,2,208,237,29
166428,2019-09-03 00:00:00+03:00,in,False,-1,True,1,0,5,5
166428,2019-09-04 00:00:00+03:00,in,False,882680,False,1,18,29,11
166428,2019-09-05 00:00:00+03:00,in,False,882680,True,1,0,21,21
166428,2019-09-05 00:00:00+03:00,in,False,882680,False,1,43,55,12
166428,2019-09-09 00:00:00+03:00,in,False,882680,False,1,42,52,10
166428,2019-09-10 00:00:00+03:00,in,False,-1,True,1,0,19,19
166428,2019-09-10 00:00:00+03:00,in,False,882680,True,1,0,23,23
166428,2019-09-10 00:00:00+03:00,in,False,882680,False,5,52,179,127
166428,2019-09-12 00:00:00+03:00,in,False,882680,False,1,12,58,46
166428,2019-09-13 00:00:00+03:00,in,False,-1,True,1,0,22,22
166428,2019-09-13 00:00:00+03:00,in,False,882680,True,1,0,49,49
166428,2019-09-17 00:00:00+03:00,in,False,882680,False,4,447,506,59
166428,2019-09-22 00:00:00+03:00,in,False,-1,True,1,0,6,6
166428,2019-09-23 00:00:00+03:00,in,False,882680,False,1,97,106,9
166428,2019-10-01 00:00:00+03:00,in,False,882680,False,1,148,164,16
166428,2019-10-04 00:00:00+03:00,in,True,928202,False,1,44,56,12
166428,2019-10-07 00:00:00+03:00,in,False,882680,False,3,394,430,36
166428,2019-10-07 00:00:00+03:00,in,False,928202,False,1,3,15,12
166428,2019-10-09 00:00:00+03:00,in,False,898676,False,1,30,37,7
166428,2019-10-10 00:00:00+03:00,in,False,898676,False,1,127,136,9
166428,2019-10-10 00:00:00+03:00,in,False,882680,False,1,1,30,29
166428,2019-10-10 00:00:00+03:00,in,False,898676,False,1,127,136,9
166428,2019-10-11 00:00:00+03:00,in,False,882680,False,1,40,57,17
166428,2019-10-14 00:00:00+03:00,in,False,-1,True,1,0,31,31
166428,2019-10-15 00:00:00+03:00,in,False,928202,False,1,1471,1488,17
166428,2019-10-15 00:00:00+03:00,in,False,928202,False,1,1471,1488,17
166428,2019-10-16 00:00:00+03:00,in,False,928202,False,2,230,255,25
166428,2019-10-16 00:00:00+03:00,in,False,882680,False,1,39,55,16
166428,2019-10-16 00:00:00+03:00,in,False,-1,True,1,0,31,31
166428,2019-10-16 00:00:00+03:00,in,False,882680,False,1,39,55,16
166428,2019-10-17 00:00:00+03:00,in,False,928202,False,2,529,561,32
166428,2019-10-18 00:00:00+03:00,in,False,-1,True,1,0,30,30
166428,2019-10-18 00:00:00+03:00,in,False,928202,False,1,117,146,29
166428,2019-10-19 00:00:00+03:00,in,False,928202,False,4,1816,1870,54
166428,2019-10-19 00:00:00+03:00,in,False,-1,True,2,0,62,62
166428,2019-10-20 00:00:00+03:00,in,False,-1,True,2,0,54,54
166428,2019-10-20 00:00:00+03:00,in,False,928202,False,3,27,36,9
166428,2019-10-21 00:00:00+03:00,in,False,928202,False,1,185,193,8
166428,2019-10-21 00:00:00+03:00,in,False,-1,True,2,0,62,62
166428,2019-10-22 00:00:00+03:00,in,False,928202,False,1,81,101,20
166428,2019-10-22 00:00:00+03:00,in,False,-1,True,1,0,27,27
166428,2019-10-23 00:00:00+03:00,in,False,882680,False,2,55,106,51
166428,2019-10-23 00:00:00+03:00,in,False,928202,False,1,453,471,18
166428,2019-10-23 00:00:00+03:00,in,False,928202,False,1,453,471,18
166428,2019-10-24 00:00:00+03:00,in,False,-1,True,1,0,27,27
166428,2019-10-25 00:00:00+03:00,in,False,-1,True,1,0,13,13
166428,2019-10-27 00:00:00+03:00,in,False,882680,False,3,14,50,36
166428,2019-10-28 00:00:00+03:00,in,False,928202,False,4,577,656,79
166428,2019-10-28 00:00:00+03:00,in,False,928202,False,4,577,656,79
166428,2019-10-29 00:00:00+03:00,in,False,928202,False,1,84,105,21
166428,2019-10-29 00:00:00+03:00,in,False,928202,False,1,84,105,21
166428,2019-10-30 00:00:00+03:00,in,False,928202,False,2,402,437,35
166428,2019-11-01 00:00:00+03:00,in,False,-1,True,1,0,0,0
166428,2019-11-03 00:00:00+03:00,in,False,-1,True,2,0,0,0
166428,2019-11-04 00:00:00+03:00,in,False,-1,True,2,0,0,0
166428,2019-11-05 00:00:00+03:00,in,False,-1,True,2,0,0,0
166428,2019-11-05 00:00:00+03:00,in,False,-1,True,3,0,2,2
166428,2019-11-05 00:00:00+03:00,in,False,882680,False,2,919,939,20
166428,2019-11-06 00:00:00+03:00,in,True,882680,False,1,28,35,7
166428,2019-11-06 00:00:00+03:00,in,False,-1,True,1,0,16,16
166428,2019-11-07 00:00:00+03:00,in,False,882680,False,2,359,378,19
166428,2019-11-08 00:00:00+03:00,in,False,882680,False,8,138,223,85
166428,2019-11-08 00:00:00+03:00,in,False,882680,False,8,138,223,85
166428,2019-11-09 00:00:00+03:00,in,False,-1,True,1,0,2,2
166428,2019-11-11 00:00:00+03:00,in,False,882680,False,2,53,79,26
166428,2019-11-11 00:00:00+03:00,in,False,-1,True,1,0,4,4
166428,2019-11-18 00:00:00+03:00,in,False,882680,False,1,14,29,15
166428,2019-11-18 00:00:00+03:00,in,False,882680,False,1,14,29,15
166428,2019-11-21 00:00:00+03:00,in,False,-1,True,1,0,3,3
166428,2019-11-24 00:00:00+03:00,in,False,882680,False,1,7,19,12
166428,2019-11-25 00:00:00+03:00,in,False,882680,False,3,63,101,38
166428,2019-11-26 00:00:00+03:00,in,False,-1,True,1,0,0,0
166428,2019-11-26 00:00:00+03:00,in,False,882680,False,4,176,230,54
166428,2019-11-28 00:00:00+03:00,in,False,882680,False,9,776,881,105
166428,2019-11-28 00:00:00+03:00,in,False,-1,True,2,0,33,33
166481,2019-08-08 00:00:00+03:00,in,False,-1,True,2,0,0,0
166481,2019-08-09 00:00:00+03:00,in,False,-1,True,9,0,4,4
166481,2019-08-09 00:00:00+03:00,in,False,884294,False,1,5,11,6
166481,2019-08-09 00:00:00+03:00,in,False,-1,True,9,0,4,4
166481,2019-08-12 00:00:00+03:00,in,False,-1,True,17,0,33,33
166481,2019-08-13 00:00:00+03:00,in,False,-1,True,2,0,2,2
166481,2019-08-27 00:00:00+03:00,in,False,-1,True,1,0,1,1
166481,2019-09-02 00:00:00+03:00,in,False,-1,True,14,0,5,5
166481,2019-09-03 00:00:00+03:00,in,False,-1,True,10,0,8,8
166481,2019-09-25 00:00:00+03:00,in,False,-1,True,1,0,2,2
166481,2019-10-11 00:00:00+03:00,in,False,-1,True,1,0,2,2
166482,2019-08-08 00:00:00+03:00,in,False,-1,True,1,0,2,2
166482,2019-08-09 00:00:00+03:00,in,False,-1,True,1,0,2,2
166482,2019-08-10 00:00:00+03:00,in,False,-1,True,1,0,2,2
166482,2019-08-12 00:00:00+03:00,in,False,-1,True,2,0,5,5
166482,2019-08-13 00:00:00+03:00,in,False,-1,True,1,0,2,2
166482,2019-08-14 00:00:00+03:00,in,False,-1,True,1,0,2,2
166482,2019-08-16 00:00:00+03:00,in,False,-1,True,1,0,2,2
166482,2019-08-17 00:00:00+03:00,in,False,-1,True,1,0,2,2
166482,2019-08-19 00:00:00+03:00,in,False,-1,True,1,0,2,2
166482,2019-08-22 00:00:00+03:00,in,False,-1,True,1,0,2,2
166482,2019-08-24 00:00:00+03:00,in,False,-1,True,2,0,4,4
166482,2019-08-25 00:00:00+03:00,in,False,-1,True,1,0,2,2
166482,2019-08-26 00:00:00+03:00,in,False,-1,True,2,0,4,4
166482,2019-09-03 00:00:00+03:00,in,False,-1,True,2,0,5,5
166482,2019-09-03 00:00:00+03:00,in,False,-1,True,2,0,5,5
166482,2019-09-09 00:00:00+03:00,in,False,-1,True,2,0,4,4
166482,2019-09-10 00:00:00+03:00,in,False,-1,True,1,0,2,2
166482,2019-09-12 00:00:00+03:00,in,False,-1,True,1,0,2,2
166482,2019-09-14 00:00:00+03:00,in,False,-1,True,1,0,2,2
166482,2019-09-16 00:00:00+03:00,in,False,-1,True,1,0,2,2
166482,2019-09-17 00:00:00+03:00,in,False,-1,True,2,0,4,4
166482,2019-09-19 00:00:00+03:00,in,False,-1,True,3,0,6,6
166482,2019-09-23 00:00:00+03:00,in,False,-1,True,1,0,2,2
166482,2019-09-25 00:00:00+03:00,in,False,-1,True,3,0,6,6
166482,2019-09-25 00:00:00+03:00,in,False,-1,True,3,0,6,6
166482,2019-09-28 00:00:00+03:00,in,False,-1,True,1,0,3,3
166482,2019-09-30 00:00:00+03:00,in,False,-1,True,1,0,2,2
166482,2019-10-02 00:00:00+03:00,in,False,-1,True,1,0,2,2
166482,2019-10-03 00:00:00+03:00,in,False,-1,True,1,0,2,2
166482,2019-10-04 00:00:00+03:00,in,False,-1,True,1,0,2,2
166482,2019-10-07 00:00:00+03:00,in,False,-1,True,1,0,2,2
166482,2019-10-08 00:00:00+03:00,in,False,-1,True,1,0,3,3
166482,2019-10-10 00:00:00+03:00,in,False,-1,True,2,0,4,4
166482,2019-10-12 00:00:00+03:00,in,False,934076,True,1,0,45,45
166482,2019-10-12 00:00:00+03:00,in,False,934076,False,1,19,54,35
166482,2019-10-13 00:00:00+03:00,in,False,-1,True,1,0,46,46
166482,2019-10-14 00:00:00+03:00,in,False,-1,True,1,0,14,14
166482,2019-10-14 00:00:00+03:00,in,False,934074,False,2,389,412,23
166482,2019-10-14 00:00:00+03:00,in,False,934076,False,1,30,57,27
166482,2019-10-15 00:00:00+03:00,in,False,-1,True,1,0,33,33
166482,2019-10-15 00:00:00+03:00,in,False,934074,False,6,515,578,63
166482,2019-10-15 00:00:00+03:00,in,False,934076,False,4,55,191,136
166482,2019-10-16 00:00:00+03:00,in,False,934074,False,3,228,260,32
166482,2019-10-16 00:00:00+03:00,in,False,-1,True,1,0,31,31
166482,2019-10-17 00:00:00+03:00,in,False,-1,True,1,0,1,1
166482,2019-10-17 00:00:00+03:00,in,False,934074,False,3,280,312,32
166482,2019-10-17 00:00:00+03:00,in,False,-1,True,1,0,1,1
166482,2019-10-18 00:00:00+03:00,in,False,934076,False,2,36,79,43
166482,2019-10-22 00:00:00+03:00,in,False,934074,False,2,263,320,57
166482,2019-10-27 00:00:00+03:00,in,False,-1,True,1,0,28,28
166482,2019-10-28 00:00:00+03:00,in,False,934074,False,1,13,28,15
166482,2019-10-29 00:00:00+03:00,in,False,934074,False,1,6,61,55
166482,2019-10-31 00:00:00+03:00,in,False,934076,False,1,44,55,11
166482,2019-10-31 00:00:00+03:00,in,False,934074,False,1,902,914,12
166482,2019-11-02 00:00:00+03:00,in,False,-1,True,1,0,1,1
166482,2019-11-02 00:00:00+03:00,in,False,934074,False,1,13,24,11
166482,2019-11-05 00:00:00+03:00,in,False,934074,True,1,1,15,14
166482,2019-11-09 00:00:00+03:00,in,False,934074,False,1,20,34,14
166482,2019-11-17 00:00:00+03:00,in,False,934074,False,1,764,802,38
166482,2019-11-17 00:00:00+03:00,in,False,934076,False,1,32,46,14
166482,2019-11-18 00:00:00+03:00,in,False,934074,False,1,43,54,11
166482,2019-11-18 00:00:00+03:00,in,False,934074,False,1,43,54,11
166482,2019-11-19 00:00:00+03:00,in,False,934074,False,3,256,290,34
166482,2019-11-20 00:00:00+03:00,in,False,934074,False,1,71,85,14
166482,2019-11-21 00:00:00+03:00,in,False,934074,False,3,300,340,40
166482,2019-11-22 00:00:00+03:00,in,False,934074,False,1,6,19,13
166482,2019-11-23 00:00:00+03:00,in,False,-1,True,1,0,44,44
166482,2019-11-23 00:00:00+03:00,in,False,-1,True,1,0,44,44
166482,2019-11-25 00:00:00+03:00,in,False,934074,False,3,247,280,33
166482,2019-11-25 00:00:00+03:00,in,False,-1,True,2,0,38,38
166482,2019-11-28 00:00:00+03:00,in,False,934074,False,2,603,626,23
166485,2019-08-13 00:00:00+03:00,out,False,887280,False,1,10,20,10
166485,2019-08-13 00:00:00+03:00,out,False,887280,True,3,0,0,0
166485,2019-08-15 00:00:00+03:00,out,False,887280,False,1,21,30,9
166485,2019-08-15 00:00:00+03:00,in,False,-1,True,3,0,38,38
166485,2019-08-16 00:00:00+03:00,out,False,887280,True,1,0,1,1
166485,2019-08-17 00:00:00+03:00,in,False,-1,True,1,0,0,0
166485,2019-08-20 00:00:00+03:00,in,False,-1,True,1,0,0,0
166485,2019-08-20 00:00:00+03:00,out,False,887280,True,1,0,0,0
166485,2019-08-21 00:00:00+03:00,in,False,-1,True,20,0,3,3
166485,2019-08-21 00:00:00+03:00,out,False,887280,True,1,0,0,0
166485,2019-08-22 00:00:00+03:00,out,False,887276,False,2,11,30,19
166485,2019-08-22 00:00:00+03:00,in,False,-1,True,8,0,1,1
166485,2019-08-22 00:00:00+03:00,out,False,887276,True,2,0,21,21
166485,2019-08-23 00:00:00+03:00,out,False,887282,False,3,16,57,41
166485,2019-08-23 00:00:00+03:00,out,False,887282,True,7,0,136,136
166485,2019-08-23 00:00:00+03:00,in,False,-1,True,4,0,112,112
166485,2019-08-23 00:00:00+03:00,out,False,887276,False,2,10,34,24
166485,2019-08-23 00:00:00+03:00,out,False,887276,True,3,0,38,38
166485,2019-08-23 00:00:00+03:00,in,False,887282,False,2,16,56,40
166485,2019-08-26 00:00:00+03:00,out,False,887276,False,6,271,329,58
166485,2019-08-26 00:00:00+03:00,in,False,887276,False,3,226,323,97
166485,2019-08-27 00:00:00+03:00,in,False,-1,True,3,0,46,46
166485,2019-08-27 00:00:00+03:00,out,False,887276,True,4,0,39,39
166485,2019-08-27 00:00:00+03:00,out,False,887282,False,2,416,449,33
166485,2019-08-27 00:00:00+03:00,out,False,887282,True,6,0,137,137
166485,2019-08-27 00:00:00+03:00,out,False,887276,False,12,897,1090,193
166485,2019-08-28 00:00:00+03:00,out,False,887276,True,1,0,22,22
166485,2019-08-28 00:00:00+03:00,in,False,-1,True,2,0,42,42
166485,2019-08-28 00:00:00+03:00,in,False,887276,False,4,325,426,101
166485,2019-08-28 00:00:00+03:00,out,False,887276,False,10,1000,1145,145
166485,2019-08-29 00:00:00+03:00,out,False,887282,True,1,0,11,11
166485,2019-08-29 00:00:00+03:00,out,False,887276,False,3,153,212,59
166485,2019-08-29 00:00:00+03:00,out,False,887282,False,1,306,324,18
166485,2019-08-29 00:00:00+03:00,out,False,887276,True,5,0,62,62
166485,2019-08-30 00:00:00+03:00,in,False,887276,False,1,88,129,41
166485,2019-08-30 00:00:00+03:00,out,False,887282,True,1,0,5,5
166485,2019-08-30 00:00:00+03:00,out,False,887276,False,4,320,368,48
166485,2019-08-30 00:00:00+03:00,out,False,887276,True,4,0,195,195
166485,2019-08-30 00:00:00+03:00,in,False,887282,False,2,93,192,99
166485,2019-08-30 00:00:00+03:00,in,False,-1,True,2,0,36,36
166485,2019-08-30 00:00:00+03:00,in,False,-1,True,2,0,36,36
166485,2019-08-31 00:00:00+03:00,in,False,-1,True,1,0,51,51
166485,2019-09-02 00:00:00+03:00,out,False,887276,False,8,264,313,49
166485,2019-09-02 00:00:00+03:00,in,False,887276,False,5,594,755,161
166485,2019-09-02 00:00:00+03:00,out,True,887276,True,1,0,1,1
166485,2019-09-02 00:00:00+03:00,in,False,-1,True,4,0,71,71
166485,2019-09-02 00:00:00+03:00,out,False,887276,True,3,0,40,40
166485,2019-09-03 00:00:00+03:00,out,True,887276,False,1,0,4,4
166485,2019-09-03 00:00:00+03:00,out,False,887276,False,11,1362,1564,202
166485,2019-09-03 00:00:00+03:00,out,False,887282,True,4,0,106,106
166485,2019-09-03 00:00:00+03:00,out,False,887282,False,10,1033,1156,123
166485,2019-09-03 00:00:00+03:00,out,False,887276,True,3,0,86,86
166485,2019-09-03 00:00:00+03:00,in,False,887276,False,8,750,954,204
166485,2019-09-04 00:00:00+03:00,in,False,887276,False,4,1015,1191,176
166485,2019-09-04 00:00:00+03:00,out,False,887282,True,2,0,16,16
166485,2019-09-04 00:00:00+03:00,out,False,887276,False,10,1771,1865,94
166485,2019-09-04 00:00:00+03:00,in,False,887282,False,2,292,392,100
166485,2019-09-04 00:00:00+03:00,in,False,-1,True,3,0,102,102
166485,2019-09-04 00:00:00+03:00,out,False,887282,False,9,1708,1792,84
166485,2019-09-05 00:00:00+03:00,out,False,887276,False,8,677,791,114
166485,2019-09-05 00:00:00+03:00,out,False,887282,True,55,0,1035,1035
166485,2019-09-05 00:00:00+03:00,in,False,887276,False,6,847,1026,179
166485,2019-09-05 00:00:00+03:00,out,False,887282,False,20,2800,3028,228
166485,2019-09-05 00:00:00+03:00,out,False,887276,True,5,0,165,165
166485,2019-09-06 00:00:00+03:00,out,False,887282,False,44,4475,4976,501
166485,2019-09-06 00:00:00+03:00,out,False,887282,True,45,0,834,834
166485,2019-09-06 00:00:00+03:00,in,False,887282,False,1,53,125,72
166485,2019-09-06 00:00:00+03:00,in,False,887276,False,8,552,778,226
166485,2019-09-06 00:00:00+03:00,in,False,-1,True,1,0,18,18
166485,2019-09-06 00:00:00+03:00,out,False,887276,False,8,594,718,124
166485,2019-09-06 00:00:00+03:00,in,False,887282,False,1,53,125,72
166485,2019-09-07 00:00:00+03:00,in,False,-1,True,1,0,19,19
166485,2019-09-09 00:00:00+03:00,in,False,887276,True,1,31,44,13
166485,2019-09-09 00:00:00+03:00,out,False,887282,False,50,5464,5920,456
166485,2019-09-09 00:00:00+03:00,out,False,887276,True,1,0,60,60
166485,2019-09-09 00:00:00+03:00,in,False,-1,True,5,0,36,36
166485,2019-09-09 00:00:00+03:00,in,False,887276,False,4,347,477,130
166485,2019-09-09 00:00:00+03:00,out,False,887282,True,26,0,405,405
166485,2019-09-09 00:00:00+03:00,out,False,907174,False,2,32,45,13
166485,2019-09-09 00:00:00+03:00,out,False,887276,False,1,130,133,3
166485,2019-09-09 00:00:00+03:00,out,False,907174,True,9,0,119,119
166485,2019-09-10 00:00:00+03:00,out,False,887282,False,45,5690,6163,473
166485,2019-09-10 00:00:00+03:00,in,False,887282,False,1,156,182,26
166485,2019-09-10 00:00:00+03:00,out,False,907174,True,1,0,60,60
166485,2019-09-10 00:00:00+03:00,out,False,907174,False,1,259,274,15
166485,2019-09-10 00:00:00+03:00,out,False,887276,False,3,178,220,42
166485,2019-09-10 00:00:00+03:00,out,False,887276,True,4,0,158,158
166485,2019-09-10 00:00:00+03:00,in,False,887276,False,5,234,411,177
166485,2019-09-10 00:00:00+03:00,in,False,-1,True,3,0,29,29
166485,2019-09-10 00:00:00+03:00,out,False,887282,True,11,0,285,285
166485,2019-09-10 00:00:00+03:00,out,False,887276,True,4,0,158,158
166485,2019-09-11 00:00:00+03:00,out,False,887282,False,35,4836,5084,248
166485,2019-09-11 00:00:00+03:00,out,False,887276,False,1,153,160,7
166485,2019-09-11 00:00:00+03:00,in,False,-1,True,1,0,4,4
166485,2019-09-11 00:00:00+03:00,in,False,887276,False,2,292,361,69
166485,2019-09-11 00:00:00+03:00,out,False,907174,True,1,0,6,6
166485,2019-09-11 00:00:00+03:00,out,False,907174,False,4,452,494,42
166485,2019-09-11 00:00:00+03:00,in,False,887282,False,1,212,286,74
166485,2019-09-11 00:00:00+03:00,out,False,887282,True,13,0,248,248
166485,2019-09-12 00:00:00+03:00,in,False,-1,True,2,0,94,94
166485,2019-09-12 00:00:00+03:00,out,False,887276,True,1,0,2,2
166485,2019-09-12 00:00:00+03:00,out,False,887282,False,22,2981,3244,263
166485,2019-09-12 00:00:00+03:00,out,False,887282,True,3,0,137,137
166485,2019-09-12 00:00:00+03:00,out,False,887276,False,1,169,178,9
166485,2019-09-12 00:00:00+03:00,in,False,887276,False,4,345,463,118
166485,2019-09-12 00:00:00+03:00,out,False,887276,True,1,0,2,2
166485,2019-09-13 00:00:00+03:00,in,False,887276,False,7,726,885,159
166485,2019-09-13 00:00:00+03:00,out,False,887276,True,2,0,90,90
166485,2019-09-13 00:00:00+03:00,in,False,907174,False,1,357,367,10
166485,2019-09-13 00:00:00+03:00,out,False,887282,False,46,5199,5682,483
166485,2019-09-13 00:00:00+03:00,out,False,887282,True,19,0,433,433
166485,2019-09-13 00:00:00+03:00,out,False,907174,True,2,0,64,64
166485,2019-09-13 00:00:00+03:00,in,False,-1,True,2,0,35,35
166485,2019-09-13 00:00:00+03:00,out,False,887276,False,7,546,642,96
166485,2019-09-13 00:00:00+03:00,in,False,887282,False,1,243,285,42
166485,2019-09-16 00:00:00+03:00,in,False,-1,True,3,0,137,137
166485,2019-09-16 00:00:00+03:00,out,False,887282,False,33,3689,3995,306
166485,2019-09-16 00:00:00+03:00,in,False,887276,False,5,382,503,121
166485,2019-09-16 00:00:00+03:00,out,False,907174,True,12,0,412,412
166485,2019-09-16 00:00:00+03:00,out,False,887282,True,26,0,525,525
166485,2019-09-16 00:00:00+03:00,out,False,887276,True,6,0,184,184
166485,2019-09-16 00:00:00+03:00,out,False,887276,False,14,1041,1225,184
166485,2019-09-16 00:00:00+03:00,out,False,907174,False,30,2405,2701,296
166485,2019-09-17 00:00:00+03:00,out,False,887282,True,7,0,267,267
166485,2019-09-17 00:00:00+03:00,in,False,887276,False,5,541,688,147
166485,2019-09-17 00:00:00+03:00,out,False,887276,True,2,0,100,100
166485,2019-09-17 00:00:00+03:00,out,False,887276,False,6,569,655,86
166485,2019-09-17 00:00:00+03:00,out,False,887282,False,51,6241,6837,596
166485,2019-09-17 00:00:00+03:00,in,False,-1,True,3,0,48,48
166485,2019-09-18 00:00:00+03:00,out,False,887276,True,1,0,15,15
166485,2019-09-18 00:00:00+03:00,in,False,-1,True,4,0,33,33
166485,2019-09-18 00:00:00+03:00,out,False,887282,False,38,5997,6411,414
166485,2019-09-18 00:00:00+03:00,in,False,887276,False,10,1719,1955,236
166485,2019-09-18 00:00:00+03:00,out,False,907174,True,7,0,198,198
166485,2019-09-18 00:00:00+03:00,out,False,887276,False,8,1123,1219,96
166485,2019-09-18 00:00:00+03:00,out,False,887282,True,4,0,98,98
166485,2019-09-18 00:00:00+03:00,out,False,907174,False,51,5251,5802,551
166485,2019-09-19 00:00:00+03:00,in,False,887282,False,1,42,91,49
166485,2019-09-19 00:00:00+03:00,out,True,887278,True,2,0,7,7
166485,2019-09-19 00:00:00+03:00,out,False,887282,True,8,0,166,166
166485,2019-09-19 00:00:00+03:00,out,False,887278,True,1,0,21,21
166485,2019-09-19 00:00:00+03:00,out,False,887282,False,23,2385,2644,259
166485,2019-09-19 00:00:00+03:00,out,True,887276,False,5,175,214,39
166485,2019-09-19 00:00:00+03:00,out,False,887278,False,1,92,103,11
166485,2019-09-19 00:00:00+03:00,out,True,887278,False,4,262,299,37
166485,2019-09-19 00:00:00+03:00,in,False,-1,True,10,0,487,487
166485,2019-09-19 00:00:00+03:00,in,False,887276,False,9,1207,1400,193
166485,2019-09-19 00:00:00+03:00,out,True,887276,True,3,0,68,68
166485,2019-09-19 00:00:00+03:00,out,False,887276,False,7,519,617,98
166485,2019-09-20 00:00:00+03:00,out,True,887276,False,7,479,568,89
166485,2019-09-20 00:00:00+03:00,out,True,887278,False,6,269,340,71
166485,2019-09-20 00:00:00+03:00,out,True,907174,False,1,125,147,22
166485,2019-09-20 00:00:00+03:00,out,False,887276,True,7,0,51,51
166485,2019-09-20 00:00:00+03:00,in,False,887276,False,2,223,261,38
166485,2019-09-20 00:00:00+03:00,in,False,887278,False,1,471,497,26
166485,2019-09-20 00:00:00+03:00,in,False,-1,True,2,0,26,26
166485,2019-09-20 00:00:00+03:00,out,False,887276,False,11,535,675,140
166485,2019-09-20 00:00:00+03:00,out,False,887282,True,7,0,147,147
166485,2019-09-20 00:00:00+03:00,out,False,887282,False,33,4489,4849,360
166485,2019-09-20 00:00:00+03:00,in,False,-1,True,2,0,26,26
166485,2019-09-22 00:00:00+03:00,in,False,-1,True,1,0,465,465
166485,2019-09-22 00:00:00+03:00,in,False,-1,True,1,0,465,465
166485,2019-09-23 00:00:00+03:00,in,False,-1,True,5,0,71,71
166485,2019-09-23 00:00:00+03:00,out,False,887282,True,12,0,161,161
166485,2019-09-23 00:00:00+03:00,out,True,887278,False,5,218,253,35
166485,2019-09-23 00:00:00+03:00,out,False,907174,True,1,0,60,60
166485,2019-09-23 00:00:00+03:00,out,False,887276,False,4,768,821,53
166485,2019-09-23 00:00:00+03:00,out,False,887278,False,1,162,165,3
166485,2019-09-23 00:00:00+03:00,out,False,887276,True,5,0,146,146
166485,2019-09-23 00:00:00+03:00,in,False,887276,False,7,635,838,203
166485,2019-09-23 00:00:00+03:00,out,False,887282,False,47,6284,6778,494
166485,2019-09-23 00:00:00+03:00,out,True,887276,False,6,198,271,73
166485,2019-09-24 00:00:00+03:00,out,False,887276,True,7,0,199,199
166485,2019-09-24 00:00:00+03:00,out,False,887282,False,42,5649,6262,613
166485,2019-09-24 00:00:00+03:00,out,False,887276,False,10,600,764,164
166485,2019-09-24 00:00:00+03:00,out,True,887278,False,10,850,943,93
166485,2019-09-24 00:00:00+03:00,in,False,887276,False,3,618,678,60
166485,2019-09-24 00:00:00+03:00,out,False,887282,True,20,0,619,619
166485,2019-09-24 00:00:00+03:00,in,False,-1,True,4,0,101,101
166485,2019-09-24 00:00:00+03:00,in,False,887282,False,1,141,184,43
166485,2019-09-24 00:00:00+03:00,out,True,887276,False,12,606,797,191
166485,2019-09-24 00:00:00+03:00,out,False,887278,True,1,0,4,4
166485,2019-09-24 00:00:00+03:00,out,False,887278,False,2,59,83,24
166485,2019-09-24 00:00:00+03:00,out,True,887276,True,2,0,112,112
166485,2019-09-24 00:00:00+03:00,in,False,-1,True,4,0,101,101
166485,2019-09-24 00:00:00+03:00,out,False,887276,False,10,600,764,164
166485,2019-09-25 00:00:00+03:00,in,False,887276,False,9,2082,2342,260
166485,2019-09-25 00:00:00+03:00,out,False,887276,False,7,827,944,117
166485,2019-09-25 00:00:00+03:00,in,False,-1,True,4,0,51,51
166485,2019-09-25 00:00:00+03:00,out,False,887282,False,24,3356,3611,255
166485,2019-09-25 00:00:00+03:00,out,True,887276,False,9,558,662,104
166485,2019-09-25 00:00:00+03:00,out,True,887276,True,1,0,31,31
166485,2019-09-25 00:00:00+03:00,out,True,887278,False,4,286,332,46
166485,2019-09-25 00:00:00+03:00,out,False,907174,True,7,0,206,206
166485,2019-09-25 00:00:00+03:00,in,False,907174,False,1,173,237,64
166485,2019-09-25 00:00:00+03:00,out,False,907174,False,13,832,1022,190
166485,2019-09-25 00:00:00+03:00,out,False,887276,True,3,0,15,15
166485,2019-09-25 00:00:00+03:00,out,False,887282,True,4,0,51,51
166485,2019-09-25 00:00:00+03:00,out,False,887278,True,1,0,8,8
166485,2019-09-25 00:00:00+03:00,out,True,887278,True,2,0,79,79
166485,2019-09-25 00:00:00+03:00,out,False,887282,True,4,0,51,51
166485,2019-09-25 00:00:00+03:00,out,False,907174,False,13,832,1022,190
166485,2019-09-26 00:00:00+03:00,out,True,887278,False,8,442,504,62
166485,2019-09-26 00:00:00+03:00,out,False,907174,False,22,1470,1781,311
166485,2019-09-26 00:00:00+03:00,in,False,887282,False,1,318,341,23
166485,2019-09-26 00:00:00+03:00,out,False,887276,True,12,0,175,175
166485,2019-09-26 00:00:00+03:00,out,False,887282,True,6,0,222,222
166485,2019-09-26 00:00:00+03:00,out,False,887276,False,8,576,700,124
166485,2019-09-26 00:00:00+03:00,in,False,887276,False,15,830,1265,435
166485,2019-09-26 00:00:00+03:00,out,True,887276,False,8,917,998,81
166485,2019-09-26 00:00:00+03:00,out,False,887282,False,21,2554,2763,209
166485,2019-09-26 00:00:00+03:00,out,True,907174,False,1,74,91,17
166485,2019-09-26 00:00:00+03:00,in,False,-1,True,6,0,110,110
166485,2019-09-26 00:00:00+03:00,out,True,887278,True,1,0,3,3
166485,2019-09-26 00:00:00+03:00,out,False,907174,True,9,0,174,174
166485,2019-09-27 00:00:00+03:00,out,True,887278,True,1,0,52,52
166485,2019-09-27 00:00:00+03:00,out,False,887282,True,12,0,201,201
166485,2019-09-27 00:00:00+03:00,out,True,887278,False,5,339,376,37
166485,2019-09-27 00:00:00+03:00,out,False,887282,False,43,3678,4159,481
166485,2019-09-27 00:00:00+03:00,out,False,907174,False,36,2541,2999,458
166485,2019-09-27 00:00:00+03:00,in,False,-1,True,4,0,30,30
166485,2019-09-27 00:00:00+03:00,out,False,887276,True,5,0,193,193
166485,2019-09-27 00:00:00+03:00,out,False,887276,False,5,396,499,103
166485,2019-09-27 00:00:00+03:00,out,False,907174,True,20,0,438,438
166485,2019-09-27 00:00:00+03:00,out,True,907174,True,1,0,1,1
166485,2019-09-27 00:00:00+03:00,in,False,887276,False,5,833,982,149
166485,2019-09-27 00:00:00+03:00,out,True,887276,False,6,882,972,90
166485,2019-09-30 00:00:00+03:00,in,False,-1,True,4,0,65,65
166485,2019-09-30 00:00:00+03:00,out,False,887282,True,9,0,162,162
166485,2019-09-30 00:00:00+03:00,out,True,907174,False,1,47,63,16
166485,2019-09-30 00:00:00+03:00,out,True,887276,False,6,456,547,91
166485,2019-09-30 00:00:00+03:00,in,False,887276,False,2,454,483,29
166485,2019-09-30 00:00:00+03:00,out,False,887282,False,7,844,949,105
166485,2019-09-30 00:00:00+03:00,out,False,907174,False,45,3451,3888,437
166485,2019-09-30 00:00:00+03:00,out,False,887276,False,4,1104,1155,51
166485,2019-09-30 00:00:00+03:00,out,True,887278,False,5,285,329,44
166485,2019-09-30 00:00:00+03:00,out,False,907174,True,26,0,425,425
166485,2019-10-01 00:00:00+03:00,in,False,887276,False,10,1444,1689,245
166485,2019-10-01 00:00:00+03:00,out,False,907174,False,53,3846,4271,425
166485,2019-10-01 00:00:00+03:00,out,True,887276,True,1,0,28,28
166485,2019-10-01 00:00:00+03:00,in,False,-1,True,4,0,23,23
166485,2019-10-01 00:00:00+03:00,in,False,887282,False,1,226,289,63
166485,2019-10-01 00:00:00+03:00,in,False,887276,True,1,0,47,47
166485,2019-10-01 00:00:00+03:00,out,True,887282,False,1,144,165,21
166485,2019-10-01 00:00:00+03:00,out,False,887276,False,12,1123,1364,241
166485,2019-10-01 00:00:00+03:00,out,True,887278,True,1,0,39,39
166485,2019-10-01 00:00:00+03:00,out,False,907174,True,27,0,635,635
166485,2019-10-01 00:00:00+03:00,out,False,887276,True,14,0,240,240
166485,2019-10-01 00:00:00+03:00,out,True,887276,False,4,211,269,58
166485,2019-10-01 00:00:00+03:00,out,True,887278,False,4,225,261,36
166485,2019-10-02 00:00:00+03:00,in,False,887276,False,4,901,1032,131
166485,2019-10-02 00:00:00+03:00,out,True,887276,False,8,395,459,64
166485,2019-10-02 00:00:00+03:00,out,True,887276,True,1,0,0,0
166485,2019-10-02 00:00:00+03:00,out,True,887278,False,5,485,533,48
166485,2019-10-02 00:00:00+03:00,out,False,907174,True,14,0,319,319
166485,2019-10-02 00:00:00+03:00,out,False,887276,True,2,0,80,80
166485,2019-10-02 00:00:00+03:00,out,True,887278,True,2,0,103,103
166485,2019-10-02 00:00:00+03:00,out,False,907174,False,60,3641,4407,766
166485,2019-10-02 00:00:00+03:00,out,False,887276,False,7,638,766,128
166485,2019-10-02 00:00:00+03:00,in,False,-1,True,1,0,6,6
166485,2019-10-02 00:00:00+03:00,out,False,907174,False,60,3641,4407,766
166485,2019-10-03 00:00:00+03:00,in,False,887276,False,3,152,250,98
166485,2019-10-03 00:00:00+03:00,in,False,-1,True,1,0,0,0
166485,2019-10-03 00:00:00+03:00,out,False,907174,False,36,2255,2620,365
166485,2019-10-03 00:00:00+03:00,out,True,887276,False,5,461,535,74
166485,2019-10-03 00:00:00+03:00,out,False,887278,True,1,0,16,16
166485,2019-10-03 00:00:00+03:00,out,False,907174,True,9,0,222,222
166485,2019-10-03 00:00:00+03:00,out,True,887278,False,2,104,122,18
166485,2019-10-03 00:00:00+03:00,out,False,907174,False,36,2255,2620,365
166485,2019-10-03 00:00:00+03:00,in,False,-1,True,1,0,0,0
166485,2019-10-04 00:00:00+03:00,out,False,907174,True,9,0,287,287
166485,2019-10-04 00:00:00+03:00,in,False,887276,False,7,408,613,205
166485,2019-10-04 00:00:00+03:00,out,False,887276,True,1,0,0,0
166485,2019-10-04 00:00:00+03:00,out,True,887276,False,9,441,561,120
166485,2019-10-04 00:00:00+03:00,out,False,907174,False,33,2144,2632,488
166485,2019-10-04 00:00:00+03:00,out,True,887278,False,6,257,304,47
166485,2019-10-04 00:00:00+03:00,in,False,887278,False,1,53,59,6
166485,2019-10-04 00:00:00+03:00,out,False,887278,True,1,0,8,8
166485,2019-10-04 00:00:00+03:00,out,True,907174,True,1,0,1,1
166485,2019-10-04 00:00:00+03:00,in,False,-1,True,14,0,297,297
166485,2019-10-04 00:00:00+03:00,out,False,887278,False,1,46,52,6
166485,2019-10-04 00:00:00+03:00,out,True,887278,False,6,257,304,47
166485,2019-10-07 00:00:00+03:00,out,False,907174,False,61,4196,4762,566
166485,2019-10-07 00:00:00+03:00,in,False,887278,False,4,534,634,100
166485,2019-10-07 00:00:00+03:00,out,True,887278,False,7,572,625,53
166485,2019-10-07 00:00:00+03:00,out,False,887278,True,3,0,65,65
166485,2019-10-07 00:00:00+03:00,out,True,887276,False,4,253,286,33
166485,2019-10-07 00:00:00+03:00,in,False,887276,False,7,2218,2445,227
166485,2019-10-07 00:00:00+03:00,out,False,907174,True,59,0,1503,1503
166485,2019-10-07 00:00:00+03:00,out,False,887276,False,5,1632,1701,69
166485,2019-10-07 00:00:00+03:00,in,False,-1,True,3,0,35,35
166485,2019-10-07 00:00:00+03:00,out,False,887276,True,4,0,107,107
166485,2019-10-07 00:00:00+03:00,out,False,887276,False,5,1632,1701,69
166485,2019-10-08 00:00:00+03:00,out,False,887276,False,2,172,203,31
166485,2019-10-08 00:00:00+03:00,in,False,887282,False,1,128,181,53
166485,2019-10-08 00:00:00+03:00,in,False,887276,False,11,879,1185,306
166485,2019-10-08 00:00:00+03:00,out,True,887278,False,10,724,788,64
166485,2019-10-08 00:00:00+03:00,in,False,887278,False,1,139,159,20
166485,2019-10-08 00:00:00+03:00,out,False,907174,True,34,0,902,902
166485,2019-10-08 00:00:00+03:00,in,False,-1,True,2,0,93,93
166485,2019-10-08 00:00:00+03:00,out,True,887276,False,8,866,944,78
166485,2019-10-08 00:00:00+03:00,out,False,907174,False,51,3675,4446,771
166485,2019-10-08 00:00:00+03:00,out,False,907174,True,34,0,902,902
166485,2019-10-08 00:00:00+03:00,in,False,887278,False,1,139,159,20
166485,2019-10-09 00:00:00+03:00,out,False,887276,False,3,241,269,28
166485,2019-10-09 00:00:00+03:00,out,False,907174,True,30,0,737,737
166485,2019-10-09 00:00:00+03:00,in,False,887282,False,2,103,153,50
166485,2019-10-09 00:00:00+03:00,in,False,-1,True,3,0,34,34
166485,2019-10-09 00:00:00+03:00,out,False,887278,False,1,65,67,2
166485,2019-10-09 00:00:00+03:00,out,False,907174,False,52,3744,4290,546
166485,2019-10-09 00:00:00+03:00,out,True,887276,False,4,273,320,47
166485,2019-10-09 00:00:00+03:00,out,False,887276,True,3,0,114,114
166485,2019-10-09 00:00:00+03:00,out,False,887282,False,23,1601,1840,239
166485,2019-10-09 00:00:00+03:00,in,False,887276,False,9,1267,1531,264
166485,2019-10-09 00:00:00+03:00,out,True,887278,False,2,189,203,14
166485,2019-10-09 00:00:00+03:00,out,False,887282,True,8,0,159,159
166485,2019-10-09 00:00:00+03:00,out,True,887276,False,4,273,320,47
166485,2019-10-09 00:00:00+03:00,out,False,887276,True,3,0,114,114
166485,2019-10-09 00:00:00+03:00,in,False,-1,True,3,0,34,34
166485,2019-10-09 00:00:00+03:00,out,False,887278,False,1,65,67,2
166485,2019-10-10 00:00:00+03:00,out,True,907174,False,1,51,64,13
166485,2019-10-10 00:00:00+03:00,in,False,-1,True,1,0,6,6
166485,2019-10-10 00:00:00+03:00,out,True,887278,False,4,238,271,33
166485,2019-10-10 00:00:00+03:00,out,True,907174,True,1,0,0,0
166485,2019-10-10 00:00:00+03:00,out,False,907174,False,56,3901,4566,665
166485,2019-10-10 00:00:00+03:00,out,False,907174,True,16,0,320,320
166485,2019-10-10 00:00:00+03:00,out,False,887276,True,1,0,7,7
166485,2019-10-10 00:00:00+03:00,in,False,887276,False,7,1020,1122,102
166485,2019-10-10 00:00:00+03:00,out,True,887276,False,6,355,415,60
166485,2019-10-10 00:00:00+03:00,out,False,887276,False,6,723,809,86
166485,2019-10-10 00:00:00+03:00,out,True,887278,True,1,0,46,46
166485,2019-10-10 00:00:00+03:00,in,False,-1,True,1,0,6,6
166485,2019-10-10 00:00:00+03:00,out,False,887276,True,1,0,7,7
166485,2019-10-11 00:00:00+03:00,out,False,887276,False,5,308,404,96
166485,2019-10-11 00:00:00+03:00,in,False,-1,True,3,0,27,27
166485,2019-10-11 00:00:00+03:00,out,True,887276,True,2,0,87,87
166485,2019-10-11 00:00:00+03:00,out,True,887278,False,8,477,524,47
166485,2019-10-11 00:00:00+03:00,out,False,907174,False,56,4790,5558,768
166485,2019-10-11 00:00:00+03:00,out,False,887278,True,1,0,22,22
166485,2019-10-11 00:00:00+03:00,out,False,887282,False,1,163,199,36
166485,2019-10-11 00:00:00+03:00,out,True,887276,False,4,384,418,34
166485,2019-10-11 00:00:00+03:00,out,False,887276,True,2,0,117,117
166485,2019-10-11 00:00:00+03:00,out,True,887278,True,3,0,50,50
166485,2019-10-11 00:00:00+03:00,out,False,907174,True,15,0,215,215
166485,2019-10-11 00:00:00+03:00,in,False,887276,False,5,493,559,66
166485,2019-10-12 00:00:00+03:00,in,False,-1,True,1,0,29,29
166485,2019-10-14 00:00:00+03:00,out,True,887276,False,7,434,522,88
166485,2019-10-14 00:00:00+03:00,in,False,-1,True,2,0,35,35
166485,2019-10-14 00:00:00+03:00,out,True,887278,False,7,583,632,49
166485,2019-10-14 00:00:00+03:00,out,False,887276,True,2,0,45,45
166485,2019-10-14 00:00:00+03:00,out,False,907174,False,50,4585,5312,727
166485,2019-10-14 00:00:00+03:00,out,False,887276,False,7,1006,1114,108
166485,2019-10-14 00:00:00+03:00,in,False,887276,False,8,1250,1433,183
166485,2019-10-14 00:00:00+03:00,out,False,907174,True,18,0,415,415
166485,2019-10-14 00:00:00+03:00,out,True,887276,True,1,0,10,10
166485,2019-10-14 00:00:00+03:00,in,False,887282,False,1,58,112,54
166485,2019-10-14 00:00:00+03:00,out,True,887276,True,1,0,10,10
166485,2019-10-15 00:00:00+03:00,out,False,-1,True,2,0,8,8
166485,2019-10-15 00:00:00+03:00,in,False,-1,True,3,0,95,95
166485,2019-10-15 00:00:00+03:00,in,False,887276,False,6,403,597,194
166485,2019-10-15 00:00:00+03:00,out,False,907174,False,10,2234,2363,129
166485,2019-10-15 00:00:00+03:00,out,True,906866,True,1,0,17,17
166485,2019-10-15 00:00:00+03:00,out,True,887276,False,1,104,116,12
166485,2019-10-15 00:00:00+03:00,out,True,906866,False,2,237,248,11
166485,2019-10-15 00:00:00+03:00,out,False,887276,False,9,980,1074,94
166485,2019-10-15 00:00:00+03:00,out,False,887276,True,4,0,22,22
166485,2019-10-15 00:00:00+03:00,out,False,907174,True,7,0,210,210
166485,2019-10-15 00:00:00+03:00,out,True,887276,True,7,0,0,0
166485,2019-10-16 00:00:00+03:00,in,False,887276,False,7,2728,2924,196
166485,2019-10-16 00:00:00+03:00,out,True,906866,False,2,585,604,19
166485,2019-10-16 00:00:00+03:00,out,True,887276,True,2,0,0,0
166485,2019-10-16 00:00:00+03:00,out,False,907174,False,20,2114,2327,213
166485,2019-10-16 00:00:00+03:00,out,False,887276,False,5,757,828,71
166485,2019-10-16 00:00:00+03:00,out,False,887276,True,5,0,77,77
166485,2019-10-16 00:00:00+03:00,out,False,907174,True,13,0,283,283
166485,2019-10-17 00:00:00+03:00,out,False,887276,False,2,367,391,24
166485,2019-10-17 00:00:00+03:00,in,False,-1,True,14,0,349,349
166485,2019-10-17 00:00:00+03:00,in,False,887282,False,1,132,201,69
166485,2019-10-17 00:00:00+03:00,out,False,907174,True,9,0,248,248
166485,2019-10-17 00:00:00+03:00,out,True,906866,False,1,22,28,6
166485,2019-10-17 00:00:00+03:00,out,False,907174,False,26,1176,1564,388
166485,2019-10-17 00:00:00+03:00,in,False,887276,False,5,747,934,187
166485,2019-10-17 00:00:00+03:00,out,False,887276,True,10,0,84,84
166485,2019-10-18 00:00:00+03:00,out,False,887276,False,2,145,172,27
166485,2019-10-18 00:00:00+03:00,out,True,887276,True,2,0,0,0
166485,2019-10-18 00:00:00+03:00,out,False,907174,True,23,0,374,374
166485,2019-10-18 00:00:00+03:00,out,True,906866,False,1,86,99,13
166485,2019-10-18 00:00:00+03:00,out,False,-1,True,3,0,11,11
166485,2019-10-18 00:00:00+03:00,out,False,907174,False,32,2863,3267,404
166485,2019-10-18 00:00:00+03:00,out,False,887276,True,1,0,4,4
166485,2019-10-18 00:00:00+03:00,in,False,887276,False,9,1601,1784,183
166485,2019-10-18 00:00:00+03:00,out,False,887276,True,1,0,4,4
166485,2019-10-18 00:00:00+03:00,out,False,-1,True,3,0,11,11
166485,2019-10-18 00:00:00+03:00,in,False,887276,False,9,1601,1784,183
166485,2019-10-18 00:00:00+03:00,out,False,907174,True,23,0,374,374
166485,2019-10-21 00:00:00+03:00,in,False,887276,False,8,1280,1558,278
166485,2019-10-21 00:00:00+03:00,out,False,887276,False,6,579,645,66
166485,2019-10-21 00:00:00+03:00,out,False,907174,False,45,3731,4200,469
166485,2019-10-21 00:00:00+03:00,out,False,887276,True,6,0,65,65
166485,2019-10-21 00:00:00+03:00,out,True,887276,True,2,0,0,0
166485,2019-10-21 00:00:00+03:00,out,False,887282,True,3,0,81,81
166485,2019-10-21 00:00:00+03:00,in,False,887278,False,1,32,53,21
166485,2019-10-21 00:00:00+03:00,out,False,887282,False,10,829,909,80
166485,2019-10-21 00:00:00+03:00,out,False,907174,True,30,0,764,764
166485,2019-10-21 00:00:00+03:00,in,False,-1,True,2,0,18,18
166485,2019-10-22 00:00:00+03:00,out,False,887276,True,4,0,144,144
166485,2019-10-22 00:00:00+03:00,in,False,-1,True,9,0,76,76
166485,2019-10-22 00:00:00+03:00,out,False,907174,False,38,2491,3041,550
166485,2019-10-22 00:00:00+03:00,in,False,887276,False,9,1022,1307,285
166485,2019-10-22 00:00:00+03:00,out,True,887278,False,3,205,224,19
166485,2019-10-22 00:00:00+03:00,out,False,887278,True,1,0,14,14
166485,2019-10-22 00:00:00+03:00,out,False,887276,False,6,366,445,79
166485,2019-10-22 00:00:00+03:00,out,True,887276,True,1,0,10,10
166485,2019-10-22 00:00:00+03:00,in,False,887278,False,2,303,336,33
166485,2019-10-22 00:00:00+03:00,out,True,887276,False,5,321,400,79
166485,2019-10-22 00:00:00+03:00,out,False,907174,True,12,0,347,347
166485,2019-10-22 00:00:00+03:00,out,False,887278,True,1,0,14,14
166485,2019-10-23 00:00:00+03:00,out,False,907174,False,29,1540,1923,383
166485,2019-10-23 00:00:00+03:00,out,True,887278,False,3,713,734,21
166485,2019-10-23 00:00:00+03:00,in,False,887278,False,6,1050,1137,87
166485,2019-10-23 00:00:00+03:00,out,True,887276,False,3,220,254,34
166485,2019-10-23 00:00:00+03:00,in,False,887276,False,8,1848,2048,200
166485,2019-10-23 00:00:00+03:00,out,False,907174,True,15,0,296,296
166485,2019-10-23 00:00:00+03:00,in,False,-1,True,2,0,29,29
166485,2019-10-23 00:00:00+03:00,out,True,887276,True,1,0,3,3
166485,2019-10-23 00:00:00+03:00,out,False,887276,True,4,0,28,28
166485,2019-10-23 00:00:00+03:00,out,False,887276,False,6,1211,1309,98
166485,2019-10-23 00:00:00+03:00,in,False,907174,False,1,35,55,20
166485,2019-10-23 00:00:00+03:00,out,False,907174,False,29,1540,1923,383
166485,2019-10-23 00:00:00+03:00,out,True,887278,False,3,713,734,21
166485,2019-10-24 00:00:00+03:00,out,True,887276,False,6,297,377,80
166485,2019-10-24 00:00:00+03:00,out,True,887276,True,1,0,42,42
166485,2019-10-24 00:00:00+03:00,out,False,887276,True,3,0,32,32
166485,2019-10-24 00:00:00+03:00,in,False,887276,False,14,3350,3724,374
166485,2019-10-24 00:00:00+03:00,out,True,887278,False,4,336,376,40
166485,2019-10-24 00:00:00+03:00,out,False,887276,False,8,712,801,89
166485,2019-10-24 00:00:00+03:00,in,False,-1,True,1,0,17,17
166485,2019-10-24 00:00:00+03:00,out,False,887276,True,3,0,32,32
166485,2019-10-25 00:00:00+03:00,out,False,887276,False,4,239,292,53
166485,2019-10-25 00:00:00+03:00,out,True,887276,False,1,194,201,7
166485,2019-10-25 00:00:00+03:00,in,False,887276,False,8,1298,1435,137
166485,2019-10-25 00:00:00+03:00,in,False,-1,True,3,0,20,20
166485,2019-10-25 00:00:00+03:00,in,False,887278,False,1,51,72,21
166485,2019-10-25 00:00:00+03:00,out,True,887278,False,3,287,311,24
166485,2019-10-25 00:00:00+03:00,out,False,907174,False,50,2669,3254,585
166485,2019-10-25 00:00:00+03:00,out,False,887276,True,1,0,23,23
166485,2019-10-25 00:00:00+03:00,out,True,887276,True,1,0,60,60
166485,2019-10-25 00:00:00+03:00,out,False,907174,True,27,0,566,566
166485,2019-10-25 00:00:00+03:00,out,False,907174,False,50,2669,3254,585
166485,2019-10-28 00:00:00+03:00,out,True,887278,False,5,309,344,35
166485,2019-10-28 00:00:00+03:00,out,True,887276,True,2,0,24,24
166485,2019-10-28 00:00:00+03:00,in,False,-1,True,5,0,166,166
166485,2019-10-28 00:00:00+03:00,out,False,887278,False,1,135,148,13
166485,2019-10-28 00:00:00+03:00,out,False,907174,False,34,1863,2203,340
166485,2019-10-28 00:00:00+03:00,out,False,907174,True,9,0,207,207
166485,2019-10-28 00:00:00+03:00,out,False,887276,False,1,404,413,9
166485,2019-10-28 00:00:00+03:00,out,True,887276,False,6,760,825,65
166485,2019-10-28 00:00:00+03:00,out,False,887276,True,2,0,24,24
166485,2019-10-28 00:00:00+03:00,in,False,887276,False,10,1809,2066,257
166485,2019-10-28 00:00:00+03:00,in,False,887278,False,4,812,894,82
166485,2019-10-28 00:00:00+03:00,out,False,907174,True,9,0,207,207
166485,2019-10-29 00:00:00+03:00,out,False,907174,True,24,0,445,445
166485,2019-10-29 00:00:00+03:00,out,False,887276,False,6,348,429,81
166485,2019-10-29 00:00:00+03:00,out,False,907174,False,51,2938,3887,949
166485,2019-10-29 00:00:00+03:00,out,True,887276,False,7,770,839,69
166485,2019-10-29 00:00:00+03:00,in,False,887276,False,7,740,912,172
166485,2019-10-29 00:00:00+03:00,out,True,887278,False,4,458,489,31
166485,2019-10-29 00:00:00+03:00,out,False,887276,True,2,0,58,58
166485,2019-10-29 00:00:00+03:00,in,False,887276,False,7,740,912,172
166485,2019-10-29 00:00:00+03:00,out,False,887276,False,6,348,429,81
166485,2019-10-30 00:00:00+03:00,out,False,907174,True,5,0,49,49
166485,2019-10-30 00:00:00+03:00,out,False,887276,False,4,257,308,51
166485,2019-10-30 00:00:00+03:00,in,False,887276,False,8,1636,1845,209
166485,2019-10-30 00:00:00+03:00,in,False,887278,False,2,763,790,27
166485,2019-10-30 00:00:00+03:00,in,False,-1,True,2,0,61,61
166485,2019-10-30 00:00:00+03:00,out,True,887278,False,8,1196,1266,70
166485,2019-10-30 00:00:00+03:00,out,False,907174,False,32,1433,2030,597
166485,2019-10-30 00:00:00+03:00,out,False,887276,True,3,0,17,17
166485,2019-10-30 00:00:00+03:00,out,False,887278,True,2,0,52,52
166485,2019-10-30 00:00:00+03:00,in,False,907174,False,1,46,65,19
166485,2019-10-30 00:00:00+03:00,out,True,887276,False,5,335,402,67
166485,2019-10-30 00:00:00+03:00,out,False,907174,True,5,0,49,49
166485,2019-10-31 00:00:00+03:00,out,False,887278,False,1,207,219,12
166485,2019-10-31 00:00:00+03:00,out,False,887276,True,1,0,12,12
166485,2019-10-31 00:00:00+03:00,out,True,887276,False,5,273,310,37
166485,2019-10-31 00:00:00+03:00,in,False,-1,True,2,0,45,45
166485,2019-10-31 00:00:00+03:00,out,False,887276,False,2,228,243,15
166485,2019-10-31 00:00:00+03:00,in,False,887276,False,3,312,407,95
166485,2019-10-31 00:00:00+03:00,out,False,907174,False,20,1901,2265,364
166485,2019-10-31 00:00:00+03:00,out,True,887276,True,2,0,0,0
166485,2019-10-31 00:00:00+03:00,out,False,907174,True,8,0,225,225
166485,2019-10-31 00:00:00+03:00,out,False,887278,True,1,0,13,13
166485,2019-10-31 00:00:00+03:00,in,False,887276,True,1,79,123,44
166485,2019-10-31 00:00:00+03:00,in,False,887278,False,3,761,816,55
166485,2019-10-31 00:00:00+03:00,out,True,887278,False,5,293,341,48
166485,2019-10-31 00:00:00+03:00,in,False,-1,True,2,0,45,45
166485,2019-11-01 00:00:00+03:00,out,False,887282,False,25,2496,2703,207
166485,2019-11-01 00:00:00+03:00,out,False,887276,False,3,346,380,34
166485,2019-11-01 00:00:00+03:00,in,False,-1,True,4,0,162,162
166485,2019-11-01 00:00:00+03:00,out,False,887276,True,4,0,112,112
166485,2019-11-01 00:00:00+03:00,out,False,887278,True,3,0,21,21
166485,2019-11-01 00:00:00+03:00,in,False,887276,False,15,2174,2683,509
166485,2019-11-01 00:00:00+03:00,out,False,887282,True,6,0,197,197
166485,2019-11-01 00:00:00+03:00,out,True,887276,True,1,0,2,2
166485,2019-11-01 00:00:00+03:00,out,True,887276,False,9,982,1065,83
166485,2019-11-01 00:00:00+03:00,in,False,887278,False,1,246,265,19
166485,2019-11-01 00:00:00+03:00,out,False,907174,False,33,1517,1942,425
166485,2019-11-01 00:00:00+03:00,out,False,907174,True,16,0,391,391
166485,2019-11-01 00:00:00+03:00,in,False,887282,False,1,61,111,50
166485,2019-11-01 00:00:00+03:00,out,True,887278,False,4,590,629,39
166485,2019-11-01 00:00:00+03:00,in,False,907174,False,1,39,85,46
166485,2019-11-01 00:00:00+03:00,out,False,907174,False,33,1517,1942,425
166485,2019-11-05 00:00:00+03:00,out,False,887278,False,1,91,112,21
166485,2019-11-05 00:00:00+03:00,in,False,887278,False,2,579,600,21
166485,2019-11-05 00:00:00+03:00,in,False,887276,False,7,760,973,213
166485,2019-11-05 00:00:00+03:00,out,False,887282,True,20,0,417,417
166485,2019-11-05 00:00:00+03:00,out,False,887282,False,65,4284,4849,565
166485,2019-11-05 00:00:00+03:00,out,False,907174,True,32,0,655,655
166485,2019-11-05 00:00:00+03:00,in,False,-1,True,7,0,280,280
166485,2019-11-05 00:00:00+03:00,out,True,887276,True,4,0,32,32
166485,2019-11-05 00:00:00+03:00,out,False,887276,False,13,916,1015,99
166485,2019-11-05 00:00:00+03:00,out,True,887278,False,4,700,726,26
166485,2019-11-05 00:00:00+03:00,out,True,887276,False,5,303,360,57
166485,2019-11-05 00:00:00+03:00,out,False,907174,False,63,4130,5082,952
166485,2019-11-05 00:00:00+03:00,out,False,887278,False,1,91,112,21
166485,2019-11-06 00:00:00+03:00,out,True,887278,False,7,369,426,57
166485,2019-11-06 00:00:00+03:00,out,False,887282,True,23,0,825,825
166485,2019-11-06 00:00:00+03:00,out,True,887282,True,1,0,0,0
166485,2019-11-06 00:00:00+03:00,out,False,887276,False,3,634,662,28
166485,2019-11-06 00:00:00+03:00,out,False,887282,False,63,5809,6442,633
166485,2019-11-06 00:00:00+03:00,in,False,887276,False,6,763,978,215
166485,2019-11-06 00:00:00+03:00,out,False,907174,True,15,0,269,269
166485,2019-11-06 00:00:00+03:00,in,False,907174,False,1,23,284,261
166485,2019-11-06 00:00:00+03:00,out,False,887276,True,5,0,179,179
166485,2019-11-06 00:00:00+03:00,out,True,887276,False,7,881,960,79
166485,2019-11-06 00:00:00+03:00,out,False,907174,False,32,2035,2402,367
166485,2019-11-06 00:00:00+03:00,in,False,-1,True,3,0,43,43
166485,2019-11-06 00:00:00+03:00,in,False,887278,False,2,451,492,41
166485,2019-11-06 00:00:00+03:00,in,False,-1,True,3,0,43,43
166485,2019-11-07 00:00:00+03:00,in,False,-1,True,3,0,43,43
166485,2019-11-07 00:00:00+03:00,out,False,887276,False,2,267,291,24
166485,2019-11-07 00:00:00+03:00,out,False,906866,True,3,0,36,36
166485,2019-11-07 00:00:00+03:00,out,False,887282,True,8,0,66,66
166485,2019-11-07 00:00:00+03:00,out,False,907174,True,13,0,243,243
166485,2019-11-07 00:00:00+03:00,in,False,887276,False,9,1247,1601,354
166485,2019-11-07 00:00:00+03:00,out,False,887282,False,24,2784,3106,322
166485,2019-11-07 00:00:00+03:00,out,True,906866,True,3,0,52,52
166485,2019-11-07 00:00:00+03:00,out,False,907174,False,35,1417,1865,448
166485,2019-11-07 00:00:00+03:00,out,True,887276,True,2,0,35,35
166485,2019-11-07 00:00:00+03:00,out,False,887282,True,8,0,66,66
166485,2019-11-08 00:00:00+03:00,in,False,-1,True,1,0,6,6
166485,2019-11-08 00:00:00+03:00,out,True,887276,True,3,0,0,0
166485,2019-11-08 00:00:00+03:00,in,False,887276,False,4,752,869,117
166485,2019-11-08 00:00:00+03:00,out,False,887282,True,11,0,166,166
166485,2019-11-08 00:00:00+03:00,out,False,887276,True,1,0,6,6
166485,2019-11-08 00:00:00+03:00,out,True,887282,True,1,0,0,0
166485,2019-11-08 00:00:00+03:00,out,False,887282,False,43,3438,3889,451
166485,2019-11-08 00:00:00+03:00,out,False,907174,False,35,2091,2608,517
166485,2019-11-08 00:00:00+03:00,out,False,887276,False,4,1115,1184,69
166485,2019-11-08 00:00:00+03:00,out,False,907174,True,7,0,262,262
166485,2019-11-08 00:00:00+03:00,in,False,887276,False,4,752,869,117
166485,2019-11-11 00:00:00+03:00,out,False,906866,True,11,0,119,119
166485,2019-11-11 00:00:00+03:00,out,True,906866,True,2,0,21,21
166485,2019-11-11 00:00:00+03:00,out,False,887282,True,25,0,322,322
166485,2019-11-11 00:00:00+03:00,out,False,887276,True,3,0,27,27
166485,2019-11-11 00:00:00+03:00,out,False,887282,False,87,6803,7682,879
166485,2019-11-11 00:00:00+03:00,out,False,887276,False,8,504,591,87
166485,2019-11-11 00:00:00+03:00,in,False,-1,True,2,0,15,15
166485,2019-11-11 00:00:00+03:00,out,False,907174,True,27,0,515,515
166485,2019-11-11 00:00:00+03:00,in,False,887276,False,3,225,320,95
166485,2019-11-11 00:00:00+03:00,out,True,906866,False,1,27,36,9
166485,2019-11-11 00:00:00+03:00,out,True,887282,True,2,0,0,0
166485,2019-11-11 00:00:00+03:00,out,False,907174,False,59,3408,4359,951
166485,2019-11-11 00:00:00+03:00,out,True,887276,True,3,0,33,33
166485,2019-11-11 00:00:00+03:00,out,False,-1,True,2,0,7,7
166485,2019-11-11 00:00:00+03:00,out,False,906866,False,21,785,1091,306
166485,2019-11-11 00:00:00+03:00,out,False,887276,False,8,504,591,87
166485,2019-11-11 00:00:00+03:00,out,False,887282,True,25,0,322,322
166485,2019-11-12 00:00:00+03:00,out,False,887276,False,4,183,225,42
166485,2019-11-12 00:00:00+03:00,out,False,907174,True,9,0,191,191
166485,2019-11-12 00:00:00+03:00,in,False,-1,True,6,0,74,74
166485,2019-11-12 00:00:00+03:00,out,False,906866,True,5,0,112,112
166485,2019-11-12 00:00:00+03:00,out,True,887276,True,2,0,0,0
166485,2019-11-12 00:00:00+03:00,out,False,887282,False,74,6444,7507,1063
166485,2019-11-12 00:00:00+03:00,in,False,887276,False,2,586,641,55
166485,2019-11-12 00:00:00+03:00,out,False,887282,True,68,0,2347,2347
166485,2019-11-12 00:00:00+03:00,out,False,-1,True,5,0,19,19
166485,2019-11-12 00:00:00+03:00,out,False,906866,False,28,1410,1781,371
166485,2019-11-12 00:00:00+03:00,out,False,907174,False,17,1067,1215,148
166485,2019-11-12 00:00:00+03:00,in,False,887276,False,2,586,641,55
166485,2019-11-13 00:00:00+03:00,out,False,887276,True,5,0,75,75
166485,2019-11-13 00:00:00+03:00,out,True,887278,True,3,0,25,25
166485,2019-11-13 00:00:00+03:00,in,False,887276,False,7,812,1045,233
166485,2019-11-13 00:00:00+03:00,in,False,-1,True,4,0,33,33
166485,2019-11-13 00:00:00+03:00,out,False,887282,True,18,0,495,495
166485,2019-11-13 00:00:00+03:00,out,True,887276,True,2,0,25,25
166485,2019-11-13 00:00:00+03:00,out,True,887278,False,7,384,430,46
166485,2019-11-13 00:00:00+03:00,out,False,906866,False,53,2379,3016,637
166485,2019-11-13 00:00:00+03:00,out,False,887276,False,17,3067,3234,167
166485,2019-11-13 00:00:00+03:00,in,False,887278,False,3,637,679,42
166485,2019-11-13 00:00:00+03:00,out,False,906866,True,26,0,828,828
166485,2019-11-13 00:00:00+03:00,out,False,887282,False,48,2493,2907,414
166485,2019-11-13 00:00:00+03:00,out,False,887278,False,2,514,540,26
166485,2019-11-13 00:00:00+03:00,out,True,887276,False,4,505,544,39
166485,2019-11-13 00:00:00+03:00,out,False,907174,False,36,1249,1938,689
166485,2019-11-13 00:00:00+03:00,out,False,907174,True,20,0,448,448
166485,2019-11-13 00:00:00+03:00,in,False,907174,False,2,87,158,71
166485,2019-11-13 00:00:00+03:00,out,True,887278,True,3,0,25,25
166485,2019-11-13 00:00:00+03:00,out,False,887282,False,48,2493,2907,414
166485,2019-11-14 00:00:00+03:00,in,False,887278,False,4,822,873,51
166485,2019-11-14 00:00:00+03:00,out,True,887278,False,3,177,217,40
166485,2019-11-14 00:00:00+03:00,out,False,887282,False,69,5648,6397,749
166485,2019-11-14 00:00:00+03:00,out,False,887278,False,1,109,150,41
166485,2019-11-14 00:00:00+03:00,out,False,887282,True,26,0,454,454
166485,2019-11-14 00:00:00+03:00,in,False,887276,False,4,194,304,110
166485,2019-11-14 00:00:00+03:00,out,True,887276,False,3,60,79,19
166485,2019-11-14 00:00:00+03:00,out,False,906866,True,38,0,1269,1269
166485,2019-11-14 00:00:00+03:00,out,False,906866,False,69,3243,4099,856
166485,2019-11-14 00:00:00+03:00,out,False,887276,False,2,281,313,32
166485,2019-11-14 00:00:00+03:00,in,False,-1,True,4,0,76,76
166485,2019-11-14 00:00:00+03:00,out,False,887276,False,2,281,313,32
166485,2019-11-15 00:00:00+03:00,in,False,887276,False,8,630,861,231
166485,2019-11-15 00:00:00+03:00,out,False,906866,True,31,0,753,753
166485,2019-11-15 00:00:00+03:00,out,False,887276,False,10,822,885,63
166485,2019-11-15 00:00:00+03:00,out,False,907174,False,51,1998,2528,530
166485,2019-11-15 00:00:00+03:00,out,True,887278,False,1,11,23,12
166485,2019-11-15 00:00:00+03:00,in,False,887278,False,2,364,394,30
166485,2019-11-15 00:00:00+03:00,out,False,907174,True,35,0,715,715
166485,2019-11-15 00:00:00+03:00,out,True,907174,True,1,0,0,0
166485,2019-11-15 00:00:00+03:00,out,False,887282,False,63,5507,6006,499
166485,2019-11-15 00:00:00+03:00,out,False,887276,True,8,0,215,215
166485,2019-11-15 00:00:00+03:00,out,False,906866,False,75,2807,3671,864
166485,2019-11-15 00:00:00+03:00,in,False,-1,True,10,0,92,92
166485,2019-11-15 00:00:00+03:00,out,False,887282,True,11,0,513,513
166485,2019-11-15 00:00:00+03:00,out,False,887276,True,8,0,215,215
166485,2019-11-15 00:00:00+03:00,out,False,887282,True,11,0,513,513
166485,2019-11-17 00:00:00+03:00,in,False,-1,True,1,0,27,27
166485,2019-11-18 00:00:00+03:00,out,True,887276,True,1,0,38,38
166485,2019-11-18 00:00:00+03:00,out,False,906866,True,31,0,868,868
166485,2019-11-18 00:00:00+03:00,in,False,887276,False,8,1003,1180,177
166485,2019-11-18 00:00:00+03:00,out,False,887276,True,3,0,63,63
166485,2019-11-18 00:00:00+03:00,in,False,887278,False,1,252,275,23
166485,2019-11-18 00:00:00+03:00,out,False,887282,False,55,4547,5028,481
166485,2019-11-18 00:00:00+03:00,in,False,-1,True,11,0,181,181
166485,2019-11-18 00:00:00+03:00,in,False,887282,False,1,140,166,26
166485,2019-11-18 00:00:00+03:00,out,False,887276,False,11,1220,1293,73
166485,2019-11-18 00:00:00+03:00,out,False,906866,False,57,2214,2897,683
166485,2019-11-18 00:00:00+03:00,out,True,887278,False,3,279,300,21
166485,2019-11-18 00:00:00+03:00,out,False,907174,False,47,1888,2476,588
166485,2019-11-18 00:00:00+03:00,out,False,887282,True,13,0,254,254
166485,2019-11-18 00:00:00+03:00,out,False,907174,True,10,0,193,193
166485,2019-11-18 00:00:00+03:00,out,True,887276,False,6,398,490,92
166485,2019-11-18 00:00:00+03:00,out,False,907174,False,47,1888,2476,588
166485,2019-11-18 00:00:00+03:00,out,True,887278,False,3,279,300,21
166485,2019-11-19 00:00:00+03:00,in,False,-1,True,6,0,114,114
166485,2019-11-19 00:00:00+03:00,out,True,887276,True,2,0,48,48
166485,2019-11-19 00:00:00+03:00,out,False,887282,False,59,6215,6919,704
166485,2019-11-19 00:00:00+03:00,in,False,887276,False,2,118,146,28
166485,2019-11-19 00:00:00+03:00,out,False,906866,True,11,0,163,163
166485,2019-11-19 00:00:00+03:00,out,False,906866,False,18,1080,1285,205
166485,2019-11-19 00:00:00+03:00,out,True,887278,True,4,0,135,135
166485,2019-11-19 00:00:00+03:00,in,False,907174,False,1,54,120,66
166485,2019-11-19 00:00:00+03:00,in,False,887282,False,4,829,972,143
166485,2019-11-19 00:00:00+03:00,out,True,887278,False,5,254,285,31
166485,2019-11-19 00:00:00+03:00,out,False,887282,True,31,0,767,767
166485,2019-11-19 00:00:00+03:00,out,False,907174,False,41,1924,2664,740
166485,2019-11-19 00:00:00+03:00,out,False,907174,True,18,0,395,395
166485,2019-11-19 00:00:00+03:00,out,True,887276,False,5,310,362,52
166485,2019-11-19 00:00:00+03:00,in,False,887278,False,1,128,146,18
166485,2019-11-19 00:00:00+03:00,out,False,887276,True,1,0,1,1
166485,2019-11-19 00:00:00+03:00,out,False,887276,False,3,137,183,46
166485,2019-11-19 00:00:00+03:00,out,True,887276,True,2,0,48,48
166485,2019-11-19 00:00:00+03:00,in,False,907174,False,1,54,120,66
166485,2019-11-20 00:00:00+03:00,out,False,906866,False,65,3191,4000,809
166485,2019-11-20 00:00:00+03:00,in,False,-1,True,5,0,45,45
166485,2019-11-20 00:00:00+03:00,out,False,887276,False,10,1120,1278,158
166485,2019-11-20 00:00:00+03:00,in,False,887276,False,6,1050,1207,157
166485,2019-11-20 00:00:00+03:00,out,True,887278,False,2,24,39,15
166485,2019-11-20 00:00:00+03:00,out,False,887276,True,5,0,50,50
166485,2019-11-20 00:00:00+03:00,out,False,887282,False,29,5198,5431,233
166485,2019-11-20 00:00:00+03:00,out,False,887282,True,8,0,190,190
166485,2019-11-20 00:00:00+03:00,out,True,887276,True,1,0,2,2
166485,2019-11-20 00:00:00+03:00,out,True,887276,False,3,136,166,30
166485,2019-11-20 00:00:00+03:00,out,False,906866,True,13,0,279,279
166485,2019-11-20 00:00:00+03:00,out,False,907174,True,13,0,263,263
166485,2019-11-20 00:00:00+03:00,out,False,907174,False,29,1689,2265,576
166485,2019-11-21 00:00:00+03:00,out,False,887282,True,7,0,217,217
166485,2019-11-21 00:00:00+03:00,out,True,887276,False,6,484,535,51
166485,2019-11-21 00:00:00+03:00,out,False,907174,True,12,0,164,164
166485,2019-11-21 00:00:00+03:00,out,True,907174,True,1,0,0,0
166485,2019-11-21 00:00:00+03:00,out,True,887276,True,1,0,28,28
166485,2019-11-21 00:00:00+03:00,out,False,887278,True,1,0,9,9
166485,2019-11-21 00:00:00+03:00,out,True,887278,False,8,1087,1132,45
166485,2019-11-21 00:00:00+03:00,out,False,887276,True,4,0,77,77
166485,2019-11-21 00:00:00+03:00,out,False,887276,False,7,409,504,95
166485,2019-11-21 00:00:00+03:00,in,False,-1,True,6,0,86,86
166485,2019-11-21 00:00:00+03:00,out,False,907174,False,36,1569,2131,562
166485,2019-11-21 00:00:00+03:00,out,False,887282,False,30,1532,1737,205
166485,2019-11-21 00:00:00+03:00,out,False,906866,False,54,3949,4481,532
166485,2019-11-21 00:00:00+03:00,out,False,906866,True,14,0,340,340
166485,2019-11-21 00:00:00+03:00,in,False,887276,False,5,405,555,150
166485,2019-11-21 00:00:00+03:00,out,False,887276,False,7,409,504,95
166485,2019-11-21 00:00:00+03:00,out,True,887276,True,1,0,28,28
166485,2019-11-21 00:00:00+03:00,in,False,887276,False,5,405,555,150
166485,2019-11-22 00:00:00+03:00,out,True,887276,False,4,182,245,63
166485,2019-11-22 00:00:00+03:00,out,True,887278,False,8,739,799,60
166485,2019-11-22 00:00:00+03:00,out,False,887282,False,57,3611,4068,457
166485,2019-11-22 00:00:00+03:00,out,False,887282,True,16,0,546,546
166485,2019-11-22 00:00:00+03:00,out,False,906866,False,12,602,668,66
166485,2019-11-22 00:00:00+03:00,out,False,887276,False,4,156,190,34
166485,2019-11-22 00:00:00+03:00,in,False,887282,False,2,381,528,147
166485,2019-11-22 00:00:00+03:00,in,False,-1,True,6,0,78,78
166485,2019-11-22 00:00:00+03:00,in,False,887276,False,12,2034,2355,321
166485,2019-11-22 00:00:00+03:00,out,False,887276,True,2,0,61,61
166485,2019-11-22 00:00:00+03:00,out,False,906866,True,7,0,217,217
166485,2019-11-22 00:00:00+03:00,out,False,887278,False,2,206,229,23
166485,2019-11-22 00:00:00+03:00,in,False,887278,False,3,664,706,42
166485,2019-11-22 00:00:00+03:00,out,False,907174,True,12,0,264,264
166485,2019-11-22 00:00:00+03:00,out,False,907174,False,44,1711,2408,697
166485,2019-11-23 00:00:00+03:00,in,False,-1,True,1,0,6,6
166485,2019-11-23 00:00:00+03:00,in,False,-1,True,1,0,6,6
166485,2019-11-25 00:00:00+03:00,out,False,887282,True,26,0,606,606
166485,2019-11-25 00:00:00+03:00,out,False,907174,True,8,0,345,345
166485,2019-11-25 00:00:00+03:00,out,True,887278,False,2,468,484,16
166485,2019-11-25 00:00:00+03:00,in,False,887278,False,2,271,309,38
166485,2019-11-25 00:00:00+03:00,out,False,887276,False,1,102,104,2
166485,2019-11-25 00:00:00+03:00,out,True,887278,True,1,0,1,1
166485,2019-11-25 00:00:00+03:00,out,False,887282,False,86,7673,8507,834
166485,2019-11-25 00:00:00+03:00,out,False,907174,False,45,2979,3727,748
166485,2019-11-25 00:00:00+03:00,in,False,887276,False,3,625,697,72
166485,2019-11-25 00:00:00+03:00,in,False,-1,True,8,0,168,168
166485,2019-11-25 00:00:00+03:00,out,True,887276,False,3,276,321,45
166485,2019-11-26 00:00:00+03:00,in,False,887278,False,1,406,416,10
166485,2019-11-26 00:00:00+03:00,out,False,907174,True,6,0,189,189
166485,2019-11-26 00:00:00+03:00,out,True,887278,False,5,535,596,61
166485,2019-11-26 00:00:00+03:00,in,False,887276,False,6,901,1151,250
166485,2019-11-26 00:00:00+03:00,in,False,-1,True,2,0,14,14
166485,2019-11-26 00:00:00+03:00,out,False,887276,False,11,1871,2031,160
166485,2019-11-26 00:00:00+03:00,out,True,887276,True,1,0,1,1
166485,2019-11-26 00:00:00+03:00,out,False,907174,False,15,1747,1957,210
166485,2019-11-26 00:00:00+03:00,out,False,887282,True,22,0,442,442
166485,2019-11-26 00:00:00+03:00,out,False,887282,False,70,7377,8061,684
166485,2019-11-26 00:00:00+03:00,out,False,887276,True,4,0,161,161
166485,2019-11-26 00:00:00+03:00,out,True,887276,False,3,100,139,39
166485,2019-11-26 00:00:00+03:00,in,False,887282,False,1,212,238,26
166485,2019-11-26 00:00:00+03:00,in,False,887278,False,1,406,416,10
166485,2019-11-27 00:00:00+03:00,out,False,887282,False,23,825,1115,290
166485,2019-11-27 00:00:00+03:00,out,True,887276,False,3,268,295,27
166485,2019-11-27 00:00:00+03:00,in,False,-1,True,4,0,25,25
166485,2019-11-27 00:00:00+03:00,out,False,907174,True,8,0,171,171
166485,2019-11-27 00:00:00+03:00,out,False,887276,True,1,0,54,54
166485,2019-11-27 00:00:00+03:00,in,False,887276,False,7,1052,1247,195
166485,2019-11-27 00:00:00+03:00,out,False,887282,True,11,0,140,140
166485,2019-11-27 00:00:00+03:00,out,False,907174,False,29,2791,3303,512
166485,2019-11-27 00:00:00+03:00,out,False,887276,False,3,125,163,38
166485,2019-11-27 00:00:00+03:00,out,True,887278,False,6,369,416,47
166485,2019-11-27 00:00:00+03:00,in,False,887278,False,3,581,657,76
166485,2019-11-27 00:00:00+03:00,in,False,-1,True,4,0,25,25
166485,2019-11-28 00:00:00+03:00,out,False,887276,False,1,137,154,17
166485,2019-11-28 00:00:00+03:00,out,False,887276,True,1,0,55,55
166485,2019-11-28 00:00:00+03:00,in,False,887278,False,1,81,91,10
166485,2019-11-28 00:00:00+03:00,out,True,887276,True,1,0,19,19
166485,2019-11-28 00:00:00+03:00,out,True,887276,False,6,226,287,61
166485,2019-11-28 00:00:00+03:00,in,False,887276,False,8,569,839,270
166485,2019-11-28 00:00:00+03:00,out,True,887278,False,2,97,112,15
166485,2019-11-28 00:00:00+03:00,in,False,-1,True,2,0,13,13
166487,2019-08-08 00:00:00+03:00,in,False,-1,True,1,0,2,2
166487,2019-08-14 00:00:00+03:00,in,False,-1,True,1,0,3,3
166487,2019-08-19 00:00:00+03:00,in,False,-1,True,1,0,2,2
166487,2019-08-21 00:00:00+03:00,in,False,-1,True,1,0,2,2
166487,2019-08-22 00:00:00+03:00,in,False,-1,True,2,0,4,4
166487,2019-08-28 00:00:00+03:00,in,False,-1,True,1,0,2,2
166487,2019-08-28 00:00:00+03:00,in,False,-1,True,1,0,2,2
166487,2019-09-02 00:00:00+03:00,in,False,-1,True,1,0,2,2
166487,2019-09-12 00:00:00+03:00,in,False,-1,True,1,0,2,2
166487,2019-09-25 00:00:00+03:00,in,False,-1,True,4,0,8,8
166487,2019-10-09 00:00:00+03:00,in,False,-1,True,1,0,2,2
166487,2019-10-09 00:00:00+03:00,in,False,-1,True,1,0,2,2
166487,2019-10-14 00:00:00+03:00,in,False,-1,True,1,0,2,2
166487,2019-10-21 00:00:00+03:00,in,False,-1,True,1,0,2,2
166487,2019-11-07 00:00:00+03:00,in,False,-1,True,1,0,2,2
166487,2019-11-12 00:00:00+03:00,out,False,959312,False,1,6,19,13
166487,2019-11-12 00:00:00+03:00,in,False,959312,False,2,22,37,15
166487,2019-11-12 00:00:00+03:00,out,False,959312,True,7,0,120,120
166487,2019-11-12 00:00:00+03:00,in,False,-1,True,5,0,44,44
166487,2019-11-12 00:00:00+03:00,out,False,959312,False,1,6,19,13
166487,2019-11-15 00:00:00+03:00,in,False,959312,False,1,111,116,5
166487,2019-11-18 00:00:00+03:00,out,False,959312,True,3,0,51,51
166487,2019-11-18 00:00:00+03:00,in,False,959312,True,7,0,15,15
166487,2019-11-18 00:00:00+03:00,in,False,959312,False,7,581,621,40
166487,2019-11-18 00:00:00+03:00,out,False,959312,False,2,286,317,31
166487,2019-11-18 00:00:00+03:00,out,False,959312,True,3,0,51,51
166487,2019-11-19 00:00:00+03:00,out,False,959312,False,2,803,816,13
166487,2019-11-19 00:00:00+03:00,in,False,959312,False,3,213,238,25
166487,2019-11-20 00:00:00+03:00,in,False,959312,False,4,288,325,37
166487,2019-11-20 00:00:00+03:00,out,False,959312,False,6,320,402,82
166487,2019-11-20 00:00:00+03:00,out,True,959312,True,49,0,0,0
166487,2019-11-20 00:00:00+03:00,out,False,959312,True,8,0,94,94
166487,2019-11-21 00:00:00+03:00,out,False,959312,False,6,335,411,76
166487,2019-11-21 00:00:00+03:00,out,False,959312,True,2,0,83,83
166487,2019-11-21 00:00:00+03:00,in,False,959312,False,3,398,423,25
166487,2019-11-22 00:00:00+03:00,out,False,959312,False,13,424,493,69
166487,2019-11-22 00:00:00+03:00,in,False,959312,False,4,1403,1437,34
166487,2019-11-23 00:00:00+03:00,in,False,959312,False,2,57,74,17
166487,2019-11-23 00:00:00+03:00,in,False,959312,False,2,57,74,17
166487,2019-11-25 00:00:00+03:00,in,False,-1,True,1,0,8,8
166487,2019-11-25 00:00:00+03:00,in,False,959312,False,11,1198,1295,97
166487,2019-11-25 00:00:00+03:00,out,False,959312,True,9,0,275,275
166487,2019-11-25 00:00:00+03:00,out,False,959312,False,18,1329,1551,222
166487,2019-11-26 00:00:00+03:00,out,False,959312,False,4,375,418,43
166487,2019-11-26 00:00:00+03:00,in,False,959312,False,6,1818,1874,56
166487,2019-11-27 00:00:00+03:00,out,False,959312,False,5,412,472,60
166487,2019-11-27 00:00:00+03:00,out,False,959312,True,3,0,33,33
166487,2019-11-27 00:00:00+03:00,in,False,959312,False,1,122,130,8
166487,2019-11-28 00:00:00+03:00,in,False,959312,False,5,227,271,44
166487,2019-11-28 00:00:00+03:00,out,False,959312,False,7,1203,1267,64
166487,2019-11-28 00:00:00+03:00,out,False,959312,False,7,1203,1267,64
166495,2019-08-08 00:00:00+03:00,out,False,883940,False,30,2030,2289,259
166495,2019-08-08 00:00:00+03:00,out,False,883942,False,21,2079,2278,199
166495,2019-08-08 00:00:00+03:00,out,False,883940,True,23,0,279,279
166495,2019-08-08 00:00:00+03:00,out,False,883942,True,17,0,227,227
166495,2019-08-08 00:00:00+03:00,in,False,883942,False,1,34,42,8
166495,2019-08-08 00:00:00+03:00,out,False,883942,False,21,2079,2278,199
166495,2019-08-09 00:00:00+03:00,out,False,883942,True,14,0,302,302
166495,2019-08-09 00:00:00+03:00,out,False,883942,False,24,2582,2827,245
166495,2019-08-09 00:00:00+03:00,out,False,883940,True,15,0,607,607
166495,2019-08-09 00:00:00+03:00,out,False,883940,False,32,1203,1523,320
166495,2019-08-09 00:00:00+03:00,in,False,883942,False,2,55,64,9
166495,2019-08-09 00:00:00+03:00,out,False,883940,True,15,0,607,607
166495,2019-08-12 00:00:00+03:00,in,False,-1,True,6,0,2,2
166495,2019-08-12 00:00:00+03:00,out,False,883940,True,8,0,168,168
166495,2019-08-12 00:00:00+03:00,out,False,883942,False,30,3135,3456,321
166495,2019-08-12 00:00:00+03:00,out,False,883940,False,33,1733,2115,382
166495,2019-08-12 00:00:00+03:00,out,False,883942,True,16,0,384,384
166495,2019-08-13 00:00:00+03:00,in,False,883940,False,1,11,25,14
166495,2019-08-13 00:00:00+03:00,in,False,883942,False,4,594,611,17
166495,2019-08-13 00:00:00+03:00,out,False,883942,False,35,2884,3218,334
166495,2019-08-13 00:00:00+03:00,out,False,883942,True,16,0,288,288
166495,2019-08-13 00:00:00+03:00,out,False,883940,False,23,918,1288,370
166495,2019-08-13 00:00:00+03:00,in,False,-1,True,1,0,1,1
166495,2019-08-13 00:00:00+03:00,out,False,883940,True,12,0,330,330
166495,2019-08-13 00:00:00+03:00,in,False,883940,False,1,11,25,14
166495,2019-08-13 00:00:00+03:00,out,False,883942,True,16,0,288,288
166495,2019-08-14 00:00:00+03:00,out,False,883940,False,41,2142,2623,481
166495,2019-08-14 00:00:00+03:00,out,False,883942,False,43,2803,3242,439
166495,2019-08-14 00:00:00+03:00,in,False,883942,False,3,263,280,17
166495,2019-08-14 00:00:00+03:00,out,False,883942,True,25,0,634,634
166495,2019-08-14 00:00:00+03:00,in,False,-1,True,2,0,0,0
166495,2019-08-14 00:00:00+03:00,out,False,883940,True,19,0,435,435
166495,2019-08-15 00:00:00+03:00,out,False,883940,False,30,1360,1750,390
166495,2019-08-15 00:00:00+03:00,out,False,883942,False,30,3359,3593,234
166495,2019-08-15 00:00:00+03:00,out,False,883942,True,6,0,90,90
166495,2019-08-15 00:00:00+03:00,out,False,883940,True,17,0,616,616
166495,2019-08-16 00:00:00+03:00,out,False,883940,True,6,0,235,235
166495,2019-08-16 00:00:00+03:00,out,False,883940,False,4,302,343,41
166495,2019-08-16 00:00:00+03:00,out,False,883940,False,4,302,343,41
166495,2019-08-19 00:00:00+03:00,out,False,883942,False,20,2023,2249,226
166495,2019-08-19 00:00:00+03:00,out,False,883940,True,25,0,624,624
166495,2019-08-19 00:00:00+03:00,out,False,883940,False,33,2004,2393,389
166495,2019-08-19 00:00:00+03:00,out,False,883942,True,10,0,303,303
166495,2019-08-19 00:00:00+03:00,in,False,-1,True,7,0,16,16
166495,2019-08-19 00:00:00+03:00,in,False,883942,False,3,187,198,11
166495,2019-08-19 00:00:00+03:00,out,False,883942,False,20,2023,2249,226
166495,2019-08-19 00:00:00+03:00,in,False,883942,False,3,187,198,11
166495,2019-08-20 00:00:00+03:00,out,False,883942,True,22,0,285,285
166495,2019-08-20 00:00:00+03:00,in,False,883942,False,1,101,107,6
166495,2019-08-20 00:00:00+03:00,in,False,-1,True,2,0,64,64
166495,2019-08-20 00:00:00+03:00,in,False,883940,False,2,59,93,34
166495,2019-08-20 00:00:00+03:00,out,False,883940,True,14,0,436,436
166495,2019-08-20 00:00:00+03:00,out,False,883940,False,32,1966,2399,433
166495,2019-08-20 00:00:00+03:00,out,False,883942,False,14,2327,2467,140
166495,2019-08-20 00:00:00+03:00,out,False,883942,False,14,2327,2467,140
166495,2019-08-21 00:00:00+03:00,out,False,883942,True,6,0,142,142
166495,2019-08-21 00:00:00+03:00,in,False,883940,False,1,75,80,5
166495,2019-08-21 00:00:00+03:00,out,False,883940,True,15,0,334,334
166495,2019-08-21 00:00:00+03:00,in,False,883942,False,2,221,231,10
166495,2019-08-21 00:00:00+03:00,out,False,883940,False,30,1571,1869,298
166495,2019-08-21 00:00:00+03:00,in,False,-1,True,3,0,20,20
166495,2019-08-21 00:00:00+03:00,out,False,883942,False,32,4357,4659,302
166495,2019-08-21 00:00:00+03:00,in,False,-1,True,3,0,20,20
166495,2019-08-22 00:00:00+03:00,in,False,883940,False,1,154,167,13
166495,2019-08-22 00:00:00+03:00,out,False,883942,False,9,1447,1495,48
166495,2019-08-22 00:00:00+03:00,in,False,883942,False,4,430,461,31
166495,2019-08-22 00:00:00+03:00,in,False,-1,True,4,0,1,1
166495,2019-08-22 00:00:00+03:00,out,False,883940,False,19,1058,1222,164
166495,2019-08-22 00:00:00+03:00,out,False,883942,True,4,0,77,77
166495,2019-08-22 00:00:00+03:00,out,False,883940,True,10,0,268,268
166495,2019-08-22 00:00:00+03:00,in,False,883942,False,4,430,461,31
166495,2019-08-23 00:00:00+03:00,out,False,883942,True,10,0,143,143
166495,2019-08-23 00:00:00+03:00,out,False,883942,False,16,1902,2096,194
166495,2019-08-26 00:00:00+03:00,out,False,883940,True,17,0,543,543
166495,2019-08-26 00:00:00+03:00,out,False,883942,False,33,2812,3065,253
166495,2019-08-26 00:00:00+03:00,in,False,883942,False,1,84,93,9
166495,2019-08-26 00:00:00+03:00,out,False,883940,False,45,2011,2630,619
166495,2019-08-26 00:00:00+03:00,out,False,883942,True,16,0,595,595
166495,2019-08-26 00:00:00+03:00,in,False,-1,True,6,0,1,1
166495,2019-08-26 00:00:00+03:00,out,False,883940,True,17,0,543,543
166495,2019-08-27 00:00:00+03:00,out,False,883942,False,39,4570,4931,361
166495,2019-08-27 00:00:00+03:00,out,False,883940,False,15,528,703,175
166495,2019-08-27 00:00:00+03:00,out,False,883940,True,7,0,331,331
166495,2019-08-27 00:00:00+03:00,in,False,-1,True,6,0,1,1
166495,2019-08-27 00:00:00+03:00,out,False,883942,True,16,0,288,288
166495,2019-08-27 00:00:00+03:00,in,False,883942,False,1,46,50,4
166495,2019-08-27 00:00:00+03:00,out,False,883940,True,7,0,331,331
166495,2019-08-27 00:00:00+03:00,out,False,883942,False,39,4570,4931,361
166495,2019-08-28 00:00:00+03:00,out,False,883942,True,13,0,415,415
166495,2019-08-28 00:00:00+03:00,in,False,-1,True,6,0,70,70
166495,2019-08-28 00:00:00+03:00,in,False,883942,False,3,162,184,22
166495,2019-08-28 00:00:00+03:00,out,False,883940,True,11,0,282,282
166495,2019-08-28 00:00:00+03:00,out,False,883940,False,40,1905,2407,502
166495,2019-08-28 00:00:00+03:00,out,False,883942,False,38,3762,4093,331
166495,2019-08-28 00:00:00+03:00,out,False,883940,True,11,0,282,282
166495,2019-08-29 00:00:00+03:00,out,False,883940,False,17,485,699,214
166495,2019-08-29 00:00:00+03:00,out,False,883942,False,39,4543,4829,286
166495,2019-08-29 00:00:00+03:00,out,False,883940,True,7,0,272,272
166495,2019-08-29 00:00:00+03:00,out,False,883942,True,10,0,285,285
166495,2019-08-29 00:00:00+03:00,in,False,883942,False,1,37,46,9
166495,2019-08-29 00:00:00+03:00,in,False,883940,False,1,54,64,10
166495,2019-08-29 00:00:00+03:00,in,False,883940,False,1,54,64,10
166495,2019-08-30 00:00:00+03:00,out,False,883942,False,25,3479,3689,210
166495,2019-08-30 00:00:00+03:00,in,False,883942,False,3,588,612,24
166495,2019-08-30 00:00:00+03:00,in,False,-1,True,1,0,18,18
166495,2019-08-30 00:00:00+03:00,out,False,883942,True,7,0,223,223
166495,2019-09-02 00:00:00+03:00,out,False,883942,False,37,3827,4250,423
166495,2019-09-02 00:00:00+03:00,in,False,-1,True,3,0,30,30
166495,2019-09-02 00:00:00+03:00,out,False,883942,True,14,0,375,375
166495,2019-09-03 00:00:00+03:00,in,False,-1,True,4,0,0,0
166495,2019-09-03 00:00:00+03:00,out,False,883942,False,20,1123,1321,198
166495,2019-09-03 00:00:00+03:00,out,False,883942,True,9,0,368,368
166495,2019-09-03 00:00:00+03:00,out,False,883942,True,9,0,368,368
166495,2019-09-04 00:00:00+03:00,in,False,-1,True,4,0,0,0
166495,2019-09-04 00:00:00+03:00,out,False,883942,False,11,1646,1743,97
166495,2019-09-04 00:00:00+03:00,in,False,883942,False,1,291,303,12
166495,2019-09-04 00:00:00+03:00,out,False,883942,True,4,0,59,59
166495,2019-09-05 00:00:00+03:00,in,False,883942,False,4,426,441,15
166495,2019-09-05 00:00:00+03:00,out,False,883942,True,14,0,448,448
166495,2019-09-05 00:00:00+03:00,out,False,883942,False,25,2593,2815,222
166495,2019-09-05 00:00:00+03:00,in,False,-1,True,7,0,3,3
166495,2019-09-05 00:00:00+03:00,in,False,883942,False,4,426,441,15
166495,2019-09-06 00:00:00+03:00,out,False,883942,True,23,0,530,530
166495,2019-09-06 00:00:00+03:00,out,False,883942,False,29,2442,2784,342
166495,2019-09-06 00:00:00+03:00,in,False,883942,False,3,572,592,20
166495,2019-09-09 00:00:00+03:00,in,False,883942,False,2,73,92,19
166495,2019-09-09 00:00:00+03:00,out,False,883942,False,27,2103,2385,282
166495,2019-09-09 00:00:00+03:00,out,False,883942,True,9,0,169,169
166495,2019-09-11 00:00:00+03:00,in,False,-1,True,6,0,0,0
166495,2019-09-16 00:00:00+03:00,out,False,883942,False,39,2438,2879,441
166495,2019-09-16 00:00:00+03:00,out,False,883942,True,12,0,400,400
166495,2019-09-16 00:00:00+03:00,in,False,883942,False,2,43,50,7
166495,2019-09-16 00:00:00+03:00,in,False,-1,True,4,0,0,0
166495,2019-09-17 00:00:00+03:00,out,False,883942,True,14,0,464,464
166495,2019-09-17 00:00:00+03:00,out,False,883942,False,39,3572,3908,336
166495,2019-09-18 00:00:00+03:00,out,False,883942,False,30,2206,2556,350
166495,2019-09-18 00:00:00+03:00,out,False,883942,True,15,0,273,273
166495,2019-09-18 00:00:00+03:00,out,False,883942,True,15,0,273,273
166495,2019-09-19 00:00:00+03:00,out,False,883942,True,3,0,28,28
166495,2019-09-19 00:00:00+03:00,in,False,-1,True,2,0,10,10
166495,2019-09-19 00:00:00+03:00,in,False,883942,False,1,103,108,5
166495,2019-09-19 00:00:00+03:00,out,False,883942,False,25,2025,2310,285
166495,2019-09-23 00:00:00+03:00,out,False,883942,False,31,2022,2376,354
166495,2019-09-23 00:00:00+03:00,out,False,883942,True,9,0,188,188
166495,2019-09-24 00:00:00+03:00,out,False,883942,False,27,1934,2260,326
166495,2019-09-24 00:00:00+03:00,in,False,883942,False,1,68,74,6
166495,2019-09-24 00:00:00+03:00,out,False,883942,True,7,0,177,177
166495,2019-09-25 00:00:00+03:00,in,False,-1,True,2,0,1,1
166495,2019-09-25 00:00:00+03:00,out,False,883942,True,16,0,133,133
166495,2019-09-25 00:00:00+03:00,out,False,883942,False,36,3197,3511,314
166495,2019-09-25 00:00:00+03:00,in,False,-1,True,2,0,1,1
166495,2019-09-26 00:00:00+03:00,out,False,883942,True,8,0,252,252
166495,2019-09-26 00:00:00+03:00,out,False,883942,False,41,3068,3495,427
166495,2019-09-26 00:00:00+03:00,out,False,883942,False,41,3068,3495,427
166495,2019-09-26 00:00:00+03:00,out,False,883942,True,8,0,252,252
166495,2019-09-27 00:00:00+03:00,in,False,883942,False,1,31,36,5
166495,2019-09-27 00:00:00+03:00,out,False,883942,True,5,0,167,167
166495,2019-09-27 00:00:00+03:00,out,False,883942,False,28,1820,2139,319
166495,2019-09-30 00:00:00+03:00,out,False,883942,True,3,0,84,84
166495,2019-09-30 00:00:00+03:00,out,False,883942,False,26,1907,2133,226
166495,2019-09-30 00:00:00+03:00,out,False,883942,True,3,0,84,84
166495,2019-10-01 00:00:00+03:00,out,False,883942,False,35,2412,2799,387
166495,2019-10-01 00:00:00+03:00,out,False,883942,True,13,0,289,289
166495,2019-10-01 00:00:00+03:00,in,False,-1,True,2,0,60,60
166495,2019-10-02 00:00:00+03:00,out,False,883942,False,16,688,844,156
166495,2019-10-02 00:00:00+03:00,out,False,883942,True,4,0,141,141
166495,2019-10-03 00:00:00+03:00,in,False,883942,False,1,281,290,9
166495,2019-10-03 00:00:00+03:00,out,False,883942,False,34,2281,2636,355
166495,2019-10-03 00:00:00+03:00,out,False,883942,True,9,0,148,148
166495,2019-10-07 00:00:00+03:00,out,False,883940,True,2,0,0,0
166495,2019-10-08 00:00:00+03:00,in,False,-1,True,1,0,30,30
166495,2019-10-08 00:00:00+03:00,out,False,883942,True,4,0,61,61
166495,2019-10-08 00:00:00+03:00,out,False,883942,False,27,1157,1440,283
166495,2019-10-08 00:00:00+03:00,in,False,883942,False,1,97,101,4
166495,2019-10-08 00:00:00+03:00,in,False,883942,False,1,97,101,4
166495,2019-10-09 00:00:00+03:00,out,False,883942,False,24,2021,2226,205
166495,2019-10-09 00:00:00+03:00,out,False,883942,True,9,0,171,171
166495,2019-10-09 00:00:00+03:00,in,False,883942,False,2,499,508,9
166495,2019-10-09 00:00:00+03:00,in,False,-1,True,2,0,0,0
166495,2019-10-10 00:00:00+03:00,in,False,-1,True,25,0,44,44
166495,2019-10-10 00:00:00+03:00,out,False,883942,False,19,2808,2932,124
166495,2019-10-10 00:00:00+03:00,in,False,883942,False,1,7,16,9
166495,2019-10-10 00:00:00+03:00,out,False,883942,True,4,0,47,47
166495,2019-10-11 00:00:00+03:00,out,False,883942,True,6,0,124,124
166495,2019-10-11 00:00:00+03:00,out,False,883942,False,29,2795,3066,271
166495,2019-10-11 00:00:00+03:00,in,False,-1,True,4,0,79,79
166495,2019-10-14 00:00:00+03:00,out,False,883942,True,5,0,124,124
166495,2019-10-14 00:00:00+03:00,in,False,883942,False,1,102,108,6
166495,2019-10-14 00:00:00+03:00,out,False,883942,False,37,3250,3654,404
166495,2019-10-14 00:00:00+03:00,in,False,-1,True,2,0,0,0
166495,2019-10-15 00:00:00+03:00,out,False,883942,False,7,387,470,83
166495,2019-10-15 00:00:00+03:00,out,False,883942,True,2,0,37,37
166495,2019-10-15 00:00:00+03:00,in,False,-1,True,2,0,0,0
166495,2019-10-15 00:00:00+03:00,out,False,883942,True,2,0,37,37
166495,2019-10-16 00:00:00+03:00,out,False,883942,False,23,1607,1903,296
166495,2019-10-16 00:00:00+03:00,in,False,883942,False,6,457,483,26
166495,2019-10-16 00:00:00+03:00,in,False,-1,True,8,0,60,60
166495,2019-10-16 00:00:00+03:00,out,False,883942,True,1,0,2,2
166495,2019-10-16 00:00:00+03:00,in,False,883942,False,6,457,483,26
166495,2019-10-17 00:00:00+03:00,in,False,-1,True,9,0,1,1
166495,2019-10-17 00:00:00+03:00,out,False,883942,True,1,0,40,40
166495,2019-10-17 00:00:00+03:00,in,False,883942,False,3,370,387,17
166495,2019-10-17 00:00:00+03:00,out,False,883942,False,17,1429,1547,118
166495,2019-10-18 00:00:00+03:00,out,False,883942,False,10,607,755,148
166495,2019-10-18 00:00:00+03:00,out,False,883942,True,4,0,151,151
166495,2019-10-18 00:00:00+03:00,in,False,-1,True,10,0,45,45
166495,2019-10-18 00:00:00+03:00,in,False,883942,False,2,55,67,12
166495,2019-10-18 00:00:00+03:00,in,False,883942,False,2,55,67,12
166495,2019-10-21 00:00:00+03:00,out,False,883942,False,3,234,259,25
166495,2019-10-21 00:00:00+03:00,in,False,883942,False,2,200,212,12
166495,2019-10-21 00:00:00+03:00,out,False,883942,True,1,0,60,60
166495,2019-10-21 00:00:00+03:00,in,False,-1,True,4,0,0,0
166495,2019-10-21 00:00:00+03:00,in,False,883942,False,2,200,212,12
166495,2019-10-22 00:00:00+03:00,in,False,-1,True,23,0,253,253
166495,2019-10-22 00:00:00+03:00,out,False,883942,False,17,952,1110,158
166495,2019-10-22 00:00:00+03:00,in,False,883942,False,7,787,894,107
166495,2019-10-22 00:00:00+03:00,out,False,883942,True,6,0,111,111
166495,2019-10-23 00:00:00+03:00,in,False,-1,True,44,0,3,3
166495,2019-10-28 00:00:00+03:00,in,False,-1,True,3,0,6,6
166495,2019-10-30 00:00:00+03:00,in,False,-1,True,1,0,2,2
166495,2019-11-03 00:00:00+03:00,in,False,-1,True,1,0,2,2
166495,2019-11-11 00:00:00+03:00,in,False,-1,True,1,0,2,2
166495,2019-11-12 00:00:00+03:00,in,False,-1,True,2,0,4,4
166495,2019-11-13 00:00:00+03:00,in,False,-1,True,1,0,2,2
166495,2019-11-14 00:00:00+03:00,out,False,883942,True,1,0,3,3
166495,2019-11-14 00:00:00+03:00,out,False,883942,True,1,0,3,3
166495,2019-11-15 00:00:00+03:00,out,False,883942,True,3,0,28,28
166495,2019-11-15 00:00:00+03:00,in,False,-1,True,4,0,0,0
166495,2019-11-15 00:00:00+03:00,out,False,883942,False,7,346,438,92
166495,2019-11-15 00:00:00+03:00,out,False,883942,True,3,0,28,28
166495,2019-11-18 00:00:00+03:00,out,False,883942,True,9,0,179,179
166495,2019-11-18 00:00:00+03:00,in,False,883942,False,1,94,115,21
166495,2019-11-18 00:00:00+03:00,out,False,883942,False,23,1760,1995,235
166495,2019-11-19 00:00:00+03:00,out,False,883942,True,6,0,236,236
166495,2019-11-19 00:00:00+03:00,out,False,883942,False,37,2353,2788,435
166495,2019-11-19 00:00:00+03:00,out,False,883942,True,6,0,236,236
166495,2019-11-20 00:00:00+03:00,out,False,883942,True,8,0,173,173
166495,2019-11-20 00:00:00+03:00,out,False,883942,False,15,1398,1591,193
166495,2019-11-20 00:00:00+03:00,in,False,-1,True,4,0,6,6
166495,2019-11-21 00:00:00+03:00,out,False,883942,False,43,2674,3069,395
166495,2019-11-21 00:00:00+03:00,out,False,883942,True,5,0,229,229
166495,2019-11-21 00:00:00+03:00,in,False,883942,False,2,212,239,27
166495,2019-11-22 00:00:00+03:00,out,False,883942,True,7,0,225,225
166495,2019-11-22 00:00:00+03:00,out,False,883942,False,36,4129,4517,388
166495,2019-11-22 00:00:00+03:00,in,False,883942,False,3,225,236,11
166495,2019-11-25 00:00:00+03:00,out,False,883942,False,19,1538,1647,109
166495,2019-11-25 00:00:00+03:00,out,False,883942,True,4,0,85,85
166495,2019-11-26 00:00:00+03:00,out,False,883942,True,6,0,139,139
166495,2019-11-26 00:00:00+03:00,in,False,-1,True,2,0,2,2
166495,2019-11-26 00:00:00+03:00,out,False,883942,False,34,2637,3034,397
166495,2019-11-27 00:00:00+03:00,out,False,883942,False,29,3100,3407,307
166495,2019-11-27 00:00:00+03:00,out,False,883942,True,12,0,487,487
166495,2019-11-28 00:00:00+03:00,out,True,883942,True,1,0,0,0
166495,2019-11-28 00:00:00+03:00,in,False,883942,False,1,56,63,7
166495,2019-11-28 00:00:00+03:00,out,False,883942,True,19,0,522,522
166495,2019-11-28 00:00:00+03:00,out,False,883942,False,47,3229,3685,456
166503,2019-08-08 00:00:00+03:00,out,False,884412,False,2,50,66,16
166503,2019-08-08 00:00:00+03:00,out,True,884412,True,3,0,36,36
166503,2019-08-08 00:00:00+03:00,in,False,-1,True,1,0,11,11
166503,2019-08-08 00:00:00+03:00,out,False,884412,True,1,0,5,5
166503,2019-08-09 00:00:00+03:00,in,False,-1,True,5,0,123,123
166503,2019-08-09 00:00:00+03:00,out,False,884408,False,1,9,25,16
166503,2019-08-09 00:00:00+03:00,in,True,884408,False,3,64,163,99
166503,2019-08-09 00:00:00+03:00,in,False,-1,True,1,0,30,30
166503,2019-08-09 00:00:00+03:00,in,False,884408,False,4,445,506,61
166503,2019-08-09 00:00:00+03:00,out,False,884408,True,4,0,82,82
166503,2019-08-11 00:00:00+03:00,in,False,-1,True,1,0,6,6
166503,2019-08-12 00:00:00+03:00,in,False,-1,True,8,0,174,174
166503,2019-08-12 00:00:00+03:00,out,True,884412,True,12,0,193,193
166503,2019-08-12 00:00:00+03:00,out,False,884412,False,22,1478,1830,352
166503,2019-08-12 00:00:00+03:00,out,False,884408,False,1,21,111,90
166503,2019-08-12 00:00:00+03:00,in,False,884408,False,1,19,62,43
166503,2019-08-12 00:00:00+03:00,out,True,884408,True,5,0,273,273
166503,2019-08-12 00:00:00+03:00,in,True,884412,False,1,54,75,21
166503,2019-08-12 00:00:00+03:00,in,True,884408,True,1,38,69,31
166503,2019-08-12 00:00:00+03:00,out,True,884412,False,2,170,198,28
166503,2019-08-12 00:00:00+03:00,in,False,-1,True,1,0,5,5
166503,2019-08-12 00:00:00+03:00,out,False,884412,True,16,0,353,353
166503,2019-08-13 00:00:00+03:00,in,False,-1,True,1,0,2,2
166503,2019-08-13 00:00:00+03:00,out,False,884412,True,28,0,630,630
166503,2019-08-13 00:00:00+03:00,out,False,884412,False,40,3528,4202,674
166503,2019-08-13 00:00:00+03:00,in,False,-1,True,2,0,40,40
166503,2019-08-14 00:00:00+03:00,out,False,884412,False,2,63,123,60
166503,2019-08-15 00:00:00+03:00,in,False,-1,True,2,0,18,18
166503,2019-08-15 00:00:00+03:00,out,True,884412,False,1,59,77,18
166503,2019-08-15 00:00:00+03:00,out,False,884412,True,12,0,297,297
166503,2019-08-15 00:00:00+03:00,out,True,884412,True,1,0,10,10
166503,2019-08-15 00:00:00+03:00,out,False,884412,False,29,3005,3441,436
166503,2019-08-15 00:00:00+03:00,in,False,-1,True,2,0,18,18
166503,2019-08-16 00:00:00+03:00,out,False,884412,True,4,0,49,49
166503,2019-08-16 00:00:00+03:00,out,False,884412,False,18,1905,2139,234
166503,2019-08-19 00:00:00+03:00,out,False,884412,True,9,0,341,341
166503,2019-08-19 00:00:00+03:00,out,False,884412,False,21,1874,2177,303
166503,2019-08-19 00:00:00+03:00,out,False,884412,False,21,1874,2177,303
166503,2019-08-20 00:00:00+03:00,out,False,884412,False,1,36,58,22
166503,2019-08-21 00:00:00+03:00,out,False,884412,True,2,0,29,29
166503,2019-08-21 00:00:00+03:00,out,False,884412,False,6,580,684,104
166503,2019-08-22 00:00:00+03:00,out,False,884412,False,2,358,383,25
166503,2019-08-22 00:00:00+03:00,out,False,884412,False,2,358,383,25
166503,2019-08-23 00:00:00+03:00,out,False,884412,False,2,253,292,39
166503,2019-08-23 00:00:00+03:00,out,False,884412,True,3,0,25,25
166503,2019-08-26 00:00:00+03:00,out,False,884412,False,10,1434,1585,151
166503,2019-08-26 00:00:00+03:00,out,False,884412,True,4,0,82,82
166503,2019-08-27 00:00:00+03:00,out,False,884412,False,6,569,658,89
166503,2019-08-27 00:00:00+03:00,out,False,884412,True,3,0,16,16
166503,2019-08-28 00:00:00+03:00,out,False,884412,False,2,298,338,40
166503,2019-08-28 00:00:00+03:00,out,False,884412,True,1,0,58,58
166503,2019-08-30 00:00:00+03:00,out,False,884412,False,1,200,218,18
166503,2019-09-02 00:00:00+03:00,out,False,884412,False,1,36,60,24
166503,2019-09-02 00:00:00+03:00,out,False,884412,True,1,0,53,53
166503,2019-09-03 00:00:00+03:00,out,False,884412,False,20,1983,2313,330
166503,2019-09-03 00:00:00+03:00,out,False,884412,True,13,0,374,374
166503,2019-09-03 00:00:00+03:00,out,False,884412,True,13,0,374,374
166503,2019-09-05 00:00:00+03:00,out,False,884412,False,17,1461,1722,261
166503,2019-09-05 00:00:00+03:00,out,False,884412,True,16,0,222,222
166503,2019-09-06 00:00:00+03:00,out,False,884412,True,13,0,475,475
166503,2019-09-06 00:00:00+03:00,out,False,884412,False,13,1004,1207,203
166503,2019-09-09 00:00:00+03:00,out,False,884412,True,22,0,646,646
166503,2019-09-09 00:00:00+03:00,out,False,884412,False,29,3271,3851,580
166503,2019-09-09 00:00:00+03:00,out,False,884412,False,29,3271,3851,580
166503,2019-09-10 00:00:00+03:00,out,False,884412,False,39,4363,4944,581
166503,2019-09-10 00:00:00+03:00,out,False,884412,True,25,0,685,685
166503,2019-09-11 00:00:00+03:00,in,False,-1,True,1,0,30,30
166503,2019-09-11 00:00:00+03:00,in,False,884408,False,1,33,63,30
166503,2019-09-11 00:00:00+03:00,out,True,884402,True,1,0,28,28
166503,2019-09-11 00:00:00+03:00,out,False,884402,False,1,42,55,13
166503,2019-09-11 00:00:00+03:00,out,True,884408,True,3,0,55,55
166503,2019-09-11 00:00:00+03:00,out,True,884402,False,2,172,204,32
166503,2019-09-11 00:00:00+03:00,out,False,884412,True,31,0,949,949
166503,2019-09-11 00:00:00+03:00,out,False,884412,False,25,3012,3469,457
166503,2019-09-11 00:00:00+03:00,out,True,906680,False,1,7,33,26
166503,2019-09-11 00:00:00+03:00,in,False,884408,False,1,33,63,30
166503,2019-09-11 00:00:00+03:00,out,True,906680,False,1,7,33,26
166503,2019-09-12 00:00:00+03:00,out,False,884412,True,1,0,34,34
166503,2019-09-12 00:00:00+03:00,out,False,884412,False,10,1566,1719,153
166503,2019-09-12 00:00:00+03:00,out,False,884412,True,1,0,34,34
166503,2019-09-13 00:00:00+03:00,out,False,884412,True,8,0,109,109
166503,2019-09-13 00:00:00+03:00,out,False,884412,False,2,226,274,48
166503,2019-09-13 00:00:00+03:00,in,False,-1,True,1,0,24,24
166503,2019-09-16 00:00:00+03:00,in,False,-1,True,3,0,72,72
166503,2019-09-17 00:00:00+03:00,out,True,884408,True,1,0,24,24
166503,2019-09-19 00:00:00+03:00,out,False,906680,False,1,42,73,31
166503,2019-09-19 00:00:00+03:00,out,False,906680,True,1,0,20,20
166503,2019-09-19 00:00:00+03:00,out,False,884412,False,2,166,200,34
166503,2019-09-19 00:00:00+03:00,out,False,884412,False,2,166,200,34
166503,2019-09-20 00:00:00+03:00,out,False,884412,False,4,2404,2481,77
166503,2019-09-20 00:00:00+03:00,in,False,884408,False,2,199,256,57
166503,2019-09-20 00:00:00+03:00,out,False,884412,True,4,0,52,52
166503,2019-09-20 00:00:00+03:00,out,False,884412,True,4,0,52,52
166503,2019-09-21 00:00:00+03:00,in,False,-1,True,2,0,218,218
166503,2019-09-21 00:00:00+03:00,in,False,884408,False,1,40,74,34
166503,2019-09-22 00:00:00+03:00,in,False,-1,True,1,0,10,10
166503,2019-09-22 00:00:00+03:00,in,False,884408,False,1,193,234,41
166503,2019-09-23 00:00:00+03:00,in,False,884408,False,5,339,459,120
166503,2019-09-23 00:00:00+03:00,out,True,884408,True,1,0,29,29
166503,2019-09-23 00:00:00+03:00,out,True,906680,True,13,0,40,40
166503,2019-09-23 00:00:00+03:00,out,True,884406,True,2,0,40,40
166503,2019-09-23 00:00:00+03:00,out,False,884412,True,1,0,6,6
166503,2019-09-23 00:00:00+03:00,out,False,906680,True,2,0,71,71
166503,2019-09-23 00:00:00+03:00,out,False,884412,False,5,336,405,69
166503,2019-09-23 00:00:00+03:00,out,True,884406,False,1,8,39,31
166503,2019-09-23 00:00:00+03:00,out,True,884406,True,2,0,40,40
166503,2019-09-23 00:00:00+03:00,in,False,884408,False,5,339,459,120
166503,2019-09-23 00:00:00+03:00,out,True,884406,False,1,8,39,31
166503,2019-09-24 00:00:00+03:00,in,False,-1,True,1,0,26,26
166503,2019-09-24 00:00:00+03:00,in,True,884412,False,1,17,45,28
166503,2019-09-24 00:00:00+03:00,out,True,906680,True,1,0,0,0
166503,2019-09-24 00:00:00+03:00,in,False,-1,True,1,0,19,19
166503,2019-09-24 00:00:00+03:00,out,True,906680,False,1,2,22,20
166503,2019-09-24 00:00:00+03:00,out,False,884408,False,2,372,394,22
166503,2019-09-24 00:00:00+03:00,out,True,884408,True,3,0,0,0
166503,2019-09-24 00:00:00+03:00,out,False,906680,True,1,0,31,31
166503,2019-09-25 00:00:00+03:00,in,False,906680,True,1,53,70,17
166503,2019-09-25 00:00:00+03:00,out,True,906680,True,3,0,10,10
166503,2019-09-25 00:00:00+03:00,out,False,884408,False,1,46,58,12
166503,2019-09-25 00:00:00+03:00,out,False,884412,False,1,60,81,21
166503,2019-09-25 00:00:00+03:00,in,False,906680,False,3,110,160,50
166503,2019-09-25 00:00:00+03:00,in,False,-1,True,10,0,169,169
166503,2019-09-25 00:00:00+03:00,out,True,884408,True,3,0,9,9
166503,2019-09-25 00:00:00+03:00,in,False,884408,True,2,47,84,37
166503,2019-09-25 00:00:00+03:00,in,False,884408,False,5,115,245,130
166503,2019-09-25 00:00:00+03:00,in,False,906680,False,3,110,160,50
166503,2019-09-26 00:00:00+03:00,in,False,884408,True,1,0,14,14
166503,2019-09-26 00:00:00+03:00,in,False,884412,False,1,70,97,27
166503,2019-09-26 00:00:00+03:00,in,False,-1,True,1,0,60,60
166503,2019-09-26 00:00:00+03:00,in,False,884408,False,6,123,302,179
166503,2019-09-26 00:00:00+03:00,in,False,-1,True,2,0,30,30
166503,2019-09-26 00:00:00+03:00,out,False,884412,False,14,771,1053,282
166503,2019-09-26 00:00:00+03:00,out,False,-1,False,1,213,220,7
166503,2019-09-26 00:00:00+03:00,out,False,884412,True,5,0,45,45
166503,2019-09-26 00:00:00+03:00,in,False,884412,False,1,70,97,27
166503,2019-09-26 00:00:00+03:00,out,False,884412,True,5,0,45,45
166503,2019-09-26 00:00:00+03:00,out,False,884412,False,14,771,1053,282
166503,2019-09-27 00:00:00+03:00,in,False,-1,True,11,0,221,221
166503,2019-09-27 00:00:00+03:00,out,False,906680,False,2,84,115,31
166503,2019-09-27 00:00:00+03:00,in,False,884408,False,2,73,121,48
166503,2019-09-27 00:00:00+03:00,in,False,884412,False,1,57,100,43
166503,2019-09-27 00:00:00+03:00,in,False,884412,False,1,57,100,43
166503,2019-09-28 00:00:00+03:00,in,False,-1,True,2,0,40,40
166503,2019-09-29 00:00:00+03:00,in,False,-1,True,2,0,38,38
166503,2019-09-30 00:00:00+03:00,in,False,884412,False,1,55,92,37
166503,2019-09-30 00:00:00+03:00,in,False,-1,True,10,0,161,161
166503,2019-09-30 00:00:00+03:00,out,False,884412,False,4,232,342,110
166503,2019-09-30 00:00:00+03:00,out,False,906680,False,4,444,542,98
166503,2019-09-30 00:00:00+03:00,out,False,906680,True,4,0,60,60
166503,2019-09-30 00:00:00+03:00,out,True,906680,True,1,0,6,6
166503,2019-09-30 00:00:00+03:00,in,False,-1,True,10,0,161,161
166503,2019-10-01 00:00:00+03:00,in,False,884412,False,1,352,383,31
166503,2019-10-01 00:00:00+03:00,out,False,906680,False,2,127,161,34
166503,2019-10-01 00:00:00+03:00,in,False,-1,True,6,0,111,111
166503,2019-10-01 00:00:00+03:00,out,False,906680,False,2,127,161,34
166503,2019-10-02 00:00:00+03:00,in,False,-1,True,6,0,111,111
166503,2019-10-02 00:00:00+03:00,out,False,906680,False,1,26,41,15
166503,2019-10-02 00:00:00+03:00,out,False,884412,False,1,73,93,20
166503,2019-10-02 00:00:00+03:00,in,False,884412,False,1,75,92,17
166503,2019-10-02 00:00:00+03:00,out,False,906680,True,1,0,36,36
166503,2019-10-02 00:00:00+03:00,in,False,906680,False,3,216,264,48
166503,2019-10-03 00:00:00+03:00,in,False,884412,False,1,17,50,33
166503,2019-10-03 00:00:00+03:00,in,False,-1,True,10,0,232,232
166503,2019-10-03 00:00:00+03:00,out,False,906680,True,1,0,14,14
166503,2019-10-03 00:00:00+03:00,out,False,906680,False,5,282,362,80
166503,2019-10-03 00:00:00+03:00,in,False,-1,True,10,0,232,232
166503,2019-10-04 00:00:00+03:00,in,False,906680,False,2,49,127,78
166503,2019-10-04 00:00:00+03:00,in,False,-1,True,1,0,11,11
166503,2019-10-04 00:00:00+03:00,out,False,906680,False,1,42,54,12
166503,2019-10-04 00:00:00+03:00,in,False,906680,False,2,49,127,78
166503,2019-10-05 00:00:00+03:00,in,False,906680,False,1,60,106,46
166503,2019-10-06 00:00:00+03:00,in,False,-1,True,1,0,77,77
166503,2019-10-07 00:00:00+03:00,in,False,906680,False,1,26,61,35
166503,2019-10-08 00:00:00+03:00,out,False,906680,False,2,108,136,28
166503,2019-10-08 00:00:00+03:00,out,False,884412,True,2,0,0,0
166503,2019-10-08 00:00:00+03:00,out,True,884412,True,1,0,1,1
166503,2019-10-08 00:00:00+03:00,in,False,906680,False,1,127,174,47
166503,2019-10-09 00:00:00+03:00,in,False,-1,True,11,0,97,97
166503,2019-10-09 00:00:00+03:00,in,False,-1,True,6,0,418,418
166503,2019-10-09 00:00:00+03:00,in,False,-1,False,1,374,405,31
166503,2019-10-09 00:00:00+03:00,in,False,884412,False,2,492,547,55
166503,2019-10-09 00:00:00+03:00,out,True,906680,False,2,431,462,31
166503,2019-10-09 00:00:00+03:00,out,False,906680,True,6,0,96,96
166503,2019-10-09 00:00:00+03:00,out,False,884412,True,1,0,40,40
166503,2019-10-09 00:00:00+03:00,in,True,906680,False,2,42,70,28
166503,2019-10-09 00:00:00+03:00,in,False,925106,False,2,259,343,84
166503,2019-10-09 00:00:00+03:00,out,False,906680,False,9,613,715,102
166503,2019-10-09 00:00:00+03:00,in,False,906680,False,6,379,546,167
166503,2019-10-09 00:00:00+03:00,in,True,925106,False,3,99,164,65
166503,2019-10-09 00:00:00+03:00,in,False,925106,False,2,259,343,84
166503,2019-10-10 00:00:00+03:00,out,False,884412,False,2,159,207,48
166503,2019-10-10 00:00:00+03:00,in,False,906680,False,9,488,758,270
166503,2019-10-10 00:00:00+03:00,out,True,906680,False,1,57,66,9
166503,2019-10-10 00:00:00+03:00,in,False,-1,True,3,0,166,166
166503,2019-10-11 00:00:00+03:00,out,False,906680,False,4,119,176,57
166503,2019-10-11 00:00:00+03:00,out,True,906680,False,1,392,403,11
166503,2019-10-11 00:00:00+03:00,out,False,884412,False,1,345,365,20
166503,2019-10-11 00:00:00+03:00,in,False,-1,True,1,0,76,76
166503,2019-10-11 00:00:00+03:00,out,False,884412,True,1,0,11,11
166503,2019-10-11 00:00:00+03:00,in,False,906680,False,4,585,686,101
166503,2019-10-11 00:00:00+03:00,out,False,884412,True,1,0,11,11
166503,2019-10-12 00:00:00+03:00,in,False,925106,False,1,33,59,26
166503,2019-10-12 00:00:00+03:00,in,False,-1,True,1,0,81,81
166503,2019-10-13 00:00:00+03:00,in,False,925106,False,1,49,72,23
166503,2019-10-13 00:00:00+03:00,in,False,-1,True,4,0,549,549
166503,2019-10-14 00:00:00+03:00,in,False,906680,False,1,94,128,34
166503,2019-10-14 00:00:00+03:00,out,False,884412,False,1,53,69,16
166503,2019-10-14 00:00:00+03:00,in,False,-1,True,7,0,497,497
166503,2019-10-15 00:00:00+03:00,out,False,884412,True,3,0,80,80
166503,2019-10-15 00:00:00+03:00,in,False,-1,True,5,0,292,292
166503,2019-10-15 00:00:00+03:00,in,False,906680,False,5,381,724,343
166503,2019-10-15 00:00:00+03:00,out,False,884412,False,4,265,342,77
166503,2019-10-15 00:00:00+03:00,out,False,906680,False,3,568,622,54
166503,2019-10-15 00:00:00+03:00,out,False,906680,True,1,0,17,17
166503,2019-10-16 00:00:00+03:00,in,True,925106,False,1,10,32,22
166503,2019-10-16 00:00:00+03:00,in,False,-1,True,1,0,7,7
166503,2019-10-16 00:00:00+03:00,out,False,884412,False,5,522,611,89
166503,2019-10-16 00:00:00+03:00,out,False,884412,True,2,0,54,54
166503,2019-10-16 00:00:00+03:00,in,True,906680,False,3,86,132,46
166503,2019-10-16 00:00:00+03:00,in,False,906680,False,4,324,442,118
166503,2019-10-16 00:00:00+03:00,out,False,906680,True,1,0,31,31
166503,2019-10-16 00:00:00+03:00,in,True,906680,True,1,79,93,14
166503,2019-10-16 00:00:00+03:00,out,False,906680,False,3,201,230,29
166503,2019-10-17 00:00:00+03:00,in,False,-1,True,4,0,762,762
166503,2019-10-17 00:00:00+03:00,out,False,884412,False,3,216,297,81
166503,2019-10-17 00:00:00+03:00,out,False,906680,False,7,753,855,102
166503,2019-10-17 00:00:00+03:00,in,False,906680,False,3,145,246,101
166503,2019-10-18 00:00:00+03:00,in,False,906680,False,2,108,185,77
166503,2019-10-18 00:00:00+03:00,in,False,-1,True,3,0,165,165
166503,2019-10-18 00:00:00+03:00,in,False,925106,False,1,12,45,33
166503,2019-10-18 00:00:00+03:00,out,False,906680,False,3,120,159,39
166503,2019-10-18 00:00:00+03:00,out,False,906680,False,3,120,159,39
166503,2019-10-19 00:00:00+03:00,in,False,906680,False,1,26,54,28
166503,2019-10-20 00:00:00+03:00,in,False,906680,False,1,56,106,50
166503,2019-10-20 00:00:00+03:00,in,False,-1,True,2,0,314,314
166503,2019-10-21 00:00:00+03:00,out,True,906680,False,2,121,137,16
166503,2019-10-21 00:00:00+03:00,out,False,906680,False,3,307,353,46
166503,2019-10-21 00:00:00+03:00,out,False,906680,True,1,0,47,47
166503,2019-10-21 00:00:00+03:00,in,False,906680,False,7,271,523,252
166503,2019-10-21 00:00:00+03:00,out,True,906680,True,1,0,0,0
166503,2019-10-21 00:00:00+03:00,in,False,-1,True,1,0,22,22
166503,2019-10-21 00:00:00+03:00,out,False,-1,False,2,382,397,15
166503,2019-10-21 00:00:00+03:00,in,False,-1,True,2,0,2,2
166503,2019-10-21 00:00:00+03:00,out,True,884412,False,1,244,253,9
166503,2019-10-21 00:00:00+03:00,out,False,906680,False,3,307,353,46
166503,2019-10-22 00:00:00+03:00,out,False,906680,False,2,135,170,35
166503,2019-10-22 00:00:00+03:00,in,False,906680,False,5,291,612,321
166503,2019-10-22 00:00:00+03:00,in,False,-1,True,4,0,306,306
166503,2019-10-22 00:00:00+03:00,out,False,884412,False,1,145,167,22
166503,2019-10-22 00:00:00+03:00,out,False,884412,True,1,0,53,53
166503,2019-10-23 00:00:00+03:00,in,False,-1,True,3,0,6,6
166503,2019-10-23 00:00:00+03:00,in,False,-1,True,1,0,2,2
166503,2019-10-24 00:00:00+03:00,in,False,925106,False,2,60,114,54
166503,2019-10-24 00:00:00+03:00,in,False,906680,False,3,168,249,81
166503,2019-10-24 00:00:00+03:00,out,False,906680,True,2,0,16,16
166503,2019-10-25 00:00:00+03:00,out,False,884412,True,20,0,90,90
166503,2019-10-25 00:00:00+03:00,out,False,906680,False,1,68,76,8
166503,2019-10-25 00:00:00+03:00,in,False,906680,False,1,102,146,44
166503,2019-10-25 00:00:00+03:00,out,False,884412,False,1,22,52,30
166503,2019-10-25 00:00:00+03:00,in,False,-1,True,4,0,447,447
166503,2019-10-25 00:00:00+03:00,out,False,906680,False,1,68,76,8
166503,2019-10-26 00:00:00+03:00,in,False,-1,True,1,0,115,115
166503,2019-10-26 00:00:00+03:00,in,False,906680,False,4,222,415,193
166503,2019-10-27 00:00:00+03:00,in,False,-1,True,1,0,354,354
166503,2019-10-27 00:00:00+03:00,in,False,906680,False,1,2,71,69
166503,2019-10-27 00:00:00+03:00,in,False,-1,True,1,0,354,354
166503,2019-10-28 00:00:00+03:00,in,False,906680,False,3,267,364,97
166503,2019-10-28 00:00:00+03:00,in,False,-1,True,3,0,204,204
166503,2019-10-28 00:00:00+03:00,in,False,925106,False,2,179,234,55
166503,2019-10-29 00:00:00+03:00,out,False,906680,True,1,0,15,15
166503,2019-10-29 00:00:00+03:00,in,False,884412,False,1,234,269,35
166503,2019-10-29 00:00:00+03:00,out,False,906680,False,4,320,383,63
166503,2019-10-29 00:00:00+03:00,in,False,906680,False,3,172,309,137
166503,2019-10-30 00:00:00+03:00,in,False,906680,False,2,145,213,68
166503,2019-10-30 00:00:00+03:00,out,False,906680,False,6,290,394,104
166503,2019-10-30 00:00:00+03:00,out,False,906680,True,1,0,28,28
166503,2019-10-30 00:00:00+03:00,out,False,884412,False,14,1606,1883,277
166503,2019-10-30 00:00:00+03:00,in,False,-1,True,3,0,77,77
166503,2019-10-30 00:00:00+03:00,out,False,884412,True,45,0,1278,1278
166503,2019-10-31 00:00:00+03:00,in,False,906680,False,2,84,145,61
166503,2019-10-31 00:00:00+03:00,in,False,884412,False,1,94,127,33
166503,2019-11-01 00:00:00+03:00,out,False,906680,True,1,0,6,6
166503,2019-11-01 00:00:00+03:00,in,False,906680,False,5,315,488,173
166503,2019-11-01 00:00:00+03:00,out,False,906680,False,2,86,118,32
166503,2019-11-01 00:00:00+03:00,in,False,-1,True,3,0,52,52
166503,2019-11-02 00:00:00+03:00,in,False,-1,True,3,0,206,206
166503,2019-11-03 00:00:00+03:00,in,False,-1,True,2,0,210,210
166503,2019-11-03 00:00:00+03:00,in,False,925106,False,1,81,106,25
166503,2019-11-04 00:00:00+03:00,in,False,925106,False,1,12,39,27
166503,2019-11-04 00:00:00+03:00,in,False,906680,False,4,91,284,193
166503,2019-11-04 00:00:00+03:00,in,False,-1,True,6,0,436,436
166503,2019-11-04 00:00:00+03:00,in,False,906680,False,4,91,284,193
166503,2019-11-05 00:00:00+03:00,out,False,884412,True,1,0,15,15
166503,2019-11-05 00:00:00+03:00,out,False,884412,False,5,732,857,125
166503,2019-11-05 00:00:00+03:00,in,False,906680,False,4,170,383,213
166503,2019-11-05 00:00:00+03:00,in,False,-1,True,2,0,364,364
166503,2019-11-06 00:00:00+03:00,in,False,925106,False,1,35,63,28
166503,2019-11-06 00:00:00+03:00,out,False,884412,False,3,256,316,60
166503,2019-11-06 00:00:00+03:00,in,False,906680,False,4,215,402,187
166503,2019-11-06 00:00:00+03:00,out,False,884412,True,1,0,18,18
166503,2019-11-07 00:00:00+03:00,out,False,906680,False,4,65,127,62
166503,2019-11-07 00:00:00+03:00,in,False,-1,True,2,0,18,18
166503,2019-11-07 00:00:00+03:00,out,False,906680,True,2,0,43,43
166503,2019-11-07 00:00:00+03:00,in,False,906680,False,3,126,222,96
166503,2019-11-08 00:00:00+03:00,out,False,906680,True,1,0,9,9
166503,2019-11-08 00:00:00+03:00,in,False,-1,True,2,0,23,23
166503,2019-11-08 00:00:00+03:00,in,False,906680,False,1,124,158,34
166503,2019-11-08 00:00:00+03:00,out,False,906680,False,1,49,68,19
166503,2019-11-08 00:00:00+03:00,in,False,906680,False,1,124,158,34
166503,2019-11-09 00:00:00+03:00,in,False,-1,True,1,0,68,68
166503,2019-11-09 00:00:00+03:00,in,False,906680,False,2,74,179,105
166503,2019-11-10 00:00:00+03:00,in,False,-1,True,3,0,338,338
166503,2019-11-10 00:00:00+03:00,in,False,925106,False,1,19,42,23
166503,2019-11-10 00:00:00+03:00,in,False,906680,False,1,41,86,45
166503,2019-11-11 00:00:00+03:00,in,False,906680,False,5,286,464,178
166503,2019-11-11 00:00:00+03:00,out,False,906680,False,2,349,402,53
166503,2019-11-11 00:00:00+03:00,out,False,906680,True,1,0,7,7
166503,2019-11-11 00:00:00+03:00,out,False,884412,True,1,0,17,17
166503,2019-11-11 00:00:00+03:00,in,False,-1,True,1,0,135,135
166503,2019-11-11 00:00:00+03:00,out,False,884412,True,1,0,17,17
166503,2019-11-12 00:00:00+03:00,in,False,906680,False,9,862,1173,311
166503,2019-11-12 00:00:00+03:00,in,False,884412,False,1,50,87,37
166503,2019-11-12 00:00:00+03:00,out,False,906680,False,5,542,604,62
166503,2019-11-12 00:00:00+03:00,out,False,884412,True,1,0,9,9
166503,2019-11-12 00:00:00+03:00,out,False,884412,False,2,212,255,43
166503,2019-11-12 00:00:00+03:00,in,False,-1,True,2,0,153,153
166503,2019-11-12 00:00:00+03:00,out,False,906680,True,4,0,80,80
166503,2019-11-12 00:00:00+03:00,in,False,-1,True,2,0,153,153
166503,2019-11-12 00:00:00+03:00,out,False,884412,True,1,0,9,9
166503,2019-11-13 00:00:00+03:00,in,False,906680,False,5,172,368,196
166503,2019-11-13 00:00:00+03:00,out,False,884412,False,11,1320,1513,193
166503,2019-11-13 00:00:00+03:00,out,False,906680,False,1,189,207,18
166503,2019-11-13 00:00:00+03:00,in,False,-1,True,1,0,5,5
166503,2019-11-13 00:00:00+03:00,out,False,884412,True,3,0,24,24
166503,2019-11-13 00:00:00+03:00,in,False,906680,False,5,172,368,196
166503,2019-11-13 00:00:00+03:00,in,False,-1,True,1,0,5,5
166503,2019-11-14 00:00:00+03:00,in,False,-1,True,1,0,4,4
166503,2019-11-14 00:00:00+03:00,in,False,906680,False,16,854,1509,655
166503,2019-11-14 00:00:00+03:00,out,False,906680,True,2,0,62,62
166503,2019-11-14 00:00:00+03:00,out,False,906680,False,2,150,168,18
166503,2019-11-15 00:00:00+03:00,out,False,884412,False,4,154,233,79
166503,2019-11-15 00:00:00+03:00,in,False,-1,True,1,0,101,101
166503,2019-11-15 00:00:00+03:00,in,False,906680,False,1,38,73,35
166503,2019-11-16 00:00:00+03:00,in,False,906680,False,2,93,178,85
166503,2019-11-17 00:00:00+03:00,in,False,906680,False,1,284,325,41
166503,2019-11-17 00:00:00+03:00,in,False,-1,True,1,0,31,31
166503,2019-11-18 00:00:00+03:00,out,False,884412,False,1,224,255,31
166503,2019-11-18 00:00:00+03:00,in,False,906680,False,4,315,447,132
166503,2019-11-18 00:00:00+03:00,out,False,906680,False,2,116,140,24
166503,2019-11-18 00:00:00+03:00,out,False,906680,True,1,0,39,39
166503,2019-11-18 00:00:00+03:00,in,False,906680,False,4,315,447,132
166503,2019-11-19 00:00:00+03:00,out,False,884412,True,1,0,21,21
166503,2019-11-19 00:00:00+03:00,out,False,884412,False,4,290,362,72
166503,2019-11-19 00:00:00+03:00,in,False,-1,True,2,0,37,37
166503,2019-11-19 00:00:00+03:00,in,False,884412,False,1,72,109,37
166503,2019-11-19 00:00:00+03:00,in,False,906680,False,7,268,512,244
166503,2019-11-19 00:00:00+03:00,out,False,906680,False,1,88,101,13
166503,2019-11-20 00:00:00+03:00,in,False,906680,False,1,44,79,35
166503,2019-11-20 00:00:00+03:00,out,False,906680,True,3,0,47,47
166503,2019-11-20 00:00:00+03:00,out,False,906680,False,4,161,221,60
166503,2019-11-20 00:00:00+03:00,in,False,906680,False,1,44,79,35
166503,2019-11-21 00:00:00+03:00,out,False,884412,True,1,0,23,23
166503,2019-11-21 00:00:00+03:00,out,False,906680,False,1,38,59,21
166503,2019-11-21 00:00:00+03:00,in,False,906680,False,8,466,738,272
166503,2019-11-21 00:00:00+03:00,out,False,884412,False,3,173,224,51
166503,2019-11-21 00:00:00+03:00,in,False,-1,True,3,0,48,48
166503,2019-11-21 00:00:00+03:00,out,False,906680,True,1,0,8,8
166503,2019-11-21 00:00:00+03:00,out,False,884412,True,1,0,23,23
166503,2019-11-22 00:00:00+03:00,out,False,906680,False,4,154,222,68
166503,2019-11-22 00:00:00+03:00,in,False,-1,True,3,0,79,79
166503,2019-11-22 00:00:00+03:00,in,False,906680,False,8,377,657,280
166503,2019-11-22 00:00:00+03:00,in,False,884412,False,1,29,63,34
166503,2019-11-22 00:00:00+03:00,out,False,884412,False,1,113,132,19
166503,2019-11-23 00:00:00+03:00,in,False,-1,True,2,0,29,29
166503,2019-11-23 00:00:00+03:00,in,False,906680,False,4,137,312,175
166503,2019-11-24 00:00:00+03:00,in,False,-1,True,8,0,758,758
166503,2019-11-24 00:00:00+03:00,in,False,925106,False,2,93,145,52
166503,2019-11-24 00:00:00+03:00,in,False,906680,False,1,50,83,33
166503,2019-11-25 00:00:00+03:00,in,False,906680,False,6,412,627,215
166503,2019-11-25 00:00:00+03:00,out,False,884412,True,1,0,51,51
166503,2019-11-25 00:00:00+03:00,out,False,884412,False,1,62,94,32
166503,2019-11-25 00:00:00+03:00,in,False,-1,True,3,0,34,34
166503,2019-11-26 00:00:00+03:00,in,True,906680,False,1,9,37,28
166503,2019-11-26 00:00:00+03:00,out,False,906680,True,2,0,6,6
166503,2019-11-26 00:00:00+03:00,in,False,906680,False,3,184,286,102
166503,2019-11-27 00:00:00+03:00,in,False,906680,False,3,364,470,106
166503,2019-11-27 00:00:00+03:00,in,False,925106,False,1,20,45,25
166503,2019-11-27 00:00:00+03:00,in,False,884412,False,1,16,53,37
166503,2019-11-28 00:00:00+03:00,in,False,-1,True,1,0,6,6
166503,2019-11-28 00:00:00+03:00,out,False,884412,False,1,44,63,19
166503,2019-11-28 00:00:00+03:00,in,False,906680,False,1,38,75,37
166503,2019-11-28 00:00:00+03:00,in,False,884412,False,2,136,381,245
166503,2019-11-28 00:00:00+03:00,in,False,925106,False,1,73,97,24
166507,2019-08-07 00:00:00+03:00,out,False,883018,True,2,0,15,15
166507,2019-08-07 00:00:00+03:00,in,False,-1,True,1,0,2,2
166507,2019-08-07 00:00:00+03:00,out,False,883898,False,1,70,80,10
166511,2019-08-20 00:00:00+03:00,out,False,891410,True,1,0,8,8
166511,2019-08-20 00:00:00+03:00,out,True,891410,True,1,0,0,0
166511,2019-08-20 00:00:00+03:00,in,False,-1,True,1,0,2,2
166511,2019-08-20 00:00:00+03:00,out,False,891410,False,2,37,65,28
166511,2019-08-21 00:00:00+03:00,out,False,891416,True,1,0,8,8
166511,2019-08-21 00:00:00+03:00,in,False,-1,True,17,0,133,133
166511,2019-08-21 00:00:00+03:00,out,False,891414,True,1,0,7,7
166511,2019-08-21 00:00:00+03:00,out,True,891414,False,1,11,13,2
166511,2019-08-21 00:00:00+03:00,out,True,891410,False,2,21,30,9
166511,2019-08-21 00:00:00+03:00,in,False,891410,False,4,73,126,53
166511,2019-08-21 00:00:00+03:00,in,False,891414,False,1,15,36,21
166511,2019-08-21 00:00:00+03:00,out,False,891410,True,5,0,44,44
166511,2019-08-21 00:00:00+03:00,out,False,891410,False,4,1338,1364,26
166511,2019-08-21 00:00:00+03:00,in,False,891414,False,1,15,36,21
166511,2019-08-21 00:00:00+03:00,in,False,891410,False,4,73,126,53
166511,2019-08-22 00:00:00+03:00,out,False,891410,True,1,0,2,2
166511,2019-08-22 00:00:00+03:00,out,True,891410,True,2,0,0,0
166511,2019-08-22 00:00:00+03:00,in,False,891410,False,2,31,77,46
166511,2019-08-22 00:00:00+03:00,out,False,891410,False,9,969,1049,80
166511,2019-08-23 00:00:00+03:00,in,False,891410,False,8,190,330,140
166511,2019-08-23 00:00:00+03:00,in,False,-1,True,7,0,114,114
166511,2019-08-23 00:00:00+03:00,out,True,891414,True,2,0,4,4
166511,2019-08-23 00:00:00+03:00,out,False,891414,False,4,185,204,19
166511,2019-08-23 00:00:00+03:00,in,False,891414,False,1,11,46,35
166511,2019-08-23 00:00:00+03:00,out,True,891410,True,1,0,5,5
166511,2019-08-23 00:00:00+03:00,out,False,891410,True,16,0,241,241
166511,2019-08-23 00:00:00+03:00,out,False,891410,False,16,2351,2461,110
166511,2019-08-23 00:00:00+03:00,out,False,891414,True,1,0,10,10
166511,2019-08-23 00:00:00+03:00,out,False,891410,True,16,0,241,241
166511,2019-08-23 00:00:00+03:00,out,False,891414,False,4,185,204,19
166511,2019-08-26 00:00:00+03:00,out,False,891414,False,13,1586,1656,70
166511,2019-08-26 00:00:00+03:00,out,False,891414,True,3,0,36,36
166511,2019-08-26 00:00:00+03:00,out,True,891410,True,1,0,0,0
166511,2019-08-26 00:00:00+03:00,in,False,891410,False,1,20,58,38
166511,2019-08-26 00:00:00+03:00,out,False,891410,False,9,423,462,39
166511,2019-08-26 00:00:00+03:00,in,False,-1,True,7,0,113,113
166511,2019-08-26 00:00:00+03:00,out,True,891414,False,1,3,6,3
166511,2019-08-26 00:00:00+03:00,out,False,891410,True,3,0,18,18
166511,2019-08-26 00:00:00+03:00,out,True,891414,True,1,0,0,0
166511,2019-08-26 00:00:00+03:00,out,False,891410,False,9,423,462,39
166511,2019-08-27 00:00:00+03:00,out,False,891414,False,14,952,1063,111
166511,2019-08-27 00:00:00+03:00,out,False,891410,False,18,1891,2064,173
166511,2019-08-27 00:00:00+03:00,in,False,-1,True,1,0,16,16
166511,2019-08-27 00:00:00+03:00,out,True,891410,True,2,0,0,0
166511,2019-08-27 00:00:00+03:00,out,False,891414,True,7,0,8,8
166511,2019-08-27 00:00:00+03:00,in,False,891410,False,3,27,89,62
166511,2019-08-27 00:00:00+03:00,out,False,891410,True,15,0,300,300
166511,2019-08-27 00:00:00+03:00,in,False,-1,True,1,0,16,16
166511,2019-08-28 00:00:00+03:00,out,False,891410,False,18,3233,3346,113
166511,2019-08-28 00:00:00+03:00,out,True,891410,True,1,0,0,0
166511,2019-08-28 00:00:00+03:00,in,False,-1,True,5,0,86,86
166511,2019-08-28 00:00:00+03:00,in,False,891414,False,1,9,15,6
166511,2019-08-28 00:00:00+03:00,in,False,891410,False,7,59,159,100
166511,2019-08-28 00:00:00+03:00,out,False,891414,True,9,0,103,103
166511,2019-08-28 00:00:00+03:00,out,False,891414,False,8,572,631,59
166511,2019-08-28 00:00:00+03:00,out,False,891410,True,4,0,11,11
166511,2019-08-28 00:00:00+03:00,out,True,891414,True,4,0,4,4
166511,2019-08-29 00:00:00+03:00,out,False,891410,True,12,0,157,157
166511,2019-08-29 00:00:00+03:00,out,False,891410,False,17,1642,1786,144
166511,2019-08-29 00:00:00+03:00,in,False,891410,False,1,8,24,16
166511,2019-08-29 00:00:00+03:00,out,True,891410,True,1,0,0,0
166511,2019-08-30 00:00:00+03:00,out,False,891414,False,1,44,46,2
166511,2019-08-30 00:00:00+03:00,out,False,891410,True,9,0,11,11
166511,2019-08-30 00:00:00+03:00,out,False,891410,False,18,2643,2778,135
166511,2019-09-02 00:00:00+03:00,out,False,891410,True,18,0,51,51
166511,2019-09-02 00:00:00+03:00,in,False,891410,False,1,10,20,10
166511,2019-09-02 00:00:00+03:00,out,False,891410,False,18,1208,1321,113
166511,2019-09-02 00:00:00+03:00,out,True,891410,True,2,0,4,4
166511,2019-09-02 00:00:00+03:00,out,False,891410,False,18,1208,1321,113
166511,2019-09-03 00:00:00+03:00,out,False,891414,False,5,657,694,37
166511,2019-09-03 00:00:00+03:00,out,True,891414,True,1,0,0,0
166511,2019-09-03 00:00:00+03:00,out,False,891410,True,2,0,3,3
166511,2019-09-03 00:00:00+03:00,out,False,891410,False,20,3196,3299,103
166511,2019-09-03 00:00:00+03:00,out,False,891414,True,1,0,0,0
166511,2019-09-03 00:00:00+03:00,in,False,891410,False,8,340,430,90
166511,2019-09-03 00:00:00+03:00,out,True,891410,True,1,0,1,1
166511,2019-09-03 00:00:00+03:00,out,False,891410,True,2,0,3,3
166511,2019-09-03 00:00:00+03:00,in,False,891410,False,8,340,430,90
166511,2019-09-04 00:00:00+03:00,in,False,891410,False,1,7,15,8
166511,2019-09-04 00:00:00+03:00,out,False,891414,True,7,0,32,32
166511,2019-09-04 00:00:00+03:00,out,False,891410,False,23,1709,1862,153
166511,2019-09-04 00:00:00+03:00,out,False,891410,True,15,0,191,191
166511,2019-09-04 00:00:00+03:00,out,True,891410,True,2,0,0,0
166511,2019-09-04 00:00:00+03:00,out,False,891414,False,9,979,1032,53
166511,2019-09-04 00:00:00+03:00,out,True,891414,True,2,0,0,0
166511,2019-09-05 00:00:00+03:00,out,False,891410,False,35,2619,2878,259
166511,2019-09-05 00:00:00+03:00,out,False,891414,False,5,964,997,33
166511,2019-09-05 00:00:00+03:00,out,False,891410,True,21,0,171,171
166511,2019-09-05 00:00:00+03:00,out,False,891414,True,14,0,32,32
166511,2019-09-05 00:00:00+03:00,out,False,891416,False,1,104,108,4
166511,2019-09-05 00:00:00+03:00,out,True,891410,True,1,0,1,1
166511,2019-09-05 00:00:00+03:00,out,True,891414,True,3,0,1,1
166511,2019-09-05 00:00:00+03:00,in,False,891410,False,1,11,28,17
166511,2019-09-05 00:00:00+03:00,in,False,891410,False,1,11,28,17
166511,2019-09-05 00:00:00+03:00,out,False,891414,True,14,0,32,32
166511,2019-09-05 00:00:00+03:00,out,True,891414,True,3,0,1,1
166511,2019-09-06 00:00:00+03:00,out,False,891414,False,18,2406,2527,121
166511,2019-09-06 00:00:00+03:00,out,True,891410,True,4,0,5,5
166511,2019-09-06 00:00:00+03:00,in,False,891410,False,2,15,40,25
166511,2019-09-06 00:00:00+03:00,out,False,891416,False,5,427,459,32
166511,2019-09-06 00:00:00+03:00,out,False,891410,True,18,0,265,265
166511,2019-09-06 00:00:00+03:00,out,False,891410,False,29,3285,3531,246
166511,2019-09-06 00:00:00+03:00,out,False,891414,True,4,0,10,10
166511,2019-09-06 00:00:00+03:00,out,False,891416,True,1,0,43,43
166511,2019-09-06 00:00:00+03:00,out,True,891414,True,2,0,0,0
166511,2019-09-06 00:00:00+03:00,out,True,891416,True,1,0,0,0
166511,2019-09-09 00:00:00+03:00,out,False,891414,True,9,0,54,54
166511,2019-09-09 00:00:00+03:00,out,True,891416,True,6,0,0,0
166511,2019-09-09 00:00:00+03:00,out,True,891414,True,3,0,0,0
166511,2019-09-09 00:00:00+03:00,out,False,891416,False,7,793,847,54
166511,2019-09-09 00:00:00+03:00,out,False,891414,False,35,5798,5986,188
166511,2019-09-09 00:00:00+03:00,out,False,891410,True,9,0,167,167
166511,2019-09-09 00:00:00+03:00,out,False,891416,True,3,0,5,5
166511,2019-09-09 00:00:00+03:00,out,False,891410,False,18,2496,2662,166
166511,2019-09-09 00:00:00+03:00,out,True,891414,False,2,14,24,10
166511,2019-09-09 00:00:00+03:00,in,False,891410,False,2,30,46,16
166511,2019-09-09 00:00:00+03:00,out,False,891416,True,3,0,5,5
166511,2019-09-10 00:00:00+03:00,in,False,-1,True,5,0,54,54
166511,2019-09-10 00:00:00+03:00,in,False,891410,False,2,15,35,20
166511,2019-09-10 00:00:00+03:00,out,True,891414,False,1,10,13,3
166511,2019-09-10 00:00:00+03:00,out,False,891416,False,7,1111,1166,55
166511,2019-09-10 00:00:00+03:00,out,False,891410,False,17,4186,4341,155
166511,2019-09-10 00:00:00+03:00,out,False,891416,True,5,0,34,34
166511,2019-09-10 00:00:00+03:00,out,False,891414,True,7,0,15,15
166511,2019-09-10 00:00:00+03:00,out,False,891410,True,11,0,61,61
166511,2019-09-10 00:00:00+03:00,out,False,891414,False,15,1416,1505,89
166511,2019-09-10 00:00:00+03:00,out,True,891416,True,3,0,0,0
166511,2019-09-10 00:00:00+03:00,in,False,-1,True,5,0,54,54
166511,2019-09-11 00:00:00+03:00,out,False,891416,False,3,1104,1124,20
166511,2019-09-11 00:00:00+03:00,out,False,891414,False,17,1723,1823,100
166511,2019-09-11 00:00:00+03:00,out,False,891410,False,21,1827,1947,120
166511,2019-09-11 00:00:00+03:00,in,False,891414,False,1,10,22,12
166511,2019-09-11 00:00:00+03:00,out,False,891414,True,10,0,129,129
166511,2019-09-11 00:00:00+03:00,in,False,-1,True,2,0,63,63
166511,2019-09-11 00:00:00+03:00,out,True,891410,True,1,0,0,0
166511,2019-09-11 00:00:00+03:00,out,False,891410,True,6,0,20,20
166511,2019-09-11 00:00:00+03:00,in,False,891416,False,1,8,11,3
166511,2019-09-11 00:00:00+03:00,in,False,891410,False,4,51,106,55
166511,2019-09-12 00:00:00+03:00,out,False,891416,True,11,0,130,130
166511,2019-09-12 00:00:00+03:00,out,True,891410,True,1,0,4,4
166511,2019-09-12 00:00:00+03:00,out,True,891416,True,2,0,0,0
166511,2019-09-12 00:00:00+03:00,out,False,891416,False,7,1124,1190,66
166511,2019-09-12 00:00:00+03:00,out,False,891414,True,12,0,119,119
166511,2019-09-12 00:00:00+03:00,out,False,891410,True,1,0,1,1
166511,2019-09-12 00:00:00+03:00,out,False,891410,False,15,1675,1784,109
166511,2019-09-12 00:00:00+03:00,out,False,891414,False,21,3950,4074,124
166511,2019-09-12 00:00:00+03:00,out,True,891416,True,2,0,0,0
166511,2019-09-12 00:00:00+03:00,out,False,891410,False,15,1675,1784,109
166511,2019-09-13 00:00:00+03:00,in,False,891410,False,1,2,26,24
166511,2019-09-13 00:00:00+03:00,out,False,891414,False,15,1474,1552,78
166511,2019-09-13 00:00:00+03:00,out,True,891410,True,2,0,0,0
166511,2019-09-13 00:00:00+03:00,out,False,891416,False,8,700,816,116
166511,2019-09-13 00:00:00+03:00,in,False,-1,True,3,0,64,64
166511,2019-09-13 00:00:00+03:00,out,False,891414,True,3,0,39,39
166511,2019-09-13 00:00:00+03:00,in,False,891414,False,1,8,17,9
166511,2019-09-13 00:00:00+03:00,out,False,891410,True,14,0,164,164
166511,2019-09-13 00:00:00+03:00,out,False,891416,True,3,0,51,51
166511,2019-09-13 00:00:00+03:00,in,False,891416,False,4,43,163,120
166511,2019-09-13 00:00:00+03:00,out,False,891410,False,35,3660,3911,251
166511,2019-09-13 00:00:00+03:00,in,False,891416,False,4,43,163,120
166511,2019-09-13 00:00:00+03:00,out,False,891416,True,3,0,51,51
166511,2019-09-13 00:00:00+03:00,in,False,891414,False,1,8,17,9
166511,2019-09-16 00:00:00+03:00,out,False,891416,True,2,0,2,2
166511,2019-09-16 00:00:00+03:00,in,False,-1,True,2,0,38,38
166511,2019-09-16 00:00:00+03:00,out,False,891414,True,20,0,138,138
166511,2019-09-16 00:00:00+03:00,out,False,891416,False,1,62,67,5
166511,2019-09-16 00:00:00+03:00,out,False,891410,True,8,0,165,165
166511,2019-09-16 00:00:00+03:00,out,False,891410,False,20,3433,3596,163
166511,2019-09-16 00:00:00+03:00,out,True,891414,True,4,0,6,6
166511,2019-09-16 00:00:00+03:00,out,False,891414,False,59,5389,5736,347
166511,2019-09-17 00:00:00+03:00,in,False,-1,True,9,0,220,220
166511,2019-09-17 00:00:00+03:00,out,False,891410,True,16,0,87,87
166511,2019-09-17 00:00:00+03:00,in,False,891410,False,8,763,882,119
166511,2019-09-17 00:00:00+03:00,out,False,891416,True,4,0,17,17
166511,2019-09-17 00:00:00+03:00,out,True,891414,True,3,0,3,3
166511,2019-09-17 00:00:00+03:00,out,False,891416,False,8,1099,1163,64
166511,2019-09-17 00:00:00+03:00,out,False,891414,False,30,2384,2502,118
166511,2019-09-17 00:00:00+03:00,out,False,891414,True,8,0,7,7
166511,2019-09-17 00:00:00+03:00,out,False,891410,False,34,3633,3812,179
166511,2019-09-17 00:00:00+03:00,in,False,891416,False,2,23,40,17
166511,2019-09-17 00:00:00+03:00,out,True,891410,True,1,0,3,3
166511,2019-09-17 00:00:00+03:00,out,True,891414,False,9,216,255,39
166511,2019-09-17 00:00:00+03:00,out,True,891416,True,2,0,0,0
166511,2019-09-17 00:00:00+03:00,in,False,891414,False,2,27,53,26
166511,2019-09-17 00:00:00+03:00,in,False,891410,False,8,763,882,119
166511,2019-09-18 00:00:00+03:00,out,False,891414,True,16,0,150,150
166511,2019-09-18 00:00:00+03:00,out,False,891410,False,17,1866,2002,136
166511,2019-09-18 00:00:00+03:00,out,False,891414,False,31,3265,3442,177
166511,2019-09-18 00:00:00+03:00,out,False,-1,True,1,0,0,0
166511,2019-09-18 00:00:00+03:00,out,False,891410,True,12,0,249,249
166511,2019-09-18 00:00:00+03:00,in,False,891414,False,8,804,916,112
166511,2019-09-18 00:00:00+03:00,in,False,891410,False,9,874,1019,145
166511,2019-09-18 00:00:00+03:00,out,False,891416,True,1,0,37,37
166511,2019-09-18 00:00:00+03:00,out,True,891414,True,1,0,1,1
166511,2019-09-18 00:00:00+03:00,in,False,891416,False,1,42,87,45
166511,2019-09-18 00:00:00+03:00,out,False,891416,False,2,150,160,10
166511,2019-09-18 00:00:00+03:00,in,False,-1,True,9,0,198,198
166511,2019-09-18 00:00:00+03:00,out,False,-1,True,1,0,0,0
166511,2019-09-18 00:00:00+03:00,in,False,891416,False,1,42,87,45
166511,2019-09-19 00:00:00+03:00,in,False,891414,False,2,607,634,27
166511,2019-09-19 00:00:00+03:00,out,False,891416,True,1,0,25,25
166511,2019-09-19 00:00:00+03:00,in,False,-1,True,20,0,284,284
166511,2019-09-19 00:00:00+03:00,out,False,891414,False,11,1808,1870,62
166511,2019-09-19 00:00:00+03:00,out,False,891410,True,9,0,34,34
166511,2019-09-19 00:00:00+03:00,out,False,891416,False,2,55,80,25
166511,2019-09-19 00:00:00+03:00,out,True,891410,True,1,0,0,0
166511,2019-09-19 00:00:00+03:00,in,False,891410,False,3,304,351,47
166511,2019-09-19 00:00:00+03:00,out,False,891414,True,7,0,9,9
166511,2019-09-19 00:00:00+03:00,out,False,891410,False,18,1745,1909,164
166511,2019-09-19 00:00:00+03:00,in,False,-1,True,20,0,284,284
166511,2019-09-19 00:00:00+03:00,out,False,891410,False,18,1745,1909,164
166511,2019-09-20 00:00:00+03:00,out,False,891410,False,22,2663,2798,135
166511,2019-09-20 00:00:00+03:00,out,False,891416,True,2,0,33,33
166511,2019-09-20 00:00:00+03:00,in,False,-1,True,11,0,298,298
166511,2019-09-20 00:00:00+03:00,out,False,891416,False,3,205,238,33
166511,2019-09-20 00:00:00+03:00,out,False,891414,True,5,0,8,8
166511,2019-09-20 00:00:00+03:00,out,False,891410,True,8,0,86,86
166511,2019-09-20 00:00:00+03:00,in,False,891416,False,3,1062,1156,94
166511,2019-09-20 00:00:00+03:00,out,False,891414,False,22,3341,3481,140
166511,2019-09-20 00:00:00+03:00,out,True,891414,False,1,11,18,7
166511,2019-09-20 00:00:00+03:00,out,True,891416,True,2,0,2,2
166511,2019-09-20 00:00:00+03:00,in,False,891414,False,5,489,596,107
166511,2019-09-20 00:00:00+03:00,in,False,891410,False,6,524,614,90
166511,2019-09-23 00:00:00+03:00,out,True,891410,True,2,0,4,4
166511,2019-09-23 00:00:00+03:00,in,False,891410,False,7,2019,2138,119
166511,2019-09-23 00:00:00+03:00,in,False,891414,False,10,680,861,181
166511,2019-09-23 00:00:00+03:00,out,False,891414,True,6,0,6,6
166511,2019-09-23 00:00:00+03:00,out,False,891410,True,7,0,57,57
166511,2019-09-23 00:00:00+03:00,out,False,891416,True,4,0,4,4
166511,2019-09-23 00:00:00+03:00,out,False,891414,False,24,2400,2530,130
166511,2019-09-23 00:00:00+03:00,in,False,-1,True,4,0,194,194
166511,2019-09-23 00:00:00+03:00,out,False,891410,False,21,1563,1690,127
166511,2019-09-23 00:00:00+03:00,out,False,891416,False,5,328,372,44
166511,2019-09-23 00:00:00+03:00,out,True,891414,True,2,0,2,2
166511,2019-09-24 00:00:00+03:00,out,False,891410,False,28,5949,6198,249
166511,2019-09-24 00:00:00+03:00,in,False,-1,True,13,0,346,346
166511,2019-09-24 00:00:00+03:00,out,False,891416,True,1,0,1,1
166511,2019-09-24 00:00:00+03:00,out,False,891410,True,21,0,230,230
166511,2019-09-24 00:00:00+03:00,out,False,891414,True,6,0,7,7
166511,2019-09-24 00:00:00+03:00,in,False,891410,False,6,1068,1147,79
166511,2019-09-24 00:00:00+03:00,out,False,891414,False,39,5480,5689,209
166511,2019-09-24 00:00:00+03:00,out,False,891416,False,8,2838,2901,63
166511,2019-09-24 00:00:00+03:00,in,False,891416,False,1,25,59,34
166511,2019-09-24 00:00:00+03:00,out,True,891410,True,2,0,2,2
166511,2019-09-24 00:00:00+03:00,in,False,891414,False,14,2410,2661,251
166511,2019-09-24 00:00:00+03:00,out,False,891414,True,6,0,7,7
166511,2019-09-24 00:00:00+03:00,out,False,891410,True,21,0,230,230
166511,2019-09-24 00:00:00+03:00,in,False,-1,True,13,0,346,346
166511,2019-09-25 00:00:00+03:00,in,False,891410,False,8,999,1092,93
166511,2019-09-25 00:00:00+03:00,in,False,891416,False,2,68,86,18
166511,2019-09-25 00:00:00+03:00,out,False,891410,False,24,2139,2301,162
166511,2019-09-25 00:00:00+03:00,in,False,-1,True,5,0,93,93
166511,2019-09-25 00:00:00+03:00,out,False,891414,True,6,0,50,50
166511,2019-09-25 00:00:00+03:00,out,False,891416,True,4,0,55,55
166511,2019-09-25 00:00:00+03:00,out,False,891414,False,30,3835,3994,159
166511,2019-09-25 00:00:00+03:00,out,True,891416,True,2,0,1,1
166511,2019-09-25 00:00:00+03:00,in,False,891414,False,8,668,790,122
166511,2019-09-25 00:00:00+03:00,out,False,891416,False,18,2312,2473,161
166511,2019-09-25 00:00:00+03:00,out,False,891410,True,12,0,104,104
166511,2019-09-25 00:00:00+03:00,out,True,891410,True,1,0,0,0
166511,2019-09-25 00:00:00+03:00,out,False,891410,False,24,2139,2301,162
166511,2019-09-26 00:00:00+03:00,in,False,-1,True,3,0,80,80
166511,2019-09-26 00:00:00+03:00,out,False,891414,True,21,0,177,177
166511,2019-09-26 00:00:00+03:00,out,False,891416,True,1,0,0,0
166511,2019-09-26 00:00:00+03:00,out,True,891410,True,2,0,6,6
166511,2019-09-26 00:00:00+03:00,in,False,891414,False,6,548,644,96
166511,2019-09-26 00:00:00+03:00,out,False,891414,False,27,4287,4449,162
166511,2019-09-26 00:00:00+03:00,out,True,891416,True,1,0,2,2
166511,2019-09-26 00:00:00+03:00,out,False,891416,False,9,706,756,50
166511,2019-09-26 00:00:00+03:00,out,True,891414,True,4,0,4,4
166511,2019-09-26 00:00:00+03:00,in,False,891410,False,3,830,871,41
166511,2019-09-26 00:00:00+03:00,out,False,891410,True,38,0,269,269
166511,2019-09-26 00:00:00+03:00,out,False,891410,False,32,4317,4546,229
166511,2019-09-26 00:00:00+03:00,in,False,891416,False,1,58,101,43
166511,2019-09-26 00:00:00+03:00,out,False,891414,False,27,4287,4449,162
166511,2019-09-26 00:00:00+03:00,out,False,891416,True,1,0,0,0
166511,2019-09-26 00:00:00+03:00,out,False,891410,False,32,4317,4546,229
166511,2019-09-26 00:00:00+03:00,in,False,-1,True,3,0,80,80
166511,2019-09-27 00:00:00+03:00,in,False,-1,True,2,0,37,37
166511,2019-09-27 00:00:00+03:00,in,False,891414,False,6,481,603,122
166511,2019-09-27 00:00:00+03:00,out,True,891414,True,2,0,1,1
166511,2019-09-27 00:00:00+03:00,out,False,891410,False,26,5226,5417,191
166511,2019-09-27 00:00:00+03:00,out,False,891410,True,11,0,18,18
166511,2019-09-27 00:00:00+03:00,out,False,891414,False,22,1643,1779,136
166511,2019-09-27 00:00:00+03:00,out,False,891416,False,1,19,31,12
166511,2019-09-27 00:00:00+03:00,in,False,891410,False,7,1660,1744,84
166511,2019-09-27 00:00:00+03:00,out,False,891414,True,17,0,53,53
166511,2019-09-27 00:00:00+03:00,in,False,891414,False,6,481,603,122
166511,2019-09-27 00:00:00+03:00,in,False,891410,False,7,1660,1744,84
166511,2019-09-28 00:00:00+03:00,out,False,891410,True,1,0,11,11
166511,2019-09-30 00:00:00+03:00,out,False,891410,True,7,0,61,61
166511,2019-09-30 00:00:00+03:00,in,False,891416,False,1,31,43,12
166511,2019-09-30 00:00:00+03:00,in,False,-1,True,10,0,285,285
166511,2019-09-30 00:00:00+03:00,out,False,891416,False,8,1030,1089,59
166511,2019-09-30 00:00:00+03:00,out,False,891414,True,13,0,17,17
166511,2019-09-30 00:00:00+03:00,out,False,891410,False,36,4455,4781,326
166511,2019-09-30 00:00:00+03:00,in,False,891410,False,13,2555,2666,111
166511,2019-09-30 00:00:00+03:00,in,False,891414,False,6,453,537,84
166511,2019-09-30 00:00:00+03:00,out,False,891416,True,3,0,3,3
166511,2019-09-30 00:00:00+03:00,out,False,891414,False,31,2951,3172,221
166511,2019-09-30 00:00:00+03:00,out,False,891416,False,8,1030,1089,59
166511,2019-10-01 00:00:00+03:00,out,False,891410,True,17,0,164,164
166511,2019-10-01 00:00:00+03:00,out,False,891414,True,6,0,15,15
166511,2019-10-01 00:00:00+03:00,in,False,-1,True,9,0,189,189
166511,2019-10-01 00:00:00+03:00,out,False,891416,True,4,0,40,40
166511,2019-10-01 00:00:00+03:00,in,False,891416,False,2,342,395,53
166511,2019-10-01 00:00:00+03:00,out,False,891410,False,35,3190,3435,245
166511,2019-10-01 00:00:00+03:00,out,False,891416,False,10,753,863,110
166511,2019-10-01 00:00:00+03:00,out,True,891410,True,6,0,3,3
166511,2019-10-01 00:00:00+03:00,in,False,891414,False,14,2954,3140,186
166511,2019-10-01 00:00:00+03:00,out,True,891414,True,1,0,0,0
166511,2019-10-01 00:00:00+03:00,in,False,891410,False,10,611,744,133
166511,2019-10-01 00:00:00+03:00,out,False,891414,False,31,4108,4275,167
166511,2019-10-01 00:00:00+03:00,out,True,891414,False,1,67,71,4
166511,2019-10-01 00:00:00+03:00,out,True,891416,True,1,0,2,2
166511,2019-10-01 00:00:00+03:00,in,False,-1,True,9,0,189,189
166511,2019-10-01 00:00:00+03:00,out,False,891410,True,17,0,164,164
166511,2019-10-01 00:00:00+03:00,out,False,891414,True,6,0,15,15
166511,2019-10-02 00:00:00+03:00,out,False,891416,False,15,1192,1359,167
166511,2019-10-02 00:00:00+03:00,out,False,891416,True,2,0,2,2
166511,2019-10-02 00:00:00+03:00,in,False,891414,False,9,1045,1153,108
166511,2019-10-02 00:00:00+03:00,out,False,891410,True,8,0,95,95
166511,2019-10-02 00:00:00+03:00,out,False,891414,True,7,0,38,38
166511,2019-10-02 00:00:00+03:00,out,True,891410,True,5,0,3,3
166511,2019-10-02 00:00:00+03:00,in,False,891410,False,11,1483,1646,163
166511,2019-10-02 00:00:00+03:00,out,False,891410,False,38,5918,6147,229
166511,2019-10-02 00:00:00+03:00,out,True,891416,True,3,0,0,0
166511,2019-10-02 00:00:00+03:00,in,False,891416,False,1,70,107,37
166511,2019-10-02 00:00:00+03:00,in,False,-1,True,9,0,268,268
166511,2019-10-02 00:00:00+03:00,out,False,891414,False,24,1650,1789,139
166511,2019-10-02 00:00:00+03:00,out,False,891414,False,24,1650,1789,139
166511,2019-10-02 00:00:00+03:00,out,True,891410,True,5,0,3,3
166511,2019-10-02 00:00:00+03:00,out,False,891414,True,7,0,38,38
166511,2019-10-03 00:00:00+03:00,out,True,891414,False,1,53,57,4
166511,2019-10-03 00:00:00+03:00,in,False,891416,False,3,172,215,43
166511,2019-10-03 00:00:00+03:00,out,False,891414,False,24,2652,2785,133
166511,2019-10-03 00:00:00+03:00,in,False,891414,False,7,997,1086,89
166511,2019-10-03 00:00:00+03:00,out,False,891416,True,1,0,2,2
166511,2019-10-03 00:00:00+03:00,out,False,891414,True,18,0,86,86
166511,2019-10-03 00:00:00+03:00,in,False,-1,True,6,0,201,201
166511,2019-10-03 00:00:00+03:00,out,True,891416,True,1,0,2,2
166511,2019-10-03 00:00:00+03:00,out,True,891414,True,2,0,2,2
166511,2019-10-03 00:00:00+03:00,out,False,891416,False,14,3736,3890,154
166511,2019-10-03 00:00:00+03:00,out,False,891410,False,31,3118,3354,236
166511,2019-10-03 00:00:00+03:00,out,False,891410,True,8,0,70,70
166511,2019-10-03 00:00:00+03:00,in,False,891410,False,9,855,1001,146
166511,2019-10-03 00:00:00+03:00,in,False,891416,False,3,172,215,43
166511,2019-10-04 00:00:00+03:00,out,False,891414,False,25,2699,2906,207
166511,2019-10-04 00:00:00+03:00,out,False,891416,False,6,616,660,44
166511,2019-10-04 00:00:00+03:00,in,False,891410,False,8,2166,2286,120
166511,2019-10-04 00:00:00+03:00,out,True,891414,True,1,0,0,0
166511,2019-10-04 00:00:00+03:00,out,False,891414,True,16,0,53,53
166511,2019-10-04 00:00:00+03:00,in,False,891414,False,6,768,840,72
166511,2019-10-04 00:00:00+03:00,out,False,891410,False,20,1497,1674,177
166511,2019-10-04 00:00:00+03:00,out,False,891410,True,10,0,107,107
166511,2019-10-04 00:00:00+03:00,in,False,-1,True,10,0,116,116
166511,2019-10-04 00:00:00+03:00,in,False,891416,False,2,403,431,28
166511,2019-10-04 00:00:00+03:00,out,False,891416,True,2,0,5,5
166511,2019-10-04 00:00:00+03:00,out,False,891416,False,6,616,660,44
166511,2019-10-06 00:00:00+03:00,out,False,891410,False,6,290,360,70
166511,2019-10-06 00:00:00+03:00,out,False,891410,True,2,0,28,28
166511,2019-10-07 00:00:00+03:00,in,False,891414,False,8,1087,1226,139
166511,2019-10-07 00:00:00+03:00,out,False,891416,True,6,0,65,65
166511,2019-10-07 00:00:00+03:00,out,True,891414,True,3,0,1,1
166511,2019-10-07 00:00:00+03:00,out,False,891414,False,29,3438,3616,178
166511,2019-10-07 00:00:00+03:00,out,False,891414,True,6,0,132,132
166511,2019-10-07 00:00:00+03:00,in,False,-1,True,6,0,135,135
166511,2019-10-07 00:00:00+03:00,in,False,891410,False,7,1492,1589,97
166511,2019-10-07 00:00:00+03:00,out,True,891416,True,1,0,1,1
166511,2019-10-07 00:00:00+03:00,out,False,891410,False,25,1994,2284,290
166511,2019-10-07 00:00:00+03:00,out,False,891410,True,5,0,55,55
166511,2019-10-07 00:00:00+03:00,in,False,891416,False,1,97,104,7
166511,2019-10-07 00:00:00+03:00,out,False,891416,False,24,2443,2620,177
166511,2019-10-08 00:00:00+03:00,out,False,891416,True,10,0,127,127
166511,2019-10-08 00:00:00+03:00,out,False,891416,False,12,1898,2010,112
166511,2019-10-08 00:00:00+03:00,in,False,891414,False,20,3833,4095,262
166511,2019-10-08 00:00:00+03:00,out,True,891414,True,3,0,2,2
166511,2019-10-08 00:00:00+03:00,in,False,891416,False,1,25,51,26
166511,2019-10-08 00:00:00+03:00,out,False,891410,False,28,3083,3251,168
166511,2019-10-08 00:00:00+03:00,out,True,891416,True,2,0,5,5
166511,2019-10-08 00:00:00+03:00,out,False,891410,True,17,0,132,132
166511,2019-10-08 00:00:00+03:00,in,False,-1,True,17,0,586,586
166511,2019-10-08 00:00:00+03:00,in,False,891410,False,12,2092,2262,170
166511,2019-10-08 00:00:00+03:00,out,False,891414,True,27,0,160,160
166511,2019-10-08 00:00:00+03:00,out,False,891414,False,35,3976,4201,225
166511,2019-10-08 00:00:00+03:00,out,True,891410,True,1,0,1,1
166511,2019-10-09 00:00:00+03:00,in,False,891416,False,2,148,188,40
166511,2019-10-09 00:00:00+03:00,out,True,891414,True,3,0,1,1
166511,2019-10-09 00:00:00+03:00,in,False,891414,False,8,2052,2157,105
166511,2019-10-09 00:00:00+03:00,out,True,891416,True,3,0,1,1
166511,2019-10-09 00:00:00+03:00,out,True,891414,False,1,29,35,6
166511,2019-10-09 00:00:00+03:00,out,True,891410,True,2,0,4,4
166511,2019-10-09 00:00:00+03:00,in,False,-1,True,4,0,101,101
166511,2019-10-09 00:00:00+03:00,in,False,891410,False,7,1461,1553,92
166511,2019-10-09 00:00:00+03:00,out,False,891416,True,15,0,6,6
166511,2019-10-09 00:00:00+03:00,out,False,891410,True,19,0,84,84
166511,2019-10-09 00:00:00+03:00,out,False,891410,False,11,1357,1447,90
166511,2019-10-09 00:00:00+03:00,out,False,891414,False,16,1600,1711,111
166511,2019-10-09 00:00:00+03:00,out,False,891414,True,30,0,21,21
166511,2019-10-09 00:00:00+03:00,out,False,891416,False,9,700,749,49
166511,2019-10-10 00:00:00+03:00,out,False,891410,False,44,4582,5043,461
166511,2019-10-10 00:00:00+03:00,out,False,891416,True,6,0,26,26
166511,2019-10-10 00:00:00+03:00,in,False,-1,True,5,0,167,167
166511,2019-10-10 00:00:00+03:00,out,True,891414,True,3,0,5,5
166511,2019-10-10 00:00:00+03:00,out,False,891414,False,23,5281,5401,120
166511,2019-10-10 00:00:00+03:00,in,False,891414,False,2,147,177,30
166511,2019-10-10 00:00:00+03:00,in,False,891410,False,11,1057,1211,154
166511,2019-10-10 00:00:00+03:00,in,False,891416,False,4,339,418,79
166511,2019-10-10 00:00:00+03:00,out,False,891410,True,31,0,572,572
166511,2019-10-10 00:00:00+03:00,out,False,891414,True,15,0,137,137
166511,2019-10-10 00:00:00+03:00,out,True,891416,True,4,0,0,0
166511,2019-10-10 00:00:00+03:00,out,False,891416,False,13,1424,1499,75
166511,2019-10-10 00:00:00+03:00,in,False,891414,False,2,147,177,30
166511,2019-10-11 00:00:00+03:00,in,False,891410,False,11,1192,1391,199
166511,2019-10-11 00:00:00+03:00,out,False,891416,True,3,0,13,13
166511,2019-10-11 00:00:00+03:00,out,False,891414,True,10,0,70,70
166511,2019-10-11 00:00:00+03:00,out,False,891416,False,21,772,1008,236
166511,2019-10-11 00:00:00+03:00,out,True,891416,True,2,0,0,0
166511,2019-10-11 00:00:00+03:00,in,False,891414,False,15,5894,6060,166
166511,2019-10-11 00:00:00+03:00,out,True,891410,True,1,0,2,2
166511,2019-10-11 00:00:00+03:00,out,False,891414,False,27,4218,4396,178
166511,2019-10-11 00:00:00+03:00,in,False,-1,True,17,0,451,451
166511,2019-10-11 00:00:00+03:00,out,False,891410,True,11,0,139,139
166511,2019-10-11 00:00:00+03:00,out,False,891410,False,41,5732,6061,329
166511,2019-10-11 00:00:00+03:00,out,True,891414,True,6,0,62,62
166511,2019-10-11 00:00:00+03:00,in,False,891416,False,11,736,892,156
166511,2019-10-11 00:00:00+03:00,out,True,891416,True,2,0,0,0
166511,2019-10-11 00:00:00+03:00,out,False,891414,False,27,4218,4396,178
166511,2019-10-13 00:00:00+03:00,out,False,891414,True,5,0,58,58
166511,2019-10-14 00:00:00+03:00,out,False,891410,False,25,3114,3277,163
166511,2019-10-14 00:00:00+03:00,out,True,891416,True,1,0,0,0
166511,2019-10-14 00:00:00+03:00,in,False,-1,True,5,0,123,123
166511,2019-10-14 00:00:00+03:00,in,False,891416,False,5,518,590,72
166511,2019-10-14 00:00:00+03:00,out,False,891416,True,2,0,3,3
166511,2019-10-14 00:00:00+03:00,in,False,891414,False,13,1138,1243,105
166511,2019-10-14 00:00:00+03:00,out,True,891410,True,2,0,0,0
166511,2019-10-14 00:00:00+03:00,in,False,891410,False,16,1873,2094,221
166511,2019-10-14 00:00:00+03:00,out,True,891414,True,6,0,5,5
166511,2019-10-14 00:00:00+03:00,out,False,891414,False,32,3836,4076,240
166511,2019-10-14 00:00:00+03:00,out,False,891410,True,23,0,362,362
166511,2019-10-14 00:00:00+03:00,out,False,891416,False,12,2914,3011,97
166511,2019-10-14 00:00:00+03:00,out,False,891414,True,37,0,145,145
166511,2019-10-14 00:00:00+03:00,out,False,891414,False,32,3836,4076,240
166511,2019-10-14 00:00:00+03:00,out,False,891410,True,23,0,362,362
166511,2019-10-15 00:00:00+03:00,in,False,891414,False,18,1929,2193,264
166511,2019-10-15 00:00:00+03:00,out,False,891410,True,2,0,31,31
166511,2019-10-15 00:00:00+03:00,out,False,891414,False,45,4618,5037,419
166511,2019-10-15 00:00:00+03:00,in,False,891410,False,6,454,545,91
166511,2019-10-15 00:00:00+03:00,out,False,891416,True,8,0,36,36
166511,2019-10-15 00:00:00+03:00,in,False,891416,False,1,93,102,9
166511,2019-10-15 00:00:00+03:00,out,False,891414,True,22,0,70,70
166511,2019-10-15 00:00:00+03:00,out,False,891416,False,9,1581,1656,75
166511,2019-10-15 00:00:00+03:00,out,False,891410,False,15,1500,1600,100
166511,2019-10-15 00:00:00+03:00,out,True,891414,True,1,0,3,3
166511,2019-10-15 00:00:00+03:00,out,True,891416,True,1,0,0,0
166511,2019-10-15 00:00:00+03:00,in,False,-1,True,9,0,238,238
166511,2019-10-15 00:00:00+03:00,out,True,891416,True,1,0,0,0
166511,2019-10-16 00:00:00+03:00,in,False,-1,True,16,0,260,260
166511,2019-10-16 00:00:00+03:00,in,False,891414,False,10,1397,1477,80
166511,2019-10-16 00:00:00+03:00,out,False,891410,True,22,0,329,329
166511,2019-10-16 00:00:00+03:00,out,False,891414,True,3,0,56,56
166511,2019-10-16 00:00:00+03:00,out,True,891416,True,1,0,0,0
166511,2019-10-16 00:00:00+03:00,in,False,891410,False,15,2324,2555,231
166511,2019-10-16 00:00:00+03:00,out,False,891410,False,22,1905,2117,212
166511,2019-10-16 00:00:00+03:00,out,False,891416,True,1,0,25,25
166511,2019-10-16 00:00:00+03:00,out,False,891414,False,16,1539,1683,144
166511,2019-10-16 00:00:00+03:00,out,False,891416,False,6,974,1022,48
166511,2019-10-16 00:00:00+03:00,out,True,891410,True,3,0,0,0
166511,2019-10-16 00:00:00+03:00,out,True,891410,True,3,0,0,0
166511,2019-10-17 00:00:00+03:00,out,False,891416,True,7,0,64,64
166511,2019-10-17 00:00:00+03:00,in,False,891416,False,9,1574,1674,100
166511,2019-10-17 00:00:00+03:00,out,False,891414,True,13,0,80,80
166511,2019-10-17 00:00:00+03:00,out,True,891410,True,2,0,0,0
166511,2019-10-17 00:00:00+03:00,out,False,891416,False,9,366,448,82
166511,2019-10-17 00:00:00+03:00,out,False,891410,False,34,3561,3780,219
166511,2019-10-17 00:00:00+03:00,out,False,891410,True,21,0,193,193
166511,2019-10-17 00:00:00+03:00,out,False,891414,False,32,2959,3169,210
166511,2019-10-17 00:00:00+03:00,in,False,891414,False,15,2417,2574,157
166511,2019-10-17 00:00:00+03:00,in,False,891410,False,15,2291,2512,221
166511,2019-10-17 00:00:00+03:00,in,False,-1,True,13,0,402,402
166511,2019-10-17 00:00:00+03:00,out,False,891414,True,13,0,80,80
166511,2019-10-18 00:00:00+03:00,out,False,891410,True,7,0,69,69
166511,2019-10-18 00:00:00+03:00,out,False,891416,False,5,352,386,34
166511,2019-10-18 00:00:00+03:00,in,False,891416,False,2,264,324,60
166511,2019-10-18 00:00:00+03:00,in,False,891410,False,7,821,949,128
166511,2019-10-18 00:00:00+03:00,in,False,-1,True,6,0,201,201
166511,2019-10-18 00:00:00+03:00,out,False,891410,False,32,2883,3131,248
166511,2019-10-18 00:00:00+03:00,out,False,891414,False,23,1352,1527,175
166511,2019-10-18 00:00:00+03:00,out,False,891414,True,1,0,6,6
166511,2019-10-18 00:00:00+03:00,out,False,891416,True,1,0,17,17
166511,2019-10-18 00:00:00+03:00,in,False,891414,False,6,830,893,63
166511,2019-10-21 00:00:00+03:00,out,False,891410,False,32,3767,4137,370
166511,2019-10-21 00:00:00+03:00,in,False,891414,False,15,2104,2285,181
166511,2019-10-21 00:00:00+03:00,in,False,891410,True,1,0,6,6
166511,2019-10-21 00:00:00+03:00,out,False,891416,False,1,174,181,7
166511,2019-10-21 00:00:00+03:00,out,False,891414,False,46,4281,4569,288
166511,2019-10-21 00:00:00+03:00,out,False,891410,True,13,0,153,153
166511,2019-10-21 00:00:00+03:00,out,False,891414,True,18,0,99,99
166511,2019-10-21 00:00:00+03:00,in,False,891416,False,1,204,214,10
166511,2019-10-21 00:00:00+03:00,out,True,891410,True,1,0,0,0
166511,2019-10-21 00:00:00+03:00,out,True,891414,True,2,0,0,0
166511,2019-10-21 00:00:00+03:00,in,False,891410,False,13,1174,1324,150
166511,2019-10-21 00:00:00+03:00,in,False,-1,True,23,0,657,657
166511,2019-10-21 00:00:00+03:00,out,True,891414,True,2,0,0,0
166511,2019-10-22 00:00:00+03:00,out,False,891416,True,9,0,156,156
166511,2019-10-22 00:00:00+03:00,in,False,-1,True,13,0,324,324
166511,2019-10-22 00:00:00+03:00,out,True,891416,True,2,0,0,0
166511,2019-10-22 00:00:00+03:00,in,False,891416,False,1,60,90,30
166511,2019-10-22 00:00:00+03:00,out,False,891414,True,10,0,9,9
166511,2019-10-22 00:00:00+03:00,in,False,891410,False,9,946,1047,101
166511,2019-10-22 00:00:00+03:00,out,False,891414,False,28,3048,3233,185
166511,2019-10-22 00:00:00+03:00,out,False,891410,True,14,0,407,407
166511,2019-10-22 00:00:00+03:00,out,True,891410,True,1,0,0,0
166511,2019-10-22 00:00:00+03:00,out,False,891416,False,14,2163,2293,130
166511,2019-10-22 00:00:00+03:00,in,False,891414,True,1,0,15,15
166511,2019-10-22 00:00:00+03:00,in,False,891414,False,12,2572,2737,165
166511,2019-10-22 00:00:00+03:00,out,False,891410,False,42,8217,8633,416
166511,2019-10-22 00:00:00+03:00,out,False,891414,True,10,0,9,9
166511,2019-10-22 00:00:00+03:00,out,True,891416,True,2,0,0,0
166511,2019-10-22 00:00:00+03:00,out,True,891410,True,1,0,0,0
166511,2019-10-22 00:00:00+03:00,out,False,891410,True,14,0,407,407
166511,2019-10-23 00:00:00+03:00,in,False,-1,True,7,0,133,133
166511,2019-10-23 00:00:00+03:00,in,False,891410,False,13,1292,1449,157
166511,2019-10-23 00:00:00+03:00,out,False,891416,False,3,674,701,27
166511,2019-10-23 00:00:00+03:00,out,False,891414,True,17,0,156,156
166511,2019-10-23 00:00:00+03:00,in,False,891414,False,9,1182,1292,110
166511,2019-10-23 00:00:00+03:00,out,False,891410,True,10,0,97,97
166511,2019-10-23 00:00:00+03:00,out,False,891410,False,20,1715,1885,170
166511,2019-10-23 00:00:00+03:00,out,False,891414,False,22,2630,2803,173
166511,2019-10-23 00:00:00+03:00,out,False,891416,True,9,0,48,48
166511,2019-10-23 00:00:00+03:00,in,False,891416,False,3,260,302,42
166511,2019-10-23 00:00:00+03:00,out,False,891414,True,17,0,156,156
166511,2019-10-24 00:00:00+03:00,out,False,891410,True,26,0,636,636
166511,2019-10-24 00:00:00+03:00,in,False,891410,False,13,4188,4350,162
166511,2019-10-24 00:00:00+03:00,out,False,891416,False,14,3833,4000,167
166511,2019-10-24 00:00:00+03:00,out,False,891410,False,20,2477,2698,221
166511,2019-10-24 00:00:00+03:00,out,False,891416,True,5,0,84,84
166511,2019-10-24 00:00:00+03:00,in,False,-1,True,11,0,279,279
166511,2019-10-24 00:00:00+03:00,out,True,891414,True,4,0,0,0
166511,2019-10-24 00:00:00+03:00,in,False,891416,False,5,1376,1467,91
166511,2019-10-24 00:00:00+03:00,out,False,891414,True,13,0,165,165
166511,2019-10-24 00:00:00+03:00,out,True,891410,True,2,0,0,0
166511,2019-10-24 00:00:00+03:00,out,False,891414,False,17,1183,1391,208
166511,2019-10-24 00:00:00+03:00,in,False,891414,False,8,1475,1554,79
166511,2019-10-24 00:00:00+03:00,out,True,891416,True,1,0,0,0
166511,2019-10-24 00:00:00+03:00,out,True,891410,True,2,0,0,0
166511,2019-10-25 00:00:00+03:00,out,True,891416,True,1,0,0,0
166511,2019-10-25 00:00:00+03:00,out,True,891414,True,6,0,0,0
166511,2019-10-25 00:00:00+03:00,out,False,891410,True,21,0,223,223
166511,2019-10-25 00:00:00+03:00,in,False,891410,False,28,3452,3749,297
166511,2019-10-25 00:00:00+03:00,out,False,891416,False,14,1794,1890,96
166511,2019-10-25 00:00:00+03:00,out,False,891414,True,14,0,110,110
166511,2019-10-25 00:00:00+03:00,in,False,891416,False,6,205,263,58
166511,2019-10-25 00:00:00+03:00,out,False,891416,True,8,0,21,21
166511,2019-10-25 00:00:00+03:00,in,False,891414,False,14,1777,1883,106
166511,2019-10-25 00:00:00+03:00,out,False,891414,False,26,2646,2826,180
166511,2019-10-25 00:00:00+03:00,out,False,891410,False,33,3452,3725,273
166511,2019-10-25 00:00:00+03:00,in,False,-1,True,24,0,507,507
166511,2019-10-28 00:00:00+03:00,out,False,891416,False,7,1238,1287,49
166511,2019-10-28 00:00:00+03:00,out,False,891414,False,23,2736,2910,174
166511,2019-10-28 00:00:00+03:00,out,False,891414,True,6,0,27,27
166511,2019-10-28 00:00:00+03:00,out,False,891416,True,2,0,31,31
166511,2019-10-28 00:00:00+03:00,out,False,891410,True,6,0,36,36
166511,2019-10-28 00:00:00+03:00,out,False,891410,False,23,5490,5662,172
166511,2019-10-28 00:00:00+03:00,out,True,891410,True,1,0,0,0
166511,2019-10-28 00:00:00+03:00,in,False,891416,False,6,1050,1158,108
166511,2019-10-28 00:00:00+03:00,in,False,891414,False,8,1652,1713,61
166511,2019-10-28 00:00:00+03:00,in,False,891410,False,13,5171,5340,169
166511,2019-10-28 00:00:00+03:00,in,False,-1,True,10,0,282,282
166511,2019-10-28 00:00:00+03:00,out,False,891414,False,23,2736,2910,174
166511,2019-10-28 00:00:00+03:00,out,False,891416,False,7,1238,1287,49
166511,2019-10-29 00:00:00+03:00,out,False,891410,True,10,0,84,84
166511,2019-10-29 00:00:00+03:00,out,False,891414,False,20,1932,2113,181
166511,2019-10-29 00:00:00+03:00,out,False,891416,False,10,791,911,120
166511,2019-10-29 00:00:00+03:00,out,False,891416,True,2,0,10,10
166511,2019-10-29 00:00:00+03:00,in,False,891410,False,11,2051,2180,129
166511,2019-10-29 00:00:00+03:00,out,True,891410,True,3,0,0,0
166511,2019-10-29 00:00:00+03:00,out,False,891414,True,9,0,149,149
166511,2019-10-29 00:00:00+03:00,in,False,891416,False,4,1724,1762,38
166511,2019-10-29 00:00:00+03:00,in,False,-1,True,12,0,320,320
166511,2019-10-29 00:00:00+03:00,out,False,891410,False,29,4082,4331,249
166511,2019-10-29 00:00:00+03:00,in,False,891414,False,2,451,466,15
166511,2019-10-30 00:00:00+03:00,in,False,891410,False,15,3082,3284,202
166511,2019-10-30 00:00:00+03:00,out,False,891414,True,12,0,31,31
166511,2019-10-30 00:00:00+03:00,in,False,-1,True,7,0,189,189
166511,2019-10-30 00:00:00+03:00,in,False,891416,False,10,771,832,61
166511,2019-10-30 00:00:00+03:00,out,False,891414,False,35,3669,3901,232
166511,2019-10-30 00:00:00+03:00,out,False,891416,False,7,1009,1092,83
166511,2019-10-30 00:00:00+03:00,out,False,891410,False,15,2970,3137,167
166511,2019-10-30 00:00:00+03:00,out,True,891416,True,1,0,0,0
166511,2019-10-30 00:00:00+03:00,out,False,891410,True,13,0,330,330
166511,2019-10-30 00:00:00+03:00,out,True,891414,True,1,0,0,0
166511,2019-10-30 00:00:00+03:00,in,False,891414,False,5,293,353,60
166511,2019-10-30 00:00:00+03:00,out,False,891416,True,11,0,123,123
166511,2019-10-30 00:00:00+03:00,in,False,891410,False,15,3082,3284,202
166511,2019-10-30 00:00:00+03:00,out,True,891416,True,1,0,0,0
166511,2019-10-31 00:00:00+03:00,out,True,891416,True,1,0,0,0
166511,2019-10-31 00:00:00+03:00,out,False,891410,True,4,0,48,48
166511,2019-10-31 00:00:00+03:00,out,False,891416,False,9,331,406,75
166511,2019-10-31 00:00:00+03:00,out,True,891414,True,1,0,0,0
166511,2019-10-31 00:00:00+03:00,out,False,891414,False,33,5863,6312,449
166511,2019-10-31 00:00:00+03:00,in,False,891410,False,11,1171,1295,124
166511,2019-10-31 00:00:00+03:00,out,False,891414,True,23,0,544,544
166511,2019-10-31 00:00:00+03:00,in,False,891416,False,3,921,963,42
166511,2019-10-31 00:00:00+03:00,out,False,891416,True,4,0,6,6
166511,2019-10-31 00:00:00+03:00,in,False,891414,False,11,2244,2356,112
166511,2019-10-31 00:00:00+03:00,out,False,891410,False,27,3436,3636,200
166511,2019-10-31 00:00:00+03:00,in,False,-1,True,6,0,179,179
166511,2019-10-31 00:00:00+03:00,out,False,891410,True,4,0,48,48
166511,2019-11-01 00:00:00+03:00,in,False,891416,False,7,1425,1492,67
166511,2019-11-01 00:00:00+03:00,in,False,-1,True,10,0,186,186
166511,2019-11-01 00:00:00+03:00,out,False,891410,False,19,1074,1199,125
166511,2019-11-01 00:00:00+03:00,out,False,891414,False,26,5009,5165,156
166511,2019-11-01 00:00:00+03:00,out,False,891410,True,4,0,107,107
166511,2019-11-01 00:00:00+03:00,out,False,891416,True,2,0,7,7
166511,2019-11-01 00:00:00+03:00,out,False,891414,True,8,0,74,74
166511,2019-11-01 00:00:00+03:00,out,True,891414,True,1,0,0,0
166511,2019-11-01 00:00:00+03:00,in,False,891414,False,16,4310,4504,194
166511,2019-11-01 00:00:00+03:00,out,False,891416,False,5,612,645,33
166511,2019-11-01 00:00:00+03:00,in,False,891410,False,9,1445,1572,127
166511,2019-11-01 00:00:00+03:00,out,False,891414,True,8,0,74,74
166511,2019-11-02 00:00:00+03:00,out,False,891410,True,1,0,0,0
166511,2019-11-04 00:00:00+03:00,out,False,891414,True,1,0,43,43
166511,2019-11-05 00:00:00+03:00,out,False,891410,False,34,4155,4365,210
166511,2019-11-05 00:00:00+03:00,in,False,891416,False,1,66,77,11
166511,2019-11-05 00:00:00+03:00,out,False,891416,False,9,493,566,73
166511,2019-11-05 00:00:00+03:00,out,False,891414,False,20,3201,3298,97
166511,2019-11-05 00:00:00+03:00,out,False,891416,True,2,0,10,10
166511,2019-11-05 00:00:00+03:00,in,False,-1,True,12,0,379,379
166511,2019-11-05 00:00:00+03:00,in,False,891414,False,8,2846,2954,108
166511,2019-11-05 00:00:00+03:00,out,False,891410,True,28,0,339,339
166511,2019-11-05 00:00:00+03:00,out,True,891414,True,1,0,0,0
166511,2019-11-05 00:00:00+03:00,in,False,891410,False,22,3343,3611,268
166511,2019-11-05 00:00:00+03:00,out,False,891414,True,15,0,52,52
166511,2019-11-05 00:00:00+03:00,out,False,891416,False,9,493,566,73
166511,2019-11-05 00:00:00+03:00,out,False,891414,True,15,0,52,52
166511,2019-11-06 00:00:00+03:00,out,False,891410,True,29,0,213,213
166511,2019-11-06 00:00:00+03:00,out,False,891414,True,14,0,102,102
166511,2019-11-06 00:00:00+03:00,in,False,891416,False,2,343,385,42
166511,2019-11-06 00:00:00+03:00,in,False,891410,False,21,3346,3570,224
166511,2019-11-06 00:00:00+03:00,out,False,891416,True,4,0,84,84
166511,2019-11-06 00:00:00+03:00,out,False,891414,False,29,5384,5590,206
166511,2019-11-06 00:00:00+03:00,out,True,891414,True,1,0,0,0
166511,2019-11-06 00:00:00+03:00,out,False,891416,False,9,2623,2694,71
166511,2019-11-06 00:00:00+03:00,out,False,891410,False,31,4331,4640,309
166511,2019-11-06 00:00:00+03:00,in,False,891414,False,14,1197,1378,181
166511,2019-11-06 00:00:00+03:00,in,False,-1,True,15,0,376,376
166511,2019-11-06 00:00:00+03:00,out,False,891414,False,29,5384,5590,206
166511,2019-11-06 00:00:00+03:00,in,False,891416,False,2,343,385,42
166511,2019-11-07 00:00:00+03:00,in,False,891410,False,21,3850,4120,270
166511,2019-11-07 00:00:00+03:00,out,False,891410,True,23,0,276,276
166511,2019-11-07 00:00:00+03:00,out,True,891410,True,1,0,0,0
166511,2019-11-07 00:00:00+03:00,out,False,891416,True,25,0,266,266
166511,2019-11-07 00:00:00+03:00,out,False,891414,True,8,0,13,13
166511,2019-11-07 00:00:00+03:00,in,False,891416,False,3,360,384,24
166511,2019-11-07 00:00:00+03:00,in,False,-1,True,12,0,267,267
166511,2019-11-07 00:00:00+03:00,in,False,891410,True,1,1,16,15
166511,2019-11-07 00:00:00+03:00,out,False,891410,False,23,2388,2563,175
166511,2019-11-07 00:00:00+03:00,out,False,891414,False,20,2540,2683,143
166511,2019-11-07 00:00:00+03:00,out,False,891416,False,14,1847,1999,152
166511,2019-11-07 00:00:00+03:00,in,False,891414,False,24,4128,4395,267
166511,2019-11-07 00:00:00+03:00,out,True,891414,True,2,0,0,0
166511,2019-11-07 00:00:00+03:00,in,False,-1,True,12,0,267,267
166511,2019-11-08 00:00:00+03:00,out,True,891410,True,1,0,0,0
166511,2019-11-08 00:00:00+03:00,out,False,891414,False,30,2544,2725,181
166511,2019-11-08 00:00:00+03:00,out,False,891410,True,12,0,115,115
166511,2019-11-08 00:00:00+03:00,out,False,891416,True,1,0,36,36
166511,2019-11-08 00:00:00+03:00,out,False,891416,False,2,186,208,22
166511,2019-11-08 00:00:00+03:00,in,False,-1,True,14,0,347,347
166511,2019-11-08 00:00:00+03:00,in,False,891410,False,17,2971,3165,194
166511,2019-11-08 00:00:00+03:00,in,False,891416,False,2,566,579,13
166511,2019-11-08 00:00:00+03:00,out,False,891414,True,3,0,6,6
166511,2019-11-08 00:00:00+03:00,out,False,891410,False,28,5199,5426,227
166511,2019-11-08 00:00:00+03:00,in,False,891414,False,10,1842,1915,73
166511,2019-11-08 00:00:00+03:00,out,False,891410,False,28,5199,5426,227
166511,2019-11-09 00:00:00+03:00,in,False,891414,False,1,122,129,7
166511,2019-11-09 00:00:00+03:00,in,False,-1,True,2,0,67,67
166511,2019-11-09 00:00:00+03:00,out,False,891414,False,3,489,505,16
166511,2019-11-10 00:00:00+03:00,out,False,891414,True,1,0,60,60
166511,2019-11-11 00:00:00+03:00,in,False,891414,False,9,3942,4030,88
166511,2019-11-11 00:00:00+03:00,out,True,891410,True,1,0,0,0
166511,2019-11-11 00:00:00+03:00,out,False,891414,False,13,2290,2371,81
166511,2019-11-11 00:00:00+03:00,in,False,891410,False,12,1647,1810,163
166511,2019-11-11 00:00:00+03:00,out,False,891416,False,2,32,56,24
166511,2019-11-11 00:00:00+03:00,out,False,891410,False,16,2412,2566,154
166511,2019-11-11 00:00:00+03:00,in,False,-1,True,8,0,267,267
166511,2019-11-11 00:00:00+03:00,out,False,891410,True,13,0,109,109
166511,2019-11-11 00:00:00+03:00,out,False,891416,True,2,0,85,85
166511,2019-11-11 00:00:00+03:00,out,False,891414,True,8,0,126,126
166511,2019-11-11 00:00:00+03:00,in,False,-1,True,8,0,267,267
166511,2019-11-11 00:00:00+03:00,in,False,891414,False,9,3942,4030,88
166511,2019-11-11 00:00:00+03:00,in,False,891410,False,12,1647,1810,163
166511,2019-11-11 00:00:00+03:00,out,False,891416,True,2,0,85,85
166511,2019-11-12 00:00:00+03:00,out,False,891410,False,21,2706,2918,212
166511,2019-11-12 00:00:00+03:00,in,False,891414,False,4,164,202,38
166511,2019-11-12 00:00:00+03:00,out,False,891416,False,3,102,131,29
166511,2019-11-12 00:00:00+03:00,out,False,891410,True,16,0,243,243
166511,2019-11-12 00:00:00+03:00,in,False,891410,False,4,631,677,46
166511,2019-11-12 00:00:00+03:00,out,False,891414,False,25,4866,5060,194
166511,2019-11-12 00:00:00+03:00,out,False,891414,True,18,0,131,131
166511,2019-11-12 00:00:00+03:00,in,False,-1,True,9,0,153,153
166511,2019-11-12 00:00:00+03:00,out,True,891414,True,3,0,7,7
166511,2019-11-13 00:00:00+03:00,out,False,891414,False,28,3818,4069,251
166511,2019-11-13 00:00:00+03:00,out,False,891416,True,2,0,6,6
166511,2019-11-13 00:00:00+03:00,out,False,891410,False,15,1695,1816,121
166511,2019-11-13 00:00:00+03:00,out,False,891410,True,4,0,96,96
166511,2019-11-13 00:00:00+03:00,in,False,891410,False,10,482,627,145
166511,2019-11-13 00:00:00+03:00,out,False,891416,False,3,346,371,25
166511,2019-11-13 00:00:00+03:00,in,False,891414,False,5,525,564,39
166511,2019-11-13 00:00:00+03:00,in,False,-1,True,5,0,117,117
166511,2019-11-13 00:00:00+03:00,out,True,891414,True,4,0,0,0
166511,2019-11-13 00:00:00+03:00,out,False,891414,True,29,0,212,212
166511,2019-11-13 00:00:00+03:00,out,False,891414,False,28,3818,4069,251
166511,2019-11-14 00:00:00+03:00,in,False,891410,False,3,832,878,46
166511,2019-11-14 00:00:00+03:00,out,True,891414,True,1,0,0,0
166511,2019-11-14 00:00:00+03:00,out,False,891414,False,31,3534,3762,228
166511,2019-11-14 00:00:00+03:00,out,False,891410,True,17,0,550,550
166511,2019-11-14 00:00:00+03:00,in,False,891414,False,15,2985,3127,142
166511,2019-11-14 00:00:00+03:00,out,False,891416,True,2,0,13,13
166511,2019-11-14 00:00:00+03:00,out,False,891410,False,22,4288,4562,274
166511,2019-11-14 00:00:00+03:00,out,False,891416,False,5,931,994,63
166511,2019-11-14 00:00:00+03:00,out,False,891414,True,5,0,6,6
166511,2019-11-14 00:00:00+03:00,in,False,891416,False,4,366,426,60
166511,2019-11-14 00:00:00+03:00,in,False,-1,True,14,0,374,374
166511,2019-11-14 00:00:00+03:00,out,True,891416,True,5,0,0,0
166511,2019-11-15 00:00:00+03:00,out,False,891416,False,1,82,94,12
166511,2019-11-15 00:00:00+03:00,in,False,-1,True,6,0,168,168
166511,2019-11-15 00:00:00+03:00,out,False,891414,False,21,2054,2287,233
166511,2019-11-15 00:00:00+03:00,out,True,891414,True,1,0,0,0
166511,2019-11-15 00:00:00+03:00,out,False,891410,True,6,0,10,10
166511,2019-11-15 00:00:00+03:00,in,False,891410,False,11,1556,1701,145
166511,2019-11-15 00:00:00+03:00,out,False,891414,True,7,0,110,110
166511,2019-11-15 00:00:00+03:00,in,False,891416,False,2,371,392,21
166511,2019-11-15 00:00:00+03:00,in,False,891414,False,9,548,626,78
166511,2019-11-15 00:00:00+03:00,out,False,891416,True,1,0,5,5
166511,2019-11-15 00:00:00+03:00,out,False,891410,False,26,4996,5203,207
166511,2019-11-15 00:00:00+03:00,out,True,891410,True,1,0,0,0
166511,2019-11-15 00:00:00+03:00,out,False,891410,True,6,0,10,10
166511,2019-11-18 00:00:00+03:00,out,False,891414,True,14,0,411,411
166511,2019-11-18 00:00:00+03:00,in,False,-1,True,7,0,231,231
166511,2019-11-18 00:00:00+03:00,out,True,891414,True,2,0,0,0
166511,2019-11-18 00:00:00+03:00,out,True,891410,True,1,0,0,0
166511,2019-11-18 00:00:00+03:00,in,False,891416,False,1,125,142,17
166511,2019-11-18 00:00:00+03:00,in,False,891410,False,10,3883,3998,115
166511,2019-11-18 00:00:00+03:00,out,False,891410,False,23,4102,4253,151
166511,2019-11-18 00:00:00+03:00,out,False,891410,True,5,0,72,72
166511,2019-11-18 00:00:00+03:00,in,False,891414,False,9,2477,2551,74
166511,2019-11-18 00:00:00+03:00,out,False,891416,False,3,395,423,28
166511,2019-11-18 00:00:00+03:00,out,False,891416,True,1,0,36,36
166511,2019-11-18 00:00:00+03:00,out,False,891414,False,32,1853,2110,257
166511,2019-11-19 00:00:00+03:00,out,False,891410,True,17,0,29,29
166511,2019-11-19 00:00:00+03:00,out,True,891410,True,5,0,0,0
166511,2019-11-19 00:00:00+03:00,out,False,891416,False,12,1647,1726,79
166511,2019-11-19 00:00:00+03:00,out,False,891410,False,25,3999,4188,189
166511,2019-11-19 00:00:00+03:00,in,False,891416,False,3,168,196,28
166511,2019-11-19 00:00:00+03:00,out,False,891414,True,23,0,120,120
166511,2019-11-19 00:00:00+03:00,in,False,891414,False,15,1802,1949,147
166511,2019-11-19 00:00:00+03:00,in,False,891410,False,15,1782,1960,178
166511,2019-11-19 00:00:00+03:00,in,False,-1,True,6,0,97,97
166511,2019-11-19 00:00:00+03:00,out,True,891414,True,1,0,0,0
166511,2019-11-19 00:00:00+03:00,out,False,891416,True,6,0,51,51
166511,2019-11-19 00:00:00+03:00,out,False,891414,False,29,3145,3347,202
166511,2019-11-20 00:00:00+03:00,out,True,891414,True,3,0,0,0
166511,2019-11-20 00:00:00+03:00,out,False,891410,True,15,0,42,42
166511,2019-11-20 00:00:00+03:00,in,False,891410,False,10,1590,1759,169
166511,2019-11-20 00:00:00+03:00,out,False,891414,False,27,2539,2768,229
166511,2019-11-20 00:00:00+03:00,out,False,891416,True,3,0,41,41
166511,2019-11-20 00:00:00+03:00,out,False,891416,False,5,742,785,43
166511,2019-11-20 00:00:00+03:00,out,False,891414,True,26,0,501,501
166511,2019-11-20 00:00:00+03:00,in,False,-1,True,22,0,536,536
166511,2019-11-20 00:00:00+03:00,out,False,891410,False,36,9625,9936,311
166511,2019-11-20 00:00:00+03:00,in,False,891416,False,1,49,57,8
166511,2019-11-20 00:00:00+03:00,in,False,891414,False,7,999,1081,82
166511,2019-11-20 00:00:00+03:00,out,False,891414,True,26,0,501,501
166511,2019-11-20 00:00:00+03:00,out,False,891416,True,3,0,41,41
166511,2019-11-20 00:00:00+03:00,out,False,891410,False,36,9625,9936,311
166511,2019-11-21 00:00:00+03:00,out,False,891410,True,13,0,158,158
166511,2019-11-21 00:00:00+03:00,in,False,891416,False,9,474,603,129
166511,2019-11-21 00:00:00+03:00,out,False,891414,True,2,0,2,2
166511,2019-11-21 00:00:00+03:00,in,False,891414,False,7,526,586,60
166511,2019-11-21 00:00:00+03:00,out,True,891416,True,1,0,0,0
166511,2019-11-21 00:00:00+03:00,out,False,891416,False,15,2498,2614,116
166511,2019-11-21 00:00:00+03:00,out,False,891416,True,8,0,58,58
166511,2019-11-21 00:00:00+03:00,out,True,891414,True,1,0,0,0
166511,2019-11-21 00:00:00+03:00,out,False,891410,False,32,4396,4641,245
166511,2019-11-21 00:00:00+03:00,in,False,-1,True,22,0,658,658
166511,2019-11-21 00:00:00+03:00,out,False,891414,False,17,2557,2654,97
166511,2019-11-21 00:00:00+03:00,in,False,891410,False,17,3483,3692,209
166511,2019-11-22 00:00:00+03:00,in,False,891414,False,5,222,265,43
166511,2019-11-22 00:00:00+03:00,out,False,891414,True,10,0,11,11
166511,2019-11-22 00:00:00+03:00,out,False,891416,True,1,0,0,0
166511,2019-11-22 00:00:00+03:00,out,False,891414,False,18,1417,1515,98
166511,2019-11-22 00:00:00+03:00,out,False,891410,True,6,0,144,144
166511,2019-11-22 00:00:00+03:00,in,False,891416,False,2,107,137,30
166511,2019-11-22 00:00:00+03:00,out,True,891416,True,1,0,0,0
166511,2019-11-22 00:00:00+03:00,in,False,-1,True,6,0,120,120
166511,2019-11-22 00:00:00+03:00,out,False,891410,False,17,1827,1986,159
166511,2019-11-22 00:00:00+03:00,out,False,891416,False,5,518,584,66
166511,2019-11-22 00:00:00+03:00,in,False,891410,False,20,2940,3162,222
166511,2019-11-22 00:00:00+03:00,in,False,-1,True,6,0,120,120
166511,2019-11-22 00:00:00+03:00,out,False,891414,True,10,0,11,11
166511,2019-11-22 00:00:00+03:00,out,False,891416,False,5,518,584,66
166511,2019-11-22 00:00:00+03:00,in,False,891410,False,20,2940,3162,222
166511,2019-11-22 00:00:00+03:00,out,True,891416,True,1,0,0,0
166511,2019-11-25 00:00:00+03:00,out,True,891414,False,1,22,29,7
166511,2019-11-25 00:00:00+03:00,out,False,891416,True,4,0,97,97
166511,2019-11-25 00:00:00+03:00,out,False,891410,False,34,5400,5692,292
166511,2019-11-25 00:00:00+03:00,out,False,891410,True,2,0,1,1
166511,2019-11-25 00:00:00+03:00,out,False,891414,False,17,1888,2006,118
166511,2019-11-25 00:00:00+03:00,out,False,891416,False,3,567,658,91
166511,2019-11-25 00:00:00+03:00,in,False,-1,True,8,0,217,217
166511,2019-11-25 00:00:00+03:00,in,False,891410,False,30,3689,4059,370
166511,2019-11-25 00:00:00+03:00,in,False,891414,False,6,1004,1082,78
166511,2019-11-25 00:00:00+03:00,out,False,891414,True,7,0,7,7
166511,2019-11-25 00:00:00+03:00,out,True,891414,True,2,0,0,0
166511,2019-11-25 00:00:00+03:00,in,False,891416,False,2,338,360,22
166511,2019-11-25 00:00:00+03:00,in,False,891414,False,6,1004,1082,78
166511,2019-11-26 00:00:00+03:00,out,False,891410,False,32,4161,4470,309
166511,2019-11-26 00:00:00+03:00,in,False,891416,False,1,189,198,9
166511,2019-11-26 00:00:00+03:00,out,False,891410,True,13,0,203,203
166511,2019-11-26 00:00:00+03:00,out,True,891410,True,2,0,0,0
166511,2019-11-26 00:00:00+03:00,in,False,891414,False,6,1428,1505,77
166511,2019-11-26 00:00:00+03:00,out,False,891416,False,7,917,973,56
166511,2019-11-26 00:00:00+03:00,in,False,891410,False,17,1731,1961,230
166511,2019-11-26 00:00:00+03:00,out,False,891416,True,6,0,147,147
166511,2019-11-26 00:00:00+03:00,out,False,891414,True,2,0,34,34
166511,2019-11-26 00:00:00+03:00,in,False,-1,True,8,0,185,185
166511,2019-11-26 00:00:00+03:00,out,False,891414,False,17,1854,1962,108
166511,2019-11-26 00:00:00+03:00,out,False,891414,False,17,1854,1962,108
166511,2019-11-27 00:00:00+03:00,in,False,891416,False,1,44,50,6
166511,2019-11-27 00:00:00+03:00,out,False,891410,False,34,6063,6392,329
166511,2019-11-27 00:00:00+03:00,in,False,891414,False,13,1272,1364,92
166511,2019-11-27 00:00:00+03:00,out,True,891410,True,1,0,1,1
166511,2019-11-27 00:00:00+03:00,in,False,-1,True,16,0,310,310
166511,2019-11-27 00:00:00+03:00,in,False,891410,False,13,2149,2326,177
166511,2019-11-27 00:00:00+03:00,out,True,891416,True,1,0,0,0
166511,2019-11-27 00:00:00+03:00,out,False,891410,True,12,0,45,45
166511,2019-11-27 00:00:00+03:00,out,False,891416,False,7,506,593,87
166511,2019-11-27 00:00:00+03:00,out,False,891414,True,23,0,118,118
166511,2019-11-27 00:00:00+03:00,out,False,891416,True,9,0,26,26
166511,2019-11-27 00:00:00+03:00,out,False,891414,False,25,4338,4523,185
166511,2019-11-28 00:00:00+03:00,in,False,-1,True,10,0,240,240
166511,2019-11-28 00:00:00+03:00,out,False,891414,False,21,1853,2000,147
166511,2019-11-28 00:00:00+03:00,out,False,891414,True,17,0,126,126
166511,2019-11-28 00:00:00+03:00,in,False,891410,False,7,1634,1723,89
166511,2019-11-28 00:00:00+03:00,in,False,891414,False,12,1662,1776,114
166511,2019-11-28 00:00:00+03:00,out,False,891410,True,8,0,114,114
166511,2019-11-28 00:00:00+03:00,out,False,891416,False,4,697,726,29
166511,2019-11-28 00:00:00+03:00,in,False,891416,False,2,46,64,18
166511,2019-11-28 00:00:00+03:00,out,False,891410,False,29,3429,3612,183
166511,2019-11-28 00:00:00+03:00,in,False,-1,True,10,0,240,240
166511,2019-11-28 00:00:00+03:00,in,False,891410,False,7,1634,1723,89
166520,2019-08-09 00:00:00+03:00,in,False,-1,True,5,0,24,24
166520,2019-08-10 00:00:00+03:00,out,False,885682,True,1,0,18,18
166520,2019-08-13 00:00:00+03:00,in,False,-1,True,1,0,6,6
166520,2019-08-14 00:00:00+03:00,out,False,885682,True,1,0,25,25
166520,2019-08-14 00:00:00+03:00,in,False,-1,True,1,0,5,5
166520,2019-08-14 00:00:00+03:00,in,False,-1,True,1,0,5,5
166520,2019-08-15 00:00:00+03:00,in,False,-1,True,1,0,6,6
166520,2019-08-17 00:00:00+03:00,out,False,884946,False,50,1725,2674,949
166520,2019-08-17 00:00:00+03:00,out,True,884946,True,1,0,0,0
166520,2019-08-17 00:00:00+03:00,out,False,885682,True,1,0,8,8
166520,2019-08-17 00:00:00+03:00,out,False,890234,False,1,85,97,12
166520,2019-08-17 00:00:00+03:00,out,False,890232,False,1,379,402,23
166520,2019-08-17 00:00:00+03:00,in,False,-1,True,5,0,81,81
166520,2019-08-17 00:00:00+03:00,out,False,884946,True,59,0,2044,2044
166520,2019-08-18 00:00:00+03:00,out,False,884946,False,1,19,30,11
166520,2019-08-18 00:00:00+03:00,in,False,-1,True,1,0,10,10
166520,2019-08-18 00:00:00+03:00,out,False,890232,False,4,1242,1294,52
166520,2019-08-19 00:00:00+03:00,out,False,890232,False,1,299,312,13
166520,2019-08-21 00:00:00+03:00,out,False,892028,True,11,0,255,255
166520,2019-08-21 00:00:00+03:00,out,False,892028,False,10,779,959,180
166520,2019-08-21 00:00:00+03:00,in,False,-1,True,1,0,5,5
166520,2019-08-22 00:00:00+03:00,in,False,-1,True,2,0,14,14
166520,2019-08-22 00:00:00+03:00,out,False,893674,False,42,1118,1824,706
166520,2019-08-22 00:00:00+03:00,out,False,893674,True,22,0,692,692
166520,2019-08-22 00:00:00+03:00,out,False,893674,False,42,1118,1824,706
166520,2019-08-23 00:00:00+03:00,in,False,-1,True,1,0,65,65
166520,2019-08-23 00:00:00+03:00,out,False,884946,True,5,0,289,289
166520,2019-08-23 00:00:00+03:00,out,False,890232,False,5,2012,2078,66
166520,2019-08-23 00:00:00+03:00,out,False,884946,True,5,0,289,289
166520,2019-08-24 00:00:00+03:00,out,False,884946,True,64,0,2026,2026
166520,2019-08-24 00:00:00+03:00,out,False,884946,False,101,3697,5402,1705
166520,2019-08-24 00:00:00+03:00,in,False,-1,True,21,0,148,148
166520,2019-08-24 00:00:00+03:00,out,False,890232,False,6,2644,2735,91
166520,2019-08-24 00:00:00+03:00,in,False,884946,False,1,36,53,17
166520,2019-08-24 00:00:00+03:00,out,False,884946,True,64,0,2026,2026
166520,2019-08-25 00:00:00+03:00,out,False,892028,True,37,0,851,851
166520,2019-08-25 00:00:00+03:00,out,False,891192,False,1,1306,1338,32
166520,2019-08-25 00:00:00+03:00,in,False,-1,True,7,0,103,103
166520,2019-08-25 00:00:00+03:00,out,False,892028,False,37,993,1579,586
166520,2019-08-25 00:00:00+03:00,out,False,892028,False,37,993,1579,586
166520,2019-08-28 00:00:00+03:00,in,False,-1,True,11,0,261,261
166520,2019-08-28 00:00:00+03:00,out,False,884946,False,107,4467,6267,1800
166520,2019-08-28 00:00:00+03:00,in,False,884946,False,3,153,200,47
166520,2019-08-28 00:00:00+03:00,out,False,897894,False,6,2978,3065,87
166520,2019-08-28 00:00:00+03:00,out,False,884946,True,64,0,2016,2016
166520,2019-08-28 00:00:00+03:00,out,False,892028,False,20,633,872,239
166520,2019-08-28 00:00:00+03:00,out,False,892028,True,7,0,214,214
166520,2019-08-29 00:00:00+03:00,out,False,897894,False,1,340,352,12
166520,2019-08-29 00:00:00+03:00,out,False,884946,True,22,0,774,774
166520,2019-08-29 00:00:00+03:00,out,False,884946,False,27,948,1397,449
166520,2019-08-29 00:00:00+03:00,in,False,884946,False,1,136,147,11
166520,2019-08-30 00:00:00+03:00,out,False,897894,False,3,493,541,48
166520,2019-08-30 00:00:00+03:00,in,False,884946,False,2,111,128,17
166520,2019-08-30 00:00:00+03:00,out,False,884946,False,60,1738,2730,992
166520,2019-08-30 00:00:00+03:00,in,False,-1,True,6,0,115,115
166520,2019-08-30 00:00:00+03:00,out,False,884946,True,14,0,558,558
166520,2019-08-31 00:00:00+03:00,out,False,884946,False,66,1482,2650,1168
166520,2019-08-31 00:00:00+03:00,in,False,-1,True,4,0,57,57
166520,2019-08-31 00:00:00+03:00,out,True,884946,True,1,0,0,0
166520,2019-08-31 00:00:00+03:00,out,False,884946,True,49,0,1096,1096
166520,2019-09-01 00:00:00+03:00,in,False,-1,True,2,0,81,81
166520,2019-09-01 00:00:00+03:00,in,False,-1,True,2,0,81,81
166520,2019-09-02 00:00:00+03:00,out,False,884946,False,13,361,643,282
166520,2019-09-02 00:00:00+03:00,in,False,-1,True,2,0,15,15
166520,2019-09-02 00:00:00+03:00,out,False,884946,True,6,0,144,144
166520,2019-09-03 00:00:00+03:00,out,False,890232,False,2,929,959,30
166520,2019-09-03 00:00:00+03:00,out,False,884946,False,4,335,381,46
166520,2019-09-03 00:00:00+03:00,out,False,884946,True,2,0,83,83
166520,2019-09-04 00:00:00+03:00,in,False,-1,True,2,0,9,9
166520,2019-09-04 00:00:00+03:00,out,False,884946,False,20,420,759,339
166520,2019-09-04 00:00:00+03:00,out,False,884946,True,4,0,68,68
166520,2019-09-05 00:00:00+03:00,out,False,884946,True,1,0,41,41
166520,2019-09-05 00:00:00+03:00,in,False,-1,True,1,0,50,50
166520,2019-09-05 00:00:00+03:00,out,False,884946,False,6,124,222,98
166520,2019-09-08 00:00:00+03:00,in,False,-1,True,1,0,3,3
166520,2019-09-08 00:00:00+03:00,out,False,897894,False,1,209,220,11
166520,2019-09-08 00:00:00+03:00,out,False,884946,False,3,245,288,43
166520,2019-09-08 00:00:00+03:00,out,False,884946,True,2,0,13,13
166520,2019-09-08 00:00:00+03:00,out,False,892028,True,1,0,24,24
166520,2019-09-10 00:00:00+03:00,in,False,-1,True,1,0,42,42
166520,2019-09-11 00:00:00+03:00,out,False,884946,True,32,0,932,932
166520,2019-09-11 00:00:00+03:00,in,False,-1,True,11,0,218,218
166520,2019-09-11 00:00:00+03:00,out,False,884946,False,69,2355,3323,968
166520,2019-09-11 00:00:00+03:00,out,False,909452,False,8,3394,3509,115
166520,2019-09-11 00:00:00+03:00,in,False,-1,True,11,0,218,218
166520,2019-09-13 00:00:00+03:00,out,False,890232,False,2,582,602,20
166520,2019-09-13 00:00:00+03:00,in,False,-1,True,14,0,304,304
166520,2019-09-13 00:00:00+03:00,in,False,884946,False,3,139,186,47
166520,2019-09-13 00:00:00+03:00,out,False,910902,False,2,907,932,25
166520,2019-09-13 00:00:00+03:00,out,False,884946,False,80,2795,4221,1426
166520,2019-09-13 00:00:00+03:00,out,False,893674,True,46,0,1436,1436
166520,2019-09-13 00:00:00+03:00,out,False,884946,True,53,0,1608,1608
166520,2019-09-13 00:00:00+03:00,out,False,910926,False,3,1216,1256,40
166520,2019-09-13 00:00:00+03:00,out,False,893674,False,77,2647,3792,1145
166520,2019-09-13 00:00:00+03:00,out,False,893674,True,46,0,1436,1436
166520,2019-09-13 00:00:00+03:00,out,False,910902,False,2,907,932,25
166520,2019-09-14 00:00:00+03:00,out,False,893674,False,17,557,778,221
166520,2019-09-14 00:00:00+03:00,out,False,893674,True,17,0,427,427
166520,2019-09-14 00:00:00+03:00,out,False,910926,False,2,684,715,31
166520,2019-09-14 00:00:00+03:00,in,False,-1,True,4,0,61,61
166520,2019-09-15 00:00:00+03:00,out,False,884946,True,1,0,6,6
166520,2019-09-15 00:00:00+03:00,out,False,892028,True,12,0,155,155
166520,2019-09-15 00:00:00+03:00,out,False,884946,False,2,61,87,26
166520,2019-09-15 00:00:00+03:00,out,False,893674,True,1,0,6,6
166520,2019-09-15 00:00:00+03:00,out,False,890232,False,1,298,313,15
166520,2019-09-15 00:00:00+03:00,out,False,892028,False,4,191,235,44
166520,2019-09-16 00:00:00+03:00,out,False,893674,True,21,0,339,339
166520,2019-09-16 00:00:00+03:00,out,False,910926,False,3,896,943,47
166520,2019-09-16 00:00:00+03:00,in,False,-1,True,4,0,64,64
166520,2019-09-16 00:00:00+03:00,out,False,893674,False,22,915,1211,296
166520,2019-09-16 00:00:00+03:00,out,False,890232,False,5,2304,2361,57
166520,2019-09-16 00:00:00+03:00,out,False,893674,False,22,915,1211,296
166520,2019-09-16 00:00:00+03:00,out,False,890232,False,5,2304,2361,57
166520,2019-09-16 00:00:00+03:00,in,False,-1,True,4,0,64,64
166520,2019-09-17 00:00:00+03:00,out,False,910926,False,2,797,812,15
166520,2019-09-17 00:00:00+03:00,out,False,893674,False,38,1401,2018,617
166520,2019-09-17 00:00:00+03:00,out,False,892028,True,4,0,63,63
166520,2019-09-17 00:00:00+03:00,out,False,893674,True,14,0,355,355
166520,2019-09-17 00:00:00+03:00,out,False,890232,False,1,267,277,10
166520,2019-09-17 00:00:00+03:00,in,False,-1,True,2,0,16,16
166520,2019-09-18 00:00:00+03:00,out,False,892028,False,5,474,539,65
166520,2019-09-18 00:00:00+03:00,out,False,892028,True,3,0,99,99
166520,2019-09-19 00:00:00+03:00,out,False,892028,False,43,1030,1800,770
166520,2019-09-19 00:00:00+03:00,out,False,884946,False,1,59,67,8
166520,2019-09-19 00:00:00+03:00,out,False,897894,False,8,5210,5318,108
166520,2019-09-19 00:00:00+03:00,out,False,893674,False,61,2423,3390,967
166520,2019-09-19 00:00:00+03:00,out,False,892028,True,8,0,271,271
166520,2019-09-19 00:00:00+03:00,out,False,893674,True,49,0,1280,1280
166520,2019-09-19 00:00:00+03:00,in,False,-1,True,12,0,158,158
166520,2019-09-19 00:00:00+03:00,out,False,884946,False,1,59,67,8
166520,2019-09-20 00:00:00+03:00,out,False,884946,False,1,95,108,13
166520,2019-09-20 00:00:00+03:00,in,False,-1,True,3,0,35,35
166520,2019-09-21 00:00:00+03:00,out,False,884946,True,7,0,159,159
166520,2019-09-21 00:00:00+03:00,in,False,-1,True,4,0,33,33
166520,2019-09-21 00:00:00+03:00,out,False,884946,False,10,103,331,228
166520,2019-09-23 00:00:00+03:00,in,False,-1,True,1,0,8,8
166520,2019-09-25 00:00:00+03:00,in,False,-1,True,1,0,24,24
166520,2019-09-25 00:00:00+03:00,in,False,-1,True,1,0,24,24
166520,2019-09-27 00:00:00+03:00,in,False,-1,True,1,0,31,31
166520,2019-09-29 00:00:00+03:00,out,False,884946,False,32,1075,1602,527
166520,2019-09-29 00:00:00+03:00,out,False,884946,True,26,0,616,616
166520,2019-09-29 00:00:00+03:00,out,False,910902,False,1,287,298,11
166520,2019-09-29 00:00:00+03:00,out,False,884946,True,26,0,616,616
166520,2019-09-30 00:00:00+03:00,out,False,884946,False,57,1906,2713,807
166520,2019-09-30 00:00:00+03:00,out,False,892028,True,68,0,1152,1152
166520,2019-09-30 00:00:00+03:00,out,False,923250,False,12,4237,4395,158
166520,2019-09-30 00:00:00+03:00,out,False,923254,False,6,1905,1977,72
166520,2019-09-30 00:00:00+03:00,out,False,892028,False,124,5305,7211,1906
166520,2019-09-30 00:00:00+03:00,out,False,910902,False,1,326,341,15
166520,2019-09-30 00:00:00+03:00,in,False,-1,True,14,0,237,237
166520,2019-09-30 00:00:00+03:00,out,False,884946,True,30,0,708,708
166520,2019-09-30 00:00:00+03:00,out,False,893674,False,1,239,244,5
166520,2019-09-30 00:00:00+03:00,out,False,923250,False,12,4237,4395,158
166520,2019-10-01 00:00:00+03:00,out,False,892028,False,40,1794,2377,583
166520,2019-10-01 00:00:00+03:00,out,False,884946,False,16,723,975,252
166520,2019-10-01 00:00:00+03:00,in,False,-1,True,8,0,214,214
166520,2019-10-01 00:00:00+03:00,out,False,892028,True,12,0,254,254
166520,2019-10-01 00:00:00+03:00,out,False,884946,True,18,0,576,576
166520,2019-10-01 00:00:00+03:00,out,False,923250,False,3,1379,1408,29
166520,2019-10-01 00:00:00+03:00,out,False,892028,False,40,1794,2377,583
166520,2019-10-02 00:00:00+03:00,out,False,923250,False,9,3371,3479,108
166520,2019-10-02 00:00:00+03:00,in,False,-1,True,12,0,363,363
166520,2019-10-02 00:00:00+03:00,out,False,892028,True,27,0,548,548
166520,2019-10-02 00:00:00+03:00,out,False,892028,False,62,1874,2700,826
166520,2019-10-02 00:00:00+03:00,out,False,884946,True,16,0,618,618
166520,2019-10-02 00:00:00+03:00,out,False,884946,False,27,1075,1555,480
166520,2019-10-02 00:00:00+03:00,out,False,890232,False,1,353,381,28
166520,2019-10-02 00:00:00+03:00,out,False,923250,False,9,3371,3479,108
166520,2019-10-03 00:00:00+03:00,out,False,892028,False,9,989,1126,137
166520,2019-10-03 00:00:00+03:00,out,False,923250,False,2,838,878,40
166520,2019-10-03 00:00:00+03:00,in,False,-1,True,1,0,10,10
166520,2019-10-03 00:00:00+03:00,out,False,892028,True,6,0,176,176
166520,2019-10-03 00:00:00+03:00,out,False,923250,False,2,838,878,40
166520,2019-10-03 00:00:00+03:00,in,False,-1,True,1,0,10,10
166520,2019-10-04 00:00:00+03:00,in,False,-1,True,11,0,364,364
166520,2019-10-04 00:00:00+03:00,out,False,892028,False,57,2385,3227,842
166520,2019-10-04 00:00:00+03:00,out,False,923250,False,18,7506,7692,186
166520,2019-10-04 00:00:00+03:00,out,False,893674,False,14,818,1017,199
166520,2019-10-04 00:00:00+03:00,out,False,892028,True,37,0,990,990
166520,2019-10-04 00:00:00+03:00,out,False,884946,True,21,0,562,562
166520,2019-10-04 00:00:00+03:00,out,False,893674,True,8,0,228,228
166520,2019-10-04 00:00:00+03:00,out,False,884946,False,47,1886,2660,774
166520,2019-10-04 00:00:00+03:00,in,False,-1,True,11,0,364,364
166520,2019-10-04 00:00:00+03:00,out,False,892028,False,57,2385,3227,842
166520,2019-10-07 00:00:00+03:00,out,False,893674,False,45,1867,2492,625
166520,2019-10-07 00:00:00+03:00,out,False,923250,False,5,1227,1316,89
166520,2019-10-07 00:00:00+03:00,out,False,-1,True,1,0,0,0
166520,2019-10-07 00:00:00+03:00,in,False,-1,True,8,0,104,104
166520,2019-10-07 00:00:00+03:00,out,False,893674,True,20,0,419,419
166520,2019-10-08 00:00:00+03:00,in,False,-1,True,4,0,80,80
166520,2019-10-08 00:00:00+03:00,out,False,893674,True,23,0,669,669
166520,2019-10-08 00:00:00+03:00,out,False,884946,True,26,0,585,585
166520,2019-10-08 00:00:00+03:00,out,False,893674,False,38,2568,3160,592
166520,2019-10-08 00:00:00+03:00,out,False,884946,False,48,2220,3067,847
166520,2019-10-08 00:00:00+03:00,out,False,923250,False,17,5172,5422,250
166520,2019-10-08 00:00:00+03:00,in,False,884946,False,1,65,74,9
166520,2019-10-08 00:00:00+03:00,out,False,893674,False,38,2568,3160,592
166520,2019-10-08 00:00:00+03:00,out,False,884946,True,26,0,585,585
166520,2019-10-09 00:00:00+03:00,out,False,930510,False,1,355,366,11
166520,2019-10-09 00:00:00+03:00,out,False,893674,True,25,0,566,566
166520,2019-10-09 00:00:00+03:00,out,False,923250,False,5,1584,1664,80
166520,2019-10-09 00:00:00+03:00,out,False,893674,False,45,2137,2781,644
166520,2019-10-09 00:00:00+03:00,in,False,-1,True,5,0,41,41
166520,2019-10-10 00:00:00+03:00,out,False,893674,False,2,50,79,29
166520,2019-10-11 00:00:00+03:00,in,False,-1,True,2,0,23,23
166520,2019-10-11 00:00:00+03:00,out,False,893674,True,10,0,332,332
166520,2019-10-11 00:00:00+03:00,out,False,893674,False,30,1062,1491,429
166520,2019-10-11 00:00:00+03:00,out,False,923250,False,2,826,846,20
166520,2019-10-14 00:00:00+03:00,in,False,-1,True,1,0,10,10
166520,2019-10-14 00:00:00+03:00,out,False,893674,False,7,92,168,76
166520,2019-10-14 00:00:00+03:00,out,False,893674,True,12,0,198,198
166520,2019-10-14 00:00:00+03:00,in,False,-1,True,1,0,10,10
166520,2019-10-15 00:00:00+03:00,out,False,884946,True,8,0,175,175
166520,2019-10-15 00:00:00+03:00,out,False,893674,False,106,2802,4366,1564
166520,2019-10-15 00:00:00+03:00,out,False,893674,True,46,0,1115,1115
166520,2019-10-15 00:00:00+03:00,out,False,923254,False,2,518,537,19
166520,2019-10-15 00:00:00+03:00,out,False,884946,False,10,227,352,125
166520,2019-10-15 00:00:00+03:00,in,False,-1,True,18,0,294,294
166520,2019-10-15 00:00:00+03:00,out,False,890232,False,1,980,992,12
166520,2019-10-15 00:00:00+03:00,out,True,893674,True,2,0,11,11
166520,2019-10-15 00:00:00+03:00,out,False,890232,False,1,980,992,12
166520,2019-10-16 00:00:00+03:00,out,False,884946,False,52,2055,2771,716
166520,2019-10-16 00:00:00+03:00,out,False,893674,True,21,0,457,457
166520,2019-10-16 00:00:00+03:00,out,False,884946,True,21,0,558,558
166520,2019-10-16 00:00:00+03:00,out,False,923250,False,16,3448,3652,204
166520,2019-10-16 00:00:00+03:00,in,False,-1,True,13,0,498,498
166520,2019-10-16 00:00:00+03:00,out,False,893674,False,54,2250,3183,933
166520,2019-10-17 00:00:00+03:00,in,False,-1,True,15,0,311,311
166520,2019-10-17 00:00:00+03:00,out,False,884946,False,43,1317,1971,654
166520,2019-10-17 00:00:00+03:00,out,False,893674,True,60,0,1421,1421
166520,2019-10-17 00:00:00+03:00,out,False,923250,False,11,2898,3043,145
166520,2019-10-17 00:00:00+03:00,out,False,892028,True,1,0,11,11
166520,2019-10-17 00:00:00+03:00,out,False,884946,True,32,0,812,812
166520,2019-10-17 00:00:00+03:00,out,False,893674,False,112,4265,6029,1764
166520,2019-10-17 00:00:00+03:00,out,False,939236,False,1,412,422,10
166520,2019-10-17 00:00:00+03:00,out,False,923250,False,11,2898,3043,145
166520,2019-10-18 00:00:00+03:00,out,False,892028,True,2,0,31,31
166520,2019-10-18 00:00:00+03:00,out,False,884946,False,47,1304,1962,658
166520,2019-10-18 00:00:00+03:00,out,False,884946,True,44,0,1116,1116
166520,2019-10-18 00:00:00+03:00,out,False,890232,False,1,534,544,10
166520,2019-10-18 00:00:00+03:00,in,False,884946,False,1,5,16,11
166520,2019-10-18 00:00:00+03:00,out,False,939236,False,3,706,739,33
166520,2019-10-18 00:00:00+03:00,out,False,893674,False,55,2465,3347,882
166520,2019-10-18 00:00:00+03:00,in,False,-1,True,8,0,208,208
166520,2019-10-18 00:00:00+03:00,out,False,893674,True,23,0,606,606
166520,2019-10-18 00:00:00+03:00,out,False,923250,False,6,1829,1929,100
166520,2019-10-18 00:00:00+03:00,out,False,892028,False,3,152,203,51
166520,2019-10-18 00:00:00+03:00,out,False,892028,False,3,152,203,51
166520,2019-10-18 00:00:00+03:00,out,False,893674,True,23,0,606,606
166520,2019-10-19 00:00:00+03:00,out,False,923250,False,8,2280,2422,142
166520,2019-10-19 00:00:00+03:00,in,False,-1,True,3,0,55,55
166520,2019-10-19 00:00:00+03:00,out,False,892028,False,17,691,944,253
166520,2019-10-19 00:00:00+03:00,out,False,884946,False,36,1267,1947,680
166520,2019-10-19 00:00:00+03:00,out,False,892028,True,13,0,281,281
166520,2019-10-19 00:00:00+03:00,out,False,884946,True,19,0,636,636
166520,2019-10-19 00:00:00+03:00,out,False,884946,True,19,0,636,636
166520,2019-10-19 00:00:00+03:00,out,False,884946,False,36,1267,1947,680
166520,2019-10-20 00:00:00+03:00,out,False,923250,False,2,573,611,38
166520,2019-10-20 00:00:00+03:00,out,False,892028,False,19,785,1070,285
166520,2019-10-20 00:00:00+03:00,out,False,884946,True,2,0,112,112
166520,2019-10-20 00:00:00+03:00,out,False,892028,True,9,0,262,262
166520,2019-10-20 00:00:00+03:00,out,False,884946,False,1,86,97,11
166520,2019-10-20 00:00:00+03:00,in,False,-1,True,2,0,19,19
166520,2019-10-21 00:00:00+03:00,out,False,884946,True,5,0,150,150
166520,2019-10-21 00:00:00+03:00,out,False,892028,True,2,0,60,60
166520,2019-10-21 00:00:00+03:00,out,False,893674,False,83,3677,5018,1341
166520,2019-10-21 00:00:00+03:00,out,False,893674,True,57,0,1426,1426
166520,2019-10-21 00:00:00+03:00,out,False,892028,False,5,325,394,69
166520,2019-10-21 00:00:00+03:00,in,False,-1,True,10,0,395,395
166520,2019-10-21 00:00:00+03:00,out,False,939236,False,1,464,486,22
166520,2019-10-21 00:00:00+03:00,out,False,923250,False,10,1966,2104,138
166520,2019-10-22 00:00:00+03:00,out,False,892028,True,13,0,250,250
166520,2019-10-22 00:00:00+03:00,out,False,893674,True,30,0,613,613
166520,2019-10-22 00:00:00+03:00,out,False,923250,False,8,2413,2534,121
166520,2019-10-22 00:00:00+03:00,out,False,892028,False,16,880,1096,216
166520,2019-10-22 00:00:00+03:00,out,False,893674,False,78,2990,4111,1121
166520,2019-10-22 00:00:00+03:00,in,False,-1,True,4,0,48,48
166520,2019-10-23 00:00:00+03:00,out,False,893674,True,41,0,977,977
166520,2019-10-23 00:00:00+03:00,in,False,-1,True,5,0,230,230
166520,2019-10-23 00:00:00+03:00,out,False,910926,False,9,2968,3072,104
166520,2019-10-23 00:00:00+03:00,out,False,893674,False,79,3242,4267,1025
166520,2019-10-23 00:00:00+03:00,out,False,893674,True,41,0,977,977
166520,2019-10-25 00:00:00+03:00,in,False,-1,True,12,0,248,248
166520,2019-10-25 00:00:00+03:00,out,False,884946,False,2,4,53,49
166520,2019-10-25 00:00:00+03:00,out,False,892028,False,53,1589,2472,883
166520,2019-10-25 00:00:00+03:00,out,False,947480,True,1,0,17,17
166520,2019-10-25 00:00:00+03:00,out,False,910926,False,4,1726,1779,53
166520,2019-10-25 00:00:00+03:00,out,False,884946,True,5,0,46,46
166520,2019-10-25 00:00:00+03:00,out,False,923250,False,4,1967,2019,52
166520,2019-10-25 00:00:00+03:00,out,False,893674,True,13,0,396,396
166520,2019-10-25 00:00:00+03:00,out,True,892028,True,4,0,9,9
166520,2019-10-25 00:00:00+03:00,out,False,892028,True,26,0,718,718
166520,2019-10-25 00:00:00+03:00,out,False,893674,False,47,1934,2530,596
166520,2019-10-25 00:00:00+03:00,out,True,947480,True,1,0,21,21
166520,2019-10-25 00:00:00+03:00,in,False,930510,False,1,3,18,15
166520,2019-10-25 00:00:00+03:00,out,False,892028,True,26,0,718,718
166520,2019-10-25 00:00:00+03:00,out,False,893674,True,13,0,396,396
166520,2019-10-26 00:00:00+03:00,out,False,893674,True,3,0,81,81
166520,2019-10-26 00:00:00+03:00,in,False,-1,True,6,0,175,175
166520,2019-10-26 00:00:00+03:00,out,False,893674,False,5,129,228,99
166520,2019-10-26 00:00:00+03:00,out,False,893674,True,3,0,81,81
166520,2019-10-27 00:00:00+03:00,in,False,-1,True,1,0,18,18
166520,2019-10-28 00:00:00+03:00,in,False,-1,True,6,0,128,128
166520,2019-10-28 00:00:00+03:00,out,False,893674,True,11,0,379,379
166520,2019-10-28 00:00:00+03:00,out,False,910926,False,2,1838,1862,24
166520,2019-10-28 00:00:00+03:00,out,False,893674,False,28,933,1351,418
166520,2019-10-28 00:00:00+03:00,in,False,-1,True,6,0,128,128
166520,2019-10-29 00:00:00+03:00,out,False,893674,True,5,0,164,164
166520,2019-10-29 00:00:00+03:00,out,False,892028,False,1,27,35,8
166520,2019-10-29 00:00:00+03:00,in,False,-1,True,1,0,13,13
166520,2019-10-29 00:00:00+03:00,out,False,893674,False,7,159,252,93
166520,2019-10-29 00:00:00+03:00,out,False,892028,True,1,0,9,9
166520,2019-10-29 00:00:00+03:00,in,False,-1,True,1,0,13,13
166520,2019-10-29 00:00:00+03:00,out,False,893674,True,5,0,164,164
166520,2019-10-30 00:00:00+03:00,out,False,890232,False,1,172,184,12
166520,2019-10-30 00:00:00+03:00,out,False,893674,False,32,882,1393,511
166520,2019-10-30 00:00:00+03:00,out,False,892028,True,5,0,42,42
166520,2019-10-30 00:00:00+03:00,out,False,923250,False,3,971,1024,53
166520,2019-10-30 00:00:00+03:00,out,False,892028,False,11,473,621,148
166520,2019-10-30 00:00:00+03:00,out,False,893674,True,21,0,479,479
166520,2019-10-30 00:00:00+03:00,in,False,-1,True,3,0,28,28
166520,2019-10-30 00:00:00+03:00,out,False,884946,False,2,151,173,22
166520,2019-10-30 00:00:00+03:00,out,False,884946,False,2,151,173,22
166520,2019-10-31 00:00:00+03:00,in,False,-1,True,4,0,40,40
166520,2019-10-31 00:00:00+03:00,out,False,884946,True,1,0,41,41
166520,2019-10-31 00:00:00+03:00,out,False,893674,False,22,735,1029,294
166520,2019-10-31 00:00:00+03:00,out,False,892028,False,32,1158,1575,417
166520,2019-10-31 00:00:00+03:00,out,False,884946,False,2,27,57,30
166520,2019-10-31 00:00:00+03:00,out,False,893674,True,21,0,410,410
166520,2019-10-31 00:00:00+03:00,out,False,923250,False,7,1785,1898,113
166520,2019-10-31 00:00:00+03:00,out,False,892028,True,21,0,508,508
166520,2019-10-31 00:00:00+03:00,out,False,892028,True,21,0,508,508
166520,2019-11-02 00:00:00+03:00,out,False,892028,False,43,1119,1755,636
166520,2019-11-02 00:00:00+03:00,out,False,884946,False,3,189,254,65
166520,2019-11-02 00:00:00+03:00,out,True,893674,False,2,2,2,0
166520,2019-11-02 00:00:00+03:00,out,False,892028,True,19,0,426,426
166520,2019-11-02 00:00:00+03:00,out,True,947480,True,2,0,14,14
166520,2019-11-02 00:00:00+03:00,out,False,893674,False,43,461,1021,560
166520,2019-11-02 00:00:00+03:00,out,False,884946,True,6,0,196,196
166520,2019-11-02 00:00:00+03:00,out,False,893674,True,38,0,870,870
166520,2019-11-02 00:00:00+03:00,in,False,-1,True,7,0,186,186
166520,2019-11-02 00:00:00+03:00,out,True,947480,False,1,219,222,3
166520,2019-11-02 00:00:00+03:00,out,False,884946,False,3,189,254,65
166520,2019-11-05 00:00:00+03:00,in,False,-1,True,1,0,18,18
166520,2019-11-06 00:00:00+03:00,in,False,-1,True,4,0,138,138
166520,2019-11-06 00:00:00+03:00,out,False,893674,False,23,1179,1518,339
166520,2019-11-06 00:00:00+03:00,out,False,930524,False,8,1792,1919,127
166520,2019-11-06 00:00:00+03:00,out,False,893674,True,13,0,325,325
166520,2019-11-07 00:00:00+03:00,out,False,930524,False,2,519,551,32
166520,2019-11-07 00:00:00+03:00,out,False,893674,True,44,0,754,754
166520,2019-11-07 00:00:00+03:00,out,False,892028,False,1,16,29,13
166520,2019-11-07 00:00:00+03:00,out,False,892028,True,1,0,49,49
166520,2019-11-07 00:00:00+03:00,in,False,-1,True,2,0,25,25
166520,2019-11-07 00:00:00+03:00,out,False,910902,False,1,276,292,16
166520,2019-11-07 00:00:00+03:00,out,False,893674,False,51,1498,2254,756
166520,2019-11-11 00:00:00+03:00,in,False,-1,True,11,0,145,145
166520,2019-11-11 00:00:00+03:00,out,False,892028,False,22,677,1033,356
166520,2019-11-11 00:00:00+03:00,out,False,923254,False,1,227,246,19
166520,2019-11-11 00:00:00+03:00,out,False,893674,False,99,2524,4074,1550
166520,2019-11-11 00:00:00+03:00,out,False,893674,True,38,0,657,657
166520,2019-11-11 00:00:00+03:00,out,False,892028,True,11,0,310,310
166520,2019-11-12 00:00:00+03:00,out,False,892028,False,16,420,689,269
166520,2019-11-12 00:00:00+03:00,out,False,893674,True,7,0,169,169
166520,2019-11-12 00:00:00+03:00,out,False,892028,True,5,0,149,149
166520,2019-11-12 00:00:00+03:00,out,False,893674,False,8,137,331,194
166520,2019-11-12 00:00:00+03:00,in,False,-1,True,2,0,60,60
166520,2019-11-13 00:00:00+03:00,in,False,-1,True,5,0,71,71
166520,2019-11-13 00:00:00+03:00,out,False,893674,False,24,1332,1723,391
166520,2019-11-13 00:00:00+03:00,out,False,893674,True,14,0,557,557
166520,2019-11-13 00:00:00+03:00,out,False,930524,False,3,1039,1087,48
166520,2019-11-14 00:00:00+03:00,in,False,-1,True,4,0,70,70
166520,2019-11-14 00:00:00+03:00,out,False,930524,False,3,1298,1350,52
166520,2019-11-14 00:00:00+03:00,out,False,930510,False,1,281,288,7
166520,2019-11-14 00:00:00+03:00,out,False,892028,False,55,1141,1989,848
166520,2019-11-14 00:00:00+03:00,out,False,884946,False,1,51,75,24
166520,2019-11-14 00:00:00+03:00,out,False,892028,True,23,0,573,573
166520,2019-11-14 00:00:00+03:00,out,False,893674,True,8,0,157,157
166520,2019-11-14 00:00:00+03:00,out,False,893674,False,7,403,526,123
166520,2019-11-14 00:00:00+03:00,out,False,890232,False,1,489,510,21
166520,2019-11-14 00:00:00+03:00,out,False,884946,False,1,51,75,24
166520,2019-11-15 00:00:00+03:00,out,False,892028,True,38,0,933,933
166520,2019-11-15 00:00:00+03:00,out,False,893674,False,30,1081,1619,538
166520,2019-11-15 00:00:00+03:00,out,False,930524,False,3,948,998,50
166520,2019-11-15 00:00:00+03:00,out,False,892028,False,33,1122,1687,565
166520,2019-11-15 00:00:00+03:00,out,False,893674,True,21,0,595,595
166520,2019-11-15 00:00:00+03:00,in,False,-1,True,7,0,77,77
166520,2019-11-15 00:00:00+03:00,out,False,910902,False,5,1687,1750,63
166520,2019-11-15 00:00:00+03:00,out,False,892028,False,33,1122,1687,565
166520,2019-11-15 00:00:00+03:00,in,False,-1,True,7,0,77,77
166520,2019-11-18 00:00:00+03:00,out,False,910902,False,1,664,676,12
166520,2019-11-18 00:00:00+03:00,out,False,893674,True,12,0,356,356
166520,2019-11-18 00:00:00+03:00,in,False,-1,True,1,0,8,8
166520,2019-11-18 00:00:00+03:00,out,False,893674,False,16,448,702,254
166520,2019-11-19 00:00:00+03:00,in,False,-1,True,4,0,42,42
166520,2019-11-19 00:00:00+03:00,out,False,893674,False,17,279,626,347
166520,2019-11-19 00:00:00+03:00,out,False,893674,True,13,0,412,412
166520,2019-11-20 00:00:00+03:00,out,False,893674,False,1,24,39,15
166520,2019-11-21 00:00:00+03:00,out,False,930524,False,5,1165,1242,77
166520,2019-11-21 00:00:00+03:00,out,False,893674,True,13,0,363,363
166520,2019-11-21 00:00:00+03:00,out,False,893674,False,27,1189,1521,332
166520,2019-11-21 00:00:00+03:00,in,False,-1,True,3,0,93,93
166520,2019-11-22 00:00:00+03:00,out,False,892028,False,36,1125,1768,643
166520,2019-11-22 00:00:00+03:00,in,False,-1,True,3,0,55,55
166520,2019-11-22 00:00:00+03:00,out,False,892028,True,18,0,447,447
166520,2019-11-22 00:00:00+03:00,out,False,910902,False,2,975,1007,32
166520,2019-11-23 00:00:00+03:00,out,False,893674,True,24,0,709,709
166520,2019-11-23 00:00:00+03:00,out,False,884946,True,12,0,382,382
166520,2019-11-23 00:00:00+03:00,in,False,-1,True,12,0,96,96
166520,2019-11-23 00:00:00+03:00,out,False,892028,False,31,1067,1576,509
166520,2019-11-23 00:00:00+03:00,out,False,884946,False,37,1530,2107,577
166520,2019-11-23 00:00:00+03:00,out,False,930524,False,2,1132,1176,44
166520,2019-11-23 00:00:00+03:00,out,True,893674,True,1,0,0,0
166520,2019-11-23 00:00:00+03:00,out,False,893674,False,46,1940,2727,787
166520,2019-11-23 00:00:00+03:00,out,False,892028,True,28,0,561,561
166520,2019-11-23 00:00:00+03:00,out,False,969600,False,9,3076,3205,129
166520,2019-11-23 00:00:00+03:00,out,False,910902,False,2,632,655,23
166520,2019-11-24 00:00:00+03:00,in,False,-1,True,1,0,47,47
166520,2019-11-26 00:00:00+03:00,in,False,-1,True,8,0,238,238
166520,2019-11-26 00:00:00+03:00,out,False,892028,False,29,1099,1567,468
166520,2019-11-26 00:00:00+03:00,out,False,892028,True,17,0,301,301
166520,2019-11-26 00:00:00+03:00,out,False,884946,True,16,0,449,449
166520,2019-11-26 00:00:00+03:00,out,False,969600,False,10,4747,4878,131
166520,2019-11-26 00:00:00+03:00,out,False,884946,False,35,1190,1851,661
166520,2019-11-26 00:00:00+03:00,out,False,969600,False,10,4747,4878,131
166520,2019-11-27 00:00:00+03:00,out,False,884946,False,24,730,1090,360
166520,2019-11-27 00:00:00+03:00,out,False,893674,False,36,1238,1797,559
166520,2019-11-27 00:00:00+03:00,out,False,892028,True,3,0,53,53
166520,2019-11-27 00:00:00+03:00,in,False,930510,False,1,6,35,29
166520,2019-11-27 00:00:00+03:00,in,False,-1,True,11,0,234,234
166520,2019-11-27 00:00:00+03:00,out,False,892028,False,10,359,512,153
166520,2019-11-27 00:00:00+03:00,out,False,893674,True,23,0,606,606
166520,2019-11-27 00:00:00+03:00,out,False,930524,False,2,1283,1308,25
166520,2019-11-27 00:00:00+03:00,out,False,884946,True,9,0,197,197
166520,2019-11-27 00:00:00+03:00,in,False,923254,False,1,55,100,45
166533,2019-08-08 00:00:00+03:00,in,False,884478,False,1,79,94,15
166533,2019-08-08 00:00:00+03:00,out,False,884478,False,6,152,257,105
166533,2019-08-08 00:00:00+03:00,out,False,884478,True,14,0,256,256
166533,2019-08-09 00:00:00+03:00,out,False,884478,True,36,0,454,454
166533,2019-08-09 00:00:00+03:00,out,False,884478,False,25,1362,1607,245
166533,2019-08-09 00:00:00+03:00,out,True,884478,True,2,0,0,0
166533,2019-08-12 00:00:00+03:00,out,False,884478,False,43,2069,2628,559
166533,2019-08-12 00:00:00+03:00,out,False,884478,True,68,0,1349,1349
166533,2019-08-13 00:00:00+03:00,out,False,884478,True,63,0,1009,1009
166533,2019-08-13 00:00:00+03:00,out,True,884478,True,1,0,0,0
166533,2019-08-13 00:00:00+03:00,in,False,884478,False,2,205,227,22
166533,2019-08-13 00:00:00+03:00,out,False,884478,False,41,2249,2658,409
166533,2019-08-14 00:00:00+03:00,in,False,884478,False,3,264,303,39
166533,2019-08-14 00:00:00+03:00,out,False,884478,True,53,0,645,645
166533,2019-08-14 00:00:00+03:00,out,False,884478,False,48,2928,3548,620
166533,2019-08-14 00:00:00+03:00,in,False,-1,True,1,0,23,23
166533,2019-08-15 00:00:00+03:00,out,False,884478,False,64,3235,3876,641
166533,2019-08-15 00:00:00+03:00,out,False,884478,True,47,0,846,846
166533,2019-08-15 00:00:00+03:00,in,False,-1,True,1,0,46,46
166533,2019-08-15 00:00:00+03:00,in,False,884478,False,3,233,291,58
166533,2019-08-16 00:00:00+03:00,out,False,884478,True,19,0,584,584
166533,2019-08-16 00:00:00+03:00,in,False,884478,False,3,127,148,21
166533,2019-08-16 00:00:00+03:00,out,False,884478,False,26,1407,1710,303
166533,2019-08-19 00:00:00+03:00,in,False,-1,True,1,0,56,56
166533,2019-08-19 00:00:00+03:00,out,False,884478,False,34,1146,1603,457
166533,2019-08-19 00:00:00+03:00,out,False,884478,True,17,0,378,378
166533,2019-08-20 00:00:00+03:00,in,False,884478,False,2,16,37,21
166533,2019-08-20 00:00:00+03:00,out,False,884478,False,55,2577,3292,715
166533,2019-08-20 00:00:00+03:00,in,False,-1,True,1,0,14,14
166533,2019-08-20 00:00:00+03:00,out,False,884478,True,33,0,625,625
166533,2019-08-20 00:00:00+03:00,in,False,-1,True,1,0,14,14
166533,2019-08-21 00:00:00+03:00,out,False,884478,False,49,2370,3070,700
166533,2019-08-21 00:00:00+03:00,out,False,884478,True,19,0,272,272
166533,2019-08-21 00:00:00+03:00,out,False,884478,True,19,0,272,272
166533,2019-08-22 00:00:00+03:00,out,False,884478,False,39,1551,2073,522
166533,2019-08-22 00:00:00+03:00,out,False,884478,True,27,0,564,564
166533,2019-08-23 00:00:00+03:00,out,False,884478,True,42,0,923,923
166533,2019-08-23 00:00:00+03:00,out,False,884478,False,42,2234,2722,488
166533,2019-08-23 00:00:00+03:00,in,False,884478,False,1,27,36,9
166533,2019-08-23 00:00:00+03:00,in,False,884478,False,1,27,36,9
166533,2019-08-26 00:00:00+03:00,out,False,884478,False,40,2012,2435,423
166533,2019-08-26 00:00:00+03:00,out,False,884478,True,14,0,345,345
166533,2019-08-27 00:00:00+03:00,out,False,884478,True,24,0,499,499
166533,2019-08-27 00:00:00+03:00,out,False,884478,False,39,2156,2628,472
166533,2019-08-27 00:00:00+03:00,in,False,-1,True,1,0,10,10
166533,2019-08-27 00:00:00+03:00,in,False,884478,False,1,25,31,6
166533,2019-08-28 00:00:00+03:00,out,False,884478,True,33,0,561,561
166533,2019-08-28 00:00:00+03:00,out,False,884478,False,50,2355,2990,635
166533,2019-08-29 00:00:00+03:00,out,False,884478,False,37,1321,1752,431
166533,2019-08-29 00:00:00+03:00,out,False,884478,True,32,0,654,654
166533,2019-08-29 00:00:00+03:00,out,False,884478,False,37,1321,1752,431
166533,2019-08-30 00:00:00+03:00,out,False,884478,False,42,2003,2635,632
166533,2019-08-30 00:00:00+03:00,out,False,884478,True,39,0,544,544
166533,2019-09-03 00:00:00+03:00,out,False,884478,False,65,3045,3987,942
166533,2019-09-03 00:00:00+03:00,out,False,884478,True,67,0,1450,1450
166533,2019-09-03 00:00:00+03:00,in,False,884478,False,2,57,70,13
166533,2019-09-03 00:00:00+03:00,in,False,884478,False,2,57,70,13
166533,2019-09-04 00:00:00+03:00,out,False,884478,False,69,2210,3083,873
166533,2019-09-04 00:00:00+03:00,out,False,884478,True,60,0,1096,1096
166533,2019-09-05 00:00:00+03:00,out,False,884478,False,64,1758,2589,831
166533,2019-09-05 00:00:00+03:00,out,False,884478,True,88,0,1862,1862
166533,2019-09-05 00:00:00+03:00,in,False,-1,True,2,0,38,38
166533,2019-09-06 00:00:00+03:00,out,False,884478,False,61,2447,3359,912
166533,2019-09-06 00:00:00+03:00,in,False,884478,False,2,57,99,42
166533,2019-09-06 00:00:00+03:00,in,False,-1,True,1,0,20,20
166533,2019-09-06 00:00:00+03:00,out,False,884478,True,53,0,1218,1218
166533,2019-09-09 00:00:00+03:00,out,False,884478,True,42,0,537,537
166533,2019-09-09 00:00:00+03:00,in,False,884478,False,1,47,54,7
166533,2019-09-09 00:00:00+03:00,out,False,884478,False,40,1423,1896,473
166533,2019-09-12 00:00:00+03:00,out,False,884478,True,74,0,1468,1468
166533,2019-09-12 00:00:00+03:00,out,False,884478,False,29,885,1215,330
166533,2019-09-13 00:00:00+03:00,in,False,884478,False,1,18,88,70
166533,2019-09-13 00:00:00+03:00,out,False,884478,True,37,0,744,744
166533,2019-09-13 00:00:00+03:00,out,False,884478,False,45,1649,2131,482
166533,2019-09-16 00:00:00+03:00,out,False,884478,True,88,0,1638,1638
166533,2019-09-16 00:00:00+03:00,out,False,884478,False,35,966,1357,391
166533,2019-09-17 00:00:00+03:00,out,False,884478,False,16,575,677,102
166533,2019-09-17 00:00:00+03:00,out,False,884478,True,30,0,834,834
166533,2019-09-18 00:00:00+03:00,in,False,-1,True,1,0,25,25
166533,2019-09-18 00:00:00+03:00,out,False,884478,True,5,0,138,138
166533,2019-09-20 00:00:00+03:00,out,False,884478,True,1,0,4,4
166533,2019-09-24 00:00:00+03:00,out,False,884478,True,2,0,77,77
166533,2019-09-24 00:00:00+03:00,out,False,884478,False,1,2,23,21
166533,2019-09-24 00:00:00+03:00,out,False,884478,True,2,0,77,77
166533,2019-09-24 00:00:00+03:00,out,False,884478,False,1,2,23,21
166533,2019-09-25 00:00:00+03:00,in,False,-1,True,1,0,0,0
166533,2019-09-25 00:00:00+03:00,out,False,884478,True,1,0,1,1
166533,2019-09-26 00:00:00+03:00,out,False,884478,True,5,0,98,98
166533,2019-09-26 00:00:00+03:00,out,False,884478,False,4,104,188,84
166533,2019-09-30 00:00:00+03:00,out,False,884478,True,2,0,62,62
166533,2019-10-04 00:00:00+03:00,out,False,884478,False,1,38,50,12
166533,2019-10-04 00:00:00+03:00,out,False,884478,True,1,0,24,24
166533,2019-10-08 00:00:00+03:00,out,False,884478,True,4,0,74,74
166533,2019-10-08 00:00:00+03:00,out,False,884478,False,1,36,40,4
166533,2019-10-08 00:00:00+03:00,out,False,884478,True,4,0,74,74
166533,2019-10-10 00:00:00+03:00,out,False,884478,True,1,0,21,21
166533,2019-10-10 00:00:00+03:00,out,True,884478,True,1,0,0,0
166533,2019-10-13 00:00:00+03:00,in,False,-1,True,1,0,0,0
166533,2019-10-15 00:00:00+03:00,out,False,884478,False,1,27,41,14
166533,2019-10-15 00:00:00+03:00,out,False,884478,True,2,0,78,78
166533,2019-10-15 00:00:00+03:00,in,False,-1,True,1,0,3,3
166533,2019-10-16 00:00:00+03:00,out,False,884478,True,1,0,60,60
166533,2019-10-18 00:00:00+03:00,out,False,884478,False,3,106,122,16
166533,2019-10-18 00:00:00+03:00,out,False,884478,True,7,0,172,172
166533,2019-10-18 00:00:00+03:00,out,False,884478,False,3,106,122,16
166533,2019-11-05 00:00:00+03:00,in,False,-1,True,1,0,2,2
166536,2019-08-17 00:00:00+03:00,in,False,884524,False,1,22,29,7
166536,2019-08-20 00:00:00+03:00,in,False,884524,False,1,28,40,12
166536,2019-08-20 00:00:00+03:00,in,False,-1,True,1,0,14,14
166536,2019-08-20 00:00:00+03:00,in,False,884524,False,1,28,40,12
166536,2019-08-30 00:00:00+03:00,in,False,900192,False,1,2,7,5
166536,2019-08-30 00:00:00+03:00,in,False,-1,True,4,0,55,55
166536,2019-08-30 00:00:00+03:00,in,False,900194,False,2,28,98,70
166536,2019-08-30 00:00:00+03:00,in,False,-1,True,8,0,22,22
166536,2019-08-30 00:00:00+03:00,out,False,900192,True,1,0,5,5
166536,2019-08-30 00:00:00+03:00,in,False,900192,False,1,2,7,5
166536,2019-09-02 00:00:00+03:00,in,False,900194,False,1,275,286,11
166536,2019-09-03 00:00:00+03:00,in,False,900194,False,1,29,46,17
166536,2019-09-04 00:00:00+03:00,in,False,900194,False,1,57,70,13
166536,2019-09-05 00:00:00+03:00,in,False,-1,True,1,0,332,332
166536,2019-09-09 00:00:00+03:00,in,False,900194,False,1,130,143,13
166536,2019-09-10 00:00:00+03:00,in,False,900194,False,1,65,81,16
166536,2019-09-10 00:00:00+03:00,in,False,-1,True,1,0,34,34
166536,2019-09-11 00:00:00+03:00,in,False,900194,False,1,25,42,17
166536,2019-09-16 00:00:00+03:00,in,False,-1,True,1,0,30,30
166536,2019-09-16 00:00:00+03:00,out,False,900194,False,1,304,330,26
166536,2019-09-17 00:00:00+03:00,in,False,900194,False,2,221,253,32
166536,2019-09-18 00:00:00+03:00,in,False,-1,True,1,0,41,41
166536,2019-09-18 00:00:00+03:00,out,False,900194,False,1,110,128,18
166536,2019-09-20 00:00:00+03:00,out,False,900194,True,1,0,67,67
166536,2019-09-20 00:00:00+03:00,in,False,-1,True,1,0,8,8
166536,2019-09-20 00:00:00+03:00,out,False,900194,True,1,0,67,67
166536,2019-09-21 00:00:00+03:00,out,False,900194,False,1,28,53,25
166536,2019-09-21 00:00:00+03:00,in,False,-1,True,1,0,91,91
166536,2019-09-23 00:00:00+03:00,in,False,900194,False,2,585,599,14
166536,2019-09-23 00:00:00+03:00,out,False,900194,True,4,0,203,203
166536,2019-09-23 00:00:00+03:00,out,False,900194,False,4,921,1009,88
166536,2019-09-23 00:00:00+03:00,out,False,900194,False,4,921,1009,88
166536,2019-09-24 00:00:00+03:00,in,False,900194,False,2,645,668,23
166536,2019-09-24 00:00:00+03:00,out,False,900194,True,1,0,21,21
166536,2019-09-24 00:00:00+03:00,out,False,900194,False,1,150,171,21
166536,2019-09-25 00:00:00+03:00,in,False,900194,False,1,15,24,9
166536,2019-09-25 00:00:00+03:00,out,False,900194,False,1,21,39,18
166536,2019-09-25 00:00:00+03:00,out,False,900194,True,3,0,58,58
166536,2019-09-25 00:00:00+03:00,in,False,-1,True,2,0,197,197
166536,2019-09-26 00:00:00+03:00,out,False,900194,True,1,0,43,43
166536,2019-09-26 00:00:00+03:00,in,False,-1,True,3,0,96,96
166536,2019-09-27 00:00:00+03:00,in,False,-1,True,3,0,11,11
166536,2019-09-27 00:00:00+03:00,out,False,900194,False,5,1146,1285,139
166536,2019-09-30 00:00:00+03:00,in,False,900194,False,1,154,167,13
166536,2019-10-01 00:00:00+03:00,in,False,-1,True,1,0,63,63
166536,2019-10-01 00:00:00+03:00,out,False,900194,True,2,0,89,89
166536,2019-10-01 00:00:00+03:00,in,False,900194,False,1,495,508,13
166536,2019-10-02 00:00:00+03:00,in,False,900194,False,2,580,593,13
166536,2019-10-02 00:00:00+03:00,out,False,900194,True,2,0,125,125
166536,2019-10-02 00:00:00+03:00,out,False,900194,False,3,961,1004,43
166536,2019-10-02 00:00:00+03:00,in,False,-1,True,1,0,29,29
166536,2019-10-02 00:00:00+03:00,in,False,-1,True,1,0,29,29
166536,2019-10-03 00:00:00+03:00,out,False,900194,True,2,0,91,91
166536,2019-10-03 00:00:00+03:00,in,False,900194,False,3,417,453,36
166536,2019-10-03 00:00:00+03:00,out,False,900194,False,1,19,36,17
166536,2019-10-03 00:00:00+03:00,in,False,-1,True,1,0,1,1
166536,2019-10-04 00:00:00+03:00,in,False,900194,False,5,622,800,178
166536,2019-10-07 00:00:00+03:00,in,False,900194,False,2,495,529,34
166536,2019-10-07 00:00:00+03:00,out,True,925826,True,2,0,5,5
166536,2019-10-07 00:00:00+03:00,out,True,925826,False,1,7,13,6
166536,2019-10-07 00:00:00+03:00,out,False,900194,True,1,0,27,27
166536,2019-10-08 00:00:00+03:00,out,False,925828,True,2,0,73,73
166536,2019-10-08 00:00:00+03:00,out,False,925826,False,4,668,729,61
166536,2019-10-08 00:00:00+03:00,out,False,925826,True,3,0,187,187
166536,2019-10-08 00:00:00+03:00,in,False,925828,False,1,95,108,13
166536,2019-10-09 00:00:00+03:00,in,False,925826,False,3,355,385,30
166536,2019-10-09 00:00:00+03:00,out,False,925826,False,4,444,497,53
166536,2019-10-09 00:00:00+03:00,in,False,-1,True,1,0,2,2
166536,2019-10-09 00:00:00+03:00,out,False,925828,False,2,91,111,20
166536,2019-10-09 00:00:00+03:00,out,False,925826,True,4,0,116,116
166536,2019-10-09 00:00:00+03:00,in,False,925828,False,2,1058,1075,17
166536,2019-10-09 00:00:00+03:00,in,False,925826,False,3,355,385,30
166536,2019-10-09 00:00:00+03:00,out,False,925826,False,4,444,497,53
166536,2019-10-10 00:00:00+03:00,in,False,925826,False,3,413,437,24
166536,2019-10-10 00:00:00+03:00,out,False,900194,False,1,411,433,22
166536,2019-10-10 00:00:00+03:00,out,False,925828,False,7,993,1104,111
166536,2019-10-10 00:00:00+03:00,out,False,925828,True,3,0,57,57
166536,2019-10-10 00:00:00+03:00,in,False,-1,True,2,0,10,10
166536,2019-10-10 00:00:00+03:00,out,False,925826,True,6,0,155,155
166536,2019-10-10 00:00:00+03:00,out,False,925826,False,10,674,766,92
166536,2019-10-10 00:00:00+03:00,in,False,925828,False,2,730,740,10
166536,2019-10-10 00:00:00+03:00,in,False,900194,False,2,638,698,60
166536,2019-10-10 00:00:00+03:00,out,False,925826,False,10,674,766,92
166536,2019-10-10 00:00:00+03:00,out,False,925828,False,7,993,1104,111
166536,2019-10-11 00:00:00+03:00,in,False,-1,True,6,0,104,104
166536,2019-10-11 00:00:00+03:00,in,False,900194,False,1,87,107,20
166536,2019-10-11 00:00:00+03:00,in,False,925826,False,2,362,374,12
166536,2019-10-11 00:00:00+03:00,out,False,925828,True,5,0,162,162
166536,2019-10-11 00:00:00+03:00,out,False,925826,True,7,0,112,112
166536,2019-10-11 00:00:00+03:00,out,False,925826,False,12,1113,1267,154
166536,2019-10-11 00:00:00+03:00,in,False,925828,False,3,385,408,23
166536,2019-10-11 00:00:00+03:00,out,False,925828,False,10,1364,1519,155
166536,2019-10-11 00:00:00+03:00,in,False,900194,False,1,87,107,20
166536,2019-10-11 00:00:00+03:00,in,False,-1,True,6,0,104,104
166536,2019-10-12 00:00:00+03:00,in,False,-1,True,1,0,10,10
166536,2019-10-14 00:00:00+03:00,in,False,900194,False,2,127,149,22
166536,2019-10-14 00:00:00+03:00,out,False,925828,False,9,1222,1385,163
166536,2019-10-14 00:00:00+03:00,out,False,925828,True,8,0,314,314
166536,2019-10-14 00:00:00+03:00,in,False,925826,False,2,121,133,12
166536,2019-10-14 00:00:00+03:00,in,False,-1,True,2,0,67,67
166536,2019-10-14 00:00:00+03:00,out,False,925826,False,3,601,635,34
166536,2019-10-14 00:00:00+03:00,in,False,925828,False,4,477,505,28
166536,2019-10-15 00:00:00+03:00,out,False,925826,True,4,0,138,138
166536,2019-10-15 00:00:00+03:00,in,False,900194,False,1,74,114,40
166536,2019-10-15 00:00:00+03:00,out,False,925826,False,11,908,1141,233
166536,2019-10-15 00:00:00+03:00,out,False,925828,False,2,31,62,31
166536,2019-10-15 00:00:00+03:00,out,False,925828,True,3,0,80,80
166536,2019-10-15 00:00:00+03:00,in,False,925828,False,1,40,45,5
166536,2019-10-15 00:00:00+03:00,in,False,925826,False,6,837,878,41
166536,2019-10-15 00:00:00+03:00,in,False,900194,False,1,74,114,40
166536,2019-10-15 00:00:00+03:00,in,False,925828,False,1,40,45,5
166536,2019-10-16 00:00:00+03:00,out,False,925826,False,10,998,1145,147
166536,2019-10-16 00:00:00+03:00,out,False,925828,False,9,999,1128,129
166536,2019-10-16 00:00:00+03:00,in,False,925826,False,5,844,888,44
166536,2019-10-16 00:00:00+03:00,in,False,-1,True,1,0,1,1
166536,2019-10-16 00:00:00+03:00,out,False,925828,True,3,0,116,116
166536,2019-10-16 00:00:00+03:00,out,False,925826,True,6,0,221,221
166536,2019-10-16 00:00:00+03:00,in,False,925828,False,3,496,513,17
166536,2019-10-17 00:00:00+03:00,in,False,925826,False,4,1156,1183,27
166536,2019-10-17 00:00:00+03:00,out,False,925828,False,5,265,342,77
166536,2019-10-17 00:00:00+03:00,in,False,-1,True,1,0,5,5
166536,2019-10-17 00:00:00+03:00,out,False,925826,False,2,417,441,24
166536,2019-10-17 00:00:00+03:00,in,False,925828,False,4,299,325,26
166536,2019-10-17 00:00:00+03:00,out,False,925828,True,2,0,18,18
166536,2019-10-18 00:00:00+03:00,out,False,925828,True,1,0,26,26
166536,2019-10-18 00:00:00+03:00,out,False,925826,True,9,0,315,315
166536,2019-10-18 00:00:00+03:00,in,False,-1,True,1,0,9,9
166536,2019-10-18 00:00:00+03:00,in,False,925826,False,1,208,215,7
166536,2019-10-18 00:00:00+03:00,out,False,925826,False,10,1083,1203,120
166536,2019-10-18 00:00:00+03:00,in,False,925828,False,3,442,457,15
166536,2019-10-18 00:00:00+03:00,out,False,925828,False,4,501,544,43
166536,2019-10-18 00:00:00+03:00,out,False,925828,False,4,501,544,43
166536,2019-10-21 00:00:00+03:00,out,False,900194,False,1,46,59,13
166536,2019-10-21 00:00:00+03:00,in,False,925826,False,2,100,111,11
166536,2019-10-21 00:00:00+03:00,in,False,900194,False,2,157,191,34
166536,2019-10-21 00:00:00+03:00,out,False,925826,True,2,0,59,59
166536,2019-10-21 00:00:00+03:00,in,False,-1,True,4,0,101,101
166536,2019-10-21 00:00:00+03:00,out,False,925826,False,3,124,167,43
166536,2019-10-21 00:00:00+03:00,in,False,900194,False,2,157,191,34
166536,2019-10-21 00:00:00+03:00,in,False,-1,True,4,0,101,101
166536,2019-10-22 00:00:00+03:00,in,False,925826,False,5,384,410,26
166536,2019-10-22 00:00:00+03:00,out,False,925828,True,9,0,139,139
166536,2019-10-22 00:00:00+03:00,in,False,925828,False,3,412,426,14
166536,2019-10-22 00:00:00+03:00,in,False,900194,False,1,59,72,13
166536,2019-10-22 00:00:00+03:00,in,False,-1,True,2,0,95,95
166536,2019-10-22 00:00:00+03:00,out,False,925826,True,6,0,263,263
166536,2019-10-22 00:00:00+03:00,out,False,925828,False,2,169,216,47
166536,2019-10-22 00:00:00+03:00,out,False,925826,False,14,1272,1510,238
166536,2019-10-22 00:00:00+03:00,out,False,925828,True,9,0,139,139
166536,2019-10-23 00:00:00+03:00,out,False,925828,True,2,0,26,26
166536,2019-10-23 00:00:00+03:00,out,False,925828,False,1,28,44,16
166536,2019-10-23 00:00:00+03:00,out,False,-1,True,1,0,0,0
166536,2019-10-23 00:00:00+03:00,out,False,925826,True,6,0,222,222
166536,2019-10-23 00:00:00+03:00,in,False,-1,True,3,0,79,79
166536,2019-10-23 00:00:00+03:00,in,False,925828,False,3,620,656,36
166536,2019-10-23 00:00:00+03:00,out,False,925826,False,16,1936,2165,229
166536,2019-10-23 00:00:00+03:00,in,False,925826,False,8,1539,1583,44
166536,2019-10-24 00:00:00+03:00,in,False,-1,True,5,0,117,117
166536,2019-10-24 00:00:00+03:00,out,False,925826,True,7,0,161,161
166536,2019-10-24 00:00:00+03:00,in,False,925826,False,8,1279,1333,54
166536,2019-10-24 00:00:00+03:00,out,False,925826,False,14,1844,1991,147
166536,2019-10-24 00:00:00+03:00,in,False,925828,False,3,138,156,18
166536,2019-10-24 00:00:00+03:00,out,False,925828,False,5,238,318,80
166536,2019-10-24 00:00:00+03:00,out,False,925828,True,7,0,117,117
166536,2019-10-25 00:00:00+03:00,in,False,925826,False,5,257,288,31
166536,2019-10-25 00:00:00+03:00,in,False,925828,False,6,1792,1825,33
166536,2019-10-25 00:00:00+03:00,out,False,925828,True,4,0,39,39
166536,2019-10-25 00:00:00+03:00,out,True,925826,False,1,726,743,17
166536,2019-10-25 00:00:00+03:00,in,False,-1,True,5,0,74,74
166536,2019-10-25 00:00:00+03:00,out,True,925826,True,1,0,0,0
166536,2019-10-25 00:00:00+03:00,out,False,925826,True,11,0,376,376
166536,2019-10-25 00:00:00+03:00,out,False,925826,False,14,2137,2276,139
166536,2019-10-25 00:00:00+03:00,out,False,925828,False,10,449,582,133
166536,2019-10-25 00:00:00+03:00,out,False,925826,False,14,2137,2276,139
166536,2019-10-26 00:00:00+03:00,in,False,-1,True,2,0,36,36
166536,2019-10-27 00:00:00+03:00,in,False,-1,True,2,0,39,39
166536,2019-10-27 00:00:00+03:00,out,False,900194,True,1,0,16,16
166536,2019-10-27 00:00:00+03:00,in,False,900194,False,1,184,200,16
166536,2019-10-27 00:00:00+03:00,out,False,900194,True,1,0,16,16
166536,2019-10-28 00:00:00+03:00,out,False,900194,False,1,212,274,62
166536,2019-10-28 00:00:00+03:00,out,False,925826,False,6,586,656,70
166536,2019-10-28 00:00:00+03:00,in,False,925826,False,6,294,328,34
166536,2019-10-28 00:00:00+03:00,in,False,900194,False,2,324,415,91
166536,2019-10-29 00:00:00+03:00,in,False,-1,True,4,0,7,7
166536,2019-10-29 00:00:00+03:00,in,False,925826,False,4,1175,1195,20
166536,2019-10-29 00:00:00+03:00,in,False,925828,False,5,1245,1272,27
166536,2019-10-29 00:00:00+03:00,in,False,900194,False,1,139,170,31
166536,2019-10-29 00:00:00+03:00,out,False,925828,False,7,464,577,113
166536,2019-10-29 00:00:00+03:00,out,False,925826,False,8,483,562,79
166536,2019-10-29 00:00:00+03:00,out,False,925828,True,7,0,213,213
166536,2019-10-30 00:00:00+03:00,out,False,925826,True,4,0,133,133
166536,2019-10-30 00:00:00+03:00,out,False,925826,False,7,892,1016,124
166536,2019-10-30 00:00:00+03:00,in,False,925826,False,4,524,547,23
166536,2019-10-30 00:00:00+03:00,out,False,925828,True,3,0,90,90
166536,2019-10-30 00:00:00+03:00,out,False,925828,False,7,1234,1315,81
166536,2019-10-31 00:00:00+03:00,out,False,925828,True,6,0,124,124
166536,2019-10-31 00:00:00+03:00,in,False,-1,True,6,0,106,106
166536,2019-10-31 00:00:00+03:00,out,False,925826,True,8,0,186,186
166536,2019-10-31 00:00:00+03:00,out,False,925826,False,12,1578,1715,137
166536,2019-10-31 00:00:00+03:00,out,False,925828,False,9,608,764,156
166536,2019-10-31 00:00:00+03:00,in,False,925826,False,7,1313,1373,60
166536,2019-10-31 00:00:00+03:00,in,False,925828,False,8,2053,2107,54
166536,2019-10-31 00:00:00+03:00,out,False,925828,True,6,0,124,124
166536,2019-11-01 00:00:00+03:00,out,False,925828,True,9,0,123,123
166536,2019-11-01 00:00:00+03:00,out,True,925826,True,1,0,0,0
166536,2019-11-01 00:00:00+03:00,out,False,925828,False,7,816,887,71
166536,2019-11-01 00:00:00+03:00,out,False,925826,False,9,989,1114,125
166536,2019-11-01 00:00:00+03:00,in,False,925828,False,4,263,300,37
166536,2019-11-01 00:00:00+03:00,in,False,925826,False,7,900,954,54
166536,2019-11-01 00:00:00+03:00,out,False,925826,True,3,0,50,50
166536,2019-11-01 00:00:00+03:00,out,True,925826,True,1,0,0,0
166536,2019-11-03 00:00:00+03:00,in,False,-1,True,1,0,27,27
166536,2019-11-05 00:00:00+03:00,in,False,925828,False,4,1019,1047,28
166536,2019-11-05 00:00:00+03:00,out,False,900194,False,1,175,212,37
166536,2019-11-05 00:00:00+03:00,in,False,925826,False,4,782,811,29
166536,2019-11-05 00:00:00+03:00,out,False,925826,False,3,218,256,38
166536,2019-11-05 00:00:00+03:00,out,False,925828,False,12,2597,2743,146
166536,2019-11-05 00:00:00+03:00,in,False,-1,True,3,0,20,20
166536,2019-11-05 00:00:00+03:00,out,False,925828,True,9,0,154,154
166536,2019-11-06 00:00:00+03:00,out,False,925826,True,4,0,101,101
166536,2019-11-06 00:00:00+03:00,out,False,925828,True,6,0,84,84
166536,2019-11-06 00:00:00+03:00,in,False,-1,True,4,0,22,22
166536,2019-11-06 00:00:00+03:00,out,False,925828,False,7,528,637,109
166536,2019-11-06 00:00:00+03:00,out,False,925826,False,9,831,904,73
166536,2019-11-06 00:00:00+03:00,in,False,900194,False,1,52,71,19
166536,2019-11-06 00:00:00+03:00,in,False,925828,False,2,177,190,13
166536,2019-11-06 00:00:00+03:00,in,False,925826,False,1,223,231,8
166536,2019-11-06 00:00:00+03:00,in,False,925826,False,1,223,231,8
166536,2019-11-06 00:00:00+03:00,in,False,900194,False,1,52,71,19
166536,2019-11-07 00:00:00+03:00,out,False,925826,True,4,0,147,147
166536,2019-11-07 00:00:00+03:00,in,False,925826,False,7,1535,1578,43
166536,2019-11-07 00:00:00+03:00,out,False,925828,False,6,919,1029,110
166536,2019-11-07 00:00:00+03:00,out,False,925826,False,9,490,616,126
166536,2019-11-07 00:00:00+03:00,in,False,-1,True,1,0,1,1
166536,2019-11-07 00:00:00+03:00,out,False,925828,True,11,0,122,122
166536,2019-11-07 00:00:00+03:00,in,False,925828,False,6,1884,1922,38
166536,2019-11-08 00:00:00+03:00,out,False,925826,False,15,1921,2098,177
166536,2019-11-08 00:00:00+03:00,out,False,925828,True,5,0,121,121
166536,2019-11-08 00:00:00+03:00,out,False,925826,True,3,0,149,149
166536,2019-11-08 00:00:00+03:00,out,False,925828,False,5,635,696,61
166536,2019-11-08 00:00:00+03:00,in,False,925828,False,10,1233,1292,59
166536,2019-11-08 00:00:00+03:00,in,False,-1,True,1,0,8,8
166536,2019-11-08 00:00:00+03:00,in,False,925826,False,5,1169,1216,47
166536,2019-11-08 00:00:00+03:00,in,False,925828,False,10,1233,1292,59
166536,2019-11-08 00:00:00+03:00,out,False,925828,False,5,635,696,61
166536,2019-11-08 00:00:00+03:00,out,False,925828,True,5,0,121,121
166536,2019-11-09 00:00:00+03:00,in,False,900194,False,1,553,584,31
166536,2019-11-11 00:00:00+03:00,in,False,925826,True,1,1,5,4
166536,2019-11-11 00:00:00+03:00,out,False,925826,True,6,0,195,195
166536,2019-11-11 00:00:00+03:00,in,False,925828,False,9,1193,1237,44
166536,2019-11-11 00:00:00+03:00,out,False,925826,False,12,1124,1339,215
166536,2019-11-11 00:00:00+03:00,in,False,925826,False,7,1447,1521,74
166536,2019-11-11 00:00:00+03:00,out,False,925828,True,2,0,13,13
166536,2019-11-11 00:00:00+03:00,out,False,925828,False,13,2137,2267,130
166536,2019-11-12 00:00:00+03:00,in,False,925828,False,2,379,387,8
166536,2019-11-12 00:00:00+03:00,out,False,925826,True,1,0,10,10
166536,2019-11-12 00:00:00+03:00,in,False,925826,False,1,86,94,8
166536,2019-11-12 00:00:00+03:00,in,False,-1,True,3,0,90,90
166536,2019-11-12 00:00:00+03:00,out,False,925828,True,4,0,31,31
166536,2019-11-12 00:00:00+03:00,out,False,925826,False,11,756,916,160
166536,2019-11-12 00:00:00+03:00,out,False,900194,True,1,0,45,45
166536,2019-11-12 00:00:00+03:00,in,False,900194,False,2,135,159,24
166536,2019-11-12 00:00:00+03:00,out,False,925828,False,8,1372,1490,118
166536,2019-11-12 00:00:00+03:00,in,False,925826,False,1,86,94,8
166536,2019-11-13 00:00:00+03:00,in,False,925828,False,1,89,94,5
166536,2019-11-13 00:00:00+03:00,in,False,925826,False,3,708,724,16
166536,2019-11-13 00:00:00+03:00,out,False,925828,False,6,1193,1293,100
166536,2019-11-13 00:00:00+03:00,out,False,925826,False,9,673,784,111
166536,2019-11-13 00:00:00+03:00,out,False,925826,True,7,0,277,277
166536,2019-11-13 00:00:00+03:00,out,False,925828,True,10,0,254,254
166536,2019-11-13 00:00:00+03:00,out,False,925828,True,10,0,254,254
166536,2019-11-13 00:00:00+03:00,in,False,925826,False,3,708,724,16
166536,2019-11-14 00:00:00+03:00,out,False,900194,False,1,272,295,23
166536,2019-11-14 00:00:00+03:00,in,False,925828,False,5,1272,1296,24
166536,2019-11-14 00:00:00+03:00,out,False,925826,False,5,1022,1115,93
166536,2019-11-14 00:00:00+03:00,out,False,925828,True,2,0,45,45
166536,2019-11-14 00:00:00+03:00,out,False,925828,False,6,1300,1406,106
166536,2019-11-14 00:00:00+03:00,out,False,925826,True,5,0,215,215
166536,2019-11-14 00:00:00+03:00,in,False,925826,False,5,921,959,38
166536,2019-11-14 00:00:00+03:00,in,False,-1,True,2,0,74,74
166536,2019-11-15 00:00:00+03:00,in,False,925826,False,2,172,182,10
166536,2019-11-15 00:00:00+03:00,out,False,925826,False,11,1374,1519,145
166536,2019-11-15 00:00:00+03:00,out,False,925828,True,12,0,256,256
166536,2019-11-15 00:00:00+03:00,in,False,900194,False,1,26,41,15
166536,2019-11-15 00:00:00+03:00,in,False,925828,False,4,983,1008,25
166536,2019-11-15 00:00:00+03:00,out,False,925828,False,13,1014,1165,151
166536,2019-11-15 00:00:00+03:00,in,False,-1,True,1,0,6,6
166536,2019-11-15 00:00:00+03:00,out,False,925826,True,1,0,49,49
166536,2019-11-16 00:00:00+03:00,in,False,900194,False,1,537,562,25
166536,2019-11-16 00:00:00+03:00,in,False,-1,True,3,0,38,38
166536,2019-11-18 00:00:00+03:00,out,False,925828,False,11,877,1003,126
166536,2019-11-18 00:00:00+03:00,out,False,925826,False,22,1593,1838,245
166536,2019-11-18 00:00:00+03:00,in,False,925826,False,6,859,895,36
166536,2019-11-18 00:00:00+03:00,out,False,925826,True,12,0,159,159
166536,2019-11-18 00:00:00+03:00,in,False,925828,False,8,1996,2039,43
166536,2019-11-18 00:00:00+03:00,in,False,900194,False,1,92,105,13
166536,2019-11-19 00:00:00+03:00,out,False,925828,True,6,0,191,191
166536,2019-11-19 00:00:00+03:00,out,False,925826,False,2,168,195,27
166536,2019-11-19 00:00:00+03:00,out,False,925828,False,5,456,522,66
166536,2019-11-19 00:00:00+03:00,in,False,925826,False,6,1798,1842,44
166536,2019-11-19 00:00:00+03:00,in,False,-1,True,1,0,4,4
166536,2019-11-19 00:00:00+03:00,out,False,925826,True,1,0,60,60
166536,2019-11-19 00:00:00+03:00,in,False,925828,False,6,746,781,35
166536,2019-11-20 00:00:00+03:00,in,False,925828,False,10,893,956,63
166536,2019-11-20 00:00:00+03:00,out,False,925828,True,4,0,140,140
166536,2019-11-20 00:00:00+03:00,out,False,925826,False,12,1150,1315,165
166536,2019-11-20 00:00:00+03:00,in,False,900194,True,1,0,44,44
166536,2019-11-20 00:00:00+03:00,in,False,925826,False,4,331,363,32
166536,2019-11-20 00:00:00+03:00,out,False,925826,True,8,0,115,115
166536,2019-11-20 00:00:00+03:00,in,False,-1,True,1,0,11,11
166536,2019-11-20 00:00:00+03:00,out,False,925828,False,13,1287,1432,145
166536,2019-11-21 00:00:00+03:00,out,False,925828,True,11,0,321,321
166536,2019-11-21 00:00:00+03:00,out,False,925826,False,9,1606,1734,128
166536,2019-11-21 00:00:00+03:00,in,False,925826,False,2,407,420,13
166536,2019-11-21 00:00:00+03:00,in,False,925828,False,4,261,288,27
166536,2019-11-21 00:00:00+03:00,out,False,925828,False,6,233,342,109
166536,2019-11-21 00:00:00+03:00,in,False,-1,True,1,0,2,2
166536,2019-11-22 00:00:00+03:00,in,False,-1,True,2,0,1,1
166536,2019-11-22 00:00:00+03:00,out,False,925828,False,2,735,756,21
166536,2019-11-22 00:00:00+03:00,in,False,925828,False,6,1182,1225,43
166536,2019-11-22 00:00:00+03:00,out,False,925828,True,2,0,52,52
166536,2019-11-22 00:00:00+03:00,out,False,925826,False,5,612,713,101
166536,2019-11-22 00:00:00+03:00,out,False,925826,True,3,0,44,44
166536,2019-11-22 00:00:00+03:00,in,False,925826,False,1,313,318,5
166536,2019-11-25 00:00:00+03:00,out,False,925828,False,15,1703,1901,198
166536,2019-11-25 00:00:00+03:00,in,False,-1,True,2,0,2,2
166536,2019-11-25 00:00:00+03:00,out,False,925826,False,6,308,368,60
166536,2019-11-25 00:00:00+03:00,out,False,925828,True,22,0,298,298
166536,2019-11-25 00:00:00+03:00,out,False,925826,True,1,0,40,40
166536,2019-11-25 00:00:00+03:00,in,False,925828,False,10,1420,1477,57
166536,2019-11-25 00:00:00+03:00,in,False,925826,False,4,369,395,26
166536,2019-11-25 00:00:00+03:00,in,False,925826,False,4,369,395,26
166536,2019-11-26 00:00:00+03:00,in,False,900194,False,2,1353,1407,54
166536,2019-11-26 00:00:00+03:00,out,False,925828,False,4,323,365,42
166536,2019-11-26 00:00:00+03:00,out,False,925828,True,4,0,60,60
166536,2019-11-26 00:00:00+03:00,in,False,-1,True,3,0,42,42
166536,2019-11-26 00:00:00+03:00,in,False,925828,False,6,936,968,32
166536,2019-11-26 00:00:00+03:00,out,False,900194,False,1,4,34,30
166536,2019-11-26 00:00:00+03:00,in,False,925826,False,5,1434,1469,35
166536,2019-11-26 00:00:00+03:00,out,False,925826,False,9,812,993,181
166536,2019-11-26 00:00:00+03:00,out,False,925826,True,10,0,141,141
166536,2019-11-27 00:00:00+03:00,in,False,900194,False,2,1268,1330,62
166536,2019-11-27 00:00:00+03:00,in,False,-1,True,5,0,6,6
166536,2019-11-27 00:00:00+03:00,in,False,925826,False,4,1231,1264,33
166536,2019-11-27 00:00:00+03:00,out,False,925826,True,3,0,36,36
166536,2019-11-27 00:00:00+03:00,out,False,925826,False,11,1647,1726,79
166536,2019-11-27 00:00:00+03:00,in,False,925828,False,9,2557,2621,64
166536,2019-11-27 00:00:00+03:00,out,False,925828,False,7,724,819,95
166536,2019-11-27 00:00:00+03:00,out,False,925828,True,8,0,195,195
166536,2019-11-28 00:00:00+03:00,in,False,900194,True,1,0,43,43
166536,2019-11-28 00:00:00+03:00,out,False,925826,False,11,956,1109,153
166536,2019-11-28 00:00:00+03:00,in,False,925828,False,3,226,245,19
166536,2019-11-28 00:00:00+03:00,in,False,925826,False,7,1242,1277,35
166536,2019-11-28 00:00:00+03:00,in,False,-1,True,3,0,2,2
166536,2019-11-28 00:00:00+03:00,out,False,925828,False,2,395,414,19
166536,2019-11-28 00:00:00+03:00,out,False,925826,True,9,0,166,166
166536,2019-11-28 00:00:00+03:00,in,False,900194,True,1,0,43,43
166536,2019-11-28 00:00:00+03:00,in,False,-1,True,3,0,2,2
166541,2019-09-10 00:00:00+03:00,out,False,908834,True,1,0,58,58
166541,2019-09-10 00:00:00+03:00,in,False,908834,False,8,1119,1188,69
166541,2019-09-10 00:00:00+03:00,in,False,-1,True,6,0,105,105
166541,2019-09-10 00:00:00+03:00,out,False,908834,True,1,0,58,58
166541,2019-09-11 00:00:00+03:00,in,False,908834,False,5,342,527,185
166541,2019-09-11 00:00:00+03:00,in,False,-1,True,7,0,355,355
166541,2019-09-11 00:00:00+03:00,in,False,908960,False,3,231,302,71
166541,2019-09-11 00:00:00+03:00,in,False,908958,False,10,1990,2299,309
166541,2019-09-11 00:00:00+03:00,in,False,908958,False,10,1990,2299,309
166541,2019-09-12 00:00:00+03:00,in,False,908834,False,3,92,249,157
166541,2019-09-12 00:00:00+03:00,in,False,908960,False,4,449,549,100
166541,2019-09-12 00:00:00+03:00,out,False,908958,True,11,0,252,252
166541,2019-09-12 00:00:00+03:00,in,False,908958,False,17,2415,2915,500
166541,2019-09-12 00:00:00+03:00,out,False,908958,False,7,887,954,67
166541,2019-09-12 00:00:00+03:00,in,False,-1,True,9,0,388,388
166541,2019-09-12 00:00:00+03:00,in,False,908960,True,1,0,23,23
166541,2019-09-13 00:00:00+03:00,in,False,908960,False,14,2704,3084,380
166541,2019-09-13 00:00:00+03:00,in,True,910958,False,1,68,119,51
166541,2019-09-13 00:00:00+03:00,out,False,908958,True,2,0,9,9
166541,2019-09-13 00:00:00+03:00,in,False,908958,True,1,1,21,20
166541,2019-09-13 00:00:00+03:00,in,False,-1,True,1,0,19,19
166541,2019-09-13 00:00:00+03:00,out,False,908958,False,1,100,113,13
166541,2019-09-13 00:00:00+03:00,in,False,910958,False,2,201,275,74
166541,2019-09-13 00:00:00+03:00,in,False,-1,True,12,0,368,368
166541,2019-09-13 00:00:00+03:00,in,False,908834,False,7,158,528,370
166541,2019-09-13 00:00:00+03:00,in,False,908958,False,11,1270,1478,208
166541,2019-09-13 00:00:00+03:00,in,True,908958,False,1,96,115,19
166541,2019-09-13 00:00:00+03:00,in,False,-1,True,12,0,368,368
166541,2019-09-13 00:00:00+03:00,out,False,908958,False,1,100,113,13
166541,2019-09-14 00:00:00+03:00,in,False,910958,False,1,109,148,39
166541,2019-09-14 00:00:00+03:00,in,False,-1,True,5,0,268,268
166541,2019-09-14 00:00:00+03:00,in,False,908958,False,12,2171,2431,260
166541,2019-09-14 00:00:00+03:00,out,False,908960,False,1,60,68,8
166541,2019-09-14 00:00:00+03:00,out,False,908960,True,2,0,6,6
166541,2019-09-14 00:00:00+03:00,in,False,908960,False,10,759,997,238
166541,2019-09-15 00:00:00+03:00,in,False,908960,False,4,327,431,104
166541,2019-09-15 00:00:00+03:00,out,False,908958,True,6,0,12,12
166541,2019-09-15 00:00:00+03:00,in,False,-1,True,3,0,369,369
166541,2019-09-15 00:00:00+03:00,in,False,908958,False,17,2425,2867,442
166541,2019-09-15 00:00:00+03:00,out,False,908958,True,6,0,12,12
166541,2019-09-16 00:00:00+03:00,out,False,908958,True,1,0,22,22
166541,2019-09-16 00:00:00+03:00,in,True,908958,False,1,83,103,20
166541,2019-09-16 00:00:00+03:00,out,False,908958,False,5,705,757,52
166541,2019-09-16 00:00:00+03:00,out,True,908958,True,2,0,60,60
166541,2019-09-16 00:00:00+03:00,out,False,908960,True,1,0,2,2
166541,2019-09-16 00:00:00+03:00,in,False,908960,False,18,1418,1880,462
166541,2019-09-16 00:00:00+03:00,in,False,908958,False,25,2074,2653,579
166541,2019-09-16 00:00:00+03:00,in,False,-1,True,6,0,101,101
166541,2019-09-16 00:00:00+03:00,in,True,908960,False,1,39,64,25
166541,2019-09-16 00:00:00+03:00,in,False,908960,True,4,109,179,70
166541,2019-09-16 00:00:00+03:00,out,False,908958,False,5,705,757,52
166541,2019-09-16 00:00:00+03:00,out,True,908958,True,2,0,60,60
166541,2019-09-17 00:00:00+03:00,out,False,908960,True,4,0,18,18
166541,2019-09-17 00:00:00+03:00,in,False,908958,False,26,2930,3547,617
166541,2019-09-17 00:00:00+03:00,in,True,908960,False,1,14,28,14
166541,2019-09-17 00:00:00+03:00,out,False,908958,False,6,559,643,84
166541,2019-09-17 00:00:00+03:00,in,False,908960,False,9,1460,1702,242
166541,2019-09-17 00:00:00+03:00,in,True,908958,False,2,195,234,39
166541,2019-09-17 00:00:00+03:00,in,False,-1,True,11,0,513,513
166541,2019-09-17 00:00:00+03:00,out,False,908958,True,2,0,6,6
166541,2019-09-18 00:00:00+03:00,in,False,908960,True,1,1,33,32
166541,2019-09-18 00:00:00+03:00,in,False,908958,False,21,2667,3284,617
166541,2019-09-18 00:00:00+03:00,out,False,908958,True,1,0,2,2
166541,2019-09-18 00:00:00+03:00,out,False,908958,False,1,189,203,14
166541,2019-09-18 00:00:00+03:00,in,False,908960,False,7,552,726,174
166541,2019-09-18 00:00:00+03:00,in,False,-1,True,5,0,209,209
166541,2019-09-18 00:00:00+03:00,in,False,910958,False,1,45,155,110
166541,2019-09-18 00:00:00+03:00,in,False,908960,False,7,552,726,174
166541,2019-09-19 00:00:00+03:00,in,False,908958,False,11,1607,1873,266
166541,2019-09-19 00:00:00+03:00,in,True,908960,False,1,71,86,15
166541,2019-09-19 00:00:00+03:00,in,False,-1,True,5,0,70,70
166541,2019-09-19 00:00:00+03:00,in,False,908960,False,4,497,577,80
166541,2019-09-19 00:00:00+03:00,out,False,908958,True,1,0,2,2
166541,2019-09-19 00:00:00+03:00,out,False,908958,False,1,1,13,12
166541,2019-09-19 00:00:00+03:00,in,True,910958,False,1,4,59,55
166541,2019-09-19 00:00:00+03:00,in,False,-1,True,5,0,70,70
166541,2019-09-20 00:00:00+03:00,out,False,908960,True,3,0,7,7
166541,2019-09-20 00:00:00+03:00,in,False,-1,True,2,0,34,34
166541,2019-09-20 00:00:00+03:00,in,False,910958,False,3,176,311,135
166541,2019-09-20 00:00:00+03:00,in,True,908960,False,4,390,465,75
166541,2019-09-20 00:00:00+03:00,in,False,908958,False,3,260,344,84
166541,2019-09-20 00:00:00+03:00,in,False,908960,False,11,907,1173,266
166541,2019-09-20 00:00:00+03:00,in,False,-1,True,5,0,114,114
166541,2019-09-21 00:00:00+03:00,out,False,908958,True,1,0,2,2
166541,2019-09-21 00:00:00+03:00,in,False,910958,False,1,57,96,39
166541,2019-09-21 00:00:00+03:00,in,False,908960,False,3,365,461,96
166541,2019-09-21 00:00:00+03:00,in,False,-1,True,3,0,168,168
166541,2019-09-22 00:00:00+03:00,in,False,908960,False,3,132,204,72
166541,2019-09-22 00:00:00+03:00,out,False,908958,False,1,62,66,4
166541,2019-09-22 00:00:00+03:00,in,True,908958,False,1,33,42,9
166541,2019-09-22 00:00:00+03:00,in,False,-1,True,3,0,167,167
166541,2019-09-22 00:00:00+03:00,in,False,908958,False,8,1106,1348,242
166541,2019-09-23 00:00:00+03:00,in,False,908958,False,12,916,1243,327
166541,2019-09-23 00:00:00+03:00,in,False,910958,False,1,11,50,39
166541,2019-09-23 00:00:00+03:00,in,False,-1,True,7,0,383,383
166541,2019-09-23 00:00:00+03:00,out,False,908958,False,1,17,25,8
166541,2019-09-23 00:00:00+03:00,in,False,908960,False,10,882,1148,266
166541,2019-09-24 00:00:00+03:00,out,False,908958,True,1,0,36,36
166541,2019-09-24 00:00:00+03:00,in,False,908960,False,4,336,456,120
166541,2019-09-24 00:00:00+03:00,out,False,908958,False,3,28,53,25
166541,2019-09-24 00:00:00+03:00,in,False,-1,True,2,0,52,52
166541,2019-09-24 00:00:00+03:00,in,False,908958,False,16,1208,1681,473
166541,2019-09-25 00:00:00+03:00,in,False,908958,False,26,1586,2365,779
166541,2019-09-25 00:00:00+03:00,out,False,908958,True,3,0,12,12
166541,2019-09-25 00:00:00+03:00,in,False,-1,True,7,0,151,151
166541,2019-09-25 00:00:00+03:00,in,False,908960,False,10,938,1184,246
166541,2019-09-25 00:00:00+03:00,out,False,908958,True,3,0,12,12
166541,2019-09-26 00:00:00+03:00,in,False,-1,True,2,0,40,40
166541,2019-09-26 00:00:00+03:00,in,True,908960,False,1,15,32,17
166541,2019-09-26 00:00:00+03:00,in,False,908960,False,6,1078,1241,163
166541,2019-09-26 00:00:00+03:00,in,False,908958,False,16,1084,1648,564
166541,2019-09-26 00:00:00+03:00,in,False,-1,True,1,0,8,8
166541,2019-09-27 00:00:00+03:00,in,False,908960,False,5,368,507,139
166541,2019-09-27 00:00:00+03:00,in,False,908958,False,10,599,886,287
166541,2019-09-28 00:00:00+03:00,in,False,908958,False,4,436,542,106
166541,2019-09-28 00:00:00+03:00,in,False,-1,True,1,0,2,2
166541,2019-09-28 00:00:00+03:00,in,False,908960,False,2,136,188,52
166541,2019-09-28 00:00:00+03:00,in,True,908960,False,2,35,77,42
166541,2019-09-29 00:00:00+03:00,in,False,908958,False,8,354,676,322
166541,2019-09-29 00:00:00+03:00,in,False,-1,True,3,0,71,71
166541,2019-09-29 00:00:00+03:00,in,False,908960,False,1,26,46,20
166541,2019-09-30 00:00:00+03:00,in,False,908958,False,18,1480,2066,586
166541,2019-09-30 00:00:00+03:00,in,False,-1,True,5,0,113,113
166541,2019-09-30 00:00:00+03:00,in,False,908960,False,11,714,995,281
166541,2019-09-30 00:00:00+03:00,in,True,908960,False,1,109,127,18
166541,2019-09-30 00:00:00+03:00,in,False,908960,False,11,714,995,281
166541,2019-10-01 00:00:00+03:00,in,False,908960,False,4,596,696,100
166541,2019-10-01 00:00:00+03:00,in,False,908958,False,18,1838,2353,515
166541,2019-10-01 00:00:00+03:00,in,False,-1,True,5,0,50,50
166541,2019-10-02 00:00:00+03:00,in,False,908958,False,8,1168,1413,245
166541,2019-10-02 00:00:00+03:00,in,False,908960,False,9,1254,1486,232
166541,2019-10-02 00:00:00+03:00,in,True,908960,False,1,56,72,16
166541,2019-10-02 00:00:00+03:00,in,False,-1,True,3,0,90,90
166541,2019-10-02 00:00:00+03:00,in,False,-1,True,3,0,90,90
166541,2019-10-03 00:00:00+03:00,in,False,908958,False,10,573,952,379
166541,2019-10-03 00:00:00+03:00,in,False,908960,False,7,377,567,190
166541,2019-10-03 00:00:00+03:00,in,False,-1,True,5,0,181,181
166541,2019-10-04 00:00:00+03:00,in,True,908958,False,2,71,98,27
166541,2019-10-04 00:00:00+03:00,in,False,908958,False,13,1121,1459,338
166541,2019-10-04 00:00:00+03:00,in,False,908960,False,6,525,692,167
166541,2019-10-04 00:00:00+03:00,in,False,-1,True,3,0,61,61
166541,2019-10-05 00:00:00+03:00,in,False,908958,False,4,398,488,90
166541,2019-10-06 00:00:00+03:00,in,False,908960,False,4,386,498,112
166541,2019-10-06 00:00:00+03:00,in,False,-1,True,1,0,4,4
166541,2019-10-06 00:00:00+03:00,in,False,908958,False,8,339,656,317
166541,2019-10-06 00:00:00+03:00,in,False,908960,False,4,386,498,112
166541,2019-10-07 00:00:00+03:00,in,False,908960,False,7,724,894,170
166541,2019-10-07 00:00:00+03:00,in,False,908958,False,15,1381,1843,462
166541,2019-10-07 00:00:00+03:00,in,True,908960,False,1,50,66,16
166541,2019-10-07 00:00:00+03:00,in,False,-1,True,3,0,47,47
166541,2019-10-07 00:00:00+03:00,in,False,908960,False,7,724,894,170
166541,2019-10-07 00:00:00+03:00,in,True,908960,False,1,50,66,16
166541,2019-10-08 00:00:00+03:00,in,False,-1,True,4,0,125,125
166541,2019-10-08 00:00:00+03:00,in,False,908960,False,3,281,362,81
166541,2019-10-08 00:00:00+03:00,in,False,908958,False,36,2977,4019,1042
166541,2019-10-09 00:00:00+03:00,in,False,908960,False,8,581,786,205
166541,2019-10-09 00:00:00+03:00,in,False,908958,False,33,3080,4157,1077
166541,2019-10-09 00:00:00+03:00,in,True,908958,False,1,81,106,25
166541,2019-10-09 00:00:00+03:00,out,False,908958,False,1,158,166,8
166541,2019-10-09 00:00:00+03:00,in,False,-1,True,7,0,202,202
166541,2019-10-09 00:00:00+03:00,in,False,910958,False,1,90,161,71
166541,2019-10-09 00:00:00+03:00,in,True,908958,False,1,81,106,25
166541,2019-10-10 00:00:00+03:00,in,False,-1,True,4,0,117,117
166541,2019-10-10 00:00:00+03:00,in,False,908958,False,14,903,1403,500
166541,2019-10-10 00:00:00+03:00,in,False,908960,False,9,1294,1529,235
166541,2019-10-11 00:00:00+03:00,in,False,-1,True,7,0,171,171
166541,2019-10-11 00:00:00+03:00,out,False,908960,False,6,261,312,51
166541,2019-10-11 00:00:00+03:00,in,False,908960,False,12,884,1181,297
166541,2019-10-11 00:00:00+03:00,in,False,908958,False,15,939,1411,472
166541,2019-10-12 00:00:00+03:00,in,False,908958,False,9,590,930,340
166541,2019-10-12 00:00:00+03:00,in,False,-1,True,7,0,177,177
166541,2019-10-12 00:00:00+03:00,in,False,908960,False,10,827,1012,185
166541,2019-10-13 00:00:00+03:00,in,False,908958,False,3,189,254,65
166541,2019-10-13 00:00:00+03:00,in,False,908960,False,4,402,502,100
166541,2019-10-13 00:00:00+03:00,in,False,910958,False,1,31,127,96
166541,2019-10-13 00:00:00+03:00,in,False,-1,True,1,0,4,4
166541,2019-10-14 00:00:00+03:00,out,False,908960,True,1,0,1,1
166541,2019-10-14 00:00:00+03:00,out,False,908958,True,1,0,0,0
166541,2019-10-14 00:00:00+03:00,out,False,908958,False,1,8,19,11
166541,2019-10-14 00:00:00+03:00,in,False,908960,False,17,2170,2666,496
166541,2019-10-14 00:00:00+03:00,in,False,-1,True,17,0,680,680
166541,2019-10-14 00:00:00+03:00,in,False,908958,False,19,1255,1960,705
166541,2019-10-14 00:00:00+03:00,in,True,908960,False,1,35,110,75
166541,2019-10-14 00:00:00+03:00,in,True,908958,True,1,1,21,20
166541,2019-10-14 00:00:00+03:00,in,True,908958,True,1,1,21,20
166541,2019-10-14 00:00:00+03:00,in,False,908958,False,19,1255,1960,705
166541,2019-10-15 00:00:00+03:00,in,False,-1,True,4,0,47,47
166541,2019-10-15 00:00:00+03:00,out,False,908960,True,3,0,114,114
166541,2019-10-15 00:00:00+03:00,in,False,908960,False,16,1352,1715,363
166541,2019-10-15 00:00:00+03:00,in,False,908958,False,19,2136,2612,476
166541,2019-10-15 00:00:00+03:00,in,True,908958,False,1,954,967,13
166541,2019-10-15 00:00:00+03:00,out,False,908958,True,1,0,2,2
166541,2019-10-15 00:00:00+03:00,out,False,908958,False,1,15,27,12
166541,2019-10-15 00:00:00+03:00,out,False,908960,False,4,535,545,10
166541,2019-10-15 00:00:00+03:00,in,False,-1,True,4,0,47,47
166541,2019-10-16 00:00:00+03:00,in,False,908960,False,6,370,498,128
166541,2019-10-16 00:00:00+03:00,in,False,-1,True,3,0,44,44
166541,2019-10-16 00:00:00+03:00,in,False,908960,True,1,0,23,23
166541,2019-10-16 00:00:00+03:00,in,False,908958,False,9,1134,1370,236
166541,2019-10-17 00:00:00+03:00,out,False,908958,False,3,130,161,31
166541,2019-10-17 00:00:00+03:00,in,False,908960,False,13,1035,1391,356
166541,2019-10-17 00:00:00+03:00,in,False,908958,False,11,1181,1419,238
166541,2019-10-17 00:00:00+03:00,in,False,-1,True,1,0,1,1
166541,2019-10-17 00:00:00+03:00,out,False,908958,True,2,0,2,2
166541,2019-10-18 00:00:00+03:00,in,False,-1,True,9,0,649,649
166541,2019-10-18 00:00:00+03:00,in,False,908960,False,7,674,864,190
166541,2019-10-18 00:00:00+03:00,in,False,908958,False,12,1234,1578,344
166541,2019-10-18 00:00:00+03:00,in,False,908958,False,12,1234,1578,344
166541,2019-10-19 00:00:00+03:00,in,False,908958,False,9,624,788,164
166541,2019-10-19 00:00:00+03:00,in,False,908960,False,7,530,681,151
166541,2019-10-20 00:00:00+03:00,in,False,908958,False,2,341,372,31
166541,2019-10-20 00:00:00+03:00,in,False,-1,True,1,0,15,15
166541,2019-10-20 00:00:00+03:00,in,False,-1,True,2,0,63,63
166541,2019-10-20 00:00:00+03:00,in,False,-1,True,2,0,63,63
166541,2019-10-21 00:00:00+03:00,in,False,908960,False,13,1532,1900,368
166541,2019-10-21 00:00:00+03:00,in,False,908958,False,22,2872,3337,465
166541,2019-10-21 00:00:00+03:00,out,False,908960,False,1,75,92,17
166541,2019-10-21 00:00:00+03:00,in,False,-1,True,6,0,227,227
166541,2019-10-21 00:00:00+03:00,out,True,908958,True,1,0,0,0
166541,2019-10-22 00:00:00+03:00,out,False,908958,False,2,52,65,13
166541,2019-10-22 00:00:00+03:00,in,False,-1,True,2,0,45,45
166541,2019-10-22 00:00:00+03:00,in,False,908960,False,13,910,1249,339
166541,2019-10-22 00:00:00+03:00,in,False,908958,False,24,3011,3505,494
166541,2019-10-22 00:00:00+03:00,out,False,908960,False,2,580,584,4
166541,2019-10-22 00:00:00+03:00,in,False,-1,True,2,0,45,45
166541,2019-10-23 00:00:00+03:00,in,True,908960,False,2,18,38,20
166541,2019-10-23 00:00:00+03:00,out,False,908960,True,1,0,27,27
166541,2019-10-23 00:00:00+03:00,out,False,908960,False,1,6,8,2
166541,2019-10-23 00:00:00+03:00,in,False,908960,False,8,642,812,170
166541,2019-10-23 00:00:00+03:00,in,False,908958,False,12,2140,2480,340
166541,2019-10-23 00:00:00+03:00,out,False,908958,True,1,0,15,15
166541,2019-10-23 00:00:00+03:00,in,False,-1,True,2,0,98,98
166541,2019-10-23 00:00:00+03:00,in,False,-1,True,2,0,98,98
166541,2019-10-23 00:00:00+03:00,out,False,908960,True,1,0,27,27
166541,2019-10-24 00:00:00+03:00,out,False,908960,True,1,0,37,37
166541,2019-10-24 00:00:00+03:00,in,False,908960,False,12,1189,1518,329
166541,2019-10-24 00:00:00+03:00,out,False,908960,False,1,90,98,8
166541,2019-10-24 00:00:00+03:00,in,False,908958,False,21,2065,2557,492
166541,2019-10-24 00:00:00+03:00,in,False,-1,True,2,0,63,63
166541,2019-10-24 00:00:00+03:00,out,False,908958,True,2,0,4,4
166541,2019-10-24 00:00:00+03:00,out,False,908958,False,3,344,367,23
166541,2019-10-24 00:00:00+03:00,out,False,908958,False,3,344,367,23
166541,2019-10-25 00:00:00+03:00,in,False,908958,False,16,1609,1987,378
166541,2019-10-25 00:00:00+03:00,in,False,908960,False,9,848,1004,156
166541,2019-10-25 00:00:00+03:00,in,False,-1,True,3,0,42,42
166541,2019-10-26 00:00:00+03:00,in,False,908958,False,5,675,764,89
166541,2019-10-26 00:00:00+03:00,in,False,908960,False,4,689,834,145
166541,2019-10-26 00:00:00+03:00,in,False,-1,True,1,0,42,42
166541,2019-10-26 00:00:00+03:00,out,False,908960,True,1,0,10,10
166541,2019-10-27 00:00:00+03:00,in,False,908958,False,8,1202,1477,275
166541,2019-10-27 00:00:00+03:00,in,False,908960,False,8,716,853,137
166541,2019-10-27 00:00:00+03:00,in,False,-1,True,4,0,139,139
166541,2019-10-27 00:00:00+03:00,out,False,908960,True,3,0,37,37
166541,2019-10-27 00:00:00+03:00,out,False,908960,False,6,288,370,82
166541,2019-10-27 00:00:00+03:00,in,False,-1,True,4,0,139,139
166541,2019-10-28 00:00:00+03:00,out,False,-1,True,1,0,0,0
166541,2019-10-28 00:00:00+03:00,in,False,908958,False,9,1733,1917,184
166541,2019-10-28 00:00:00+03:00,in,False,-1,True,1,0,14,14
166541,2019-10-28 00:00:00+03:00,out,False,908960,False,1,85,103,18
166541,2019-10-28 00:00:00+03:00,in,False,908960,False,8,710,896,186
166541,2019-10-29 00:00:00+03:00,out,False,908960,False,1,34,36,2
166541,2019-10-29 00:00:00+03:00,in,True,908960,False,2,268,313,45
166541,2019-10-29 00:00:00+03:00,in,False,908958,False,16,1800,2175,375
166541,2019-10-29 00:00:00+03:00,in,False,-1,True,3,0,59,59
166541,2019-10-29 00:00:00+03:00,in,False,908960,False,7,580,706,126
166541,2019-10-30 00:00:00+03:00,out,False,908960,False,2,120,124,4
166541,2019-10-30 00:00:00+03:00,in,False,908958,False,11,1106,1562,456
166541,2019-10-30 00:00:00+03:00,in,False,908960,False,8,1492,1689,197
166541,2019-10-30 00:00:00+03:00,in,False,-1,True,6,0,101,101
166541,2019-10-30 00:00:00+03:00,in,False,-1,True,6,0,101,101
166541,2019-10-31 00:00:00+03:00,in,False,908960,False,16,1225,1565,340
166541,2019-10-31 00:00:00+03:00,in,False,908958,False,8,1142,1356,214
166541,2019-10-31 00:00:00+03:00,out,False,908960,False,1,41,53,12
166541,2019-10-31 00:00:00+03:00,out,False,908958,True,1,0,28,28
166541,2019-10-31 00:00:00+03:00,in,False,-1,True,4,0,45,45
166541,2019-11-01 00:00:00+03:00,out,False,908958,False,1,247,249,2
166541,2019-11-01 00:00:00+03:00,in,False,-1,True,1,0,28,28
166541,2019-11-01 00:00:00+03:00,in,False,908958,False,9,1725,1902,177
166541,2019-11-01 00:00:00+03:00,in,False,908960,False,7,716,855,139
166541,2019-11-01 00:00:00+03:00,in,True,908958,False,1,110,120,10
166541,2019-11-02 00:00:00+03:00,in,False,908958,True,1,27,84,57
166541,2019-11-02 00:00:00+03:00,in,False,908958,False,5,2322,2452,130
166541,2019-11-02 00:00:00+03:00,in,False,908960,False,6,857,1015,158
166541,2019-11-02 00:00:00+03:00,in,False,-1,True,1,0,9,9
166541,2019-11-03 00:00:00+03:00,out,False,908960,False,1,18,26,8
166541,2019-11-03 00:00:00+03:00,in,False,-1,True,3,0,103,103
166541,2019-11-03 00:00:00+03:00,out,False,908960,True,1,0,8,8
166541,2019-11-03 00:00:00+03:00,in,False,908958,False,7,280,577,297
166541,2019-11-03 00:00:00+03:00,in,False,908960,False,11,900,1099,199
166541,2019-11-04 00:00:00+03:00,in,False,908958,False,12,2043,2380,337
166541,2019-11-04 00:00:00+03:00,in,False,-1,True,3,0,41,41
166541,2019-11-04 00:00:00+03:00,out,False,908960,False,1,21,23,2
166541,2019-11-04 00:00:00+03:00,out,True,908958,True,2,0,0,0
166541,2019-11-04 00:00:00+03:00,in,False,908960,False,5,280,406,126
166541,2019-11-05 00:00:00+03:00,in,False,908960,False,18,2138,2471,333
166541,2019-11-05 00:00:00+03:00,in,False,908958,False,15,1151,1497,346
166541,2019-11-05 00:00:00+03:00,out,False,908960,False,6,1169,1178,9
166541,2019-11-05 00:00:00+03:00,in,False,-1,True,8,0,253,253
166541,2019-11-05 00:00:00+03:00,out,True,908958,True,1,0,0,0
166541,2019-11-05 00:00:00+03:00,in,False,908958,False,15,1151,1497,346
166541,2019-11-06 00:00:00+03:00,in,False,908960,False,6,755,913,158
166541,2019-11-06 00:00:00+03:00,in,False,908958,False,12,1368,1794,426
166541,2019-11-06 00:00:00+03:00,out,False,908960,False,1,65,67,2
166541,2019-11-07 00:00:00+03:00,in,False,908958,False,14,1099,1453,354
166541,2019-11-07 00:00:00+03:00,in,False,908960,False,9,1767,1988,221
166541,2019-11-07 00:00:00+03:00,out,False,908958,False,3,191,231,40
166541,2019-11-07 00:00:00+03:00,in,False,-1,True,1,0,6,6
166541,2019-11-08 00:00:00+03:00,in,True,908960,False,3,135,169,34
166541,2019-11-08 00:00:00+03:00,out,True,908960,False,1,125,143,18
166541,2019-11-08 00:00:00+03:00,out,False,908960,False,1,47,48,1
166541,2019-11-08 00:00:00+03:00,in,False,-1,True,2,0,82,82
166541,2019-11-08 00:00:00+03:00,in,False,908960,False,18,1712,2103,391
166541,2019-11-08 00:00:00+03:00,in,False,908958,False,12,1985,2225,240
166541,2019-11-09 00:00:00+03:00,out,False,908960,False,1,85,87,2
166541,2019-11-09 00:00:00+03:00,in,False,908960,False,7,418,583,165
166541,2019-11-09 00:00:00+03:00,in,False,-1,True,3,0,105,105
166541,2019-11-09 00:00:00+03:00,in,False,908958,False,6,350,448,98
166541,2019-11-10 00:00:00+03:00,in,False,-1,True,3,0,104,104
166541,2019-11-10 00:00:00+03:00,out,False,908960,False,1,96,104,8
166541,2019-11-10 00:00:00+03:00,in,False,908958,False,5,325,493,168
166541,2019-11-10 00:00:00+03:00,in,False,908960,False,13,338,626,288
166541,2019-11-10 00:00:00+03:00,out,False,908960,True,2,0,27,27
166541,2019-11-11 00:00:00+03:00,in,False,908958,False,13,1283,1776,493
166541,2019-11-11 00:00:00+03:00,in,False,-1,True,1,0,82,82
166541,2019-11-11 00:00:00+03:00,in,False,908960,False,17,1242,1583,341
166541,2019-11-12 00:00:00+03:00,in,False,-1,True,1,0,7,7
166541,2019-11-12 00:00:00+03:00,out,False,908960,True,1,0,5,5
166541,2019-11-12 00:00:00+03:00,in,False,908958,False,3,196,237,41
166541,2019-11-12 00:00:00+03:00,in,False,908960,False,9,871,1079,208
166541,2019-11-12 00:00:00+03:00,out,False,908960,False,6,544,643,99
166541,2019-11-12 00:00:00+03:00,out,False,908960,True,1,0,5,5
166541,2019-11-12 00:00:00+03:00,in,False,908960,False,9,871,1079,208
166541,2019-11-13 00:00:00+03:00,in,False,908960,False,7,1032,1175,143
166541,2019-11-13 00:00:00+03:00,in,False,908958,False,12,1139,1482,343
166541,2019-11-13 00:00:00+03:00,out,False,908960,True,3,0,7,7
166541,2019-11-13 00:00:00+03:00,out,False,908960,False,4,294,355,61
166541,2019-11-13 00:00:00+03:00,in,False,-1,True,5,0,114,114
166541,2019-11-13 00:00:00+03:00,in,True,908960,False,1,23,35,12
166541,2019-11-14 00:00:00+03:00,in,False,908958,False,10,565,926,361
166541,2019-11-14 00:00:00+03:00,in,False,-1,True,5,0,151,151
166541,2019-11-14 00:00:00+03:00,in,True,908960,False,1,98,114,16
166541,2019-11-14 00:00:00+03:00,in,False,908960,False,7,735,929,194
166541,2019-11-15 00:00:00+03:00,out,True,908958,True,1,0,0,0
166541,2019-11-15 00:00:00+03:00,in,False,908960,False,5,362,446,84
166541,2019-11-15 00:00:00+03:00,out,False,908960,False,2,178,187,9
166541,2019-11-15 00:00:00+03:00,in,False,908958,False,5,868,973,105
166541,2019-11-15 00:00:00+03:00,out,False,908960,True,1,0,40,40
166541,2019-11-15 00:00:00+03:00,out,False,908958,False,2,259,264,5
166541,2019-11-15 00:00:00+03:00,in,False,908960,True,2,0,56,56
166541,2019-11-15 00:00:00+03:00,in,False,-1,True,16,0,332,332
166541,2019-11-15 00:00:00+03:00,in,True,908960,False,1,130,139,9
166541,2019-11-15 00:00:00+03:00,in,True,908958,False,1,125,142,17
166541,2019-11-16 00:00:00+03:00,in,False,-1,True,3,0,63,63
166541,2019-11-16 00:00:00+03:00,in,False,908960,False,10,734,943,209
166541,2019-11-16 00:00:00+03:00,in,False,908958,False,7,417,589,172
166541,2019-11-17 00:00:00+03:00,in,False,908960,False,2,162,202,40
166541,2019-11-17 00:00:00+03:00,in,False,908958,False,6,1131,1245,114
166541,2019-11-17 00:00:00+03:00,in,False,-1,True,2,0,6,6
166541,2019-11-17 00:00:00+03:00,in,False,-1,True,2,0,6,6
166541,2019-11-18 00:00:00+03:00,in,False,908960,False,6,328,441,113
166541,2019-11-18 00:00:00+03:00,out,False,908958,False,1,89,91,2
166541,2019-11-18 00:00:00+03:00,in,False,908958,False,2,831,874,43
166541,2019-11-18 00:00:00+03:00,out,False,908960,False,10,1212,1282,70
166541,2019-11-18 00:00:00+03:00,in,True,908958,False,1,271,281,10
166541,2019-11-18 00:00:00+03:00,out,False,908960,True,1,0,1,1
166541,2019-11-19 00:00:00+03:00,in,False,-1,True,10,0,272,272
166541,2019-11-19 00:00:00+03:00,in,False,908960,False,14,720,1007,287
166541,2019-11-19 00:00:00+03:00,out,False,908960,False,2,77,99,22
166541,2019-11-19 00:00:00+03:00,in,False,908958,False,8,1094,1279,185
166541,2019-11-19 00:00:00+03:00,in,True,908960,False,1,33,44,11
166541,2019-11-19 00:00:00+03:00,in,False,908960,False,14,720,1007,287
166541,2019-11-20 00:00:00+03:00,in,False,-1,True,2,0,31,31
166541,2019-11-20 00:00:00+03:00,in,False,-1,True,1,0,38,38
166541,2019-11-20 00:00:00+03:00,out,True,908958,False,1,26,34,8
166541,2019-11-20 00:00:00+03:00,out,False,908960,False,6,574,641,67
166541,2019-11-20 00:00:00+03:00,out,False,908958,True,1,0,1,1
166541,2019-11-20 00:00:00+03:00,out,False,908958,False,5,559,582,23
166541,2019-11-20 00:00:00+03:00,in,True,908958,False,2,10,66,56
166541,2019-11-20 00:00:00+03:00,in,False,908960,True,1,1,15,14
166541,2019-11-20 00:00:00+03:00,in,True,908960,False,2,254,297,43
166541,2019-11-20 00:00:00+03:00,in,False,908958,False,10,1403,1669,266
166541,2019-11-20 00:00:00+03:00,in,False,908960,False,13,1848,2139,291
166541,2019-11-20 00:00:00+03:00,in,False,-1,True,1,0,38,38
166541,2019-11-20 00:00:00+03:00,out,False,908958,False,5,559,582,23
166541,2019-11-21 00:00:00+03:00,out,False,908960,False,1,96,98,2
166541,2019-11-21 00:00:00+03:00,out,False,908958,True,3,0,31,31
166541,2019-11-21 00:00:00+03:00,in,False,908958,False,5,489,604,115
166541,2019-11-21 00:00:00+03:00,in,False,908960,False,10,965,1163,198
166541,2019-11-22 00:00:00+03:00,in,False,-1,True,2,0,15,15
166541,2019-11-22 00:00:00+03:00,out,False,908960,False,3,110,113,3
166541,2019-11-22 00:00:00+03:00,in,False,908958,False,13,2367,2641,274
166541,2019-11-22 00:00:00+03:00,out,False,908958,False,4,729,762,33
166541,2019-11-22 00:00:00+03:00,in,True,908960,False,1,150,160,10
166541,2019-11-22 00:00:00+03:00,in,False,908960,False,9,1457,1650,193
166541,2019-11-23 00:00:00+03:00,out,False,908958,True,2,0,33,33
166541,2019-11-23 00:00:00+03:00,in,False,908960,False,6,419,531,112
166541,2019-11-23 00:00:00+03:00,in,False,908958,False,5,509,646,137
166541,2019-11-23 00:00:00+03:00,in,False,-1,True,2,0,142,142
166541,2019-11-23 00:00:00+03:00,in,False,908960,True,2,0,145,145
166541,2019-11-23 00:00:00+03:00,out,False,908960,False,1,177,186,9
166541,2019-11-23 00:00:00+03:00,out,False,908960,True,1,0,35,35
166541,2019-11-24 00:00:00+03:00,in,False,908960,False,5,476,623,147
166541,2019-11-24 00:00:00+03:00,in,False,-1,True,2,0,31,31
166541,2019-11-24 00:00:00+03:00,in,False,908958,False,8,957,1191,234
166541,2019-11-24 00:00:00+03:00,in,False,908960,True,2,0,41,41
166541,2019-11-24 00:00:00+03:00,in,True,908960,False,1,44,55,11
166541,2019-11-25 00:00:00+03:00,in,False,908958,False,10,1145,1393,248
166541,2019-11-25 00:00:00+03:00,out,False,908960,False,3,167,182,15
166541,2019-11-25 00:00:00+03:00,in,False,-1,True,2,0,4,4
166541,2019-11-25 00:00:00+03:00,out,True,908958,True,1,0,0,0
166541,2019-11-25 00:00:00+03:00,in,False,908960,False,11,672,903,231
166541,2019-11-26 00:00:00+03:00,in,True,908960,False,1,68,80,12
166541,2019-11-26 00:00:00+03:00,in,False,908958,False,8,941,1094,153
166541,2019-11-26 00:00:00+03:00,out,False,908960,True,1,0,60,60
166541,2019-11-26 00:00:00+03:00,in,False,-1,True,7,0,5,5
166541,2019-11-26 00:00:00+03:00,out,False,908958,True,1,0,38,38
166541,2019-11-26 00:00:00+03:00,in,False,908960,False,12,1484,1718,234
166541,2019-11-26 00:00:00+03:00,out,False,908960,True,1,0,60,60
166541,2019-11-27 00:00:00+03:00,in,False,908958,False,13,1471,1735,264
166541,2019-11-27 00:00:00+03:00,in,False,908960,False,4,635,704,69
166541,2019-11-27 00:00:00+03:00,out,False,908960,False,2,87,101,14
166541,2019-11-28 00:00:00+03:00,out,False,908960,False,1,116,118,2
166541,2019-11-28 00:00:00+03:00,out,False,908958,False,1,1,11,10
166541,2019-11-28 00:00:00+03:00,in,True,908958,False,1,64,76,12
166541,2019-11-28 00:00:00+03:00,in,False,908960,False,8,539,731,192
166541,2019-11-28 00:00:00+03:00,out,False,908960,True,1,0,7,7
166541,2019-11-28 00:00:00+03:00,in,False,908958,False,7,964,1120,156
166541,2019-11-28 00:00:00+03:00,in,True,908960,False,1,36,43,7
166541,2019-11-28 00:00:00+03:00,in,False,908960,False,8,539,731,192
166548,2019-08-08 00:00:00+03:00,in,False,-1,True,1,0,2,2
166548,2019-08-09 00:00:00+03:00,in,False,-1,True,6,0,50,50
166548,2019-08-10 00:00:00+03:00,in,False,-1,True,5,0,125,125
166548,2019-08-11 00:00:00+03:00,in,False,-1,True,1,0,16,16
166548,2019-08-13 00:00:00+03:00,in,False,-1,True,6,0,87,87
166548,2019-08-13 00:00:00+03:00,in,False,-1,True,6,0,87,87
166548,2019-08-18 00:00:00+03:00,in,False,-1,True,1,0,15,15
166548,2019-08-19 00:00:00+03:00,in,False,-1,True,2,0,86,86
166548,2019-08-19 00:00:00+03:00,in,False,-1,True,2,0,86,86
166548,2019-08-20 00:00:00+03:00,in,False,-1,True,2,0,23,23
166548,2019-08-21 00:00:00+03:00,in,False,-1,True,1,0,14,14
166548,2019-08-21 00:00:00+03:00,in,False,-1,True,1,0,14,14
166548,2019-08-23 00:00:00+03:00,in,False,-1,True,1,0,10,10
166548,2019-08-31 00:00:00+03:00,in,False,-1,True,1,0,2,2
166548,2019-09-07 00:00:00+03:00,in,False,-1,True,1,0,1,1
166548,2019-09-09 00:00:00+03:00,in,False,-1,True,1,0,17,17
166548,2019-09-14 00:00:00+03:00,in,False,-1,True,1,0,21,21
166548,2019-09-27 00:00:00+03:00,in,False,-1,True,1,0,14,14
166548,2019-10-01 00:00:00+03:00,in,False,-1,True,1,0,2,2
166548,2019-10-08 00:00:00+03:00,in,False,-1,True,1,0,1,1
166548,2019-10-16 00:00:00+03:00,in,False,-1,True,3,0,45,45
166548,2019-10-21 00:00:00+03:00,in,False,-1,True,2,0,42,42
166548,2019-10-22 00:00:00+03:00,in,False,-1,True,14,0,178,178
166548,2019-10-23 00:00:00+03:00,in,False,-1,True,1,0,2,2
166548,2019-10-23 00:00:00+03:00,in,False,-1,True,1,0,2,2
166548,2019-10-24 00:00:00+03:00,in,False,-1,True,3,0,40,40
166548,2019-10-25 00:00:00+03:00,in,False,-1,True,4,0,45,45
166548,2019-11-09 00:00:00+03:00,in,False,946468,False,1,18,43,25
166548,2019-11-09 00:00:00+03:00,in,False,-1,True,9,0,114,114
166548,2019-11-19 00:00:00+03:00,in,False,-1,True,1,0,9,9
166548,2019-11-21 00:00:00+03:00,in,False,-1,True,2,0,38,38
166548,2019-11-23 00:00:00+03:00,in,False,-1,True,1,0,7,7
166548,2019-11-23 00:00:00+03:00,in,False,-1,True,1,0,21,21
166548,2019-11-25 00:00:00+03:00,in,False,-1,True,3,0,58,58
166554,2019-08-09 00:00:00+03:00,in,False,-1,True,2,0,8,8
166582,2019-08-12 00:00:00+03:00,out,False,885890,False,181,18953,22349,3396
166582,2019-08-12 00:00:00+03:00,out,False,885876,False,184,20746,24152,3406
166582,2019-08-12 00:00:00+03:00,out,False,885876,True,219,0,5687,5687
166582,2019-08-12 00:00:00+03:00,in,False,885876,False,9,387,473,86
166582,2019-08-12 00:00:00+03:00,out,False,885890,True,113,0,3691,3691
166582,2019-08-12 00:00:00+03:00,in,False,885890,False,5,532,570,38
166582,2019-08-12 00:00:00+03:00,in,False,-1,True,9,0,79,79
166582,2019-08-12 00:00:00+03:00,out,False,885876,False,184,20746,24152,3406
166582,2019-08-13 00:00:00+03:00,out,False,885890,True,182,0,6486,6486
166582,2019-08-13 00:00:00+03:00,in,False,885876,False,12,613,745,132
166582,2019-08-13 00:00:00+03:00,out,False,885890,False,308,35126,40739,5613
166582,2019-08-13 00:00:00+03:00,in,False,885890,False,15,1241,1442,201
166582,2019-08-13 00:00:00+03:00,out,False,885876,False,265,30422,35448,5026
166582,2019-08-13 00:00:00+03:00,in,False,885890,True,1,1,9,8
166582,2019-08-13 00:00:00+03:00,out,False,-1,True,1,0,0,0
166582,2019-08-13 00:00:00+03:00,in,False,-1,True,6,0,35,35
166582,2019-08-13 00:00:00+03:00,out,False,885876,True,185,0,6036,6036
166582,2019-08-13 00:00:00+03:00,in,False,885890,True,1,1,9,8
166582,2019-08-14 00:00:00+03:00,in,False,885876,False,11,542,661,119
166582,2019-08-14 00:00:00+03:00,out,False,885890,True,116,0,3859,3859
166582,2019-08-14 00:00:00+03:00,in,False,-1,True,6,0,76,76
166582,2019-08-14 00:00:00+03:00,out,False,885876,False,170,21756,24643,2887
166582,2019-08-14 00:00:00+03:00,in,False,885890,False,5,268,304,36
166582,2019-08-14 00:00:00+03:00,out,False,885890,False,230,30890,35295,4405
166582,2019-08-14 00:00:00+03:00,out,False,885876,True,177,0,6363,6363
166582,2019-08-14 00:00:00+03:00,out,False,885890,True,116,0,3859,3859
166582,2019-08-15 00:00:00+03:00,in,False,885890,False,20,1877,2056,179
166582,2019-08-15 00:00:00+03:00,out,False,885876,False,112,17547,19939,2392
166582,2019-08-15 00:00:00+03:00,in,False,-1,True,16,0,186,186
166582,2019-08-15 00:00:00+03:00,out,False,885890,True,240,0,8019,8019
166582,2019-08-15 00:00:00+03:00,out,False,885890,False,417,42258,49942,7684
166582,2019-08-15 00:00:00+03:00,in,False,885876,False,4,180,196,16
166582,2019-08-15 00:00:00+03:00,out,False,885876,True,127,0,3788,3788
166582,2019-08-16 00:00:00+03:00,out,False,885876,False,128,12935,15473,2538
166582,2019-08-16 00:00:00+03:00,in,False,885876,False,8,466,545,79
166582,2019-08-16 00:00:00+03:00,out,False,885890,True,335,0,11630,11630
166582,2019-08-16 00:00:00+03:00,out,False,885876,True,89,0,3109,3109
166582,2019-08-16 00:00:00+03:00,in,False,885890,False,13,1078,1244,166
166582,2019-08-16 00:00:00+03:00,out,False,-1,True,1,0,0,0
166582,2019-08-16 00:00:00+03:00,in,False,-1,True,23,0,227,227
166582,2019-08-16 00:00:00+03:00,out,False,885890,False,517,57988,67232,9244
166582,2019-08-16 00:00:00+03:00,out,False,885876,True,89,0,3109,3109
166582,2019-08-17 00:00:00+03:00,in,False,885890,False,2,58,66,8
166582,2019-08-17 00:00:00+03:00,in,False,885876,False,5,236,284,48
166582,2019-08-17 00:00:00+03:00,out,False,885876,False,171,10061,13839,3778
166582,2019-08-17 00:00:00+03:00,out,False,885890,False,260,22654,27671,5017
166582,2019-08-17 00:00:00+03:00,out,False,885876,True,167,0,4522,4522
166582,2019-08-17 00:00:00+03:00,out,False,885890,True,182,0,6231,6231
166582,2019-08-17 00:00:00+03:00,in,False,-1,True,31,0,351,351
166582,2019-08-17 00:00:00+03:00,out,False,885876,True,167,0,4522,4522
166582,2019-08-17 00:00:00+03:00,in,False,885890,False,2,58,66,8
166582,2019-08-18 00:00:00+03:00,in,False,885890,False,2,208,237,29
166582,2019-08-18 00:00:00+03:00,out,False,885876,True,51,0,1979,1979
166582,2019-08-18 00:00:00+03:00,out,False,885876,False,83,8120,9898,1778
166582,2019-08-18 00:00:00+03:00,out,False,885890,False,136,14877,17257,2380
166582,2019-08-18 00:00:00+03:00,in,False,885876,False,2,394,415,21
166582,2019-08-18 00:00:00+03:00,in,False,-1,True,30,0,88,88
166582,2019-08-18 00:00:00+03:00,out,False,885890,True,80,0,2697,2697
166582,2019-08-18 00:00:00+03:00,in,False,885890,True,1,0,10,10
166582,2019-08-19 00:00:00+03:00,out,False,885876,False,343,36898,43738,6840
166582,2019-08-19 00:00:00+03:00,out,False,885890,True,310,0,10421,10421
166582,2019-08-19 00:00:00+03:00,out,False,885890,False,546,59043,69599,10556
166582,2019-08-19 00:00:00+03:00,in,False,885890,False,18,1142,1344,202
166582,2019-08-19 00:00:00+03:00,in,False,885876,True,3,0,41,41
166582,2019-08-19 00:00:00+03:00,out,False,885876,True,295,0,9598,9598
166582,2019-08-19 00:00:00+03:00,in,False,885876,False,18,729,895,166
166582,2019-08-19 00:00:00+03:00,in,False,-1,True,29,0,234,234
166582,2019-08-19 00:00:00+03:00,out,False,885876,True,295,0,9598,9598
166582,2019-08-20 00:00:00+03:00,out,False,885876,False,270,29512,34819,5307
166582,2019-08-20 00:00:00+03:00,out,False,885890,False,387,46077,52888,6811
166582,2019-08-20 00:00:00+03:00,in,False,-1,True,53,0,495,495
166582,2019-08-20 00:00:00+03:00,out,False,885890,True,285,0,9648,9648
166582,2019-08-20 00:00:00+03:00,out,False,885876,True,209,0,6613,6613
166582,2019-08-20 00:00:00+03:00,in,False,885876,True,1,1,7,6
166582,2019-08-20 00:00:00+03:00,in,False,885876,False,6,183,222,39
166582,2019-08-20 00:00:00+03:00,in,False,885890,False,16,1174,1366,192
166582,2019-08-21 00:00:00+03:00,out,False,885876,True,343,0,9104,9104
166582,2019-08-21 00:00:00+03:00,in,False,-1,True,52,0,666,666
166582,2019-08-21 00:00:00+03:00,out,False,885890,False,511,66966,76310,9344
166582,2019-08-21 00:00:00+03:00,in,False,885890,False,19,1434,1603,169
166582,2019-08-21 00:00:00+03:00,out,False,885876,False,317,29161,35061,5900
166582,2019-08-21 00:00:00+03:00,out,False,885890,True,319,0,9881,9881
166582,2019-08-21 00:00:00+03:00,in,False,885876,False,7,700,743,43
166582,2019-08-22 00:00:00+03:00,out,False,885876,False,295,31838,37351,5513
166582,2019-08-22 00:00:00+03:00,in,False,885890,True,1,0,6,6
166582,2019-08-22 00:00:00+03:00,in,False,885890,False,15,1313,1469,156
166582,2019-08-22 00:00:00+03:00,out,False,885890,False,411,42269,50138,7869
166582,2019-08-22 00:00:00+03:00,in,False,885876,True,1,0,13,13
166582,2019-08-22 00:00:00+03:00,out,False,885876,True,251,0,8418,8418
166582,2019-08-22 00:00:00+03:00,out,False,885890,True,268,0,9760,9760
166582,2019-08-22 00:00:00+03:00,in,False,885876,False,20,692,850,158
166582,2019-08-22 00:00:00+03:00,in,False,-1,True,37,0,268,268
166582,2019-08-22 00:00:00+03:00,out,False,885890,True,268,0,9760,9760
166582,2019-08-22 00:00:00+03:00,in,False,885876,True,1,0,13,13
166582,2019-08-23 00:00:00+03:00,in,False,885876,False,12,380,486,106
166582,2019-08-23 00:00:00+03:00,out,False,885890,True,341,0,11574,11574
166582,2019-08-23 00:00:00+03:00,in,False,885876,True,1,0,5,5
166582,2019-08-23 00:00:00+03:00,out,False,885876,True,253,0,8340,8340
166582,2019-08-23 00:00:00+03:00,in,False,885890,False,16,1038,1146,108
166582,2019-08-23 00:00:00+03:00,in,False,-1,True,23,0,261,261
166582,2019-08-23 00:00:00+03:00,out,False,885876,False,329,33507,39590,6083
166582,2019-08-23 00:00:00+03:00,out,False,885890,False,536,56153,66469,10316
166582,2019-08-24 00:00:00+03:00,in,False,885876,False,2,33,47,14
166582,2019-08-24 00:00:00+03:00,out,False,885876,False,53,3153,4304,1151
166582,2019-08-24 00:00:00+03:00,out,False,885890,True,117,0,3055,3055
166582,2019-08-24 00:00:00+03:00,out,False,885890,False,129,10334,12771,2437
166582,2019-08-24 00:00:00+03:00,in,False,885890,False,1,25,35,10
166582,2019-08-24 00:00:00+03:00,in,False,-1,True,29,0,289,289
166582,2019-08-24 00:00:00+03:00,out,False,885876,True,37,0,1088,1088
166582,2019-08-25 00:00:00+03:00,in,False,-1,True,18,0,179,179
166582,2019-08-25 00:00:00+03:00,in,False,885890,False,3,570,584,14
166582,2019-08-25 00:00:00+03:00,out,False,885876,True,4,0,18,18
166582,2019-08-25 00:00:00+03:00,out,False,885890,False,125,15153,17507,2354
166582,2019-08-25 00:00:00+03:00,out,False,885890,True,139,0,2967,2967
166582,2019-08-26 00:00:00+03:00,in,False,885876,False,12,612,712,100
166582,2019-08-26 00:00:00+03:00,out,False,885890,False,545,53356,63754,10398
166582,2019-08-26 00:00:00+03:00,out,False,885876,True,264,0,9256,9256
166582,2019-08-26 00:00:00+03:00,out,False,885876,False,318,44713,50817,6104
166582,2019-08-26 00:00:00+03:00,out,False,885890,True,387,0,12085,12085
166582,2019-08-26 00:00:00+03:00,in,False,-1,True,35,0,453,453
166582,2019-08-26 00:00:00+03:00,in,False,885890,False,26,1797,1992,195
166582,2019-08-27 00:00:00+03:00,in,False,885890,True,1,1,6,5
166582,2019-08-27 00:00:00+03:00,out,False,885890,False,635,61812,73876,12064
166582,2019-08-27 00:00:00+03:00,in,False,885876,False,7,217,291,74
166582,2019-08-27 00:00:00+03:00,out,False,885890,True,415,0,13823,13823
166582,2019-08-27 00:00:00+03:00,out,False,885876,True,94,0,3440,3440
166582,2019-08-27 00:00:00+03:00,out,False,885876,False,162,16852,19804,2952
166582,2019-08-27 00:00:00+03:00,in,False,-1,True,22,0,285,285
166582,2019-08-27 00:00:00+03:00,in,False,885890,False,26,1928,2148,220
166582,2019-08-27 00:00:00+03:00,in,False,885890,False,26,1928,2148,220
166582,2019-08-28 00:00:00+03:00,out,False,885890,False,572,58895,69419,10524
166582,2019-08-28 00:00:00+03:00,in,False,-1,True,34,0,385,385
166582,2019-08-28 00:00:00+03:00,in,False,885890,False,27,1243,1414,171
166582,2019-08-28 00:00:00+03:00,out,False,885890,True,369,0,11394,11394
166582,2019-08-28 00:00:00+03:00,in,False,885876,False,9,227,296,69
166582,2019-08-28 00:00:00+03:00,out,False,885876,False,316,43805,49615,5810
166582,2019-08-28 00:00:00+03:00,out,False,885876,True,248,0,8026,8026
166582,2019-08-29 00:00:00+03:00,in,False,885890,False,31,2426,2676,250
166582,2019-08-29 00:00:00+03:00,out,False,885876,True,163,0,5214,5214
166582,2019-08-29 00:00:00+03:00,out,False,885876,False,341,43529,49859,6330
166582,2019-08-29 00:00:00+03:00,out,False,885890,False,667,66041,78998,12957
166582,2019-08-29 00:00:00+03:00,in,False,-1,True,42,0,553,553
166582,2019-08-29 00:00:00+03:00,out,False,885890,True,411,0,15150,15150
166582,2019-08-29 00:00:00+03:00,in,False,885876,False,7,943,992,49
166582,2019-08-29 00:00:00+03:00,out,True,885876,True,2,0,2,2
166582,2019-08-29 00:00:00+03:00,out,False,885890,True,411,0,15150,15150
166582,2019-08-29 00:00:00+03:00,in,False,885876,False,7,943,992,49
166582,2019-08-29 00:00:00+03:00,out,False,885876,True,163,0,5214,5214
166582,2019-08-30 00:00:00+03:00,out,False,885876,False,460,60520,69383,8863
166582,2019-08-30 00:00:00+03:00,in,False,885890,False,17,1203,1364,161
166582,2019-08-30 00:00:00+03:00,in,False,-1,True,75,0,1059,1059
166582,2019-08-30 00:00:00+03:00,out,False,885890,True,431,0,13855,13855
166582,2019-08-30 00:00:00+03:00,out,False,885876,True,215,0,6713,6713
166582,2019-08-30 00:00:00+03:00,in,False,885876,False,6,198,256,58
166582,2019-08-30 00:00:00+03:00,out,False,885890,False,622,58134,69987,11853
166582,2019-08-30 00:00:00+03:00,in,False,885890,True,1,0,6,6
166582,2019-08-30 00:00:00+03:00,out,False,885890,False,622,58134,69987,11853
166582,2019-08-31 00:00:00+03:00,in,False,-1,True,57,0,764,764
166582,2019-08-31 00:00:00+03:00,out,False,885890,True,60,0,2242,2242
166582,2019-08-31 00:00:00+03:00,out,False,885890,False,116,10095,12260,2165
166582,2019-08-31 00:00:00+03:00,out,False,885876,False,340,41811,47988,6177
166582,2019-08-31 00:00:00+03:00,out,False,885876,True,213,0,6807,6807
166582,2019-08-31 00:00:00+03:00,in,False,885876,False,5,313,338,25
166582,2019-08-31 00:00:00+03:00,in,False,885876,False,5,313,338,25
166582,2019-09-01 00:00:00+03:00,in,False,-1,True,22,0,190,190
166582,2019-09-01 00:00:00+03:00,in,False,885876,False,1,58,64,6
166582,2019-09-01 00:00:00+03:00,out,False,885890,False,15,2344,2584,240
166582,2019-09-01 00:00:00+03:00,out,False,885890,True,7,0,345,345
166582,2019-09-01 00:00:00+03:00,out,False,885876,True,141,0,4761,4761
166582,2019-09-01 00:00:00+03:00,out,False,885876,False,229,34934,39213,4279
166582,2019-09-02 00:00:00+03:00,out,False,885876,True,470,0,16145,16145
166582,2019-09-02 00:00:00+03:00,in,False,885890,False,28,2189,2456,267
166582,2019-09-02 00:00:00+03:00,out,False,885890,True,305,0,10882,10882
166582,2019-09-02 00:00:00+03:00,in,False,-1,True,68,0,938,938
166582,2019-09-02 00:00:00+03:00,out,False,-1,True,1,0,0,0
166582,2019-09-02 00:00:00+03:00,in,False,885876,False,20,1351,1580,229
166582,2019-09-02 00:00:00+03:00,out,False,885876,False,1018,90095,108665,18570
166582,2019-09-02 00:00:00+03:00,in,False,885890,True,1,0,22,22
166582,2019-09-02 00:00:00+03:00,in,False,885876,True,2,1,26,25
166582,2019-09-02 00:00:00+03:00,out,False,885890,False,575,58462,68790,10328
166582,2019-09-02 00:00:00+03:00,in,False,885876,False,20,1351,1580,229
166582,2019-09-03 00:00:00+03:00,out,False,885890,False,592,58782,69569,10787
166582,2019-09-03 00:00:00+03:00,out,False,-1,True,2,0,0,0
166582,2019-09-03 00:00:00+03:00,out,False,885876,True,743,0,21944,21944
166582,2019-09-03 00:00:00+03:00,in,False,885890,True,1,0,17,17
166582,2019-09-03 00:00:00+03:00,out,False,885876,False,1137,87700,109600,21900
166582,2019-09-03 00:00:00+03:00,out,False,885890,True,398,0,12464,12464
166582,2019-09-03 00:00:00+03:00,in,False,-1,True,134,0,2435,2435
166582,2019-09-03 00:00:00+03:00,in,False,885890,False,24,1988,2196,208
166582,2019-09-03 00:00:00+03:00,in,False,885876,True,1,0,14,14
166582,2019-09-03 00:00:00+03:00,in,False,885876,False,16,1010,1199,189
166582,2019-09-04 00:00:00+03:00,in,False,885876,True,1,0,8,8
166582,2019-09-04 00:00:00+03:00,out,False,885876,False,863,91813,107524,15711
166582,2019-09-04 00:00:00+03:00,out,False,885890,True,359,0,12969,12969
166582,2019-09-04 00:00:00+03:00,in,False,885890,False,20,1146,1306,160
166582,2019-09-04 00:00:00+03:00,in,False,885876,False,41,2242,2668,426
166582,2019-09-04 00:00:00+03:00,out,False,885890,False,545,52874,63538,10664
166582,2019-09-04 00:00:00+03:00,in,False,-1,True,60,0,1057,1057
166582,2019-09-04 00:00:00+03:00,out,False,885876,True,469,0,16523,16523
166582,2019-09-04 00:00:00+03:00,in,False,885876,False,41,2242,2668,426
166582,2019-09-05 00:00:00+03:00,out,False,885876,False,602,109032,120064,11032
166582,2019-09-05 00:00:00+03:00,out,False,885876,True,369,0,13065,13065
166582,2019-09-05 00:00:00+03:00,out,False,885890,True,389,0,14019,14019
166582,2019-09-05 00:00:00+03:00,in,False,885876,True,1,0,5,5
166582,2019-09-05 00:00:00+03:00,in,False,885890,False,17,890,1041,151
166582,2019-09-05 00:00:00+03:00,out,False,-1,True,1,0,0,0
166582,2019-09-05 00:00:00+03:00,in,False,-1,True,49,0,645,645
166582,2019-09-05 00:00:00+03:00,in,False,885876,False,28,2275,2501,226
166582,2019-09-05 00:00:00+03:00,out,False,885890,False,591,58819,69489,10670
166582,2019-09-06 00:00:00+03:00,out,True,885876,True,1,0,0,0
166582,2019-09-06 00:00:00+03:00,in,False,885890,False,13,515,637,122
166582,2019-09-06 00:00:00+03:00,in,False,-1,True,47,0,648,648
166582,2019-09-06 00:00:00+03:00,out,False,885890,False,471,40168,48988,8820
166582,2019-09-06 00:00:00+03:00,in,False,885890,True,2,0,26,26
166582,2019-09-06 00:00:00+03:00,in,False,885876,True,1,0,20,20
166582,2019-09-06 00:00:00+03:00,out,False,885890,True,350,0,12693,12693
166582,2019-09-06 00:00:00+03:00,in,False,885876,False,29,1983,2302,319
166582,2019-09-06 00:00:00+03:00,out,False,885876,False,584,87556,98711,11155
166582,2019-09-06 00:00:00+03:00,out,False,885876,True,393,0,13848,13848
166582,2019-09-06 00:00:00+03:00,out,False,885890,False,471,40168,48988,8820
166582,2019-09-06 00:00:00+03:00,in,False,885876,True,1,0,20,20
166582,2019-09-07 00:00:00+03:00,out,False,885876,False,192,28333,32291,3958
166582,2019-09-07 00:00:00+03:00,in,False,885876,False,2,67,83,16
166582,2019-09-07 00:00:00+03:00,out,False,885890,False,195,12612,16152,3540
166582,2019-09-07 00:00:00+03:00,out,False,885890,True,90,0,3012,3012
166582,2019-09-07 00:00:00+03:00,out,False,885876,True,116,0,4081,4081
166582,2019-09-07 00:00:00+03:00,in,False,885890,False,13,566,685,119
166582,2019-09-07 00:00:00+03:00,in,False,-1,True,37,0,443,443
166582,2019-09-07 00:00:00+03:00,out,False,885876,False,192,28333,32291,3958
166582,2019-09-08 00:00:00+03:00,in,False,885890,False,4,163,222,59
166582,2019-09-08 00:00:00+03:00,in,False,-1,True,30,0,375,375
166582,2019-09-08 00:00:00+03:00,out,False,885890,False,177,12118,15599,3481
166582,2019-09-08 00:00:00+03:00,in,False,885876,False,1,30,34,4
166582,2019-09-08 00:00:00+03:00,out,False,885876,True,236,0,7687,7687
166582,2019-09-08 00:00:00+03:00,out,False,885876,False,331,31247,37915,6668
166582,2019-09-08 00:00:00+03:00,out,False,885890,True,93,0,3129,3129
166582,2019-09-08 00:00:00+03:00,out,False,885876,False,331,31247,37915,6668
166582,2019-09-09 00:00:00+03:00,in,False,885876,False,30,1427,1782,355
166582,2019-09-09 00:00:00+03:00,in,False,885876,True,1,1,12,11
166582,2019-09-09 00:00:00+03:00,out,False,885876,False,1138,121093,141930,20837
166582,2019-09-09 00:00:00+03:00,out,False,885890,True,219,0,7430,7430
166582,2019-09-09 00:00:00+03:00,in,False,885890,False,4,386,441,55
166582,2019-09-09 00:00:00+03:00,out,False,885890,False,322,27246,33088,5842
166582,2019-09-09 00:00:00+03:00,out,False,885876,True,531,0,17102,17102
166582,2019-09-09 00:00:00+03:00,in,False,-1,True,86,0,1372,1372
166582,2019-09-10 00:00:00+03:00,in,False,885890,True,1,0,5,5
166582,2019-09-10 00:00:00+03:00,in,False,885890,False,23,1275,1472,197
166582,2019-09-10 00:00:00+03:00,out,False,885876,False,1053,80782,100139,19357
166582,2019-09-10 00:00:00+03:00,out,False,885876,True,718,0,21660,21660
166582,2019-09-10 00:00:00+03:00,in,False,885876,False,17,455,600,145
166582,2019-09-10 00:00:00+03:00,out,False,885890,True,396,0,13488,13488
166582,2019-09-10 00:00:00+03:00,in,False,-1,True,137,0,2202,2202
166582,2019-09-10 00:00:00+03:00,out,False,885890,False,570,48824,59235,10411
166582,2019-09-10 00:00:00+03:00,out,False,885876,False,1053,80782,100139,19357
166582,2019-09-11 00:00:00+03:00,in,False,885876,True,1,1,4,3
166582,2019-09-11 00:00:00+03:00,out,False,885890,False,621,61487,72816,11329
166582,2019-09-11 00:00:00+03:00,out,False,885876,False,946,115057,132708,17651
166582,2019-09-11 00:00:00+03:00,in,False,885890,True,1,1,27,26
166582,2019-09-11 00:00:00+03:00,out,False,885876,True,460,0,15972,15972
166582,2019-09-11 00:00:00+03:00,in,False,885876,False,11,644,730,86
166582,2019-09-11 00:00:00+03:00,in,False,885890,False,35,3354,3710,356
166582,2019-09-11 00:00:00+03:00,out,False,885890,True,442,0,15907,15907
166582,2019-09-11 00:00:00+03:00,in,False,-1,True,106,0,1621,1621
166582,2019-09-12 00:00:00+03:00,out,False,885890,False,556,72094,82634,10540
166582,2019-09-12 00:00:00+03:00,out,False,885876,False,696,125286,138643,13357
166582,2019-09-12 00:00:00+03:00,in,False,-1,True,55,0,936,936
166582,2019-09-12 00:00:00+03:00,out,False,885876,True,386,0,13553,13553
166582,2019-09-12 00:00:00+03:00,in,False,885876,False,22,1430,1597,167
166582,2019-09-12 00:00:00+03:00,in,False,885890,False,21,977,1181,204
166582,2019-09-12 00:00:00+03:00,out,False,885890,True,448,0,14811,14811
166582,2019-09-13 00:00:00+03:00,in,False,885876,False,26,1145,1317,172
166582,2019-09-13 00:00:00+03:00,in,False,-1,True,47,0,508,508
166582,2019-09-13 00:00:00+03:00,in,False,885876,True,1,0,19,19
166582,2019-09-13 00:00:00+03:00,out,False,885890,True,517,0,16796,16796
166582,2019-09-13 00:00:00+03:00,out,False,885876,True,460,0,14443,14443
166582,2019-09-13 00:00:00+03:00,out,False,885876,False,652,98748,111703,12955
166582,2019-09-13 00:00:00+03:00,in,False,885890,True,2,0,32,32
166582,2019-09-13 00:00:00+03:00,in,False,885890,False,26,1596,1820,224
166582,2019-09-13 00:00:00+03:00,out,False,885890,False,623,63102,75143,12041
166582,2019-09-14 00:00:00+03:00,in,False,-1,True,53,0,352,352
166582,2019-09-14 00:00:00+03:00,out,False,885876,True,220,0,4827,4827
166582,2019-09-14 00:00:00+03:00,in,False,885890,True,1,0,11,11
166582,2019-09-14 00:00:00+03:00,out,False,885890,True,293,0,8049,8049
166582,2019-09-14 00:00:00+03:00,out,False,885876,False,246,24830,29397,4567
166582,2019-09-14 00:00:00+03:00,out,False,885890,False,371,29392,36585,7193
166582,2019-09-14 00:00:00+03:00,in,False,885890,False,11,449,543,94
166582,2019-09-14 00:00:00+03:00,in,False,885890,False,11,449,543,94
166582,2019-09-15 00:00:00+03:00,in,False,885890,False,5,110,153,43
166582,2019-09-15 00:00:00+03:00,in,False,-1,True,69,0,939,939
166582,2019-09-15 00:00:00+03:00,out,False,885890,True,133,0,3818,3818
166582,2019-09-15 00:00:00+03:00,out,False,885876,True,299,0,7295,7295
166582,2019-09-15 00:00:00+03:00,out,False,885876,False,283,30267,35454,5187
166582,2019-09-15 00:00:00+03:00,out,False,885890,False,221,14578,18676,4098
166582,2019-09-16 00:00:00+03:00,in,False,885876,False,12,721,804,83
166582,2019-09-16 00:00:00+03:00,out,False,885890,False,443,48442,56436,7994
166582,2019-09-16 00:00:00+03:00,out,False,885876,True,479,0,14784,14784
166582,2019-09-16 00:00:00+03:00,in,False,-1,True,107,0,2008,2008
166582,2019-09-16 00:00:00+03:00,out,False,885876,False,878,71910,87712,15802
166582,2019-09-16 00:00:00+03:00,in,False,885890,True,3,0,27,27
166582,2019-09-16 00:00:00+03:00,out,False,885890,True,301,0,10705,10705
166582,2019-09-16 00:00:00+03:00,in,False,885890,False,18,1945,2079,134
166582,2019-09-16 00:00:00+03:00,in,False,-1,True,107,0,2008,2008
166582,2019-09-16 00:00:00+03:00,in,False,885890,False,18,1945,2079,134
166582,2019-09-16 00:00:00+03:00,out,False,885890,True,301,0,10705,10705
166582,2019-09-16 00:00:00+03:00,out,False,885890,False,443,48442,56436,7994
166582,2019-09-17 00:00:00+03:00,out,False,885876,False,1375,100454,124787,24333
166582,2019-09-17 00:00:00+03:00,out,False,885890,True,373,0,12056,12056
166582,2019-09-17 00:00:00+03:00,in,False,-1,True,129,0,2347,2347
166582,2019-09-17 00:00:00+03:00,out,False,885876,True,817,0,24833,24833
166582,2019-09-17 00:00:00+03:00,in,False,885890,False,21,1222,1381,159
166582,2019-09-17 00:00:00+03:00,out,False,885890,False,536,54889,65281,10392
166582,2019-09-17 00:00:00+03:00,in,False,885876,False,14,709,866,157
166582,2019-09-17 00:00:00+03:00,out,False,885890,False,536,54889,65281,10392
166582,2019-09-18 00:00:00+03:00,out,False,885890,True,430,0,14250,14250
166582,2019-09-18 00:00:00+03:00,out,False,885876,True,620,0,18915,18915
166582,2019-09-18 00:00:00+03:00,in,False,885890,False,23,1451,1588,137
166582,2019-09-18 00:00:00+03:00,in,False,885890,True,1,0,10,10
166582,2019-09-18 00:00:00+03:00,in,False,885876,False,5,172,213,41
166582,2019-09-18 00:00:00+03:00,out,False,885890,False,664,64709,77183,12474
166582,2019-09-18 00:00:00+03:00,in,False,-1,True,140,0,2706,2706
166582,2019-09-18 00:00:00+03:00,out,False,885876,False,1013,121664,140050,18386
166582,2019-09-18 00:00:00+03:00,out,False,885890,True,430,0,14250,14250
166582,2019-09-19 00:00:00+03:00,out,False,885876,False,673,108207,120596,12389
166582,2019-09-19 00:00:00+03:00,out,False,885890,True,489,0,16896,16896
166582,2019-09-19 00:00:00+03:00,in,False,885890,True,1,0,9,9
166582,2019-09-19 00:00:00+03:00,out,False,885890,False,662,63872,76458,12586
166582,2019-09-19 00:00:00+03:00,in,False,-1,True,106,0,1692,1692
166582,2019-09-19 00:00:00+03:00,in,False,885890,False,27,1316,1592,276
166582,2019-09-19 00:00:00+03:00,out,False,885876,True,561,0,15260,15260
166582,2019-09-19 00:00:00+03:00,in,False,885876,False,18,1645,1757,112
166582,2019-09-20 00:00:00+03:00,out,False,885890,False,679,63058,75769,12711
166582,2019-09-20 00:00:00+03:00,in,False,885890,False,34,1888,2166,278
166582,2019-09-20 00:00:00+03:00,in,False,-1,True,59,0,999,999
166582,2019-09-20 00:00:00+03:00,out,False,885876,False,737,114463,127868,13405
166582,2019-09-20 00:00:00+03:00,in,False,885876,False,14,2373,2485,112
166582,2019-09-20 00:00:00+03:00,out,False,885890,True,494,0,17146,17146
166582,2019-09-20 00:00:00+03:00,out,False,885876,True,580,0,17315,17315
166582,2019-09-21 00:00:00+03:00,in,False,885876,False,4,230,255,25
166582,2019-09-21 00:00:00+03:00,out,False,885876,True,213,0,4930,4930
166582,2019-09-21 00:00:00+03:00,out,False,885890,False,196,12854,16468,3614
166582,2019-09-21 00:00:00+03:00,out,False,885890,True,111,0,3749,3749
166582,2019-09-21 00:00:00+03:00,in,False,-1,True,42,0,601,601
166582,2019-09-21 00:00:00+03:00,out,False,885876,False,172,21505,24537,3032
166582,2019-09-21 00:00:00+03:00,in,False,885890,False,1,62,68,6
166582,2019-09-22 00:00:00+03:00,out,False,885876,False,54,6129,7354,1225
166582,2019-09-22 00:00:00+03:00,out,False,885876,True,57,0,1976,1976
166582,2019-09-22 00:00:00+03:00,in,False,885890,False,1,13,19,6
166582,2019-09-22 00:00:00+03:00,out,False,885890,False,230,15612,20137,4525
166582,2019-09-22 00:00:00+03:00,in,False,-1,True,39,0,390,390
166582,2019-09-22 00:00:00+03:00,out,False,885890,True,133,0,4603,4603
166582,2019-09-22 00:00:00+03:00,out,False,885876,True,57,0,1976,1976
166582,2019-09-23 00:00:00+03:00,in,False,-1,True,98,0,1671,1671
166582,2019-09-23 00:00:00+03:00,out,False,885890,True,459,0,16034,16034
166582,2019-09-23 00:00:00+03:00,in,False,885876,False,20,676,828,152
166582,2019-09-23 00:00:00+03:00,out,False,885876,False,1436,103526,129484,25958
166582,2019-09-23 00:00:00+03:00,in,False,885890,False,19,1130,1313,183
166582,2019-09-23 00:00:00+03:00,out,False,885890,False,667,58300,70399,12099
166582,2019-09-23 00:00:00+03:00,in,False,885876,True,1,0,5,5
166582,2019-09-23 00:00:00+03:00,out,False,885876,True,729,0,22996,22996
166582,2019-09-23 00:00:00+03:00,in,False,885876,False,20,676,828,152
166582,2019-09-23 00:00:00+03:00,out,False,885876,True,729,0,22996,22996
166582,2019-09-24 00:00:00+03:00,out,False,885890,False,614,55559,66994,11435
166582,2019-09-24 00:00:00+03:00,out,False,885876,False,1118,61814,82550,20736
166582,2019-09-24 00:00:00+03:00,in,False,885890,False,13,1038,1174,136
166582,2019-09-24 00:00:00+03:00,out,False,885890,True,377,0,13637,13637
166582,2019-09-24 00:00:00+03:00,out,False,885876,True,1195,0,33367,33367
166582,2019-09-24 00:00:00+03:00,in,False,885876,False,11,301,389,88
166582,2019-09-24 00:00:00+03:00,in,False,-1,True,156,0,2191,2191
166582,2019-09-24 00:00:00+03:00,in,False,885876,True,1,0,4,4
166582,2019-09-24 00:00:00+03:00,in,False,-1,True,156,0,2191,2191
166582,2019-09-25 00:00:00+03:00,out,False,885890,True,433,0,14513,14513
166582,2019-09-25 00:00:00+03:00,out,False,885890,False,626,57929,69386,11457
166582,2019-09-25 00:00:00+03:00,out,False,885876,True,796,0,23081,23081
166582,2019-09-25 00:00:00+03:00,in,False,885876,False,13,611,753,142
166582,2019-09-25 00:00:00+03:00,in,False,885890,False,30,2162,2427,265
166582,2019-09-25 00:00:00+03:00,in,False,-1,True,154,0,2481,2481
166582,2019-09-25 00:00:00+03:00,in,False,885890,True,1,1,10,9
166582,2019-09-25 00:00:00+03:00,out,False,885876,False,1230,144395,166155,21760
166582,2019-09-26 00:00:00+03:00,out,False,885890,False,612,55060,66961,11901
166582,2019-09-26 00:00:00+03:00,out,False,885890,True,461,0,15614,15614
166582,2019-09-26 00:00:00+03:00,in,False,885890,False,18,1044,1164,120
166582,2019-09-26 00:00:00+03:00,out,False,885876,False,843,132206,146903,14697
166582,2019-09-26 00:00:00+03:00,in,False,-1,True,71,0,735,735
166582,2019-09-26 00:00:00+03:00,out,False,885876,True,720,0,19948,19948
166582,2019-09-26 00:00:00+03:00,in,False,885876,False,40,4932,5314,382
166582,2019-09-27 00:00:00+03:00,out,False,885890,True,330,0,11973,11973
166582,2019-09-27 00:00:00+03:00,out,False,885890,False,455,42012,50842,8830
166582,2019-09-27 00:00:00+03:00,out,False,885876,False,754,114325,127751,13426
166582,2019-09-27 00:00:00+03:00,in,False,885876,True,1,1,15,14
166582,2019-09-27 00:00:00+03:00,out,False,885876,True,701,0,19481,19481
166582,2019-09-27 00:00:00+03:00,in,False,885876,False,31,2201,2433,232
166582,2019-09-27 00:00:00+03:00,in,False,885890,False,29,2132,2364,232
166582,2019-09-27 00:00:00+03:00,in,False,-1,True,49,0,785,785
166582,2019-09-27 00:00:00+03:00,in,False,885876,True,1,1,15,14
166582,2019-09-27 00:00:00+03:00,out,False,885876,True,701,0,19481,19481
166582,2019-09-28 00:00:00+03:00,out,False,885890,False,242,18424,22706,4282
166582,2019-09-28 00:00:00+03:00,out,False,885890,True,133,0,4521,4521
166582,2019-09-28 00:00:00+03:00,in,False,885890,False,5,921,979,58
166582,2019-09-28 00:00:00+03:00,in,False,-1,True,30,0,369,369
166582,2019-09-28 00:00:00+03:00,out,False,885876,True,1,0,53,53
166582,2019-09-29 00:00:00+03:00,in,False,885876,False,1,89,95,6
166582,2019-09-29 00:00:00+03:00,in,False,-1,True,31,0,453,453
166582,2019-09-29 00:00:00+03:00,out,False,885890,False,200,15305,19381,4076
166582,2019-09-29 00:00:00+03:00,out,False,885890,True,153,0,4624,4624
166582,2019-09-29 00:00:00+03:00,out,False,885876,True,57,0,1656,1656
166582,2019-09-29 00:00:00+03:00,out,False,885876,False,52,3589,4688,1099
166582,2019-09-29 00:00:00+03:00,out,False,885890,False,200,15305,19381,4076
166582,2019-09-30 00:00:00+03:00,out,False,885890,False,485,49747,58971,9224
166582,2019-09-30 00:00:00+03:00,out,False,885876,False,1063,93800,112572,18772
166582,2019-09-30 00:00:00+03:00,in,False,-1,True,52,0,523,523
166582,2019-09-30 00:00:00+03:00,out,False,885890,True,346,0,11041,11041
166582,2019-09-30 00:00:00+03:00,out,False,885876,True,632,0,18592,18592
166582,2019-09-30 00:00:00+03:00,in,False,885890,False,10,306,383,77
166582,2019-09-30 00:00:00+03:00,in,False,885876,False,28,1147,1388,241
166582,2019-09-30 00:00:00+03:00,in,False,-1,True,52,0,523,523
166582,2019-10-01 00:00:00+03:00,out,False,885876,False,1480,86910,113843,26933
166582,2019-10-01 00:00:00+03:00,in,False,885876,False,46,2402,2822,420
166582,2019-10-01 00:00:00+03:00,out,False,-1,True,1,0,0,0
166582,2019-10-01 00:00:00+03:00,in,False,-1,True,119,0,1800,1800
166582,2019-10-01 00:00:00+03:00,in,False,885890,False,29,1904,2188,284
166582,2019-10-01 00:00:00+03:00,in,False,885890,True,2,0,11,11
166582,2019-10-01 00:00:00+03:00,out,False,885890,True,374,0,11829,11829
166582,2019-10-01 00:00:00+03:00,out,False,885876,True,1241,0,33538,33538
166582,2019-10-01 00:00:00+03:00,out,False,885890,False,622,44133,55237,11104
166582,2019-10-01 00:00:00+03:00,out,False,885876,True,1241,0,33538,33538
166582,2019-10-02 00:00:00+03:00,in,False,-1,True,113,0,1607,1607
166582,2019-10-02 00:00:00+03:00,out,False,885876,True,559,0,16004,16004
166582,2019-10-02 00:00:00+03:00,out,False,885890,False,445,27915,35964,8049
166582,2019-10-02 00:00:00+03:00,in,False,925922,True,1,0,17,17
166582,2019-10-02 00:00:00+03:00,out,False,925922,False,227,26493,30560,4067
166582,2019-10-02 00:00:00+03:00,out,False,885890,True,254,0,7472,7472
166582,2019-10-02 00:00:00+03:00,out,False,885876,False,995,120175,137324,17149
166582,2019-10-02 00:00:00+03:00,out,False,925922,True,231,0,5761,5761
166582,2019-10-02 00:00:00+03:00,in,False,925922,False,7,569,621,52
166582,2019-10-02 00:00:00+03:00,in,False,885876,False,16,1933,2074,141
166582,2019-10-02 00:00:00+03:00,in,False,885890,False,8,464,515,51
166582,2019-10-02 00:00:00+03:00,in,False,885876,False,16,1933,2074,141
166582,2019-10-03 00:00:00+03:00,out,False,925922,True,519,0,13334,13334
166582,2019-10-03 00:00:00+03:00,out,False,885876,True,149,0,4939,4939
166582,2019-10-03 00:00:00+03:00,in,False,885890,False,21,1637,1808,171
166582,2019-10-03 00:00:00+03:00,out,False,885876,False,314,94237,99839,5602
166582,2019-10-03 00:00:00+03:00,in,False,885876,False,21,867,1008,141
166582,2019-10-03 00:00:00+03:00,in,False,925922,False,25,2602,2819,217
166582,2019-10-03 00:00:00+03:00,in,False,-1,True,50,0,757,757
166582,2019-10-03 00:00:00+03:00,out,False,885890,False,464,52863,61662,8799
166582,2019-10-03 00:00:00+03:00,in,False,925922,True,1,1,4,3
166582,2019-10-03 00:00:00+03:00,out,False,925922,False,564,59922,70031,10109
166582,2019-10-03 00:00:00+03:00,out,False,885890,True,274,0,8331,8331
166582,2019-10-04 00:00:00+03:00,out,False,925922,False,544,60890,70403,9513
166582,2019-10-04 00:00:00+03:00,out,False,885890,False,338,34050,40186,6136
166582,2019-10-04 00:00:00+03:00,in,False,925922,False,12,2590,2678,88
166582,2019-10-04 00:00:00+03:00,out,False,885890,True,253,0,8061,8061
166582,2019-10-04 00:00:00+03:00,in,False,-1,True,76,0,1161,1161
166582,2019-10-04 00:00:00+03:00,in,False,885876,False,13,497,606,109
166582,2019-10-04 00:00:00+03:00,out,False,885876,False,277,83560,87883,4323
166582,2019-10-04 00:00:00+03:00,in,False,885890,False,17,816,987,171
166582,2019-10-04 00:00:00+03:00,out,False,925922,True,507,0,12774,12774
166582,2019-10-04 00:00:00+03:00,out,False,885876,True,159,0,5621,5621
166582,2019-10-04 00:00:00+03:00,out,False,885890,True,253,0,8061,8061
166582,2019-10-05 00:00:00+03:00,out,False,885876,False,10,3565,3767,202
166582,2019-10-05 00:00:00+03:00,out,False,925922,True,86,0,3471,3471
166582,2019-10-05 00:00:00+03:00,out,False,885876,True,5,0,164,164
166582,2019-10-05 00:00:00+03:00,in,False,-1,True,42,0,435,435
166582,2019-10-05 00:00:00+03:00,in,False,885890,False,9,565,664,99
166582,2019-10-05 00:00:00+03:00,in,False,925922,False,1,138,142,4
166582,2019-10-05 00:00:00+03:00,out,False,925922,False,141,13157,16164,3007
166582,2019-10-05 00:00:00+03:00,out,False,885890,True,145,0,4916,4916
166582,2019-10-05 00:00:00+03:00,out,False,885890,False,194,13740,17382,3642
166582,2019-10-05 00:00:00+03:00,in,False,-1,True,42,0,435,435
166582,2019-10-06 00:00:00+03:00,in,False,-1,True,51,0,442,442
166582,2019-10-06 00:00:00+03:00,out,False,925922,True,129,0,4563,4563
166582,2019-10-06 00:00:00+03:00,out,False,885876,False,4,555,620,65
166582,2019-10-06 00:00:00+03:00,out,False,885876,True,17,0,433,433
166582,2019-10-06 00:00:00+03:00,out,False,925922,False,122,13083,15439,2356
166582,2019-10-06 00:00:00+03:00,in,False,885890,False,10,333,395,62
166582,2019-10-06 00:00:00+03:00,out,False,885890,False,331,21049,27521,6472
166582,2019-10-06 00:00:00+03:00,out,False,885890,True,216,0,7448,7448
166582,2019-10-06 00:00:00+03:00,out,False,885876,True,17,0,433,433
166582,2019-10-07 00:00:00+03:00,in,False,885876,False,15,772,865,93
166582,2019-10-07 00:00:00+03:00,out,False,885890,False,530,46336,56228,9892
166582,2019-10-07 00:00:00+03:00,in,False,885890,False,17,927,1083,156
166582,2019-10-07 00:00:00+03:00,out,False,925922,True,438,0,12568,12568
166582,2019-10-07 00:00:00+03:00,in,False,-1,True,60,0,851,851
166582,2019-10-07 00:00:00+03:00,out,False,925922,False,682,45132,56801,11669
166582,2019-10-07 00:00:00+03:00,in,False,885876,True,1,0,13,13
166582,2019-10-07 00:00:00+03:00,out,False,885890,True,326,0,10822,10822
166582,2019-10-07 00:00:00+03:00,out,False,885876,False,418,57176,65117,7941
166582,2019-10-07 00:00:00+03:00,out,False,885876,True,255,0,9159,9159
166582,2019-10-07 00:00:00+03:00,in,False,925922,False,26,2254,2433,179
166582,2019-10-07 00:00:00+03:00,out,False,885876,False,418,57176,65117,7941
166582,2019-10-07 00:00:00+03:00,in,False,885876,False,15,772,865,93
166582,2019-10-08 00:00:00+03:00,in,False,-1,True,108,0,1269,1269
166582,2019-10-08 00:00:00+03:00,in,False,925922,False,30,1756,1963,207
166582,2019-10-08 00:00:00+03:00,in,False,885876,False,27,993,1335,342
166582,2019-10-08 00:00:00+03:00,out,False,885890,True,363,0,11439,11439
166582,2019-10-08 00:00:00+03:00,out,False,885876,False,931,38485,56305,17820
166582,2019-10-08 00:00:00+03:00,out,False,-1,True,3,0,0,0
166582,2019-10-08 00:00:00+03:00,out,False,885876,True,678,0,19944,19944
166582,2019-10-08 00:00:00+03:00,in,False,885890,False,24,1527,1764,237
166582,2019-10-08 00:00:00+03:00,in,False,885876,True,1,0,29,29
166582,2019-10-08 00:00:00+03:00,out,False,925922,False,790,49497,63765,14268
166582,2019-10-08 00:00:00+03:00,in,False,925922,True,1,1,5,4
166582,2019-10-08 00:00:00+03:00,out,False,925922,True,827,0,20386,20386
166582,2019-10-08 00:00:00+03:00,out,False,885890,False,503,48239,57410,9171
166582,2019-10-08 00:00:00+03:00,in,False,885876,True,1,0,29,29
166582,2019-10-08 00:00:00+03:00,out,False,925922,False,790,49497,63765,14268
166582,2019-10-09 00:00:00+03:00,out,False,885876,False,696,117177,129395,12218
166582,2019-10-09 00:00:00+03:00,out,False,885876,True,283,0,8533,8533
166582,2019-10-09 00:00:00+03:00,out,False,885890,False,538,44939,55165,10226
166582,2019-10-09 00:00:00+03:00,in,False,885876,False,28,3299,3645,346
166582,2019-10-09 00:00:00+03:00,out,False,925922,True,401,0,9856,9856
166582,2019-10-09 00:00:00+03:00,in,False,885890,False,19,943,1143,200
166582,2019-10-09 00:00:00+03:00,out,False,925922,False,532,54897,63964,9067
166582,2019-10-09 00:00:00+03:00,in,False,-1,True,84,0,1098,1098
166582,2019-10-09 00:00:00+03:00,in,False,925922,False,16,836,914,78
166582,2019-10-09 00:00:00+03:00,out,False,885890,True,368,0,12605,12605
166582,2019-10-10 00:00:00+03:00,out,False,885890,False,500,48318,57868,9550
166582,2019-10-10 00:00:00+03:00,out,False,925922,True,490,0,11545,11545
166582,2019-10-10 00:00:00+03:00,out,False,925922,False,581,56676,66860,10184
166582,2019-10-10 00:00:00+03:00,out,False,885890,True,366,0,12400,12400
166582,2019-10-10 00:00:00+03:00,in,False,925922,True,1,1,7,6
166582,2019-10-10 00:00:00+03:00,out,False,885876,True,156,0,4662,4662
166582,2019-10-10 00:00:00+03:00,in,False,925922,False,37,2939,3161,222
166582,2019-10-10 00:00:00+03:00,in,False,-1,True,69,0,943,943
166582,2019-10-10 00:00:00+03:00,in,False,885890,False,23,1143,1335,192
166582,2019-10-10 00:00:00+03:00,in,False,885876,False,19,1203,1396,193
166582,2019-10-10 00:00:00+03:00,out,False,885876,False,348,89576,95440,5864
166582,2019-10-10 00:00:00+03:00,out,False,925922,True,490,0,11545,11545
166582,2019-10-10 00:00:00+03:00,in,False,925922,False,37,2939,3161,222
166582,2019-10-11 00:00:00+03:00,out,False,885876,False,253,74815,79213,4398
166582,2019-10-11 00:00:00+03:00,in,False,885876,False,15,1058,1181,123
166582,2019-10-11 00:00:00+03:00,out,False,885890,False,501,44831,54511,9680
166582,2019-10-11 00:00:00+03:00,in,False,-1,True,69,0,1079,1079
166582,2019-10-11 00:00:00+03:00,in,False,925922,False,24,2022,2181,159
166582,2019-10-11 00:00:00+03:00,out,False,925922,True,581,0,14775,14775
166582,2019-10-11 00:00:00+03:00,out,False,885890,True,387,0,13156,13156
166582,2019-10-11 00:00:00+03:00,out,False,885876,True,122,0,4067,4067
166582,2019-10-11 00:00:00+03:00,in,False,925922,True,1,0,4,4
166582,2019-10-11 00:00:00+03:00,out,False,925922,False,597,47815,58656,10841
166582,2019-10-11 00:00:00+03:00,in,False,885890,False,21,1459,1683,224
166582,2019-10-11 00:00:00+03:00,out,False,885876,True,122,0,4067,4067
166582,2019-10-11 00:00:00+03:00,out,False,925922,False,597,47815,58656,10841
166582,2019-10-12 00:00:00+03:00,out,False,885876,False,3,38,38,0
166582,2019-10-12 00:00:00+03:00,in,False,-1,True,67,0,994,994
166582,2019-10-12 00:00:00+03:00,out,False,925922,False,282,27269,32148,4879
166582,2019-10-12 00:00:00+03:00,out,False,925922,True,274,0,6028,6028
166582,2019-10-12 00:00:00+03:00,out,False,885890,False,216,13299,17540,4241
166582,2019-10-12 00:00:00+03:00,out,False,885876,True,5,0,19,19
166582,2019-10-12 00:00:00+03:00,in,False,885890,False,1,53,59,6
166582,2019-10-12 00:00:00+03:00,in,False,925922,False,11,1387,1497,110
166582,2019-10-12 00:00:00+03:00,out,False,885890,True,118,0,3778,3778
166582,2019-10-12 00:00:00+03:00,out,False,925922,True,274,0,6028,6028
166582,2019-10-13 00:00:00+03:00,out,False,925922,True,21,0,611,611
166582,2019-10-13 00:00:00+03:00,in,False,-1,True,38,0,425,425
166582,2019-10-13 00:00:00+03:00,out,False,925922,False,54,4006,5065,1059
166582,2019-10-13 00:00:00+03:00,out,False,885890,True,139,0,4592,4592
166582,2019-10-13 00:00:00+03:00,out,False,885890,False,238,14338,18825,4487
166582,2019-10-14 00:00:00+03:00,in,False,925922,False,24,1364,1561,197
166582,2019-10-14 00:00:00+03:00,out,False,925922,False,684,43968,55481,11513
166582,2019-10-14 00:00:00+03:00,out,False,885890,True,338,0,11453,11453
166582,2019-10-14 00:00:00+03:00,out,False,885876,True,94,0,3433,3433
166582,2019-10-14 00:00:00+03:00,out,False,885876,False,165,33206,36167,2961
166582,2019-10-14 00:00:00+03:00,out,False,925922,True,492,0,12498,12498
166582,2019-10-14 00:00:00+03:00,in,False,925922,True,2,0,9,9
166582,2019-10-14 00:00:00+03:00,in,False,885890,False,21,1295,1506,211
166582,2019-10-14 00:00:00+03:00,in,False,885876,False,6,275,322,47
166582,2019-10-14 00:00:00+03:00,in,False,-1,True,49,0,860,860
166582,2019-10-14 00:00:00+03:00,out,False,885890,False,559,47545,57946,10401
166582,2019-10-14 00:00:00+03:00,in,False,885890,False,21,1295,1506,211
166582,2019-10-15 00:00:00+03:00,out,False,925922,False,813,44611,59364,14753
166582,2019-10-15 00:00:00+03:00,out,False,885890,True,376,0,12083,12083
166582,2019-10-15 00:00:00+03:00,out,False,885890,False,512,42776,52410,9634
166582,2019-10-15 00:00:00+03:00,out,False,885876,False,414,19964,28038,8074
166582,2019-10-15 00:00:00+03:00,in,False,925922,True,1,1,18,17
166582,2019-10-15 00:00:00+03:00,out,False,925922,True,634,0,18196,18196
166582,2019-10-15 00:00:00+03:00,in,False,885890,False,20,1138,1348,210
166582,2019-10-15 00:00:00+03:00,out,False,885876,True,283,0,9108,9108
166582,2019-10-15 00:00:00+03:00,in,False,925922,False,26,1272,1439,167
166582,2019-10-15 00:00:00+03:00,in,False,-1,True,79,0,1073,1073
166582,2019-10-15 00:00:00+03:00,in,False,885876,False,20,977,1175,198
166582,2019-10-15 00:00:00+03:00,in,False,925922,True,1,1,18,17
166582,2019-10-15 00:00:00+03:00,out,False,885890,True,376,0,12083,12083
166582,2019-10-15 00:00:00+03:00,in,False,885876,False,20,977,1175,198
166582,2019-10-15 00:00:00+03:00,out,False,885890,False,512,42776,52410,9634
166582,2019-10-16 00:00:00+03:00,out,False,885876,False,368,71070,77877,6807
166582,2019-10-16 00:00:00+03:00,out,False,925922,False,594,57955,67752,9797
166582,2019-10-16 00:00:00+03:00,in,False,925922,False,21,1686,1869,183
166582,2019-10-16 00:00:00+03:00,in,False,885876,False,15,568,711,143
166582,2019-10-16 00:00:00+03:00,out,False,925922,True,430,0,12234,12234
166582,2019-10-16 00:00:00+03:00,out,False,885890,True,380,0,12643,12643
166582,2019-10-16 00:00:00+03:00,in,False,885890,False,18,1282,1508,226
166582,2019-10-16 00:00:00+03:00,in,False,-1,True,82,0,1177,1177
166582,2019-10-16 00:00:00+03:00,out,False,885890,False,629,49741,61791,12050
166582,2019-10-16 00:00:00+03:00,out,False,885876,True,161,0,4970,4970
166582,2019-10-16 00:00:00+03:00,out,False,885876,True,161,0,4970,4970
166582,2019-10-17 00:00:00+03:00,in,False,925922,True,2,0,23,23
166582,2019-10-17 00:00:00+03:00,out,False,925922,False,691,52141,64416,12275
166582,2019-10-17 00:00:00+03:00,in,False,885890,False,22,1604,1763,159
166582,2019-10-17 00:00:00+03:00,out,False,885890,True,514,0,17332,17332
166582,2019-10-17 00:00:00+03:00,out,False,885876,True,111,0,3720,3720
166582,2019-10-17 00:00:00+03:00,in,False,885876,False,22,1121,1280,159
166582,2019-10-17 00:00:00+03:00,in,False,925922,False,35,3498,3767,269
166582,2019-10-17 00:00:00+03:00,out,False,-1,True,1,0,0,0
166582,2019-10-17 00:00:00+03:00,out,False,925922,True,540,0,13414,13414
166582,2019-10-17 00:00:00+03:00,out,False,885890,False,768,67904,82221,14317
166582,2019-10-17 00:00:00+03:00,in,False,885890,True,1,0,6,6
166582,2019-10-17 00:00:00+03:00,out,False,885876,False,214,68581,72812,4231
166582,2019-10-17 00:00:00+03:00,in,False,-1,True,69,0,972,972
166582,2019-10-17 00:00:00+03:00,out,False,885876,False,214,68581,72812,4231
166582,2019-10-18 00:00:00+03:00,out,False,885890,False,729,63142,77286,14144
166582,2019-10-18 00:00:00+03:00,in,False,925922,False,28,2630,2772,142
166582,2019-10-18 00:00:00+03:00,out,False,925922,True,645,0,16458,16458
166582,2019-10-18 00:00:00+03:00,in,False,885890,False,20,1303,1535,232
166582,2019-10-18 00:00:00+03:00,out,False,885876,True,124,0,4258,4258
166582,2019-10-18 00:00:00+03:00,out,False,925922,False,568,41381,51323,9942
166582,2019-10-18 00:00:00+03:00,in,False,885876,False,4,85,144,59
166582,2019-10-18 00:00:00+03:00,out,False,885876,False,166,58399,61487,3088
166582,2019-10-18 00:00:00+03:00,out,False,885890,True,417,0,15249,15249
166582,2019-10-18 00:00:00+03:00,in,False,-1,True,45,0,462,462
166582,2019-10-18 00:00:00+03:00,out,False,885876,True,124,0,4258,4258
166582,2019-10-18 00:00:00+03:00,in,False,885890,False,20,1303,1535,232
166582,2019-10-19 00:00:00+03:00,out,False,925922,False,187,17164,20693,3529
166582,2019-10-19 00:00:00+03:00,in,False,885890,False,1,486,495,9
166582,2019-10-19 00:00:00+03:00,in,False,925922,False,3,257,268,11
166582,2019-10-19 00:00:00+03:00,out,False,885890,True,51,0,1260,1260
166582,2019-10-19 00:00:00+03:00,out,False,885890,False,111,8598,10674,2076
166582,2019-10-19 00:00:00+03:00,out,False,885876,True,6,0,140,140
166582,2019-10-19 00:00:00+03:00,out,False,885876,False,5,45,102,57
166582,2019-10-19 00:00:00+03:00,out,False,925922,True,206,0,6527,6527
166582,2019-10-19 00:00:00+03:00,in,False,-1,True,47,0,561,561
166582,2019-10-20 00:00:00+03:00,out,False,925922,True,43,0,1255,1255
166582,2019-10-20 00:00:00+03:00,out,False,885890,True,140,0,4786,4786
166582,2019-10-20 00:00:00+03:00,out,False,925922,False,30,2388,2999,611
166582,2019-10-20 00:00:00+03:00,in,False,-1,True,32,0,471,471
166582,2019-10-20 00:00:00+03:00,out,False,885890,False,255,14498,19361,4863
166582,2019-10-21 00:00:00+03:00,out,False,925922,False,840,40920,55044,14124
166582,2019-10-21 00:00:00+03:00,in,False,925922,False,30,1753,1909,156
166582,2019-10-21 00:00:00+03:00,out,False,885876,False,229,32081,36390,4309
166582,2019-10-21 00:00:00+03:00,out,False,925922,True,590,0,13376,13376
166582,2019-10-21 00:00:00+03:00,in,False,885890,False,22,910,1114,204
166582,2019-10-21 00:00:00+03:00,in,False,-1,True,67,0,731,731
166582,2019-10-21 00:00:00+03:00,out,False,885876,True,142,0,4805,4805
166582,2019-10-21 00:00:00+03:00,in,False,885876,False,11,468,533,65
166582,2019-10-21 00:00:00+03:00,out,False,885890,False,878,49006,64140,15134
166582,2019-10-21 00:00:00+03:00,out,False,885890,True,1248,0,15843,15843
166582,2019-10-22 00:00:00+03:00,out,False,-1,True,1,0,0,0
166582,2019-10-22 00:00:00+03:00,out,False,925922,False,815,32814,47708,14894
166582,2019-10-22 00:00:00+03:00,out,False,925922,True,1155,0,28145,28145
166582,2019-10-22 00:00:00+03:00,out,False,885890,False,559,58693,68971,10278
166582,2019-10-22 00:00:00+03:00,in,False,885876,False,9,831,907,76
166582,2019-10-22 00:00:00+03:00,in,False,885890,True,1,1,5,4
166582,2019-10-22 00:00:00+03:00,out,False,885876,False,222,38300,42487,4187
166582,2019-10-22 00:00:00+03:00,out,False,885876,True,168,0,4954,4954
166582,2019-10-22 00:00:00+03:00,in,False,-1,True,67,0,939,939
166582,2019-10-22 00:00:00+03:00,in,False,925922,False,48,2823,3077,254
166582,2019-10-22 00:00:00+03:00,out,False,885890,True,310,0,9793,9793
166582,2019-10-22 00:00:00+03:00,in,False,885890,False,19,915,1077,162
166582,2019-10-22 00:00:00+03:00,out,False,885876,True,168,0,4954,4954
166582,2019-10-22 00:00:00+03:00,out,False,885890,False,559,58693,68971,10278
166582,2019-10-23 00:00:00+03:00,out,False,885890,True,295,0,10318,10318
166582,2019-10-23 00:00:00+03:00,out,False,925922,False,1,900,915,15
166582,2019-10-23 00:00:00+03:00,out,False,885876,True,156,0,5414,5414
166582,2019-10-23 00:00:00+03:00,in,False,885890,False,26,1736,1973,237
166582,2019-10-23 00:00:00+03:00,out,False,885876,False,318,73054,78535,5481
166582,2019-10-23 00:00:00+03:00,in,False,885876,False,16,934,1078,144
166582,2019-10-23 00:00:00+03:00,in,False,-1,True,82,0,873,873
166582,2019-10-23 00:00:00+03:00,out,False,885890,False,501,52658,62056,9398
166582,2019-10-24 00:00:00+03:00,in,False,885890,True,1,0,5,5
166582,2019-10-24 00:00:00+03:00,out,False,885876,False,178,63411,66472,3061
166582,2019-10-24 00:00:00+03:00,out,False,885890,True,289,0,9303,9303
166582,2019-10-24 00:00:00+03:00,in,False,-1,True,44,0,519,519
166582,2019-10-24 00:00:00+03:00,in,False,885876,False,12,750,844,94
166582,2019-10-24 00:00:00+03:00,out,False,885876,True,77,0,2910,2910
166582,2019-10-24 00:00:00+03:00,in,False,885890,False,15,1074,1227,153
166582,2019-10-24 00:00:00+03:00,out,False,885890,False,530,48907,58352,9445
166582,2019-10-24 00:00:00+03:00,in,False,885876,False,12,750,844,94
166582,2019-10-25 00:00:00+03:00,out,False,925922,False,15,2134,2462,328
166582,2019-10-25 00:00:00+03:00,out,False,885890,True,370,0,13108,13108
166582,2019-10-25 00:00:00+03:00,out,False,925922,True,9,0,361,361
166582,2019-10-25 00:00:00+03:00,in,False,885890,False,20,981,1129,148
166582,2019-10-25 00:00:00+03:00,out,False,885876,False,159,52541,55460,2919
166582,2019-10-25 00:00:00+03:00,out,False,885876,True,80,0,2975,2975
166582,2019-10-25 00:00:00+03:00,in,False,925922,False,4,298,332,34
166582,2019-10-25 00:00:00+03:00,in,False,-1,True,37,0,333,333
166582,2019-10-25 00:00:00+03:00,out,False,885890,False,662,54622,67080,12458
166582,2019-10-25 00:00:00+03:00,in,False,885876,False,12,915,1020,105
166582,2019-10-26 00:00:00+03:00,out,False,885890,False,284,16351,22040,5689
166582,2019-10-26 00:00:00+03:00,in,False,-1,True,40,0,520,520
166582,2019-10-26 00:00:00+03:00,out,False,885890,True,178,0,5410,5410
166582,2019-10-26 00:00:00+03:00,out,False,885890,True,178,0,5410,5410
166582,2019-10-26 00:00:00+03:00,in,False,-1,True,40,0,520,520
166582,2019-10-27 00:00:00+03:00,in,False,885890,False,3,344,361,17
166582,2019-10-27 00:00:00+03:00,out,False,885890,True,172,0,5981,5981
166582,2019-10-27 00:00:00+03:00,out,False,885890,False,295,24064,29880,5816
166582,2019-10-27 00:00:00+03:00,in,False,-1,True,37,0,573,573
166582,2019-10-27 00:00:00+03:00,out,False,925922,False,1,891,910,19
166582,2019-10-27 00:00:00+03:00,in,False,885890,False,3,344,361,17
166582,2019-10-28 00:00:00+03:00,out,False,885876,False,184,23396,26774,3378
166582,2019-10-28 00:00:00+03:00,out,False,885890,False,458,46165,55037,8872
166582,2019-10-28 00:00:00+03:00,in,False,-1,True,23,0,361,361
166582,2019-10-28 00:00:00+03:00,out,False,885890,True,282,0,10315,10315
166582,2019-10-28 00:00:00+03:00,in,False,885890,True,1,0,6,6
166582,2019-10-28 00:00:00+03:00,out,False,885876,True,89,0,2932,2932
166582,2019-10-28 00:00:00+03:00,in,False,885890,False,25,1241,1469,228
166582,2019-10-28 00:00:00+03:00,in,False,885876,False,9,452,543,91
166582,2019-10-28 00:00:00+03:00,in,False,-1,True,23,0,361,361
166582,2019-10-29 00:00:00+03:00,in,False,885876,False,10,193,279,86
166582,2019-10-29 00:00:00+03:00,out,False,885890,False,439,46835,55278,8443
166582,2019-10-29 00:00:00+03:00,out,False,885876,False,222,24051,28523,4472
166582,2019-10-29 00:00:00+03:00,in,False,885890,False,17,613,778,165
166582,2019-10-29 00:00:00+03:00,in,False,-1,True,37,0,388,388
166582,2019-10-29 00:00:00+03:00,out,False,885890,True,273,0,10875,10875
166582,2019-10-29 00:00:00+03:00,out,False,885876,True,152,0,5010,5010
166582,2019-10-29 00:00:00+03:00,in,False,885890,False,17,613,778,165
166582,2019-10-30 00:00:00+03:00,in,False,-1,True,23,0,306,306
166582,2019-10-30 00:00:00+03:00,out,False,885876,True,17,0,719,719
166582,2019-10-30 00:00:00+03:00,out,False,885890,True,3,0,15,15
166582,2019-10-30 00:00:00+03:00,out,False,885876,False,45,7539,8368,829
166582,2019-10-30 00:00:00+03:00,in,False,885876,False,2,67,100,33
166582,2019-10-31 00:00:00+03:00,in,False,-1,True,26,0,62,62
166582,2019-10-31 00:00:00+03:00,in,False,885876,False,2,38,64,26
166582,2019-10-31 00:00:00+03:00,out,False,885876,True,17,0,567,567
166582,2019-10-31 00:00:00+03:00,out,False,885876,False,14,3796,4057,261
166582,2019-11-01 00:00:00+03:00,out,False,885876,True,13,0,422,422
166582,2019-11-01 00:00:00+03:00,out,False,885876,False,15,2209,2560,351
166582,2019-11-01 00:00:00+03:00,in,False,-1,True,8,0,8,8
166582,2019-11-04 00:00:00+03:00,in,False,-1,True,4,0,4,4
166582,2019-11-05 00:00:00+03:00,in,False,-1,True,6,0,23,23
166582,2019-11-05 00:00:00+03:00,out,False,885876,False,14,3178,3377,199
166582,2019-11-05 00:00:00+03:00,out,False,885876,True,4,0,117,117
166582,2019-11-05 00:00:00+03:00,in,False,885876,False,1,119,133,14
166582,2019-11-05 00:00:00+03:00,out,False,885876,False,14,3178,3377,199
166582,2019-11-05 00:00:00+03:00,out,False,885876,True,4,0,117,117
166582,2019-11-06 00:00:00+03:00,out,False,885876,True,1,0,8,8
166582,2019-11-06 00:00:00+03:00,in,False,-1,True,2,0,2,2
166582,2019-11-06 00:00:00+03:00,out,False,885876,False,10,1955,2076,121
166582,2019-11-07 00:00:00+03:00,out,False,885876,True,5,0,187,187
166582,2019-11-07 00:00:00+03:00,out,False,885876,False,15,1824,2020,196
166582,2019-11-07 00:00:00+03:00,in,False,-1,True,4,0,5,5
166582,2019-11-07 00:00:00+03:00,in,False,885876,False,1,2,6,4
166582,2019-11-08 00:00:00+03:00,out,False,885876,True,14,0,536,536
166582,2019-11-08 00:00:00+03:00,out,False,885876,False,55,12264,13234,970
166582,2019-11-08 00:00:00+03:00,in,False,-1,True,10,0,11,11
166582,2019-11-09 00:00:00+03:00,in,False,-1,True,4,0,4,4
166582,2019-11-10 00:00:00+03:00,in,False,-1,True,2,0,2,2
166582,2019-11-10 00:00:00+03:00,in,False,-1,True,2,0,2,2
166582,2019-11-11 00:00:00+03:00,out,False,885876,True,16,0,250,250
166582,2019-11-11 00:00:00+03:00,out,False,885876,False,30,5441,5945,504
166582,2019-11-11 00:00:00+03:00,in,False,-1,True,2,0,2,2
166582,2019-11-12 00:00:00+03:00,in,False,-1,True,11,0,32,32
166582,2019-11-12 00:00:00+03:00,out,False,885876,True,7,0,263,263
166582,2019-11-12 00:00:00+03:00,out,False,885876,False,21,4105,4532,427
166582,2019-11-13 00:00:00+03:00,in,False,-1,True,4,0,4,4
166582,2019-11-13 00:00:00+03:00,out,False,885876,False,27,5970,6427,457
166582,2019-11-13 00:00:00+03:00,out,False,885876,True,14,0,536,536
166582,2019-11-13 00:00:00+03:00,out,False,885876,True,14,0,536,536
166582,2019-11-14 00:00:00+03:00,out,False,885876,False,19,5149,5467,318
166582,2019-11-14 00:00:00+03:00,in,False,-1,True,4,0,4,4
166582,2019-11-14 00:00:00+03:00,out,False,885876,True,11,0,476,476
166582,2019-11-15 00:00:00+03:00,in,False,-1,True,4,0,4,4
166582,2019-11-15 00:00:00+03:00,out,False,885876,False,11,2337,2518,181
166582,2019-11-15 00:00:00+03:00,in,False,885876,False,1,130,136,6
166582,2019-11-15 00:00:00+03:00,out,False,885876,True,7,0,321,321
166582,2019-11-16 00:00:00+03:00,out,False,885876,False,1,46,48,2
166582,2019-11-18 00:00:00+03:00,in,False,885876,False,1,185,189,4
166582,2019-11-18 00:00:00+03:00,out,False,885876,False,8,851,1012,161
166582,2019-11-18 00:00:00+03:00,out,False,885876,True,8,0,335,335
166582,2019-11-19 00:00:00+03:00,out,False,885876,True,2,0,116,116
166582,2019-11-19 00:00:00+03:00,out,False,885876,False,9,1788,1879,91
166582,2019-11-19 00:00:00+03:00,in,False,-1,True,2,0,60,60
166582,2019-11-20 00:00:00+03:00,in,False,-1,True,2,0,2,2
166582,2019-11-20 00:00:00+03:00,out,False,885876,False,5,953,1019,66
166582,2019-11-20 00:00:00+03:00,out,False,885876,True,3,0,118,118
166582,2019-11-21 00:00:00+03:00,out,False,885876,False,20,2764,3146,382
166582,2019-11-21 00:00:00+03:00,in,False,-1,True,2,0,2,2
166582,2019-11-21 00:00:00+03:00,out,False,885876,True,6,0,86,86
166582,2019-11-22 00:00:00+03:00,out,False,885876,True,2,0,85,85
166582,2019-11-22 00:00:00+03:00,out,False,885876,False,13,1302,1515,213
166582,2019-11-22 00:00:00+03:00,out,False,885876,True,2,0,85,85
166582,2019-11-23 00:00:00+03:00,in,False,-1,True,2,0,2,2
166582,2019-11-25 00:00:00+03:00,out,False,885876,False,49,6152,6925,773
166582,2019-11-25 00:00:00+03:00,out,False,885876,True,26,0,704,704
166582,2019-11-25 00:00:00+03:00,in,False,-1,True,5,0,134,134
166582,2019-11-26 00:00:00+03:00,in,False,-1,True,8,0,89,89
166582,2019-11-26 00:00:00+03:00,in,False,885876,False,1,114,119,5
166582,2019-11-26 00:00:00+03:00,out,False,885876,True,51,0,1560,1560
166582,2019-11-26 00:00:00+03:00,out,False,885876,False,79,6926,8361,1435
166582,2019-11-27 00:00:00+03:00,out,False,885876,False,35,6811,7334,523
166582,2019-11-27 00:00:00+03:00,in,False,-1,True,2,0,42,42
166582,2019-11-27 00:00:00+03:00,out,False,885876,True,21,0,776,776
166582,2019-11-28 00:00:00+03:00,in,False,-1,True,7,0,89,89
166582,2019-11-28 00:00:00+03:00,out,False,885876,False,34,5357,5973,616
166582,2019-11-28 00:00:00+03:00,out,False,885876,True,17,0,504,504
166584,2019-08-16 00:00:00+03:00,in,False,-1,True,2,0,4,4
166585,2019-08-16 00:00:00+03:00,in,False,889638,False,2,8,35,27
166585,2019-08-16 00:00:00+03:00,in,False,-1,True,2,0,20,20
166585,2019-08-27 00:00:00+03:00,in,False,889638,False,1,20,36,16
166585,2019-10-05 00:00:00+03:00,in,False,889638,False,1,16,31,15
166585,2019-11-24 00:00:00+03:00,in,False,-1,True,1,0,7,7
166604,2019-08-21 00:00:00+03:00,in,False,-1,True,7,0,21,21
166604,2019-08-21 00:00:00+03:00,in,False,-1,True,2,0,4,4
166604,2019-08-22 00:00:00+03:00,out,True,893420,False,1,1,12,11
166604,2019-08-22 00:00:00+03:00,out,False,893420,True,1,0,30,30
166604,2019-08-22 00:00:00+03:00,in,True,893400,False,1,58,66,8
166604,2019-08-22 00:00:00+03:00,in,False,893400,False,1,1,32,31
166604,2019-08-22 00:00:00+03:00,out,False,893420,True,1,0,30,30
166604,2019-08-22 00:00:00+03:00,in,False,893400,False,1,1,32,31
166604,2019-08-23 00:00:00+03:00,in,False,-1,True,1,0,11,11
166604,2019-08-25 00:00:00+03:00,in,False,-1,True,1,0,10,10
166604,2019-08-30 00:00:00+03:00,in,False,893402,False,1,75,84,9
166604,2019-09-01 00:00:00+03:00,in,False,-1,True,1,0,24,24
166604,2019-09-01 00:00:00+03:00,in,False,893402,False,1,307,316,9
166604,2019-09-02 00:00:00+03:00,in,False,893402,False,2,392,414,22
166604,2019-09-03 00:00:00+03:00,in,False,-1,True,1,0,12,12
166604,2019-09-04 00:00:00+03:00,in,False,-1,True,2,0,37,37
166604,2019-09-09 00:00:00+03:00,in,False,893402,False,1,152,167,15
166604,2019-09-09 00:00:00+03:00,out,False,893400,False,1,5,17,12
166604,2019-09-09 00:00:00+03:00,in,False,893420,False,2,60,136,76
166604,2019-09-09 00:00:00+03:00,out,False,893400,True,1,0,14,14
166604,2019-09-09 00:00:00+03:00,out,True,893400,False,1,26,38,12
166604,2019-09-13 00:00:00+03:00,in,False,-1,True,1,0,21,21
166604,2019-09-16 00:00:00+03:00,in,True,893402,False,1,9,18,9
166604,2019-09-16 00:00:00+03:00,in,False,893402,False,2,210,234,24
166604,2019-09-17 00:00:00+03:00,in,False,-1,True,2,0,37,37
166604,2019-09-17 00:00:00+03:00,out,False,893420,True,1,0,41,41
166604,2019-09-17 00:00:00+03:00,in,False,893402,False,2,155,178,23
166604,2019-09-17 00:00:00+03:00,out,False,893420,False,4,94,133,39
166604,2019-09-18 00:00:00+03:00,in,False,-1,True,1,0,11,11
166604,2019-09-18 00:00:00+03:00,in,False,893402,False,1,77,88,11
166604,2019-09-19 00:00:00+03:00,in,False,893402,False,5,337,396,59
166604,2019-09-19 00:00:00+03:00,in,False,893420,False,2,235,309,74
166604,2019-09-19 00:00:00+03:00,in,False,893402,False,5,337,396,59
166604,2019-09-20 00:00:00+03:00,in,False,893402,False,1,292,302,10
166604,2019-09-20 00:00:00+03:00,out,False,893420,True,1,0,8,8
166604,2019-09-21 00:00:00+03:00,out,False,893402,False,1,53,68,15
166604,2019-09-21 00:00:00+03:00,in,False,893402,False,5,457,523,66
166604,2019-09-21 00:00:00+03:00,out,False,893420,False,1,44,56,12
166604,2019-09-21 00:00:00+03:00,in,False,893420,False,3,160,203,43
166604,2019-09-22 00:00:00+03:00,in,False,893402,False,1,131,160,29
166604,2019-09-23 00:00:00+03:00,in,False,893402,False,3,88,114,26
166604,2019-09-24 00:00:00+03:00,in,False,893402,False,2,46,68,22
166604,2019-09-24 00:00:00+03:00,in,False,-1,True,1,0,24,24
166604,2019-09-24 00:00:00+03:00,in,False,893420,False,2,14,70,56
166604,2019-09-25 00:00:00+03:00,in,True,893402,False,1,2,10,8
166604,2019-09-25 00:00:00+03:00,in,True,893402,False,1,2,10,8
166604,2019-09-26 00:00:00+03:00,in,False,893402,False,1,184,199,15
166604,2019-09-27 00:00:00+03:00,in,False,893402,False,2,134,161,27
166604,2019-09-28 00:00:00+03:00,in,False,-1,True,1,0,44,44
166604,2019-09-29 00:00:00+03:00,in,False,-1,True,1,0,48,48
166604,2019-09-29 00:00:00+03:00,in,False,893420,False,1,106,118,12
166604,2019-09-29 00:00:00+03:00,in,False,893402,False,1,25,52,27
166604,2019-09-30 00:00:00+03:00,out,False,893402,False,2,158,180,22
166604,2019-09-30 00:00:00+03:00,in,False,-1,True,3,0,83,83
166604,2019-09-30 00:00:00+03:00,out,False,893402,True,2,0,70,70
166604,2019-09-30 00:00:00+03:00,in,False,893402,False,3,270,296,26
166604,2019-10-01 00:00:00+03:00,in,False,-1,True,1,0,35,35
166604,2019-10-01 00:00:00+03:00,in,False,893402,False,4,246,305,59
166604,2019-10-01 00:00:00+03:00,in,False,893402,False,4,246,305,59
166604,2019-10-02 00:00:00+03:00,in,False,893402,False,4,477,518,41
166604,2019-10-02 00:00:00+03:00,in,False,-1,True,1,0,27,27
166604,2019-10-03 00:00:00+03:00,in,False,-1,True,1,0,24,24
166604,2019-10-03 00:00:00+03:00,in,False,893420,False,1,35,78,43
166604,2019-10-04 00:00:00+03:00,in,False,893402,False,4,432,480,48
166604,2019-10-04 00:00:00+03:00,in,False,-1,True,1,0,17,17
166604,2019-10-04 00:00:00+03:00,in,False,893420,False,1,9,21,12
166604,2019-10-05 00:00:00+03:00,in,False,-1,True,1,0,45,45
166604,2019-10-05 00:00:00+03:00,in,False,893402,False,5,610,664,54
166604,2019-10-05 00:00:00+03:00,out,False,893420,False,1,58,84,26
166604,2019-10-05 00:00:00+03:00,in,False,893420,False,2,151,242,91
166604,2019-10-06 00:00:00+03:00,out,False,893402,False,1,23,31,8
166604,2019-10-06 00:00:00+03:00,in,False,893402,False,2,137,163,26
166604,2019-10-07 00:00:00+03:00,in,False,893402,False,4,285,319,34
166604,2019-10-07 00:00:00+03:00,in,False,893420,False,2,76,130,54
166604,2019-10-08 00:00:00+03:00,in,False,893402,False,6,443,510,67
166604,2019-10-08 00:00:00+03:00,out,False,893402,False,1,25,35,10
166604,2019-10-09 00:00:00+03:00,in,False,893420,False,2,239,280,41
166604,2019-10-09 00:00:00+03:00,in,False,893402,False,6,568,648,80
166604,2019-10-10 00:00:00+03:00,out,False,893420,True,1,0,33,33
166604,2019-10-10 00:00:00+03:00,in,False,893420,False,2,396,459,63
166604,2019-10-10 00:00:00+03:00,in,False,-1,True,2,0,42,42
166604,2019-10-10 00:00:00+03:00,in,False,893402,False,2,69,92,23
166604,2019-10-11 00:00:00+03:00,out,False,893420,True,1,0,5,5
166604,2019-10-11 00:00:00+03:00,in,False,893402,False,4,243,298,55
166604,2019-10-11 00:00:00+03:00,in,False,-1,True,2,0,38,38
166604,2019-10-11 00:00:00+03:00,out,False,893420,False,1,12,14,2
166604,2019-10-11 00:00:00+03:00,in,False,893402,False,4,243,298,55
166604,2019-10-11 00:00:00+03:00,out,False,893420,True,1,0,5,5
166604,2019-10-12 00:00:00+03:00,in,False,893402,False,5,620,691,71
166604,2019-10-12 00:00:00+03:00,in,False,-1,True,2,0,61,61
166604,2019-10-13 00:00:00+03:00,in,False,-1,True,4,0,132,132
166604,2019-10-13 00:00:00+03:00,in,False,893402,False,1,28,40,12
166604,2019-10-13 00:00:00+03:00,out,False,893420,True,1,0,51,51
166604,2019-10-13 00:00:00+03:00,in,False,893420,False,1,8,32,24
166604,2019-10-13 00:00:00+03:00,in,False,893402,False,1,28,40,12
166604,2019-10-14 00:00:00+03:00,in,False,-1,True,1,0,42,42
166604,2019-10-14 00:00:00+03:00,out,False,893420,True,2,0,49,49
166604,2019-10-14 00:00:00+03:00,out,False,893420,False,2,363,400,37
166604,2019-10-14 00:00:00+03:00,in,False,893420,False,8,557,659,102
166604,2019-10-15 00:00:00+03:00,out,False,893420,False,1,40,54,14
166604,2019-10-15 00:00:00+03:00,in,False,893420,False,2,244,267,23
166604,2019-10-15 00:00:00+03:00,out,False,893420,False,1,40,54,14
166604,2019-10-16 00:00:00+03:00,in,False,893402,False,1,13,55,42
166604,2019-10-16 00:00:00+03:00,in,False,893420,False,8,1336,1428,92
166604,2019-10-16 00:00:00+03:00,in,False,893402,False,1,13,55,42
166604,2019-10-17 00:00:00+03:00,in,True,893420,False,1,1,9,8
166604,2019-10-17 00:00:00+03:00,in,False,893402,False,2,122,215,93
166604,2019-10-17 00:00:00+03:00,in,False,893420,False,5,223,278,55
166604,2019-10-18 00:00:00+03:00,in,False,893402,False,4,320,373,53
166604,2019-10-18 00:00:00+03:00,in,False,893420,False,1,8,51,43
166604,2019-10-18 00:00:00+03:00,out,False,893402,False,1,9,24,15
166604,2019-10-18 00:00:00+03:00,in,False,-1,True,1,0,10,10
166604,2019-10-19 00:00:00+03:00,in,False,893420,False,1,277,297,20
166604,2019-10-19 00:00:00+03:00,in,False,893402,False,8,1303,1406,103
166604,2019-10-19 00:00:00+03:00,in,False,893402,False,8,1303,1406,103
166604,2019-10-20 00:00:00+03:00,in,False,893402,False,1,129,141,12
166604,2019-10-20 00:00:00+03:00,in,False,893420,False,2,33,114,81
166604,2019-10-20 00:00:00+03:00,in,False,-1,True,1,0,13,13
166604,2019-10-21 00:00:00+03:00,in,False,-1,True,1,0,27,27
166604,2019-10-21 00:00:00+03:00,in,False,893420,False,1,170,209,39
166604,2019-10-21 00:00:00+03:00,in,False,893402,False,5,455,517,62
166604,2019-10-22 00:00:00+03:00,in,False,893420,False,1,171,208,37
166604,2019-10-22 00:00:00+03:00,in,False,893402,False,1,106,123,17
166604,2019-10-23 00:00:00+03:00,out,False,893402,True,2,0,101,101
166604,2019-10-23 00:00:00+03:00,in,False,893402,False,3,267,312,45
166604,2019-10-23 00:00:00+03:00,in,False,-1,True,2,0,15,15
166604,2019-10-23 00:00:00+03:00,out,False,893402,False,1,196,211,15
166604,2019-10-23 00:00:00+03:00,out,False,893402,True,2,0,101,101
166604,2019-10-24 00:00:00+03:00,in,False,893402,False,3,114,156,42
166604,2019-10-24 00:00:00+03:00,out,False,893402,False,1,1,22,21
166604,2019-10-24 00:00:00+03:00,in,False,-1,True,1,0,6,6
166604,2019-10-24 00:00:00+03:00,in,False,-1,True,1,0,6,6
166604,2019-10-25 00:00:00+03:00,out,False,893402,False,2,499,518,19
166604,2019-10-25 00:00:00+03:00,in,False,-1,True,1,0,5,5
166604,2019-10-25 00:00:00+03:00,in,False,-1,True,3,0,128,128
166604,2019-10-25 00:00:00+03:00,in,False,893402,False,2,279,299,20
166604,2019-10-25 00:00:00+03:00,in,True,893402,False,1,7,16,9
166604,2019-10-26 00:00:00+03:00,in,False,893420,False,1,21,50,29
166604,2019-10-26 00:00:00+03:00,out,False,893420,True,1,0,32,32
166604,2019-10-26 00:00:00+03:00,in,False,893402,False,4,180,251,71
166604,2019-10-26 00:00:00+03:00,out,False,893420,False,2,69,103,34
166604,2019-10-26 00:00:00+03:00,in,False,-1,True,1,0,5,5
166604,2019-10-26 00:00:00+03:00,in,False,893420,True,1,0,37,37
166604,2019-10-26 00:00:00+03:00,out,False,893402,False,1,49,59,10
166604,2019-10-27 00:00:00+03:00,in,False,893402,False,6,479,543,64
166604,2019-10-28 00:00:00+03:00,in,False,893402,False,4,455,508,53
166604,2019-10-28 00:00:00+03:00,out,False,893402,False,1,1,22,21
166604,2019-10-28 00:00:00+03:00,in,False,-1,True,1,0,32,32
166604,2019-10-29 00:00:00+03:00,in,False,-1,True,1,0,41,41
166604,2019-10-29 00:00:00+03:00,out,False,893420,True,1,0,59,59
166604,2019-10-29 00:00:00+03:00,in,False,893420,False,2,30,119,89
166604,2019-10-29 00:00:00+03:00,in,False,893402,False,1,82,102,20
166604,2019-10-29 00:00:00+03:00,out,False,893402,False,1,182,197,15
166604,2019-10-29 00:00:00+03:00,in,False,893420,False,2,30,119,89
166604,2019-10-31 00:00:00+03:00,in,False,-1,True,1,0,15,15
166604,2019-10-31 00:00:00+03:00,in,False,-1,True,1,0,5,5
166604,2019-10-31 00:00:00+03:00,in,False,893420,False,1,190,210,20
166604,2019-10-31 00:00:00+03:00,out,False,893402,False,1,15,15,0
166604,2019-10-31 00:00:00+03:00,in,True,893420,False,1,6,20,14
166604,2019-10-31 00:00:00+03:00,in,False,893402,False,4,620,679,59
166604,2019-11-01 00:00:00+03:00,out,False,893402,False,1,13,22,9
166604,2019-11-01 00:00:00+03:00,in,False,893420,False,1,116,157,41
166604,2019-11-01 00:00:00+03:00,in,False,893402,False,4,303,354,51
166604,2019-11-02 00:00:00+03:00,in,False,893402,False,6,688,775,87
166604,2019-11-02 00:00:00+03:00,in,False,893420,False,1,11,52,41
166604,2019-11-02 00:00:00+03:00,in,False,-1,True,2,0,59,59
166604,2019-11-02 00:00:00+03:00,out,False,893402,True,1,0,60,60
166604,2019-11-03 00:00:00+03:00,in,False,893402,False,5,952,1013,61
166604,2019-11-03 00:00:00+03:00,in,False,-1,True,2,0,64,64
166604,2019-11-03 00:00:00+03:00,out,False,893420,False,2,163,183,20
166604,2019-11-03 00:00:00+03:00,out,False,893402,False,2,52,78,26
166604,2019-11-03 00:00:00+03:00,in,False,-1,True,2,0,64,64
166604,2019-11-03 00:00:00+03:00,out,False,893420,False,2,163,183,20
166604,2019-11-04 00:00:00+03:00,in,False,893420,False,1,149,188,39
166604,2019-11-04 00:00:00+03:00,in,False,893402,False,4,404,459,55
166604,2019-11-04 00:00:00+03:00,in,False,-1,True,1,0,21,21
166604,2019-11-05 00:00:00+03:00,in,False,-1,True,1,0,3,3
166604,2019-11-05 00:00:00+03:00,out,False,893402,False,2,43,68,25
166604,2019-11-05 00:00:00+03:00,in,False,893402,False,3,382,433,51
166604,2019-11-05 00:00:00+03:00,in,False,893420,False,1,183,228,45
166604,2019-11-05 00:00:00+03:00,in,False,893420,False,1,183,228,45
166604,2019-11-06 00:00:00+03:00,in,False,893402,False,3,283,329,46
166604,2019-11-06 00:00:00+03:00,in,True,893402,False,1,7,25,18
166604,2019-11-06 00:00:00+03:00,in,False,893420,False,1,242,269,27
166604,2019-11-07 00:00:00+03:00,out,False,893420,False,2,115,156,41
166604,2019-11-07 00:00:00+03:00,out,False,893402,True,2,0,34,34
166604,2019-11-07 00:00:00+03:00,out,False,893402,False,2,8,33,25
166604,2019-11-07 00:00:00+03:00,in,False,893402,False,5,1005,1071,66
166604,2019-11-07 00:00:00+03:00,in,False,893420,False,4,491,614,123
166604,2019-11-07 00:00:00+03:00,out,False,893420,False,2,115,156,41
166604,2019-11-07 00:00:00+03:00,in,False,893402,False,5,1005,1071,66
166604,2019-11-08 00:00:00+03:00,in,False,893420,False,1,17,50,33
166604,2019-11-08 00:00:00+03:00,in,False,893402,False,6,320,383,63
166604,2019-11-08 00:00:00+03:00,out,False,893402,True,2,0,43,43
166604,2019-11-09 00:00:00+03:00,in,False,893420,False,3,274,351,77
166604,2019-11-09 00:00:00+03:00,out,False,893402,True,1,0,45,45
166604,2019-11-09 00:00:00+03:00,in,False,893402,False,1,100,110,10
166604,2019-11-09 00:00:00+03:00,out,False,893420,False,1,35,50,15
166604,2019-11-09 00:00:00+03:00,in,False,893402,True,1,1,23,22
166604,2019-11-10 00:00:00+03:00,in,False,-1,True,2,0,128,128
166604,2019-11-10 00:00:00+03:00,out,False,893420,True,1,0,60,60
166604,2019-11-10 00:00:00+03:00,in,False,893402,False,2,241,261,20
166604,2019-11-10 00:00:00+03:00,out,False,893402,True,1,0,37,37
166604,2019-11-11 00:00:00+03:00,out,False,893402,True,5,0,45,45
166604,2019-11-11 00:00:00+03:00,out,False,893402,False,1,49,67,18
166604,2019-11-11 00:00:00+03:00,in,False,893402,False,4,383,438,55
166604,2019-11-11 00:00:00+03:00,in,False,-1,True,1,0,6,6
166604,2019-11-12 00:00:00+03:00,out,False,893402,True,2,0,25,25
166604,2019-11-12 00:00:00+03:00,in,False,-1,True,3,0,36,36
166604,2019-11-12 00:00:00+03:00,in,False,893402,False,5,240,304,64
166604,2019-11-12 00:00:00+03:00,out,False,893402,False,1,155,165,10
166604,2019-11-12 00:00:00+03:00,in,True,893420,False,1,13,51,38
166604,2019-11-12 00:00:00+03:00,in,True,893402,False,2,38,46,8
166604,2019-11-12 00:00:00+03:00,out,False,893402,True,2,0,25,25
166604,2019-11-13 00:00:00+03:00,in,False,893402,False,8,1034,1257,223
166604,2019-11-13 00:00:00+03:00,in,False,-1,True,1,0,27,27
166604,2019-11-13 00:00:00+03:00,in,False,893420,False,3,323,412,89
166604,2019-11-13 00:00:00+03:00,in,False,-1,True,1,0,27,27
166604,2019-11-14 00:00:00+03:00,out,False,893402,False,1,141,157,16
166604,2019-11-14 00:00:00+03:00,in,False,-1,True,3,0,103,103
166604,2019-11-14 00:00:00+03:00,in,False,893420,False,5,335,418,83
166604,2019-11-14 00:00:00+03:00,in,False,893402,False,12,1225,1358,133
166604,2019-11-14 00:00:00+03:00,in,False,-1,True,1,0,5,5
166604,2019-11-14 00:00:00+03:00,out,False,893402,False,1,141,157,16
166604,2019-11-15 00:00:00+03:00,in,False,-1,True,3,0,37,37
166604,2019-11-15 00:00:00+03:00,out,False,893402,False,1,197,207,10
166604,2019-11-15 00:00:00+03:00,in,True,893402,False,1,6,17,11
166604,2019-11-15 00:00:00+03:00,in,False,893402,False,5,457,518,61
166604,2019-11-15 00:00:00+03:00,out,False,893402,True,1,0,39,39
166604,2019-11-15 00:00:00+03:00,in,False,893420,False,1,206,234,28
166604,2019-11-15 00:00:00+03:00,in,True,893402,False,1,6,17,11
166604,2019-11-16 00:00:00+03:00,in,False,893420,False,2,74,144,70
166604,2019-11-16 00:00:00+03:00,in,False,893402,False,4,465,511,46
166604,2019-11-16 00:00:00+03:00,out,False,893402,True,1,0,66,66
166604,2019-11-16 00:00:00+03:00,in,False,-1,True,1,0,34,34
166604,2019-11-16 00:00:00+03:00,in,False,-1,True,1,0,34,34
166604,2019-11-17 00:00:00+03:00,in,False,893420,False,2,184,249,65
166604,2019-11-17 00:00:00+03:00,in,False,893402,False,4,277,338,61
166604,2019-11-17 00:00:00+03:00,in,False,-1,True,2,0,12,12
166604,2019-11-18 00:00:00+03:00,in,False,893402,False,4,448,533,85
166604,2019-11-18 00:00:00+03:00,out,False,893402,True,1,0,2,2
166604,2019-11-19 00:00:00+03:00,in,False,-1,True,2,0,15,15
166604,2019-11-19 00:00:00+03:00,in,False,-1,True,1,0,18,18
166604,2019-11-19 00:00:00+03:00,in,False,893420,False,2,170,225,55
166604,2019-11-19 00:00:00+03:00,in,False,893402,False,5,679,764,85
166604,2019-11-19 00:00:00+03:00,out,False,893402,False,1,46,56,10
166604,2019-11-20 00:00:00+03:00,in,False,893402,False,10,1484,1671,187
166604,2019-11-20 00:00:00+03:00,in,False,893420,False,3,234,345,111
166604,2019-11-20 00:00:00+03:00,in,False,893402,True,1,0,18,18
166604,2019-11-20 00:00:00+03:00,in,False,-1,True,1,0,5,5
166604,2019-11-21 00:00:00+03:00,in,False,893402,False,12,1251,1410,159
166604,2019-11-21 00:00:00+03:00,in,False,893420,False,4,271,418,147
166604,2019-11-21 00:00:00+03:00,in,False,-1,True,3,0,47,47
166604,2019-11-22 00:00:00+03:00,in,False,893402,False,8,823,948,125
166604,2019-11-22 00:00:00+03:00,in,False,-1,True,2,0,11,11
166604,2019-11-22 00:00:00+03:00,in,False,-1,True,4,0,128,128
166604,2019-11-22 00:00:00+03:00,in,False,893420,False,4,1318,1521,203
166604,2019-11-23 00:00:00+03:00,in,False,893420,False,2,675,717,42
166604,2019-11-23 00:00:00+03:00,in,False,893402,False,8,1096,1191,95
166604,2019-11-24 00:00:00+03:00,in,False,-1,True,1,0,3,3
166604,2019-11-24 00:00:00+03:00,in,False,-1,True,1,0,14,14
166604,2019-11-24 00:00:00+03:00,in,False,893420,False,5,1033,1221,188
166604,2019-11-24 00:00:00+03:00,in,False,893402,False,6,510,584,74
166604,2019-11-25 00:00:00+03:00,in,False,893420,False,10,980,1208,228
166604,2019-11-25 00:00:00+03:00,out,False,893402,False,1,31,46,15
166604,2019-11-25 00:00:00+03:00,in,False,893402,False,9,827,956,129
166604,2019-11-26 00:00:00+03:00,in,False,893402,False,1,106,154,48
166604,2019-11-26 00:00:00+03:00,in,False,-1,True,2,0,22,22
166604,2019-11-26 00:00:00+03:00,in,False,893420,False,13,1396,1567,171
166604,2019-11-27 00:00:00+03:00,in,False,893420,False,39,2781,3239,458
166604,2019-11-27 00:00:00+03:00,in,False,893402,False,3,68,164,96
166604,2019-11-27 00:00:00+03:00,out,False,893402,False,3,15,48,33
166604,2019-11-27 00:00:00+03:00,in,False,-1,True,6,0,97,97
166604,2019-11-28 00:00:00+03:00,in,False,-1,True,11,0,791,791
166604,2019-11-28 00:00:00+03:00,in,False,-1,True,1,0,4,4
166604,2019-11-28 00:00:00+03:00,in,False,893420,False,40,2005,2546,541
166604,2019-11-28 00:00:00+03:00,in,False,893402,True,1,48,71,23
166604,2019-11-28 00:00:00+03:00,in,False,893402,False,50,1013,2437,1424
166609,2019-08-13 00:00:00+03:00,out,False,886146,False,1,9,26,17
166609,2019-08-13 00:00:00+03:00,out,False,886146,True,1,0,1,1
166609,2019-08-14 00:00:00+03:00,out,False,886146,True,2,0,21,21
166609,2019-08-14 00:00:00+03:00,out,False,887992,True,6,0,158,158
166609,2019-08-14 00:00:00+03:00,out,False,887992,False,14,607,797,190
166609,2019-08-14 00:00:00+03:00,out,False,886146,False,1,9,20,11
166609,2019-08-15 00:00:00+03:00,out,False,887992,False,5,222,292,70
166609,2019-08-15 00:00:00+03:00,out,False,887992,True,15,0,136,136
166609,2019-08-20 00:00:00+03:00,out,False,886146,False,11,3015,3205,190
166609,2019-08-20 00:00:00+03:00,out,False,886146,True,9,0,430,430
166609,2019-08-20 00:00:00+03:00,in,False,-1,True,1,0,1,1
166609,2019-08-21 00:00:00+03:00,out,False,886146,False,4,299,350,51
166609,2019-08-21 00:00:00+03:00,in,False,-1,True,1,0,35,35
166609,2019-08-21 00:00:00+03:00,out,False,886146,True,3,0,142,142
166609,2019-08-21 00:00:00+03:00,in,False,886146,False,1,1799,1808,9
166609,2019-08-22 00:00:00+03:00,out,False,886146,True,1,0,38,38
166609,2019-08-22 00:00:00+03:00,out,False,886146,False,1,13,25,12
166609,2019-08-22 00:00:00+03:00,out,False,886146,True,1,0,38,38
166609,2019-08-26 00:00:00+03:00,out,False,886146,False,10,731,879,148
166609,2019-08-26 00:00:00+03:00,out,False,892800,True,2,0,13,13
166609,2019-08-26 00:00:00+03:00,in,False,-1,True,2,0,40,40
166609,2019-08-26 00:00:00+03:00,out,False,892798,False,6,178,251,73
166609,2019-08-26 00:00:00+03:00,out,False,892798,True,28,0,165,165
166609,2019-08-26 00:00:00+03:00,out,False,887992,True,2,0,46,46
166609,2019-08-26 00:00:00+03:00,out,False,895370,False,7,217,286,69
166609,2019-08-26 00:00:00+03:00,out,False,895370,True,3,0,0,0
166609,2019-08-26 00:00:00+03:00,out,False,887992,False,5,142,222,80
166609,2019-08-26 00:00:00+03:00,out,False,892800,False,5,1291,1376,85
166609,2019-08-26 00:00:00+03:00,out,False,892800,True,2,0,13,13
166609,2019-08-27 00:00:00+03:00,in,False,-1,True,1,0,41,41
166609,2019-08-29 00:00:00+03:00,out,False,892798,True,2,0,0,0
166609,2019-09-04 00:00:00+03:00,out,False,892800,True,1,0,0,0
166609,2019-09-07 00:00:00+03:00,out,False,886146,False,1,24,34,10
166609,2019-09-07 00:00:00+03:00,out,False,886146,True,1,0,0,0
166609,2019-09-14 00:00:00+03:00,out,False,886146,False,1,17,25,8
166609,2019-09-14 00:00:00+03:00,out,False,886146,True,1,0,14,14
166609,2019-09-14 00:00:00+03:00,out,False,886146,True,1,0,14,14
166609,2019-09-25 00:00:00+03:00,in,False,-1,True,1,0,9,9
166609,2019-09-26 00:00:00+03:00,in,False,-1,True,2,0,15,15
166609,2019-09-27 00:00:00+03:00,in,False,-1,True,2,0,14,14
166609,2019-09-30 00:00:00+03:00,out,False,886146,True,1,0,0,0
166609,2019-10-04 00:00:00+03:00,in,False,892798,False,1,49,92,43
166609,2019-10-04 00:00:00+03:00,in,False,-1,True,1,0,46,46
166609,2019-10-10 00:00:00+03:00,in,False,-1,True,3,0,48,48
166609,2019-10-14 00:00:00+03:00,in,False,-1,True,1,0,5,5
166609,2019-10-17 00:00:00+03:00,in,False,-1,True,3,0,18,18
166609,2019-10-18 00:00:00+03:00,in,False,-1,True,2,0,15,15
166609,2019-10-23 00:00:00+03:00,in,False,-1,True,1,0,6,6
166609,2019-11-04 00:00:00+03:00,in,False,-1,True,1,0,9,9
166609,2019-11-05 00:00:00+03:00,in,False,-1,True,2,0,13,13
166609,2019-11-06 00:00:00+03:00,in,False,-1,True,5,0,42,42
166609,2019-11-07 00:00:00+03:00,in,False,-1,True,1,0,11,11
166609,2019-11-08 00:00:00+03:00,in,False,-1,True,4,0,26,26
166609,2019-11-11 00:00:00+03:00,in,False,-1,True,1,0,12,12
166609,2019-11-14 00:00:00+03:00,in,False,-1,True,1,0,3,3
166619,2019-08-16 00:00:00+03:00,in,False,-1,True,1,0,2,2
166619,2019-08-28 00:00:00+03:00,out,False,897872,False,2,245,257,12
166619,2019-08-30 00:00:00+03:00,out,True,897872,True,1,0,3,3
166619,2019-08-30 00:00:00+03:00,out,False,897872,False,3,600,617,17
166619,2019-09-02 00:00:00+03:00,out,False,897872,True,3,0,27,27
166619,2019-09-02 00:00:00+03:00,out,False,897872,False,4,768,783,15
166619,2019-09-03 00:00:00+03:00,out,False,897872,True,2,0,23,23
166619,2019-09-04 00:00:00+03:00,out,False,897872,False,2,177,215,38
166619,2019-09-06 00:00:00+03:00,out,False,897872,False,1,235,247,12
166619,2019-09-13 00:00:00+03:00,out,False,897872,False,1,264,274,10
166619,2019-09-18 00:00:00+03:00,out,False,897872,False,2,201,207,6
166619,2019-09-18 00:00:00+03:00,out,False,897872,False,2,201,207,6
166619,2019-09-20 00:00:00+03:00,out,False,897872,False,1,7,16,9
166619,2019-09-20 00:00:00+03:00,out,False,897872,True,1,0,6,6
166619,2019-09-23 00:00:00+03:00,out,False,897872,False,1,419,434,15
166619,2019-09-24 00:00:00+03:00,in,False,-1,True,1,0,2,2
166619,2019-09-24 00:00:00+03:00,out,False,897872,True,2,0,9,9
166619,2019-09-24 00:00:00+03:00,in,False,897872,True,1,0,30,30
166619,2019-09-24 00:00:00+03:00,out,False,897872,False,1,71,81,10
166619,2019-09-24 00:00:00+03:00,in,False,897872,False,1,59,77,18
166619,2019-09-24 00:00:00+03:00,out,False,897872,True,2,0,9,9
166619,2019-10-02 00:00:00+03:00,out,False,897872,False,4,522,546,24
166619,2019-10-03 00:00:00+03:00,in,False,-1,True,1,0,2,2
166619,2019-10-03 00:00:00+03:00,in,False,897872,False,1,12,29,17
166619,2019-10-03 00:00:00+03:00,out,False,897872,False,1,49,57,8
166619,2019-10-03 00:00:00+03:00,in,False,897872,False,1,12,29,17
166619,2019-10-07 00:00:00+03:00,out,False,897872,False,1,256,258,2
166619,2019-10-07 00:00:00+03:00,out,True,897872,True,1,0,0,0
166619,2019-11-06 00:00:00+03:00,out,True,897872,True,2,0,0,0
166619,2019-11-06 00:00:00+03:00,out,False,897872,False,2,138,143,5
166619,2019-11-07 00:00:00+03:00,out,False,897872,False,1,235,237,2
166619,2019-11-15 00:00:00+03:00,out,False,897872,False,3,136,149,13
166619,2019-11-15 00:00:00+03:00,out,False,897872,True,2,0,2,2
166619,2019-11-21 00:00:00+03:00,out,False,897872,False,1,48,54,6
166619,2019-11-28 00:00:00+03:00,out,False,897872,False,4,543,551,8
166636,2019-08-14 00:00:00+03:00,in,False,-1,True,1,0,2,2
166636,2019-08-20 00:00:00+03:00,in,False,-1,True,1,0,1,1
166636,2019-08-26 00:00:00+03:00,in,False,-1,True,1,0,1,1
166636,2019-09-01 00:00:00+03:00,in,False,-1,True,1,0,1,1
166636,2019-09-01 00:00:00+03:00,in,False,-1,True,1,0,1,1
166636,2019-09-02 00:00:00+03:00,in,False,-1,True,1,0,1,1
166636,2019-09-03 00:00:00+03:00,in,False,-1,True,4,0,4,4
166636,2019-09-04 00:00:00+03:00,in,False,890582,False,1,15,27,12
166636,2019-09-04 00:00:00+03:00,in,False,-1,True,1,0,1,1
166636,2019-09-05 00:00:00+03:00,in,False,-1,True,3,0,3,3
166636,2019-09-05 00:00:00+03:00,in,False,890582,False,1,5,10,5
166636,2019-09-05 00:00:00+03:00,in,False,-1,True,3,0,3,3
166636,2019-09-06 00:00:00+03:00,in,False,890582,False,3,32,75,43
166636,2019-09-06 00:00:00+03:00,in,False,-1,True,7,0,75,75
166636,2019-09-06 00:00:00+03:00,in,False,890582,False,3,32,75,43
166636,2019-09-08 00:00:00+03:00,in,False,-1,True,1,0,22,22
166636,2019-09-10 00:00:00+03:00,out,False,890582,False,2,81,92,11
166636,2019-09-10 00:00:00+03:00,in,False,890582,False,3,58,78,20
166636,2019-09-10 00:00:00+03:00,in,False,-1,True,5,0,37,37
166636,2019-09-11 00:00:00+03:00,in,False,890582,False,7,336,409,73
166636,2019-09-11 00:00:00+03:00,in,False,-1,True,4,0,148,148
166636,2019-09-13 00:00:00+03:00,out,False,890582,False,1,76,79,3
166636,2019-09-13 00:00:00+03:00,in,False,-1,True,1,0,5,5
166636,2019-09-20 00:00:00+03:00,in,False,-1,True,2,0,97,97
166636,2019-09-24 00:00:00+03:00,in,False,-1,True,1,0,9,9
166636,2019-09-24 00:00:00+03:00,in,False,-1,True,1,0,9,9
166636,2019-09-25 00:00:00+03:00,in,False,890582,False,1,22,39,17
166636,2019-09-26 00:00:00+03:00,in,False,890582,False,7,178,249,71
166636,2019-09-26 00:00:00+03:00,in,False,-1,True,1,0,48,48
166636,2019-09-27 00:00:00+03:00,in,False,890582,False,1,17,23,6
166636,2019-09-29 00:00:00+03:00,in,False,890582,False,7,282,353,71
166636,2019-09-30 00:00:00+03:00,in,False,890582,False,5,84,138,54
166636,2019-10-03 00:00:00+03:00,in,False,-1,True,2,0,48,48
166636,2019-10-04 00:00:00+03:00,in,False,890582,False,1,13,25,12
166636,2019-10-08 00:00:00+03:00,in,False,890582,False,3,81,110,29
166636,2019-10-08 00:00:00+03:00,out,False,890582,True,7,0,77,77
166636,2019-10-08 00:00:00+03:00,in,False,-1,True,4,0,149,149
166636,2019-10-08 00:00:00+03:00,in,False,890582,False,3,81,110,29
166636,2019-10-09 00:00:00+03:00,in,False,-1,True,1,0,32,32
166636,2019-10-10 00:00:00+03:00,in,False,890582,False,1,5,14,9
166636,2019-10-10 00:00:00+03:00,out,False,890582,False,2,30,32,2
166636,2019-10-11 00:00:00+03:00,in,False,890582,False,3,63,105,42
166636,2019-10-12 00:00:00+03:00,out,False,890582,False,1,22,37,15
166636,2019-10-12 00:00:00+03:00,in,False,890582,False,3,194,228,34
166636,2019-10-14 00:00:00+03:00,in,False,890582,False,1,85,99,14
166636,2019-10-15 00:00:00+03:00,in,False,-1,True,1,0,38,38
166636,2019-10-15 00:00:00+03:00,in,False,890582,False,2,17,40,23
166636,2019-10-17 00:00:00+03:00,in,False,-1,True,1,0,15,15
166636,2019-10-17 00:00:00+03:00,in,False,890582,False,2,165,184,19
166636,2019-10-18 00:00:00+03:00,in,False,-1,True,1,0,45,45
166636,2019-10-18 00:00:00+03:00,out,False,890582,False,2,60,77,17
166636,2019-10-21 00:00:00+03:00,in,False,-1,True,1,0,0,0
166636,2019-10-21 00:00:00+03:00,in,False,890582,False,1,83,98,15
166636,2019-10-23 00:00:00+03:00,in,False,890582,False,6,246,308,62
166636,2019-10-23 00:00:00+03:00,in,False,-1,True,2,0,50,50
166636,2019-10-24 00:00:00+03:00,in,False,890582,False,2,270,291,21
166636,2019-10-24 00:00:00+03:00,in,False,-1,True,1,0,14,14
166636,2019-10-24 00:00:00+03:00,in,False,890582,False,2,270,291,21
166636,2019-10-25 00:00:00+03:00,in,False,890582,False,1,170,183,13
166636,2019-10-26 00:00:00+03:00,in,False,890582,False,1,64,81,17
166636,2019-10-29 00:00:00+03:00,in,False,890582,False,1,50,66,16
166636,2019-10-30 00:00:00+03:00,out,False,890582,True,3,0,32,32
166636,2019-10-30 00:00:00+03:00,out,True,890582,True,2,0,0,0
166636,2019-10-30 00:00:00+03:00,out,False,890582,False,4,59,118,59
166636,2019-10-30 00:00:00+03:00,in,False,-1,True,8,0,140,140
166636,2019-10-30 00:00:00+03:00,in,False,890582,False,10,700,759,59
166636,2019-10-30 00:00:00+03:00,in,False,-1,True,8,0,140,140
166636,2019-10-30 00:00:00+03:00,out,False,890582,False,4,59,118,59
166636,2019-10-30 00:00:00+03:00,out,True,890582,True,2,0,0,0
166636,2019-11-01 00:00:00+03:00,out,False,890582,True,1,0,37,37
166636,2019-11-05 00:00:00+03:00,out,False,890582,True,2,0,6,6
166636,2019-11-05 00:00:00+03:00,in,False,890582,False,1,11,27,16
166636,2019-11-06 00:00:00+03:00,in,False,-1,True,3,0,38,38
166636,2019-11-06 00:00:00+03:00,in,False,890582,False,4,306,350,44
166636,2019-11-06 00:00:00+03:00,out,False,890582,True,2,0,20,20
166636,2019-11-06 00:00:00+03:00,out,False,890582,False,1,10,19,9
166636,2019-11-07 00:00:00+03:00,out,False,890582,True,1,0,11,11
166636,2019-11-07 00:00:00+03:00,in,False,890582,True,1,0,5,5
166636,2019-11-07 00:00:00+03:00,in,False,-1,True,7,0,68,68
166636,2019-11-07 00:00:00+03:00,in,False,890582,False,4,152,178,26
166636,2019-11-07 00:00:00+03:00,in,False,-1,True,7,0,68,68
166636,2019-11-08 00:00:00+03:00,out,False,890582,True,1,0,58,58
166636,2019-11-08 00:00:00+03:00,out,False,890582,False,1,55,70,15
166636,2019-11-11 00:00:00+03:00,out,False,890582,True,3,0,25,25
166636,2019-11-11 00:00:00+03:00,in,False,-1,True,1,0,20,20
166636,2019-11-11 00:00:00+03:00,out,False,890582,True,3,0,25,25
166636,2019-11-13 00:00:00+03:00,in,False,-1,True,1,0,34,34
166636,2019-11-14 00:00:00+03:00,out,False,890582,True,1,0,58,58
166636,2019-11-14 00:00:00+03:00,out,True,890582,True,1,0,0,0
166636,2019-11-14 00:00:00+03:00,in,False,890582,False,1,6,21,15
166636,2019-11-17 00:00:00+03:00,out,False,890582,False,1,93,107,14
166636,2019-11-17 00:00:00+03:00,in,False,-1,True,1,0,65,65
166636,2019-11-18 00:00:00+03:00,in,False,890582,False,3,226,274,48
166636,2019-11-18 00:00:00+03:00,in,False,-1,True,2,0,140,140
166636,2019-11-19 00:00:00+03:00,in,False,-1,True,1,0,13,13
166636,2019-11-19 00:00:00+03:00,in,False,890582,False,2,118,140,22
166636,2019-11-20 00:00:00+03:00,in,False,890582,False,3,25,65,40
166636,2019-11-22 00:00:00+03:00,in,False,890582,False,2,111,137,26
166636,2019-11-23 00:00:00+03:00,in,False,890582,False,1,127,142,15
166636,2019-11-24 00:00:00+03:00,in,False,890582,False,1,60,82,22
166636,2019-11-24 00:00:00+03:00,out,False,890582,True,1,0,2,2
166636,2019-11-24 00:00:00+03:00,in,False,-1,True,2,0,241,241
166636,2019-11-25 00:00:00+03:00,in,False,890582,False,1,107,121,14
166636,2019-11-26 00:00:00+03:00,in,False,890582,False,1,93,106,13
166636,2019-11-27 00:00:00+03:00,out,True,890582,True,1,0,0,0
166636,2019-11-27 00:00:00+03:00,out,False,890582,False,2,104,128,24
166636,2019-11-27 00:00:00+03:00,out,False,890582,True,2,0,11,11
166636,2019-11-27 00:00:00+03:00,in,False,890582,False,3,100,277,177
166636,2019-11-28 00:00:00+03:00,out,False,890582,True,9,0,133,133
166636,2019-11-28 00:00:00+03:00,out,False,890582,False,4,426,480,54
166636,2019-11-28 00:00:00+03:00,in,False,-1,True,1,0,6,6
166636,2019-11-28 00:00:00+03:00,in,False,890582,False,2,18,84,66
166636,2019-11-28 00:00:00+03:00,in,False,-1,True,1,0,6,6
166636,2019-11-28 00:00:00+03:00,in,False,890582,False,2,18,84,66
166649,2019-08-13 00:00:00+03:00,in,False,-1,True,8,0,0,0
166649,2019-08-13 00:00:00+03:00,in,False,-1,True,8,0,0,0
166649,2019-08-14 00:00:00+03:00,in,False,887416,False,1,1,18,17
166649,2019-09-03 00:00:00+03:00,in,False,-1,True,1,0,12,12
166649,2019-09-05 00:00:00+03:00,in,False,-1,True,1,0,0,0
166649,2019-09-05 00:00:00+03:00,in,False,887416,False,6,1945,2040,95
166649,2019-09-10 00:00:00+03:00,in,False,887416,False,1,35,49,14
166649,2019-09-24 00:00:00+03:00,in,False,887416,False,2,61,87,26
166649,2019-09-24 00:00:00+03:00,in,False,887416,False,2,61,87,26
166649,2019-09-30 00:00:00+03:00,in,False,887416,False,1,2,21,19
166649,2019-10-01 00:00:00+03:00,in,False,887416,False,1,74,87,13
166649,2019-10-08 00:00:00+03:00,in,False,-1,True,1,0,16,16
166649,2019-10-14 00:00:00+03:00,in,False,887416,False,1,12,24,12
166649,2019-10-21 00:00:00+03:00,in,False,-1,True,1,0,2,2
166649,2019-10-23 00:00:00+03:00,in,False,-1,True,1,0,2,2
166649,2019-10-28 00:00:00+03:00,in,False,-1,True,1,0,4,4
166649,2019-11-05 00:00:00+03:00,in,False,887416,False,1,2,32,30
166649,2019-11-05 00:00:00+03:00,in,False,887416,False,1,2,32,30
166649,2019-11-12 00:00:00+03:00,in,False,887416,False,1,47,73,26
166649,2019-11-13 00:00:00+03:00,in,False,887416,False,1,1,13,12
166649,2019-11-13 00:00:00+03:00,in,False,887416,False,1,1,13,12
166649,2019-11-14 00:00:00+03:00,in,False,887416,False,2,46,83,37
166658,2019-08-14 00:00:00+03:00,in,False,-1,True,2,0,4,4
166658,2019-08-15 00:00:00+03:00,in,False,-1,True,1,0,2,2
166658,2019-08-16 00:00:00+03:00,in,False,-1,True,1,0,3,3
166658,2019-08-17 00:00:00+03:00,in,False,-1,True,3,0,6,6
166658,2019-08-19 00:00:00+03:00,out,False,890404,False,22,7388,7687,299
166658,2019-08-19 00:00:00+03:00,in,False,890406,False,4,716,784,68
166658,2019-08-19 00:00:00+03:00,out,False,890416,False,20,2309,2609,300
166658,2019-08-19 00:00:00+03:00,out,False,-1,True,1,0,0,0
166658,2019-08-19 00:00:00+03:00,out,False,890402,False,9,1085,1225,140
166658,2019-08-19 00:00:00+03:00,out,False,890416,True,22,0,330,330
166658,2019-08-19 00:00:00+03:00,out,False,890412,False,22,4939,5207,268
166658,2019-08-19 00:00:00+03:00,in,False,890404,False,4,900,934,34
166658,2019-08-19 00:00:00+03:00,out,True,890404,True,1,0,0,0
166658,2019-08-19 00:00:00+03:00,in,False,890412,False,2,812,820,8
166658,2019-08-19 00:00:00+03:00,in,False,890402,False,3,1342,1367,25
166658,2019-08-19 00:00:00+03:00,out,False,890412,True,21,0,155,155
166658,2019-08-19 00:00:00+03:00,in,False,-1,True,34,0,103,103
166658,2019-08-19 00:00:00+03:00,out,False,890406,True,2,0,11,11
166658,2019-08-19 00:00:00+03:00,out,False,890404,True,22,0,252,252
166658,2019-08-19 00:00:00+03:00,out,False,890410,True,23,0,260,260
166658,2019-08-19 00:00:00+03:00,out,False,890410,False,18,3291,3538,247
166658,2019-08-19 00:00:00+03:00,out,False,890402,True,10,0,55,55
166658,2019-08-19 00:00:00+03:00,out,False,890406,False,10,2874,3005,131
166658,2019-08-19 00:00:00+03:00,in,False,890402,False,3,1342,1367,25
166658,2019-08-19 00:00:00+03:00,out,False,890404,False,22,7388,7687,299
166658,2019-08-20 00:00:00+03:00,out,False,890412,False,10,1727,1908,181
166658,2019-08-20 00:00:00+03:00,in,False,-1,True,14,0,306,306
166658,2019-08-20 00:00:00+03:00,out,False,890406,False,12,5539,5705,166
166658,2019-08-20 00:00:00+03:00,out,False,890416,True,19,0,551,551
166658,2019-08-20 00:00:00+03:00,out,False,891166,False,2,132,156,24
166658,2019-08-20 00:00:00+03:00,in,False,890406,False,1,1791,1811,20
166658,2019-08-20 00:00:00+03:00,out,False,891166,True,3,0,0,0
166658,2019-08-20 00:00:00+03:00,out,False,891152,False,1,190,193,3
166658,2019-08-20 00:00:00+03:00,in,False,890404,False,6,1401,1518,117
166658,2019-08-20 00:00:00+03:00,in,False,890402,False,6,1185,1310,125
166658,2019-08-20 00:00:00+03:00,out,False,891154,True,1,0,0,0
166658,2019-08-20 00:00:00+03:00,out,False,890410,False,7,2211,2334,123
166658,2019-08-20 00:00:00+03:00,out,False,890404,True,4,0,27,27
166658,2019-08-20 00:00:00+03:00,out,False,890402,False,13,1403,1578,175
166658,2019-08-20 00:00:00+03:00,out,False,891158,False,7,4074,4155,81
166658,2019-08-20 00:00:00+03:00,out,False,890412,True,5,0,147,147
166658,2019-08-20 00:00:00+03:00,out,False,890404,False,22,5007,5263,256
166658,2019-08-20 00:00:00+03:00,out,False,890410,True,7,0,121,121
166658,2019-08-20 00:00:00+03:00,out,False,891154,False,9,1574,1691,117
166658,2019-08-20 00:00:00+03:00,out,False,890416,False,31,4549,5019,470
166658,2019-08-20 00:00:00+03:00,in,False,890412,False,7,871,968,97
166658,2019-08-20 00:00:00+03:00,out,False,890402,True,9,0,150,150
166658,2019-08-20 00:00:00+03:00,out,False,890406,True,4,0,29,29
166658,2019-08-20 00:00:00+03:00,out,False,890406,False,12,5539,5705,166
166658,2019-08-20 00:00:00+03:00,in,False,890402,False,6,1185,1310,125
166658,2019-08-20 00:00:00+03:00,out,False,890412,True,5,0,147,147
166658,2019-08-21 00:00:00+03:00,out,False,890404,True,3,0,85,85
166658,2019-08-21 00:00:00+03:00,out,False,890404,False,6,2065,2151,86
166658,2019-08-21 00:00:00+03:00,in,False,890404,False,7,3190,3545,355
166658,2019-08-21 00:00:00+03:00,in,False,890406,False,2,1654,1722,68
166658,2019-08-21 00:00:00+03:00,out,False,890406,False,6,1999,2082,83
166658,2019-08-21 00:00:00+03:00,out,False,890410,False,12,5024,5158,134
166658,2019-08-21 00:00:00+03:00,in,False,890412,False,3,1631,1648,17
166658,2019-08-21 00:00:00+03:00,out,False,891154,True,1,0,28,28
166658,2019-08-21 00:00:00+03:00,out,False,890410,True,2,0,34,34
166658,2019-08-21 00:00:00+03:00,out,False,890416,True,12,0,348,348
166658,2019-08-21 00:00:00+03:00,out,False,890412,True,2,0,36,36
166658,2019-08-21 00:00:00+03:00,in,False,-1,True,16,0,219,219
166658,2019-08-21 00:00:00+03:00,out,False,890402,True,10,0,163,163
166658,2019-08-21 00:00:00+03:00,out,False,891154,False,5,5369,5416,47
166658,2019-08-21 00:00:00+03:00,out,False,891158,False,4,3963,4007,44
166658,2019-08-21 00:00:00+03:00,out,False,890412,False,11,4254,4380,126
166658,2019-08-21 00:00:00+03:00,out,False,-1,True,1,0,0,0
166658,2019-08-21 00:00:00+03:00,in,False,890402,False,7,875,1015,140
166658,2019-08-21 00:00:00+03:00,out,False,890406,True,2,0,61,61
166658,2019-08-21 00:00:00+03:00,out,False,890416,False,30,3814,4205,391
166658,2019-08-21 00:00:00+03:00,out,False,890402,False,20,4144,4381,237
166658,2019-08-21 00:00:00+03:00,in,False,890412,False,3,1631,1648,17
166658,2019-08-21 00:00:00+03:00,out,False,890412,False,11,4254,4380,126
166658,2019-08-22 00:00:00+03:00,in,False,890404,False,6,357,614,257
166658,2019-08-22 00:00:00+03:00,in,False,890402,False,1,512,516,4
166658,2019-08-22 00:00:00+03:00,out,False,891154,False,7,1863,1953,90
166658,2019-08-22 00:00:00+03:00,out,False,891154,True,4,0,114,114
166658,2019-08-22 00:00:00+03:00,out,False,890410,True,11,0,312,312
166658,2019-08-22 00:00:00+03:00,out,False,891166,False,3,777,803,26
166658,2019-08-22 00:00:00+03:00,in,False,-1,True,19,0,381,381
166658,2019-08-22 00:00:00+03:00,out,True,891154,True,3,0,0,0
166658,2019-08-22 00:00:00+03:00,out,False,890404,True,10,0,187,187
166658,2019-08-22 00:00:00+03:00,out,False,890412,False,13,4068,4212,144
166658,2019-08-22 00:00:00+03:00,out,False,890406,False,3,5783,5819,36
166658,2019-08-22 00:00:00+03:00,out,False,890416,True,6,0,194,194
166658,2019-08-22 00:00:00+03:00,out,False,890402,False,3,1086,1127,41
166658,2019-08-22 00:00:00+03:00,out,False,891158,False,4,1174,1188,14
166658,2019-08-22 00:00:00+03:00,out,False,890412,True,10,0,307,307
166658,2019-08-22 00:00:00+03:00,in,False,890412,False,3,371,488,117
166658,2019-08-22 00:00:00+03:00,out,False,890416,False,9,3157,3232,75
166658,2019-08-22 00:00:00+03:00,out,False,890406,True,3,0,16,16
166658,2019-08-22 00:00:00+03:00,out,False,890404,False,23,3032,3331,299
166658,2019-08-22 00:00:00+03:00,out,False,890410,False,29,2826,3188,362
166658,2019-08-22 00:00:00+03:00,out,False,890412,False,13,4068,4212,144
166658,2019-08-22 00:00:00+03:00,out,False,891154,True,4,0,114,114
166658,2019-08-22 00:00:00+03:00,out,False,890416,False,9,3157,3232,75
166658,2019-08-22 00:00:00+03:00,in,False,890412,False,3,371,488,117
166658,2019-08-23 00:00:00+03:00,out,False,890420,True,7,0,169,169
166658,2019-08-23 00:00:00+03:00,out,False,890420,False,9,3424,3566,142
166658,2019-08-23 00:00:00+03:00,out,False,890402,True,3,0,108,108
166658,2019-08-23 00:00:00+03:00,out,False,890402,False,8,3252,3320,68
166658,2019-08-23 00:00:00+03:00,out,False,890404,True,8,0,303,303
166658,2019-08-23 00:00:00+03:00,out,False,890412,True,3,0,15,15
166658,2019-08-23 00:00:00+03:00,out,False,890406,False,14,2957,3174,217
166658,2019-08-23 00:00:00+03:00,out,False,890410,False,9,1310,1414,104
166658,2019-08-23 00:00:00+03:00,out,False,891154,False,6,5343,5407,64
166658,2019-08-23 00:00:00+03:00,in,False,890402,False,3,878,910,32
166658,2019-08-23 00:00:00+03:00,out,False,890422,True,11,0,275,275
166658,2019-08-23 00:00:00+03:00,out,False,890406,True,4,0,167,167
166658,2019-08-23 00:00:00+03:00,out,False,890422,False,8,1302,1414,112
166658,2019-08-23 00:00:00+03:00,out,False,890404,False,21,2663,2989,326
166658,2019-08-23 00:00:00+03:00,out,False,890410,True,4,0,129,129
166658,2019-08-23 00:00:00+03:00,in,False,890404,False,7,1339,1460,121
166658,2019-08-23 00:00:00+03:00,in,False,890406,False,1,836,841,5
166658,2019-08-23 00:00:00+03:00,in,False,-1,True,13,0,68,68
166658,2019-08-23 00:00:00+03:00,out,False,890416,True,12,0,432,432
166658,2019-08-23 00:00:00+03:00,out,False,891158,True,1,0,37,37
166658,2019-08-23 00:00:00+03:00,out,False,890416,False,22,5030,5355,325
166658,2019-08-23 00:00:00+03:00,in,False,890412,False,3,1087,1123,36
166658,2019-08-23 00:00:00+03:00,out,False,890412,False,11,4480,4600,120
166658,2019-08-23 00:00:00+03:00,out,False,890410,True,4,0,129,129
166658,2019-08-23 00:00:00+03:00,in,False,890404,False,7,1339,1460,121
166658,2019-08-24 00:00:00+03:00,in,False,-1,True,5,0,4,4
166658,2019-08-24 00:00:00+03:00,out,False,890412,False,1,65,79,14
166658,2019-08-25 00:00:00+03:00,out,False,890412,True,1,0,58,58
166658,2019-08-25 00:00:00+03:00,out,False,890412,False,1,121,138,17
166658,2019-08-25 00:00:00+03:00,in,False,-1,True,24,0,8,8
166658,2019-08-25 00:00:00+03:00,out,False,890412,False,1,121,138,17
166658,2019-08-26 00:00:00+03:00,out,False,890422,False,19,4070,4349,279
166658,2019-08-26 00:00:00+03:00,out,False,890416,True,11,0,150,150
166658,2019-08-26 00:00:00+03:00,out,False,891154,True,18,0,714,714
166658,2019-08-26 00:00:00+03:00,out,False,890420,False,23,1776,2093,317
166658,2019-08-26 00:00:00+03:00,out,False,890402,True,12,0,211,211
166658,2019-08-26 00:00:00+03:00,out,False,890412,False,27,4136,4510,374
166658,2019-08-26 00:00:00+03:00,out,False,891158,False,4,1844,1880,36
166658,2019-08-26 00:00:00+03:00,out,False,890410,True,7,0,195,195
166658,2019-08-26 00:00:00+03:00,in,False,-1,True,13,0,102,102
166658,2019-08-26 00:00:00+03:00,out,False,891152,False,7,4469,4544,75
166658,2019-08-26 00:00:00+03:00,in,False,890406,False,6,4181,4241,60
166658,2019-08-26 00:00:00+03:00,in,False,890404,False,8,1698,1843,145
166658,2019-08-26 00:00:00+03:00,out,False,890406,True,11,0,164,164
166658,2019-08-26 00:00:00+03:00,in,False,890412,False,4,2637,2726,89
166658,2019-08-26 00:00:00+03:00,out,False,890412,True,19,0,332,332
166658,2019-08-26 00:00:00+03:00,out,False,890420,True,19,0,566,566
166658,2019-08-26 00:00:00+03:00,out,False,891166,True,2,0,74,74
166658,2019-08-26 00:00:00+03:00,out,False,891166,False,1,22,36,14
166658,2019-08-26 00:00:00+03:00,out,False,890404,True,24,0,365,365
166658,2019-08-26 00:00:00+03:00,out,False,891158,True,7,0,123,123
166658,2019-08-26 00:00:00+03:00,out,False,890410,False,8,501,606,105
166658,2019-08-26 00:00:00+03:00,out,False,890402,False,25,2483,2815,332
166658,2019-08-26 00:00:00+03:00,out,False,890404,False,14,3369,3544,175
166658,2019-08-26 00:00:00+03:00,out,False,890422,True,12,0,160,160
166658,2019-08-26 00:00:00+03:00,in,False,890402,False,8,3855,4036,181
166658,2019-08-26 00:00:00+03:00,out,False,891154,False,4,3025,3068,43
166658,2019-08-26 00:00:00+03:00,out,False,891152,True,6,0,255,255
166658,2019-08-26 00:00:00+03:00,out,False,890406,False,10,2250,2441,191
166658,2019-08-26 00:00:00+03:00,out,False,890416,False,12,3041,3215,174
166658,2019-08-26 00:00:00+03:00,out,False,890412,False,27,4136,4510,374
166658,2019-08-26 00:00:00+03:00,out,False,890422,True,12,0,160,160
166658,2019-08-26 00:00:00+03:00,out,False,891154,False,4,3025,3068,43
166658,2019-08-27 00:00:00+03:00,out,False,890420,True,8,0,208,208
166658,2019-08-27 00:00:00+03:00,out,False,891166,False,2,2159,2180,21
166658,2019-08-27 00:00:00+03:00,in,False,890402,False,6,4767,4929,162
166658,2019-08-27 00:00:00+03:00,out,False,891154,True,3,0,95,95
166658,2019-08-27 00:00:00+03:00,out,False,890402,True,9,0,266,266
166658,2019-08-27 00:00:00+03:00,out,False,890416,False,10,1668,1814,146
166658,2019-08-27 00:00:00+03:00,out,False,891154,False,8,5782,5888,106
166658,2019-08-27 00:00:00+03:00,out,False,890410,False,4,1006,1059,53
166658,2019-08-27 00:00:00+03:00,out,False,890410,True,3,0,148,148
166658,2019-08-27 00:00:00+03:00,out,False,891158,True,3,0,111,111
166658,2019-08-27 00:00:00+03:00,in,False,-1,True,20,0,115,115
166658,2019-08-27 00:00:00+03:00,out,False,890404,True,7,0,143,143
166658,2019-08-27 00:00:00+03:00,out,False,890422,False,2,32,83,51
166658,2019-08-27 00:00:00+03:00,out,False,890406,False,22,9523,9735,212
166658,2019-08-27 00:00:00+03:00,in,False,890404,False,12,2082,2209,127
166658,2019-08-27 00:00:00+03:00,out,False,890416,True,1,0,7,7
166658,2019-08-27 00:00:00+03:00,out,False,890402,False,4,1305,1348,43
166658,2019-08-27 00:00:00+03:00,out,False,890412,False,11,3597,3741,144
166658,2019-08-27 00:00:00+03:00,out,False,891152,False,7,1312,1383,71
166658,2019-08-27 00:00:00+03:00,out,False,890406,True,10,0,273,273
166658,2019-08-27 00:00:00+03:00,out,False,891152,True,5,0,159,159
166658,2019-08-27 00:00:00+03:00,out,False,891158,False,2,155,169,14
166658,2019-08-27 00:00:00+03:00,out,False,890420,False,10,1925,2056,131
166658,2019-08-27 00:00:00+03:00,out,False,890412,True,4,0,115,115
166658,2019-08-27 00:00:00+03:00,in,False,890406,False,6,3169,3205,36
166658,2019-08-27 00:00:00+03:00,in,False,890412,False,1,79,84,5
166658,2019-08-27 00:00:00+03:00,out,False,890404,False,19,5225,5505,280
166658,2019-08-28 00:00:00+03:00,in,False,890404,False,10,2470,2581,111
166658,2019-08-28 00:00:00+03:00,out,False,891170,True,1,0,12,12
166658,2019-08-28 00:00:00+03:00,out,False,891152,True,4,0,94,94
166658,2019-08-28 00:00:00+03:00,out,False,891152,False,10,950,1090,140
166658,2019-08-28 00:00:00+03:00,out,False,890410,False,6,2273,2390,117
166658,2019-08-28 00:00:00+03:00,in,False,890402,False,13,2635,2747,112
166658,2019-08-28 00:00:00+03:00,out,False,890406,False,16,7540,7718,178
166658,2019-08-28 00:00:00+03:00,out,False,890412,True,2,0,33,33
166658,2019-08-28 00:00:00+03:00,out,False,890420,True,20,0,784,784
166658,2019-08-28 00:00:00+03:00,out,False,890402,True,15,0,521,521
166658,2019-08-28 00:00:00+03:00,in,False,-1,True,28,0,57,57
166658,2019-08-28 00:00:00+03:00,out,False,890404,False,15,4347,4563,216
166658,2019-08-28 00:00:00+03:00,out,False,890412,False,7,2185,2233,48
166658,2019-08-28 00:00:00+03:00,out,False,890406,True,9,0,195,195
166658,2019-08-28 00:00:00+03:00,out,False,891158,True,5,0,71,71
166658,2019-08-28 00:00:00+03:00,out,False,890416,True,9,0,228,228
166658,2019-08-28 00:00:00+03:00,out,True,890404,True,1,0,0,0
166658,2019-08-28 00:00:00+03:00,out,False,890402,False,23,5063,5306,243
166658,2019-08-28 00:00:00+03:00,out,False,891166,False,3,152,194,42
166658,2019-08-28 00:00:00+03:00,in,False,890406,False,5,2890,2931,41
166658,2019-08-28 00:00:00+03:00,out,False,890404,True,9,0,307,307
166658,2019-08-28 00:00:00+03:00,out,False,891154,False,10,5082,5187,105
166658,2019-08-28 00:00:00+03:00,out,False,891166,True,1,0,42,42
166658,2019-08-28 00:00:00+03:00,out,False,890420,False,44,3928,4603,675
166658,2019-08-28 00:00:00+03:00,out,False,890416,False,22,5234,5563,329
166658,2019-08-28 00:00:00+03:00,out,False,890410,True,5,0,37,37
166658,2019-08-28 00:00:00+03:00,out,False,891154,True,5,0,59,59
166658,2019-08-28 00:00:00+03:00,in,False,890406,False,5,2890,2931,41
166658,2019-08-28 00:00:00+03:00,out,False,890406,True,9,0,195,195
166658,2019-08-28 00:00:00+03:00,out,False,891152,True,4,0,94,94
166658,2019-08-28 00:00:00+03:00,in,False,890404,False,10,2470,2581,111
166658,2019-08-28 00:00:00+03:00,out,False,890402,False,23,5063,5306,243
166658,2019-08-29 00:00:00+03:00,out,False,891158,True,2,0,10,10
166658,2019-08-29 00:00:00+03:00,out,False,890412,False,13,3932,4081,149
166658,2019-08-29 00:00:00+03:00,out,False,890420,True,5,0,173,173
166658,2019-08-29 00:00:00+03:00,out,False,890416,False,10,2329,2432,103
166658,2019-08-29 00:00:00+03:00,out,False,891152,False,1,23,37,14
166658,2019-08-29 00:00:00+03:00,out,False,890416,True,5,0,122,122
166658,2019-08-29 00:00:00+03:00,in,False,-1,True,7,0,36,36
166658,2019-08-29 00:00:00+03:00,out,False,890410,True,7,0,201,201
166658,2019-08-29 00:00:00+03:00,out,False,891162,False,1,1210,1212,2
166658,2019-08-29 00:00:00+03:00,out,False,891160,False,4,312,391,79
166658,2019-08-29 00:00:00+03:00,out,False,890404,True,4,0,119,119
166658,2019-08-29 00:00:00+03:00,out,False,891170,True,4,0,153,153
166658,2019-08-29 00:00:00+03:00,in,False,890404,False,8,2557,2615,58
166658,2019-08-29 00:00:00+03:00,out,False,891154,False,2,209,243,34
166658,2019-08-29 00:00:00+03:00,out,False,890404,False,10,2212,2335,123
166658,2019-08-29 00:00:00+03:00,out,False,890402,False,8,751,875,124
166658,2019-08-29 00:00:00+03:00,out,False,891158,False,2,106,134,28
166658,2019-08-29 00:00:00+03:00,out,False,891152,True,1,0,55,55
166658,2019-08-29 00:00:00+03:00,out,False,890410,False,2,425,451,26
166658,2019-08-29 00:00:00+03:00,out,False,891166,False,9,3856,3952,96
166658,2019-08-29 00:00:00+03:00,out,False,890412,True,5,0,148,148
166658,2019-08-29 00:00:00+03:00,in,False,890406,False,2,3673,3688,15
166658,2019-08-29 00:00:00+03:00,out,False,890420,False,7,2858,2945,87
166658,2019-08-29 00:00:00+03:00,out,False,890406,True,5,0,129,129
166658,2019-08-29 00:00:00+03:00,out,False,890402,True,2,0,68,68
166658,2019-08-29 00:00:00+03:00,in,False,890402,False,7,2050,2106,56
166658,2019-08-29 00:00:00+03:00,out,False,890406,False,2,3909,3938,29
166658,2019-08-29 00:00:00+03:00,out,False,891170,False,8,593,685,92
166658,2019-08-29 00:00:00+03:00,out,False,891166,True,2,0,35,35
166658,2019-08-29 00:00:00+03:00,out,False,891170,True,4,0,153,153
166658,2019-08-30 00:00:00+03:00,out,False,890410,False,9,4263,4387,124
166658,2019-08-30 00:00:00+03:00,out,True,891158,True,2,0,0,0
166658,2019-08-30 00:00:00+03:00,out,False,891158,True,3,0,35,35
166658,2019-08-30 00:00:00+03:00,in,False,890406,False,4,1558,1623,65
166658,2019-08-30 00:00:00+03:00,in,False,890402,False,6,1332,1394,62
166658,2019-08-30 00:00:00+03:00,out,False,891160,True,6,0,37,37
166658,2019-08-30 00:00:00+03:00,out,False,890416,True,1,0,48,48
166658,2019-08-30 00:00:00+03:00,out,False,890402,True,8,0,124,124
166658,2019-08-30 00:00:00+03:00,out,False,891154,False,4,2716,2783,67
166658,2019-08-30 00:00:00+03:00,out,False,890416,False,4,1408,1437,29
166658,2019-08-30 00:00:00+03:00,out,False,890420,True,6,0,156,156
166658,2019-08-30 00:00:00+03:00,out,False,891160,False,10,1637,1802,165
166658,2019-08-30 00:00:00+03:00,out,False,890412,False,16,3041,3238,197
166658,2019-08-30 00:00:00+03:00,out,False,890420,False,4,1456,1485,29
166658,2019-08-30 00:00:00+03:00,out,False,890402,False,10,3142,3309,167
166658,2019-08-30 00:00:00+03:00,out,False,890404,True,3,0,43,43
166658,2019-08-30 00:00:00+03:00,out,False,891158,False,2,2402,2425,23
166658,2019-08-30 00:00:00+03:00,out,False,890404,False,10,5775,5914,139
166658,2019-08-30 00:00:00+03:00,out,False,890410,True,7,0,214,214
166658,2019-08-30 00:00:00+03:00,out,False,890406,True,11,0,171,171
166658,2019-08-30 00:00:00+03:00,out,False,890406,False,10,1860,2010,150
166658,2019-08-30 00:00:00+03:00,in,False,890404,False,5,2384,2423,39
166658,2019-08-30 00:00:00+03:00,out,False,891154,True,2,0,71,71
166658,2019-08-30 00:00:00+03:00,out,False,891166,False,2,928,949,21
166658,2019-08-30 00:00:00+03:00,out,False,890412,True,7,0,144,144
166658,2019-08-30 00:00:00+03:00,out,False,891152,False,1,527,536,9
166658,2019-08-30 00:00:00+03:00,in,False,-1,True,7,0,10,10
166658,2019-08-30 00:00:00+03:00,out,False,891158,False,2,2402,2425,23
166658,2019-08-30 00:00:00+03:00,out,False,890402,False,10,3142,3309,167
166658,2019-08-30 00:00:00+03:00,in,False,-1,True,7,0,10,10
166658,2019-08-30 00:00:00+03:00,out,False,891154,False,4,2716,2783,67
166658,2019-08-30 00:00:00+03:00,out,False,890402,True,8,0,124,124
166658,2019-08-31 00:00:00+03:00,in,False,-1,True,2,0,1,1
166658,2019-09-01 00:00:00+03:00,out,False,890404,True,1,0,37,37
166658,2019-09-01 00:00:00+03:00,out,False,891160,True,1,0,11,11
166658,2019-09-01 00:00:00+03:00,out,False,890410,True,2,0,18,18
166658,2019-09-01 00:00:00+03:00,out,False,891170,True,1,0,11,11
166658,2019-09-01 00:00:00+03:00,out,False,891162,True,1,0,11,11
166658,2019-09-01 00:00:00+03:00,out,False,890404,True,1,0,37,37
166658,2019-09-02 00:00:00+03:00,out,False,890422,True,3,0,75,75
166658,2019-09-02 00:00:00+03:00,out,False,890406,False,3,1291,1324,33
166658,2019-09-02 00:00:00+03:00,out,False,890404,False,12,2334,2566,232
166658,2019-09-02 00:00:00+03:00,in,False,890402,False,6,508,559,51
166658,2019-09-02 00:00:00+03:00,out,False,890402,True,3,0,23,23
166658,2019-09-02 00:00:00+03:00,out,False,890422,False,16,3773,3965,192
166658,2019-09-02 00:00:00+03:00,out,False,890416,True,1,0,9,9
166658,2019-09-02 00:00:00+03:00,out,False,890416,False,9,1269,1365,96
166658,2019-09-02 00:00:00+03:00,out,False,890402,False,4,3575,3621,46
166658,2019-09-02 00:00:00+03:00,in,False,890404,False,3,559,597,38
166658,2019-09-02 00:00:00+03:00,out,False,891154,False,1,552,594,42
166658,2019-09-02 00:00:00+03:00,out,False,890420,False,4,730,799,69
166658,2019-09-02 00:00:00+03:00,out,False,890412,True,3,0,57,57
166658,2019-09-02 00:00:00+03:00,out,False,891166,False,2,1249,1277,28
166658,2019-09-02 00:00:00+03:00,out,False,890410,False,3,352,377,25
166658,2019-09-02 00:00:00+03:00,out,False,890406,True,2,0,8,8
166658,2019-09-02 00:00:00+03:00,out,False,891158,True,4,0,132,132
166658,2019-09-02 00:00:00+03:00,out,False,891152,False,2,2530,2558,28
166658,2019-09-02 00:00:00+03:00,out,False,890412,False,17,2709,2986,277
166658,2019-09-02 00:00:00+03:00,out,False,890420,True,3,0,45,45
166658,2019-09-02 00:00:00+03:00,out,False,890404,True,3,0,84,84
166658,2019-09-02 00:00:00+03:00,in,False,890406,False,4,903,930,27
166658,2019-09-02 00:00:00+03:00,in,False,-1,True,1,0,37,37
166658,2019-09-02 00:00:00+03:00,out,False,891166,False,2,1249,1277,28
166658,2019-09-02 00:00:00+03:00,out,False,890422,True,3,0,75,75
166658,2019-09-03 00:00:00+03:00,out,False,891152,False,2,794,835,41
166658,2019-09-03 00:00:00+03:00,out,False,890404,True,2,0,47,47
166658,2019-09-03 00:00:00+03:00,out,False,890422,True,21,0,466,466
166658,2019-09-03 00:00:00+03:00,out,False,891166,True,2,0,101,101
166658,2019-09-03 00:00:00+03:00,out,False,890402,False,9,1792,1883,91
166658,2019-09-03 00:00:00+03:00,out,False,890406,False,13,3951,4148,197
166658,2019-09-03 00:00:00+03:00,out,False,890412,False,5,2534,2587,53
166658,2019-09-03 00:00:00+03:00,out,False,890410,False,17,5491,5723,232
166658,2019-09-03 00:00:00+03:00,out,False,890416,True,4,0,124,124
166658,2019-09-03 00:00:00+03:00,in,False,890404,False,6,1461,1550,89
166658,2019-09-03 00:00:00+03:00,out,False,890420,True,3,0,139,139
166658,2019-09-03 00:00:00+03:00,out,False,890412,True,4,0,145,145
166658,2019-09-03 00:00:00+03:00,out,False,891166,False,3,683,709,26
166658,2019-09-03 00:00:00+03:00,out,False,890402,True,2,0,63,63
166658,2019-09-03 00:00:00+03:00,out,False,891154,True,4,0,47,47
166658,2019-09-03 00:00:00+03:00,out,False,890404,False,3,763,793,30
166658,2019-09-03 00:00:00+03:00,in,False,890406,False,6,1661,1740,79
166658,2019-09-03 00:00:00+03:00,out,False,890410,True,9,0,217,217
166658,2019-09-03 00:00:00+03:00,out,False,891158,True,1,0,3,3
166658,2019-09-03 00:00:00+03:00,out,False,890422,False,20,3082,3393,311
166658,2019-09-03 00:00:00+03:00,out,False,890406,True,15,0,209,209
166658,2019-09-03 00:00:00+03:00,out,False,891154,False,3,1612,1651,39
166658,2019-09-03 00:00:00+03:00,out,False,890416,False,20,5645,5960,315
166658,2019-09-03 00:00:00+03:00,in,False,890402,False,4,1267,1303,36
166658,2019-09-03 00:00:00+03:00,in,False,-1,True,4,0,24,24
166658,2019-09-03 00:00:00+03:00,out,False,891158,False,5,4856,4910,54
166658,2019-09-03 00:00:00+03:00,out,False,890422,False,20,3082,3393,311
166658,2019-09-03 00:00:00+03:00,in,False,890406,False,6,1661,1740,79
166658,2019-09-03 00:00:00+03:00,out,False,890422,True,21,0,466,466
166658,2019-09-03 00:00:00+03:00,out,False,891158,False,5,4856,4910,54
166658,2019-09-03 00:00:00+03:00,out,False,890410,True,9,0,217,217
166658,2019-09-03 00:00:00+03:00,out,False,891166,False,3,683,709,26
166658,2019-09-04 00:00:00+03:00,out,False,891158,True,3,0,60,60
166658,2019-09-04 00:00:00+03:00,out,False,890404,False,26,9994,10358,364
166658,2019-09-04 00:00:00+03:00,out,False,890402,False,7,2256,2392,136
166658,2019-09-04 00:00:00+03:00,out,False,891154,False,5,242,322,80
166658,2019-09-04 00:00:00+03:00,out,False,891166,True,4,0,100,100
166658,2019-09-04 00:00:00+03:00,in,False,-1,True,12,0,11,11
166658,2019-09-04 00:00:00+03:00,out,False,890416,True,2,0,17,17
166658,2019-09-04 00:00:00+03:00,out,False,890412,False,5,3703,3722,19
166658,2019-09-04 00:00:00+03:00,out,False,891152,False,3,198,274,76
166658,2019-09-04 00:00:00+03:00,out,False,890406,False,11,1865,1987,122
166658,2019-09-04 00:00:00+03:00,out,False,891154,True,2,0,17,17
166658,2019-09-04 00:00:00+03:00,out,False,891166,False,3,1720,1759,39
166658,2019-09-04 00:00:00+03:00,out,False,890412,True,4,0,49,49
166658,2019-09-04 00:00:00+03:00,in,False,890402,False,5,606,649,43
166658,2019-09-04 00:00:00+03:00,out,False,890420,False,16,5144,5373,229
166658,2019-09-04 00:00:00+03:00,out,False,890402,True,8,0,165,165
166658,2019-09-04 00:00:00+03:00,in,False,890406,False,4,638,669,31
166658,2019-09-04 00:00:00+03:00,out,False,890404,True,8,0,226,226
166658,2019-09-04 00:00:00+03:00,out,False,890410,False,13,4660,4810,150
166658,2019-09-04 00:00:00+03:00,out,False,891162,True,1,0,30,30
166658,2019-09-04 00:00:00+03:00,out,False,890416,False,6,534,629,95
166658,2019-09-04 00:00:00+03:00,in,False,890404,False,4,709,752,43
166658,2019-09-04 00:00:00+03:00,out,False,890410,True,10,0,252,252
166658,2019-09-04 00:00:00+03:00,out,False,891158,False,1,54,67,13
166658,2019-09-04 00:00:00+03:00,out,False,891152,True,3,0,47,47
166658,2019-09-04 00:00:00+03:00,out,False,890406,True,2,0,5,5
166658,2019-09-04 00:00:00+03:00,in,False,890406,False,4,638,669,31
166658,2019-09-04 00:00:00+03:00,out,False,891162,True,1,0,30,30
166658,2019-09-04 00:00:00+03:00,out,False,891166,False,3,1720,1759,39
166658,2019-09-05 00:00:00+03:00,out,False,890410,False,12,827,1030,203
166658,2019-09-05 00:00:00+03:00,out,False,890406,False,15,2135,2325,190
166658,2019-09-05 00:00:00+03:00,out,False,890420,False,14,4205,4362,157
166658,2019-09-05 00:00:00+03:00,in,False,-1,True,20,0,169,169
166658,2019-09-05 00:00:00+03:00,out,False,890402,False,13,2659,2832,173
166658,2019-09-05 00:00:00+03:00,out,False,891154,False,2,1587,1628,41
166658,2019-09-05 00:00:00+03:00,out,False,890404,True,1,0,38,38
166658,2019-09-05 00:00:00+03:00,out,False,890420,True,5,0,92,92
166658,2019-09-05 00:00:00+03:00,out,False,890416,False,12,1718,1949,231
166658,2019-09-05 00:00:00+03:00,in,False,890402,False,13,2117,2217,100
166658,2019-09-05 00:00:00+03:00,out,False,890406,True,14,0,467,467
166658,2019-09-05 00:00:00+03:00,out,False,891166,False,2,70,89,19
166658,2019-09-05 00:00:00+03:00,out,False,890416,True,6,0,184,184
166658,2019-09-05 00:00:00+03:00,in,False,890406,False,7,2261,2337,76
166658,2019-09-05 00:00:00+03:00,out,False,891158,False,1,49,60,11
166658,2019-09-05 00:00:00+03:00,out,False,890410,True,10,0,152,152
166658,2019-09-05 00:00:00+03:00,out,False,890404,False,7,3734,3847,113
166658,2019-09-05 00:00:00+03:00,out,False,891152,True,1,0,8,8
166658,2019-09-05 00:00:00+03:00,out,False,890412,False,24,8098,8364,266
166658,2019-09-05 00:00:00+03:00,in,False,890404,False,11,2180,2265,85
166658,2019-09-05 00:00:00+03:00,out,False,890422,False,5,174,271,97
166658,2019-09-05 00:00:00+03:00,out,False,891162,True,1,0,60,60
166658,2019-09-05 00:00:00+03:00,out,True,890402,True,1,0,0,0
166658,2019-09-05 00:00:00+03:00,out,False,890422,True,2,0,79,79
166658,2019-09-05 00:00:00+03:00,out,False,891152,False,3,512,547,35
166658,2019-09-05 00:00:00+03:00,out,False,890412,True,5,0,181,181
166658,2019-09-05 00:00:00+03:00,out,False,890402,True,9,0,318,318
166658,2019-09-05 00:00:00+03:00,out,False,891158,False,1,49,60,11
166658,2019-09-05 00:00:00+03:00,out,False,890402,False,13,2659,2832,173
166658,2019-09-06 00:00:00+03:00,out,False,891152,False,2,166,174,8
166658,2019-09-06 00:00:00+03:00,in,False,890402,False,4,1928,1949,21
166658,2019-09-06 00:00:00+03:00,out,False,890412,True,3,0,75,75
166658,2019-09-06 00:00:00+03:00,out,False,890406,True,8,0,245,245
166658,2019-09-06 00:00:00+03:00,out,False,890422,True,2,0,68,68
166658,2019-09-06 00:00:00+03:00,out,False,891154,True,2,0,98,98
166658,2019-09-06 00:00:00+03:00,out,False,890406,False,12,3654,3838,184
166658,2019-09-06 00:00:00+03:00,out,False,890422,False,4,2892,2995,103
166658,2019-09-06 00:00:00+03:00,out,False,890416,True,2,0,85,85
166658,2019-09-06 00:00:00+03:00,out,False,890412,False,4,1532,1591,59
166658,2019-09-06 00:00:00+03:00,out,False,890404,True,4,0,97,97
166658,2019-09-06 00:00:00+03:00,out,False,890420,False,10,6599,6739,140
166658,2019-09-06 00:00:00+03:00,out,False,891154,False,2,408,425,17
166658,2019-09-06 00:00:00+03:00,in,False,890406,False,9,2823,2919,96
166658,2019-09-06 00:00:00+03:00,out,False,891158,True,1,0,39,39
166658,2019-09-06 00:00:00+03:00,in,False,890404,False,7,2856,2903,47
166658,2019-09-06 00:00:00+03:00,out,False,890420,True,2,0,23,23
166658,2019-09-06 00:00:00+03:00,out,False,890416,False,2,731,763,32
166658,2019-09-06 00:00:00+03:00,in,False,-1,True,9,0,25,25
166658,2019-09-06 00:00:00+03:00,out,False,891166,True,2,0,51,51
166658,2019-09-06 00:00:00+03:00,out,False,891166,False,1,156,173,17
166658,2019-09-06 00:00:00+03:00,out,False,891158,False,3,529,543,14
166658,2019-09-06 00:00:00+03:00,out,False,890402,True,9,0,246,246
166658,2019-09-06 00:00:00+03:00,out,False,890404,False,13,5259,5422,163
166658,2019-09-06 00:00:00+03:00,out,False,890402,False,13,5385,5558,173
166658,2019-09-06 00:00:00+03:00,out,False,891166,False,1,156,173,17
166658,2019-09-06 00:00:00+03:00,out,False,891166,True,2,0,51,51
166658,2019-09-06 00:00:00+03:00,out,False,890416,False,2,731,763,32
166658,2019-09-07 00:00:00+03:00,in,False,-1,True,3,0,1,1
166658,2019-09-09 00:00:00+03:00,out,False,890420,False,12,3690,3857,167
166658,2019-09-09 00:00:00+03:00,in,False,890402,False,8,1845,1913,68
166658,2019-09-09 00:00:00+03:00,out,True,890412,True,1,0,0,0
166658,2019-09-09 00:00:00+03:00,out,False,890422,False,21,2508,2792,284
166658,2019-09-09 00:00:00+03:00,in,False,890406,False,5,1736,1804,68
166658,2019-09-09 00:00:00+03:00,in,False,890404,False,16,2204,2374,170
166658,2019-09-09 00:00:00+03:00,out,False,890416,False,13,11640,11795,155
166658,2019-09-09 00:00:00+03:00,out,False,890422,True,3,0,79,79
166658,2019-09-09 00:00:00+03:00,out,False,890412,True,2,0,52,52
166658,2019-09-09 00:00:00+03:00,out,False,891152,True,2,0,110,110
166658,2019-09-09 00:00:00+03:00,out,False,890404,True,10,0,250,250
166658,2019-09-09 00:00:00+03:00,out,False,890402,True,6,0,181,181
166658,2019-09-09 00:00:00+03:00,out,False,891160,True,1,0,49,49
166658,2019-09-09 00:00:00+03:00,out,False,891166,False,1,94,110,16
166658,2019-09-09 00:00:00+03:00,out,False,890412,False,7,3238,3304,66
166658,2019-09-09 00:00:00+03:00,out,False,891154,False,4,1513,1561,48
166658,2019-09-09 00:00:00+03:00,out,False,891158,False,5,477,510,33
166658,2019-09-09 00:00:00+03:00,in,False,-1,True,12,0,216,216
166658,2019-09-09 00:00:00+03:00,out,False,890406,True,11,0,262,262
166658,2019-09-09 00:00:00+03:00,out,False,890406,False,14,2346,2529,183
166658,2019-09-09 00:00:00+03:00,out,False,890410,False,6,1421,1528,107
166658,2019-09-09 00:00:00+03:00,out,False,890404,False,13,1660,1866,206
166658,2019-09-09 00:00:00+03:00,out,False,890420,True,8,0,227,227
166658,2019-09-09 00:00:00+03:00,out,False,891152,False,1,27,47,20
166658,2019-09-09 00:00:00+03:00,out,False,891160,False,2,546,576,30
166658,2019-09-09 00:00:00+03:00,out,False,890402,False,13,1075,1237,162
166658,2019-09-09 00:00:00+03:00,out,False,891154,True,5,0,88,88
166658,2019-09-09 00:00:00+03:00,out,False,890420,True,8,0,227,227
166658,2019-09-09 00:00:00+03:00,out,False,891160,False,2,546,576,30
166658,2019-09-10 00:00:00+03:00,out,False,890404,False,11,3460,3620,160
166658,2019-09-10 00:00:00+03:00,out,False,890406,True,1,0,7,7
166658,2019-09-10 00:00:00+03:00,out,False,890404,True,8,0,312,312
166658,2019-09-10 00:00:00+03:00,out,False,890422,False,7,468,575,107
166658,2019-09-10 00:00:00+03:00,out,False,890412,False,9,3835,3952,117
166658,2019-09-10 00:00:00+03:00,out,False,891158,False,6,1302,1338,36
166658,2019-09-10 00:00:00+03:00,out,False,890402,False,17,1540,1734,194
166658,2019-09-10 00:00:00+03:00,out,False,891160,False,1,646,655,9
166658,2019-09-10 00:00:00+03:00,in,False,890402,False,13,3608,3733,125
166658,2019-09-10 00:00:00+03:00,in,False,890404,False,16,2770,2918,148
166658,2019-09-10 00:00:00+03:00,out,False,890410,True,4,0,164,164
166658,2019-09-10 00:00:00+03:00,out,False,891158,True,1,0,10,10
166658,2019-09-10 00:00:00+03:00,out,False,890416,True,7,0,102,102
166658,2019-09-10 00:00:00+03:00,out,False,890402,True,10,0,169,169
166658,2019-09-10 00:00:00+03:00,out,False,891166,True,2,0,79,79
166658,2019-09-10 00:00:00+03:00,out,False,891154,False,4,7131,7178,47
166658,2019-09-10 00:00:00+03:00,out,False,891152,False,4,2458,2510,52
166658,2019-09-10 00:00:00+03:00,out,False,890412,True,3,0,125,125
166658,2019-09-10 00:00:00+03:00,in,False,-1,True,7,0,25,25
166658,2019-09-10 00:00:00+03:00,out,False,890416,False,18,3784,3981,197
166658,2019-09-10 00:00:00+03:00,out,False,890406,False,11,4510,4639,129
166658,2019-09-10 00:00:00+03:00,out,False,891166,False,3,327,362,35
166658,2019-09-10 00:00:00+03:00,out,False,891154,True,3,0,68,68
166658,2019-09-10 00:00:00+03:00,out,False,891160,True,1,0,30,30
166658,2019-09-10 00:00:00+03:00,out,False,890410,False,4,1556,1595,39
166658,2019-09-10 00:00:00+03:00,out,False,890420,True,9,0,284,284
166658,2019-09-10 00:00:00+03:00,in,False,890406,False,6,4304,4359,55
166658,2019-09-10 00:00:00+03:00,out,False,890420,False,17,3779,4005,226
166658,2019-09-10 00:00:00+03:00,out,False,890422,True,4,0,75,75
166658,2019-09-11 00:00:00+03:00,in,False,890402,False,8,769,823,54
166658,2019-09-11 00:00:00+03:00,out,False,891154,True,1,0,46,46
166658,2019-09-11 00:00:00+03:00,out,False,891160,False,1,17,30,13
166658,2019-09-11 00:00:00+03:00,out,False,890402,False,8,3327,3428,101
166658,2019-09-11 00:00:00+03:00,out,False,890422,True,4,0,111,111
166658,2019-09-11 00:00:00+03:00,out,False,890402,True,2,0,83,83
166658,2019-09-11 00:00:00+03:00,out,False,890412,False,2,5798,5815,17
166658,2019-09-11 00:00:00+03:00,out,False,890410,True,10,0,303,303
166658,2019-09-11 00:00:00+03:00,out,False,890404,True,5,0,183,183
166658,2019-09-11 00:00:00+03:00,out,False,890422,False,18,2059,2284,225
166658,2019-09-11 00:00:00+03:00,in,False,890406,False,3,1003,1024,21
166658,2019-09-11 00:00:00+03:00,in,False,890404,False,3,1594,1613,19
166658,2019-09-11 00:00:00+03:00,out,False,890420,False,6,1002,1082,80
166658,2019-09-11 00:00:00+03:00,out,False,890404,False,7,3170,3225,55
166658,2019-09-11 00:00:00+03:00,in,False,-1,True,6,0,41,41
166658,2019-09-11 00:00:00+03:00,out,False,890406,False,13,4497,4656,159
166658,2019-09-11 00:00:00+03:00,out,False,891152,False,3,1255,1317,62
166658,2019-09-11 00:00:00+03:00,out,False,891166,True,1,0,10,10
166658,2019-09-11 00:00:00+03:00,out,False,890420,True,1,0,23,23
166658,2019-09-11 00:00:00+03:00,out,False,890406,True,9,0,273,273
166658,2019-09-11 00:00:00+03:00,out,False,890416,True,1,0,39,39
166658,2019-09-11 00:00:00+03:00,out,False,891160,True,4,0,126,126
166658,2019-09-11 00:00:00+03:00,out,False,891158,False,2,1580,1603,23
166658,2019-09-11 00:00:00+03:00,out,False,891154,False,5,1795,1858,63
166658,2019-09-11 00:00:00+03:00,out,False,890410,False,5,1150,1192,42
166658,2019-09-11 00:00:00+03:00,out,False,891166,False,3,517,545,28
166658,2019-09-11 00:00:00+03:00,out,False,890420,True,1,0,23,23
166658,2019-09-11 00:00:00+03:00,out,False,890422,True,4,0,111,111
166658,2019-09-11 00:00:00+03:00,out,False,891154,True,1,0,46,46
166658,2019-09-11 00:00:00+03:00,out,False,890422,False,18,2059,2284,225
166658,2019-09-11 00:00:00+03:00,out,False,890402,False,8,3327,3428,101
166658,2019-09-12 00:00:00+03:00,out,False,891160,False,2,512,565,53
166658,2019-09-12 00:00:00+03:00,out,False,890402,False,7,2261,2329,68
166658,2019-09-12 00:00:00+03:00,in,False,890402,False,4,4015,4043,28
166658,2019-09-12 00:00:00+03:00,out,False,890412,False,6,2896,2990,94
166658,2019-09-12 00:00:00+03:00,out,False,890404,True,7,0,152,152
166658,2019-09-12 00:00:00+03:00,in,False,-1,True,21,0,13,13
166658,2019-09-12 00:00:00+03:00,out,False,891158,False,2,719,751,32
166658,2019-09-12 00:00:00+03:00,out,False,890404,False,10,4448,4576,128
166658,2019-09-12 00:00:00+03:00,out,False,891152,True,1,0,58,58
166658,2019-09-12 00:00:00+03:00,out,False,891162,False,1,622,632,10
166658,2019-09-12 00:00:00+03:00,out,False,890420,True,4,0,150,150
166658,2019-09-12 00:00:00+03:00,out,False,891154,False,7,4625,4744,119
166658,2019-09-12 00:00:00+03:00,out,False,891158,True,1,0,1,1
166658,2019-09-12 00:00:00+03:00,out,False,891166,False,3,244,281,37
166658,2019-09-12 00:00:00+03:00,in,False,890406,True,1,1,19,18
166658,2019-09-12 00:00:00+03:00,in,False,890404,False,10,1666,1754,88
166658,2019-09-12 00:00:00+03:00,out,False,890402,True,10,0,148,148
166658,2019-09-12 00:00:00+03:00,out,False,890406,False,14,6065,6242,177
166658,2019-09-12 00:00:00+03:00,out,False,891160,True,1,0,11,11
166658,2019-09-12 00:00:00+03:00,out,False,890422,False,7,701,794,93
166658,2019-09-12 00:00:00+03:00,out,False,890406,True,10,0,231,231
166658,2019-09-12 00:00:00+03:00,out,False,890410,False,7,5098,5118,20
166658,2019-09-12 00:00:00+03:00,in,False,890406,False,6,3965,4035,70
166658,2019-09-12 00:00:00+03:00,out,False,890416,False,8,950,1059,109
166658,2019-09-12 00:00:00+03:00,out,False,890412,True,3,0,86,86
166658,2019-09-12 00:00:00+03:00,out,False,890422,True,7,0,207,207
166658,2019-09-12 00:00:00+03:00,out,False,890416,True,3,0,95,95
166658,2019-09-12 00:00:00+03:00,out,False,891152,False,3,2769,2799,30
166658,2019-09-12 00:00:00+03:00,out,False,891154,True,4,0,170,170
166658,2019-09-12 00:00:00+03:00,out,False,890420,False,10,2559,2705,146
166658,2019-09-12 00:00:00+03:00,out,False,891160,False,2,512,565,53
166658,2019-09-12 00:00:00+03:00,out,False,891160,True,1,0,11,11
166658,2019-09-13 00:00:00+03:00,out,False,890416,False,10,6301,6421,120
166658,2019-09-13 00:00:00+03:00,out,False,890402,True,3,0,105,105
166658,2019-09-13 00:00:00+03:00,out,False,890422,True,2,0,98,98
166658,2019-09-13 00:00:00+03:00,out,False,890412,True,2,0,32,32
166658,2019-09-13 00:00:00+03:00,out,False,890410,False,2,1273,1291,18
166658,2019-09-13 00:00:00+03:00,out,False,891158,False,3,777,818,41
166658,2019-09-13 00:00:00+03:00,out,False,890404,False,25,1283,1787,504
166658,2019-09-13 00:00:00+03:00,out,False,891152,False,4,144,191,47
166658,2019-09-13 00:00:00+03:00,out,False,890416,True,6,0,96,96
166658,2019-09-13 00:00:00+03:00,in,False,890402,False,3,1234,1268,34
166658,2019-09-13 00:00:00+03:00,in,False,-1,True,10,0,13,13
166658,2019-09-13 00:00:00+03:00,out,False,891154,False,10,10925,11093,168
166658,2019-09-13 00:00:00+03:00,out,False,891166,False,2,589,625,36
166658,2019-09-13 00:00:00+03:00,in,False,890404,False,8,790,880,90
166658,2019-09-13 00:00:00+03:00,out,False,890406,True,4,0,59,59
166658,2019-09-13 00:00:00+03:00,out,False,890420,False,13,2243,2432,189
166658,2019-09-13 00:00:00+03:00,out,False,890422,False,12,3888,4093,205
166658,2019-09-13 00:00:00+03:00,out,False,890402,False,8,1387,1529,142
166658,2019-09-13 00:00:00+03:00,out,False,890410,True,2,0,14,14
166658,2019-09-13 00:00:00+03:00,out,False,891154,True,5,0,44,44
166658,2019-09-13 00:00:00+03:00,out,False,890404,True,10,0,296,296
166658,2019-09-13 00:00:00+03:00,in,False,890406,False,5,1373,1426,53
166658,2019-09-13 00:00:00+03:00,out,False,890412,False,6,4655,4707,52
166658,2019-09-13 00:00:00+03:00,out,False,891152,True,1,0,40,40
166658,2019-09-13 00:00:00+03:00,out,False,890420,True,6,0,122,122
166658,2019-09-13 00:00:00+03:00,out,False,890406,False,15,3050,3225,175
166658,2019-09-13 00:00:00+03:00,in,False,890406,False,5,1373,1426,53
166658,2019-09-13 00:00:00+03:00,out,False,890402,False,8,1387,1529,142
166658,2019-09-14 00:00:00+03:00,in,False,-1,True,1,0,0,0
166658,2019-09-16 00:00:00+03:00,out,False,891166,True,1,0,10,10
166658,2019-09-16 00:00:00+03:00,out,False,890420,True,5,0,150,150
166658,2019-09-16 00:00:00+03:00,out,False,891152,False,4,1264,1338,74
166658,2019-09-16 00:00:00+03:00,out,False,890412,False,10,2638,2791,153
166658,2019-09-16 00:00:00+03:00,out,False,890416,False,9,2365,2521,156
166658,2019-09-16 00:00:00+03:00,out,False,890406,True,1,0,34,34
166658,2019-09-16 00:00:00+03:00,in,False,890406,False,10,1590,1674,84
166658,2019-09-16 00:00:00+03:00,out,False,890410,False,14,2095,2304,209
166658,2019-09-16 00:00:00+03:00,out,False,890402,True,9,0,108,108
166658,2019-09-16 00:00:00+03:00,in,False,-1,True,3,0,2,2
166658,2019-09-16 00:00:00+03:00,out,False,890422,False,6,457,533,76
166658,2019-09-16 00:00:00+03:00,out,False,891152,True,1,0,9,9
166658,2019-09-16 00:00:00+03:00,out,False,891154,False,5,6690,6766,76
166658,2019-09-16 00:00:00+03:00,out,False,890402,False,11,970,1112,142
166658,2019-09-16 00:00:00+03:00,out,False,890404,False,5,458,555,97
166658,2019-09-16 00:00:00+03:00,out,False,890404,True,4,0,110,110
166658,2019-09-16 00:00:00+03:00,out,False,890420,False,13,4688,4867,179
166658,2019-09-16 00:00:00+03:00,out,False,890412,True,5,0,106,106
166658,2019-09-16 00:00:00+03:00,out,False,890422,True,1,0,25,25
166658,2019-09-16 00:00:00+03:00,out,False,891166,False,2,752,776,24
166658,2019-09-16 00:00:00+03:00,out,False,890416,True,7,0,242,242
166658,2019-09-16 00:00:00+03:00,in,False,890402,False,5,733,837,104
166658,2019-09-16 00:00:00+03:00,out,False,891154,True,4,0,81,81
166658,2019-09-16 00:00:00+03:00,in,False,890404,False,2,2141,2165,24
166658,2019-09-16 00:00:00+03:00,out,False,890410,True,2,0,81,81
166658,2019-09-16 00:00:00+03:00,out,False,890406,False,3,392,437,45
166658,2019-09-16 00:00:00+03:00,out,False,890416,False,9,2365,2521,156
166658,2019-09-16 00:00:00+03:00,in,False,890406,False,10,1590,1674,84
166658,2019-09-17 00:00:00+03:00,out,False,891158,False,6,744,795,51
166658,2019-09-17 00:00:00+03:00,out,False,890420,True,5,0,139,139
166658,2019-09-17 00:00:00+03:00,in,False,890402,False,7,1915,2045,130
166658,2019-09-17 00:00:00+03:00,out,False,890422,True,6,0,172,172
166658,2019-09-17 00:00:00+03:00,out,False,890422,False,14,2263,2442,179
166658,2019-09-17 00:00:00+03:00,out,False,890402,True,9,0,192,192
166658,2019-09-17 00:00:00+03:00,out,False,890416,True,9,0,239,239
166658,2019-09-17 00:00:00+03:00,out,False,890410,False,40,3192,3652,460
166658,2019-09-17 00:00:00+03:00,out,False,890404,False,8,1118,1246,128
166658,2019-09-17 00:00:00+03:00,out,False,890416,False,9,2401,2501,100
166658,2019-09-17 00:00:00+03:00,out,False,891154,True,6,0,221,221
166658,2019-09-17 00:00:00+03:00,in,False,890406,False,13,1789,1899,110
166658,2019-09-17 00:00:00+03:00,in,False,-1,True,13,0,81,81
166658,2019-09-17 00:00:00+03:00,out,False,890406,True,3,0,73,73
166658,2019-09-17 00:00:00+03:00,out,False,891158,True,1,0,27,27
166658,2019-09-17 00:00:00+03:00,out,False,890410,True,10,0,301,301
166658,2019-09-17 00:00:00+03:00,out,False,890402,False,13,3606,3789,183
166658,2019-09-17 00:00:00+03:00,out,False,890404,True,11,0,286,286
166658,2019-09-17 00:00:00+03:00,out,False,890406,False,7,5999,6090,91
166658,2019-09-17 00:00:00+03:00,in,False,890404,False,7,1864,2000,136
166658,2019-09-17 00:00:00+03:00,out,False,890420,False,7,1775,1888,113
166658,2019-09-17 00:00:00+03:00,out,False,890412,True,3,0,132,132
166658,2019-09-17 00:00:00+03:00,out,False,890412,False,4,157,221,64
166658,2019-09-17 00:00:00+03:00,out,False,891154,False,20,6238,6504,266
166658,2019-09-17 00:00:00+03:00,out,False,891166,True,2,0,104,104
166658,2019-09-17 00:00:00+03:00,out,False,891154,False,20,6238,6504,266
166658,2019-09-17 00:00:00+03:00,out,False,890412,False,4,157,221,64
166658,2019-09-17 00:00:00+03:00,out,False,890412,True,3,0,132,132
166658,2019-09-18 00:00:00+03:00,out,False,890410,True,5,0,190,190
166658,2019-09-18 00:00:00+03:00,out,False,891158,True,1,0,61,61
166658,2019-09-18 00:00:00+03:00,out,False,891160,False,7,635,783,148
166658,2019-09-18 00:00:00+03:00,out,False,890422,False,21,2884,3175,291
166658,2019-09-18 00:00:00+03:00,in,False,890404,False,7,2537,2818,281
166658,2019-09-18 00:00:00+03:00,out,False,890402,True,8,0,184,184
166658,2019-09-18 00:00:00+03:00,in,False,890402,False,6,2572,2775,203
166658,2019-09-18 00:00:00+03:00,out,False,890422,True,7,0,196,196
166658,2019-09-18 00:00:00+03:00,out,False,890412,False,2,88,120,32
166658,2019-09-18 00:00:00+03:00,out,False,891160,True,3,0,36,36
166658,2019-09-18 00:00:00+03:00,out,False,890404,False,8,2797,2896,99
166658,2019-09-18 00:00:00+03:00,out,False,890402,False,5,1071,1129,58
166658,2019-09-18 00:00:00+03:00,out,False,891154,False,13,2764,2952,188
166658,2019-09-18 00:00:00+03:00,out,False,890404,True,4,0,87,87
166658,2019-09-18 00:00:00+03:00,out,False,890420,True,2,0,28,28
166658,2019-09-18 00:00:00+03:00,out,False,891158,False,2,217,220,3
166658,2019-09-18 00:00:00+03:00,out,False,891166,False,4,1369,1407,38
166658,2019-09-18 00:00:00+03:00,out,False,890416,False,14,5234,5459,225
166658,2019-09-18 00:00:00+03:00,out,False,891152,False,3,4052,4098,46
166658,2019-09-18 00:00:00+03:00,out,False,890416,True,6,0,102,102
166658,2019-09-18 00:00:00+03:00,out,False,891154,True,5,0,172,172
166658,2019-09-18 00:00:00+03:00,out,False,890410,False,8,720,851,131
166658,2019-09-18 00:00:00+03:00,in,False,-1,True,11,0,257,257
166658,2019-09-18 00:00:00+03:00,out,False,890412,True,3,0,161,161
166658,2019-09-18 00:00:00+03:00,out,False,891154,False,13,2764,2952,188
166658,2019-09-18 00:00:00+03:00,out,False,891158,True,1,0,61,61
166658,2019-09-18 00:00:00+03:00,out,False,890416,False,14,5234,5459,225
166658,2019-09-18 00:00:00+03:00,out,False,890404,True,4,0,87,87
166658,2019-09-18 00:00:00+03:00,out,False,890420,True,2,0,28,28
166658,2019-09-19 00:00:00+03:00,out,False,891170,False,1,271,284,13
166658,2019-09-19 00:00:00+03:00,in,False,-1,True,12,0,208,208
166658,2019-09-19 00:00:00+03:00,out,False,890406,False,14,1740,1956,216
166658,2019-09-19 00:00:00+03:00,out,False,891158,False,3,4226,4254,28
166658,2019-09-19 00:00:00+03:00,out,False,891152,False,7,2099,2180,81
166658,2019-09-19 00:00:00+03:00,out,False,891154,True,1,0,30,30
166658,2019-09-19 00:00:00+03:00,out,False,891158,True,1,0,39,39
166658,2019-09-19 00:00:00+03:00,out,False,890420,True,1,0,53,53
166658,2019-09-19 00:00:00+03:00,out,False,890422,True,7,0,271,271
166658,2019-09-19 00:00:00+03:00,out,False,890416,True,7,0,210,210
166658,2019-09-19 00:00:00+03:00,out,False,890422,False,5,1470,1517,47
166658,2019-09-19 00:00:00+03:00,out,False,890404,False,21,10821,11105,284
166658,2019-09-19 00:00:00+03:00,out,False,890402,False,3,6395,6422,27
166658,2019-09-19 00:00:00+03:00,out,False,891160,True,2,0,53,53
166658,2019-09-19 00:00:00+03:00,in,False,890406,False,8,1938,2035,97
166658,2019-09-19 00:00:00+03:00,out,False,891160,False,4,3077,3123,46
166658,2019-09-19 00:00:00+03:00,out,False,891166,True,1,0,60,60
166658,2019-09-19 00:00:00+03:00,out,False,890416,False,11,2887,3022,135
166658,2019-09-19 00:00:00+03:00,out,False,890404,True,3,0,24,24
166658,2019-09-19 00:00:00+03:00,out,False,891154,False,9,6268,6385,117
166658,2019-09-19 00:00:00+03:00,out,False,891166,False,2,42,70,28
166658,2019-09-19 00:00:00+03:00,out,False,-1,True,1,0,0,0
166658,2019-09-19 00:00:00+03:00,in,False,890402,False,3,1786,1812,26
166658,2019-09-19 00:00:00+03:00,out,False,890406,True,12,0,312,312
166658,2019-09-19 00:00:00+03:00,out,False,890410,False,8,4137,4233,96
166658,2019-09-19 00:00:00+03:00,out,False,890402,True,1,0,6,6
166658,2019-09-19 00:00:00+03:00,in,False,890404,False,4,1446,1483,37
166658,2019-09-19 00:00:00+03:00,out,False,890420,False,5,2105,2217,112
166658,2019-09-19 00:00:00+03:00,out,False,890410,True,5,0,103,103
166658,2019-09-19 00:00:00+03:00,out,False,890420,True,1,0,53,53
166658,2019-09-20 00:00:00+03:00,out,False,890422,True,5,0,12,12
166658,2019-09-20 00:00:00+03:00,out,False,890420,False,6,2366,2442,76
166658,2019-09-20 00:00:00+03:00,in,False,890406,False,4,408,453,45
166658,2019-09-20 00:00:00+03:00,out,False,891166,False,2,869,899,30
166658,2019-09-20 00:00:00+03:00,out,False,891158,False,1,128,130,2
166658,2019-09-20 00:00:00+03:00,out,False,891152,False,3,3078,3122,44
166658,2019-09-20 00:00:00+03:00,out,False,890410,False,16,4882,5063,181
166658,2019-09-20 00:00:00+03:00,out,False,891166,True,2,0,86,86
166658,2019-09-20 00:00:00+03:00,out,False,891154,False,7,8843,8922,79
166658,2019-09-20 00:00:00+03:00,out,False,890402,True,1,0,7,7
166658,2019-09-20 00:00:00+03:00,in,False,890404,False,8,1070,1136,66
166658,2019-09-20 00:00:00+03:00,out,False,890404,True,4,0,210,210
166658,2019-09-20 00:00:00+03:00,out,False,890422,False,3,1060,1080,20
166658,2019-09-20 00:00:00+03:00,out,False,890416,True,15,0,488,488
166658,2019-09-20 00:00:00+03:00,out,False,890402,False,6,972,1065,93
166658,2019-09-20 00:00:00+03:00,in,False,890402,False,8,1350,1487,137
166658,2019-09-20 00:00:00+03:00,out,False,891158,True,2,0,47,47
166658,2019-09-20 00:00:00+03:00,out,False,890416,False,39,1771,2360,589
166658,2019-09-20 00:00:00+03:00,out,False,891154,True,1,0,38,38
166658,2019-09-20 00:00:00+03:00,out,False,890420,True,1,0,29,29
166658,2019-09-20 00:00:00+03:00,out,False,891160,False,1,52,57,5
166658,2019-09-20 00:00:00+03:00,in,False,-1,True,6,0,89,89
166658,2019-09-20 00:00:00+03:00,out,False,890410,True,7,0,187,187
166658,2019-09-20 00:00:00+03:00,out,False,890404,False,13,1070,1255,185
166658,2019-09-20 00:00:00+03:00,out,False,890406,False,15,4121,4335,214
166658,2019-09-20 00:00:00+03:00,out,False,890412,False,1,67,78,11
166658,2019-09-20 00:00:00+03:00,out,False,891152,True,1,0,14,14
166658,2019-09-20 00:00:00+03:00,out,False,890406,True,8,0,186,186
166658,2019-09-20 00:00:00+03:00,out,False,890412,True,1,0,1,1
166658,2019-09-20 00:00:00+03:00,out,False,890422,False,3,1060,1080,20
166658,2019-09-20 00:00:00+03:00,out,False,890420,True,1,0,29,29
166658,2019-09-20 00:00:00+03:00,out,False,890406,False,15,4121,4335,214
166658,2019-09-21 00:00:00+03:00,in,False,-1,True,15,0,8,8
166658,2019-09-22 00:00:00+03:00,in,False,-1,True,10,0,5,5
166658,2019-09-23 00:00:00+03:00,out,False,890402,False,18,2963,3256,293
166658,2019-09-23 00:00:00+03:00,out,False,890422,True,3,0,79,79
166658,2019-09-23 00:00:00+03:00,out,False,-1,True,1,0,0,0
166658,2019-09-23 00:00:00+03:00,out,False,891158,False,2,794,806,12
166658,2019-09-23 00:00:00+03:00,in,False,890404,False,11,2162,2240,78
166658,2019-09-23 00:00:00+03:00,in,False,890406,False,8,2694,2744,50
166658,2019-09-23 00:00:00+03:00,out,False,890420,False,11,5453,5574,121
166658,2019-09-23 00:00:00+03:00,out,False,890404,False,14,1313,1548,235
166658,2019-09-23 00:00:00+03:00,out,False,890412,False,15,4820,5135,315
166658,2019-09-23 00:00:00+03:00,out,False,890406,False,22,2476,2708,232
166658,2019-09-23 00:00:00+03:00,out,False,890410,False,13,662,909,247
166658,2019-09-23 00:00:00+03:00,out,False,890412,True,3,0,110,110
166658,2019-09-23 00:00:00+03:00,out,False,890410,True,21,0,620,620
166658,2019-09-23 00:00:00+03:00,out,False,890422,False,3,250,293,43
166658,2019-09-23 00:00:00+03:00,in,False,890402,False,7,2011,2068,57
166658,2019-09-23 00:00:00+03:00,out,False,891166,False,3,963,1024,61
166658,2019-09-23 00:00:00+03:00,out,False,891162,False,5,1809,1914,105
166658,2019-09-23 00:00:00+03:00,out,False,891152,False,6,1515,1599,84
166658,2019-09-23 00:00:00+03:00,out,False,891154,False,6,2426,2541,115
166658,2019-09-23 00:00:00+03:00,out,True,890410,True,1,0,0,0
166658,2019-09-23 00:00:00+03:00,out,False,890416,True,1,0,11,11
166658,2019-09-23 00:00:00+03:00,out,False,891152,True,1,0,27,27
166658,2019-09-23 00:00:00+03:00,out,False,890420,True,9,0,224,224
166658,2019-09-23 00:00:00+03:00,out,False,890402,True,7,0,260,260
166658,2019-09-23 00:00:00+03:00,out,False,891166,True,3,0,86,86
166658,2019-09-23 00:00:00+03:00,out,False,890404,True,10,0,243,243
166658,2019-09-23 00:00:00+03:00,out,False,891154,True,3,0,142,142
166658,2019-09-23 00:00:00+03:00,in,False,-1,True,5,0,56,56
166658,2019-09-23 00:00:00+03:00,out,False,890416,False,5,1769,1833,64
166658,2019-09-23 00:00:00+03:00,out,False,890406,True,14,0,370,370
166658,2019-09-23 00:00:00+03:00,out,False,890412,True,3,0,110,110
166658,2019-09-23 00:00:00+03:00,out,False,891154,False,6,2426,2541,115
166658,2019-09-23 00:00:00+03:00,out,False,890420,False,11,5453,5574,121
166658,2019-09-24 00:00:00+03:00,out,False,890420,True,8,0,226,226
166658,2019-09-24 00:00:00+03:00,out,False,890402,False,6,1679,1761,82
166658,2019-09-24 00:00:00+03:00,in,False,890406,False,10,2856,2932,76
166658,2019-09-24 00:00:00+03:00,out,False,890416,False,23,2981,3351,370
166658,2019-09-24 00:00:00+03:00,out,False,891158,False,5,5741,5799,58
166658,2019-09-24 00:00:00+03:00,out,False,890404,True,6,0,251,251
166658,2019-09-24 00:00:00+03:00,out,False,891162,False,2,449,455,6
166658,2019-09-24 00:00:00+03:00,in,False,890404,False,5,2192,2254,62
166658,2019-09-24 00:00:00+03:00,out,False,891158,True,1,0,5,5
166658,2019-09-24 00:00:00+03:00,out,False,890410,False,10,836,1019,183
166658,2019-09-24 00:00:00+03:00,out,False,891160,False,1,143,160,17
166658,2019-09-24 00:00:00+03:00,out,False,890404,False,11,5161,5293,132
166658,2019-09-24 00:00:00+03:00,out,False,890410,True,2,0,85,85
166658,2019-09-24 00:00:00+03:00,out,False,891154,True,2,0,72,72
166658,2019-09-24 00:00:00+03:00,out,False,890406,False,6,1969,2056,87
166658,2019-09-24 00:00:00+03:00,out,False,890412,False,10,4417,4566,149
166658,2019-09-24 00:00:00+03:00,out,False,890416,True,6,0,71,71
166658,2019-09-24 00:00:00+03:00,out,False,891152,False,1,29,34,5
166658,2019-09-24 00:00:00+03:00,out,False,891166,True,1,0,17,17
166658,2019-09-24 00:00:00+03:00,out,False,890422,False,7,6572,6657,85
166658,2019-09-24 00:00:00+03:00,in,False,-1,True,5,0,3,3
166658,2019-09-24 00:00:00+03:00,out,False,890402,True,5,0,89,89
166658,2019-09-24 00:00:00+03:00,out,False,890420,False,8,1484,1614,130
166658,2019-09-24 00:00:00+03:00,in,False,890402,False,10,3681,3779,98
166658,2019-09-24 00:00:00+03:00,out,False,890412,True,2,0,64,64
166658,2019-09-24 00:00:00+03:00,out,False,891154,False,7,2327,2412,85
166658,2019-09-24 00:00:00+03:00,out,False,891166,False,3,2424,2468,44
166658,2019-09-24 00:00:00+03:00,out,False,890422,True,1,0,48,48
166658,2019-09-24 00:00:00+03:00,out,False,890406,True,3,0,65,65
166658,2019-09-24 00:00:00+03:00,out,False,890410,True,2,0,85,85
166658,2019-09-24 00:00:00+03:00,out,False,890402,True,5,0,89,89
166658,2019-09-24 00:00:00+03:00,out,False,890422,True,1,0,48,48
166658,2019-09-24 00:00:00+03:00,out,False,890404,True,6,0,251,251
166658,2019-09-25 00:00:00+03:00,out,False,890422,True,8,0,230,230
166658,2019-09-25 00:00:00+03:00,out,False,890404,True,7,0,99,99
166658,2019-09-25 00:00:00+03:00,out,False,890420,False,4,1362,1436,74
166658,2019-09-25 00:00:00+03:00,out,False,890406,False,20,8537,8828,291
166658,2019-09-25 00:00:00+03:00,out,False,890410,False,3,1181,1232,51
166658,2019-09-25 00:00:00+03:00,out,False,890416,False,9,1355,1496,141
166658,2019-09-25 00:00:00+03:00,out,False,890402,False,4,210,268,58
166658,2019-09-25 00:00:00+03:00,out,False,891160,False,1,50,71,21
166658,2019-09-25 00:00:00+03:00,out,False,891158,True,5,0,137,137
166658,2019-09-25 00:00:00+03:00,out,False,891166,False,5,4628,4669,41
166658,2019-09-25 00:00:00+03:00,out,False,890412,True,2,0,38,38
166658,2019-09-25 00:00:00+03:00,out,False,890422,False,5,493,572,79
166658,2019-09-25 00:00:00+03:00,out,False,890412,False,5,1946,2000,54
166658,2019-09-25 00:00:00+03:00,out,False,890404,False,11,1949,2105,156
166658,2019-09-25 00:00:00+03:00,out,False,890406,True,4,0,75,75
166658,2019-09-25 00:00:00+03:00,in,False,890402,False,6,1196,1266,70
166658,2019-09-25 00:00:00+03:00,out,False,891158,False,5,3359,3465,106
166658,2019-09-25 00:00:00+03:00,out,False,890410,True,1,0,49,49
166658,2019-09-25 00:00:00+03:00,in,False,-1,True,9,0,22,22
166658,2019-09-25 00:00:00+03:00,in,False,890406,True,1,0,10,10
166658,2019-09-25 00:00:00+03:00,out,False,890416,True,2,0,61,61
166658,2019-09-25 00:00:00+03:00,in,False,890404,False,10,945,1019,74
166658,2019-09-25 00:00:00+03:00,out,False,891166,True,1,0,60,60
166658,2019-09-25 00:00:00+03:00,out,False,890402,True,2,0,83,83
166658,2019-09-25 00:00:00+03:00,out,False,891154,False,4,3310,3360,50
166658,2019-09-25 00:00:00+03:00,in,False,890406,False,4,326,368,42
166658,2019-09-25 00:00:00+03:00,out,False,890416,False,9,1355,1496,141
166658,2019-09-25 00:00:00+03:00,out,False,890410,True,1,0,49,49
166658,2019-09-25 00:00:00+03:00,out,False,890404,False,11,1949,2105,156
166658,2019-09-25 00:00:00+03:00,out,False,891166,False,5,4628,4669,41
166658,2019-09-26 00:00:00+03:00,out,False,890402,False,14,4526,4694,168
166658,2019-09-26 00:00:00+03:00,out,False,890404,True,3,0,83,83
166658,2019-09-26 00:00:00+03:00,out,False,890416,False,10,3747,3912,165
166658,2019-09-26 00:00:00+03:00,out,False,890410,True,8,0,249,249
166658,2019-09-26 00:00:00+03:00,out,False,890412,True,1,0,10,10
166658,2019-09-26 00:00:00+03:00,out,False,890416,True,3,0,108,108
166658,2019-09-26 00:00:00+03:00,out,False,891158,True,1,0,8,8
166658,2019-09-26 00:00:00+03:00,out,False,890406,False,8,5963,6067,104
166658,2019-09-26 00:00:00+03:00,out,False,890422,False,18,2973,3268,295
166658,2019-09-26 00:00:00+03:00,in,False,890404,False,3,1839,1892,53
166658,2019-09-26 00:00:00+03:00,out,False,890406,True,3,0,37,37
166658,2019-09-26 00:00:00+03:00,out,False,891160,True,2,0,89,89
166658,2019-09-26 00:00:00+03:00,out,False,890422,True,9,0,275,275
166658,2019-09-26 00:00:00+03:00,out,False,890410,False,25,7981,8325,344
166658,2019-09-26 00:00:00+03:00,out,False,890412,False,8,2096,2169,73
166658,2019-09-26 00:00:00+03:00,out,False,891154,True,1,0,49,49
166658,2019-09-26 00:00:00+03:00,in,False,-1,True,25,0,46,46
166658,2019-09-26 00:00:00+03:00,in,False,890406,False,7,1366,1433,67
166658,2019-09-26 00:00:00+03:00,out,False,891166,False,2,431,445,14
166658,2019-09-26 00:00:00+03:00,out,False,891158,False,2,688,714,26
166658,2019-09-26 00:00:00+03:00,out,False,891154,False,7,7291,7415,124
166658,2019-09-26 00:00:00+03:00,out,False,890404,False,11,4009,4135,126
166658,2019-09-26 00:00:00+03:00,in,False,890402,False,9,643,708,65
166658,2019-09-26 00:00:00+03:00,out,False,891160,False,3,741,774,33
166658,2019-09-26 00:00:00+03:00,out,False,890420,True,1,0,8,8
166658,2019-09-26 00:00:00+03:00,out,False,890402,True,6,0,171,171
166658,2019-09-26 00:00:00+03:00,out,False,891158,False,2,688,714,26
166658,2019-09-26 00:00:00+03:00,out,False,890404,True,3,0,83,83
166658,2019-09-26 00:00:00+03:00,in,False,890404,False,3,1839,1892,53
166658,2019-09-27 00:00:00+03:00,out,False,890404,False,5,1925,1996,71
166658,2019-09-27 00:00:00+03:00,out,False,891166,False,5,610,654,44
166658,2019-09-27 00:00:00+03:00,out,False,890416,True,1,0,21,21
166658,2019-09-27 00:00:00+03:00,out,False,890406,True,2,0,66,66
166658,2019-09-27 00:00:00+03:00,out,False,890420,True,4,0,114,114
166658,2019-09-27 00:00:00+03:00,in,False,890402,False,8,2606,2683,77
166658,2019-09-27 00:00:00+03:00,in,False,890404,False,6,2907,2976,69
166658,2019-09-27 00:00:00+03:00,out,False,891154,False,8,5113,5211,98
166658,2019-09-27 00:00:00+03:00,out,False,891152,False,5,1163,1229,66
166658,2019-09-27 00:00:00+03:00,out,False,891166,True,2,0,41,41
166658,2019-09-27 00:00:00+03:00,out,False,890412,True,2,0,51,51
166658,2019-09-27 00:00:00+03:00,out,False,891152,True,4,0,71,71
166658,2019-09-27 00:00:00+03:00,out,False,890420,False,7,1143,1228,85
166658,2019-09-27 00:00:00+03:00,out,False,890406,False,5,578,626,48
166658,2019-09-27 00:00:00+03:00,out,False,890412,False,8,1052,1182,130
166658,2019-09-27 00:00:00+03:00,out,False,891158,False,2,175,210,35
166658,2019-09-27 00:00:00+03:00,in,False,-1,True,4,0,2,2
166658,2019-09-27 00:00:00+03:00,out,False,890410,True,3,0,66,66
166658,2019-09-27 00:00:00+03:00,in,False,890406,False,9,3184,3290,106
166658,2019-09-27 00:00:00+03:00,out,False,890416,False,3,251,282,31
166658,2019-09-27 00:00:00+03:00,out,False,890404,True,1,0,39,39
166658,2019-09-27 00:00:00+03:00,out,False,891160,False,3,2507,2561,54
166658,2019-09-27 00:00:00+03:00,out,False,890402,True,3,0,145,145
166658,2019-09-27 00:00:00+03:00,out,False,890402,False,9,1099,1259,160
166658,2019-09-27 00:00:00+03:00,out,False,890410,False,5,788,852,64
166658,2019-09-27 00:00:00+03:00,out,False,891158,False,2,175,210,35
166658,2019-09-27 00:00:00+03:00,out,False,890402,True,3,0,145,145
166658,2019-09-28 00:00:00+03:00,in,False,-1,True,10,0,5,5
166658,2019-09-28 00:00:00+03:00,in,False,-1,True,10,0,5,5
166658,2019-09-29 00:00:00+03:00,out,False,890410,False,1,27,37,10
166658,2019-09-29 00:00:00+03:00,out,False,890410,True,1,0,12,12
166658,2019-09-30 00:00:00+03:00,out,False,891160,False,7,1133,1264,131
166658,2019-09-30 00:00:00+03:00,out,False,891158,False,4,378,446,68
166658,2019-09-30 00:00:00+03:00,in,False,890406,False,11,1291,1376,85
166658,2019-09-30 00:00:00+03:00,out,False,890422,True,9,0,215,215
166658,2019-09-30 00:00:00+03:00,out,False,890406,False,17,6168,6346,178
166658,2019-09-30 00:00:00+03:00,out,False,891154,True,1,0,11,11
166658,2019-09-30 00:00:00+03:00,out,False,890404,True,1,0,14,14
166658,2019-09-30 00:00:00+03:00,out,False,890402,False,23,7076,7387,311
166658,2019-09-30 00:00:00+03:00,out,False,891160,True,2,0,22,22
166658,2019-09-30 00:00:00+03:00,out,False,891152,False,4,1355,1439,84
166658,2019-09-30 00:00:00+03:00,out,False,891154,False,7,2240,2326,86
166658,2019-09-30 00:00:00+03:00,out,False,891166,False,2,125,167,42
166658,2019-09-30 00:00:00+03:00,out,False,890416,False,5,188,291,103
166658,2019-09-30 00:00:00+03:00,out,False,890412,True,2,0,34,34
166658,2019-09-30 00:00:00+03:00,out,False,890410,False,19,2165,2423,258
166658,2019-09-30 00:00:00+03:00,out,False,890402,True,5,0,44,44
166658,2019-09-30 00:00:00+03:00,out,False,890420,True,3,0,73,73
166658,2019-09-30 00:00:00+03:00,in,False,-1,True,3,0,0,0
166658,2019-09-30 00:00:00+03:00,out,False,890416,True,1,0,60,60
166658,2019-09-30 00:00:00+03:00,out,False,890406,True,3,0,21,21
166658,2019-09-30 00:00:00+03:00,out,False,890410,True,3,0,86,86
166658,2019-09-30 00:00:00+03:00,out,False,890422,False,11,1186,1394,208
166658,2019-09-30 00:00:00+03:00,out,False,891166,True,1,0,35,35
166658,2019-09-30 00:00:00+03:00,in,False,890402,False,6,2242,2292,50
166658,2019-09-30 00:00:00+03:00,out,False,890404,False,1,95,105,10
166658,2019-09-30 00:00:00+03:00,out,False,890412,False,3,107,133,26
166658,2019-09-30 00:00:00+03:00,in,False,890404,False,2,1596,1608,12
166658,2019-10-01 00:00:00+03:00,out,False,890402,True,4,0,118,118
166658,2019-10-01 00:00:00+03:00,out,False,891166,True,4,0,123,123
166658,2019-10-01 00:00:00+03:00,in,False,890402,False,6,2323,2384,61
166658,2019-10-01 00:00:00+03:00,out,False,890412,True,3,0,81,81
166658,2019-10-01 00:00:00+03:00,out,False,890416,False,7,1137,1225,88
166658,2019-10-01 00:00:00+03:00,out,False,890422,False,2,101,123,22
166658,2019-10-01 00:00:00+03:00,out,False,890416,True,4,0,33,33
166658,2019-10-01 00:00:00+03:00,out,False,890410,True,2,0,18,18
166658,2019-10-01 00:00:00+03:00,in,False,890406,False,7,1820,1875,55
166658,2019-10-01 00:00:00+03:00,out,False,891152,False,1,126,127,1
166658,2019-10-01 00:00:00+03:00,out,False,891154,False,4,2501,2535,34
166658,2019-10-01 00:00:00+03:00,out,False,891166,False,2,117,134,17
166658,2019-10-01 00:00:00+03:00,out,False,890420,False,9,1286,1384,98
166658,2019-10-01 00:00:00+03:00,out,False,890406,True,3,0,20,20
166658,2019-10-01 00:00:00+03:00,out,False,890404,False,4,1034,1100,66
166658,2019-10-01 00:00:00+03:00,out,False,890410,False,12,2110,2255,145
166658,2019-10-01 00:00:00+03:00,out,False,890406,False,9,7533,7631,98
166658,2019-10-01 00:00:00+03:00,out,False,891160,True,1,0,36,36
166658,2019-10-01 00:00:00+03:00,out,False,890402,False,6,1623,1688,65
166658,2019-10-01 00:00:00+03:00,out,False,891160,False,1,4,39,35
166658,2019-10-01 00:00:00+03:00,in,False,-1,True,3,0,6,6
166658,2019-10-01 00:00:00+03:00,out,False,890404,True,9,0,167,167
166658,2019-10-01 00:00:00+03:00,in,False,890404,False,5,1607,1639,32
166658,2019-10-01 00:00:00+03:00,out,False,891152,True,2,0,71,71
166658,2019-10-01 00:00:00+03:00,out,False,891158,False,2,340,365,25
166658,2019-10-01 00:00:00+03:00,out,False,890412,False,6,1523,1602,79
166658,2019-10-01 00:00:00+03:00,out,False,890420,True,2,0,51,51
166658,2019-10-01 00:00:00+03:00,out,False,890412,False,6,1523,1602,79
166658,2019-10-01 00:00:00+03:00,out,False,890406,False,9,7533,7631,98
166658,2019-10-02 00:00:00+03:00,out,False,890402,False,7,2703,2791,88
166658,2019-10-02 00:00:00+03:00,out,False,890410,True,1,0,30,30
166658,2019-10-02 00:00:00+03:00,in,False,890406,False,9,1828,1932,104
166658,2019-10-02 00:00:00+03:00,out,False,890412,True,1,0,61,61
166658,2019-10-02 00:00:00+03:00,out,False,890416,False,1,131,151,20
166658,2019-10-02 00:00:00+03:00,out,False,891154,True,1,0,24,24
166658,2019-10-02 00:00:00+03:00,out,False,891160,False,1,348,353,5
166658,2019-10-02 00:00:00+03:00,out,False,890410,False,11,1526,1691,165
166658,2019-10-02 00:00:00+03:00,in,False,890402,False,5,1350,1433,83
166658,2019-10-02 00:00:00+03:00,in,False,890404,False,8,1304,1373,69
166658,2019-10-02 00:00:00+03:00,out,False,891152,False,2,2905,2944,39
166658,2019-10-02 00:00:00+03:00,out,False,891154,False,4,4475,4525,50
166658,2019-10-02 00:00:00+03:00,out,False,890404,True,3,0,40,40
166658,2019-10-02 00:00:00+03:00,out,False,890404,False,6,1240,1324,84
166658,2019-10-02 00:00:00+03:00,in,False,-1,True,6,0,23,23
166658,2019-10-02 00:00:00+03:00,out,False,890406,False,6,5797,5872,75
166658,2019-10-02 00:00:00+03:00,out,False,890412,False,11,3347,3530,183
166658,2019-10-02 00:00:00+03:00,out,False,890420,True,2,0,23,23
166658,2019-10-02 00:00:00+03:00,out,False,890420,False,9,4456,4603,147
166658,2019-10-02 00:00:00+03:00,out,False,891160,False,1,348,353,5
166658,2019-10-03 00:00:00+03:00,in,False,890406,False,4,1233,1270,37
166658,2019-10-03 00:00:00+03:00,out,False,890410,True,4,0,103,103
166658,2019-10-03 00:00:00+03:00,out,False,890420,False,17,3226,3470,244
166658,2019-10-03 00:00:00+03:00,out,False,890412,False,9,1328,1490,162
166658,2019-10-03 00:00:00+03:00,out,False,891152,True,3,0,101,101
166658,2019-10-03 00:00:00+03:00,out,False,890422,False,3,135,192,57
166658,2019-10-03 00:00:00+03:00,out,False,890402,True,5,0,44,44
166658,2019-10-03 00:00:00+03:00,out,False,890402,False,9,763,871,108
166658,2019-10-03 00:00:00+03:00,out,False,890412,True,8,0,293,293
166658,2019-10-03 00:00:00+03:00,out,False,890422,True,3,0,159,159
166658,2019-10-03 00:00:00+03:00,out,False,890420,True,4,0,90,90
166658,2019-10-03 00:00:00+03:00,in,False,-1,True,4,0,3,3
166658,2019-10-03 00:00:00+03:00,out,False,890410,False,4,435,493,58
166658,2019-10-03 00:00:00+03:00,in,False,890404,False,6,1329,1374,45
166658,2019-10-03 00:00:00+03:00,out,False,890404,False,12,3541,3719,178
166658,2019-10-03 00:00:00+03:00,out,False,890406,True,8,0,157,157
166658,2019-10-03 00:00:00+03:00,out,False,890406,False,8,1071,1202,131
166658,2019-10-03 00:00:00+03:00,out,False,890404,True,13,0,255,255
166658,2019-10-03 00:00:00+03:00,out,False,891158,False,2,794,798,4
166658,2019-10-03 00:00:00+03:00,in,False,890402,False,10,1180,1269,89
166658,2019-10-03 00:00:00+03:00,out,False,891152,False,3,1555,1605,50
166658,2019-10-04 00:00:00+03:00,in,False,890406,False,7,2611,2695,84
166658,2019-10-04 00:00:00+03:00,out,False,890404,True,7,0,124,124
166658,2019-10-04 00:00:00+03:00,out,False,891154,False,5,4960,5013,53
166658,2019-10-04 00:00:00+03:00,out,False,891158,False,3,1255,1281,26
166658,2019-10-04 00:00:00+03:00,out,False,891162,True,2,0,84,84
166658,2019-10-04 00:00:00+03:00,in,False,890404,False,10,2011,2075,64
166658,2019-10-04 00:00:00+03:00,out,False,890410,True,13,0,427,427
166658,2019-10-04 00:00:00+03:00,out,False,890406,False,8,1704,1799,95
166658,2019-10-04 00:00:00+03:00,out,False,890420,True,2,0,12,12
166658,2019-10-04 00:00:00+03:00,out,False,890410,False,20,8304,8571,267
166658,2019-10-04 00:00:00+03:00,in,False,890402,False,7,1752,1818,66
166658,2019-10-04 00:00:00+03:00,out,False,890420,False,15,3600,3793,193
166658,2019-10-04 00:00:00+03:00,out,False,890402,False,10,4220,4327,107
166658,2019-10-04 00:00:00+03:00,out,False,890404,False,18,5833,6034,201
166658,2019-10-04 00:00:00+03:00,out,False,890402,True,4,0,84,84
166658,2019-10-04 00:00:00+03:00,in,False,-1,True,7,0,19,19
166658,2019-10-04 00:00:00+03:00,out,False,890412,False,12,1126,1296,170
166658,2019-10-04 00:00:00+03:00,out,False,890412,True,3,0,125,125
166658,2019-10-04 00:00:00+03:00,out,False,891152,False,7,919,1064,145
166658,2019-10-04 00:00:00+03:00,out,True,890404,True,1,0,0,0
166658,2019-10-04 00:00:00+03:00,out,False,890406,True,9,0,267,267
166658,2019-10-04 00:00:00+03:00,out,False,891152,True,2,0,69,69
166658,2019-10-04 00:00:00+03:00,out,False,891162,False,1,51,66,15
166658,2019-10-04 00:00:00+03:00,out,False,890410,False,20,8304,8571,267
166658,2019-10-04 00:00:00+03:00,out,False,890410,True,13,0,427,427
166658,2019-10-04 00:00:00+03:00,out,False,890412,False,12,1126,1296,170
166658,2019-10-04 00:00:00+03:00,out,True,890404,True,1,0,0,0
166658,2019-10-05 00:00:00+03:00,in,False,-1,True,7,0,3,3
166658,2019-10-06 00:00:00+03:00,in,False,-1,True,26,0,14,14
166658,2019-10-07 00:00:00+03:00,out,False,890406,True,3,0,13,13
166658,2019-10-07 00:00:00+03:00,out,False,890404,True,2,0,47,47
166658,2019-10-07 00:00:00+03:00,out,False,890406,False,5,430,480,50
166658,2019-10-07 00:00:00+03:00,out,False,890412,True,17,0,411,411
166658,2019-10-07 00:00:00+03:00,out,False,-1,True,1,0,0,0
166658,2019-10-07 00:00:00+03:00,out,False,890404,False,12,1031,1278,247
166658,2019-10-07 00:00:00+03:00,in,False,890402,False,5,1745,1781,36
166658,2019-10-07 00:00:00+03:00,out,False,890420,True,7,0,158,158
166658,2019-10-07 00:00:00+03:00,out,False,890420,False,12,1066,1208,142
166658,2019-10-07 00:00:00+03:00,out,False,890416,False,6,3097,3184,87
166658,2019-10-07 00:00:00+03:00,out,False,890412,False,20,2805,3097,292
166658,2019-10-07 00:00:00+03:00,out,False,891160,False,1,24,36,12
166658,2019-10-07 00:00:00+03:00,out,False,891154,False,2,441,451,10
166658,2019-10-07 00:00:00+03:00,out,False,891152,True,1,0,29,29
166658,2019-10-07 00:00:00+03:00,out,False,890410,False,20,3820,4062,242
166658,2019-10-07 00:00:00+03:00,in,False,890404,False,7,1703,1749,46
166658,2019-10-07 00:00:00+03:00,in,False,890406,False,5,1871,1905,34
166658,2019-10-07 00:00:00+03:00,out,False,891158,False,2,1789,1803,14
166658,2019-10-07 00:00:00+03:00,out,False,890402,False,10,2047,2147,100
166658,2019-10-07 00:00:00+03:00,in,False,-1,True,1,0,3,3
166658,2019-10-07 00:00:00+03:00,out,False,891158,True,3,0,22,22
166658,2019-10-07 00:00:00+03:00,out,False,890410,True,17,0,398,398
166658,2019-10-07 00:00:00+03:00,out,False,890402,True,9,0,129,129
166658,2019-10-07 00:00:00+03:00,out,False,891154,True,2,0,87,87
166658,2019-10-07 00:00:00+03:00,out,False,890416,True,2,0,31,31
166658,2019-10-07 00:00:00+03:00,out,False,891152,False,2,130,155,25
166658,2019-10-07 00:00:00+03:00,out,False,891160,True,1,0,48,48
166658,2019-10-07 00:00:00+03:00,out,False,890406,False,5,430,480,50
166658,2019-10-07 00:00:00+03:00,in,False,890404,False,7,1703,1749,46
166658,2019-10-07 00:00:00+03:00,out,False,891154,True,2,0,87,87
166658,2019-10-08 00:00:00+03:00,out,False,890420,False,10,5375,5526,151
166658,2019-10-08 00:00:00+03:00,in,False,-1,True,5,0,12,12
166658,2019-10-08 00:00:00+03:00,out,False,891158,False,4,1247,1270,23
166658,2019-10-08 00:00:00+03:00,out,False,890402,False,8,1465,1577,112
166658,2019-10-08 00:00:00+03:00,out,False,890406,True,13,0,379,379
166658,2019-10-08 00:00:00+03:00,out,False,890412,True,9,0,222,222
166658,2019-10-08 00:00:00+03:00,out,False,890404,True,11,0,354,354
166658,2019-10-08 00:00:00+03:00,in,False,890402,False,4,1585,1624,39
166658,2019-10-08 00:00:00+03:00,out,False,891154,False,3,2163,2220,57
166658,2019-10-08 00:00:00+03:00,out,False,890416,True,4,0,151,151
166658,2019-10-08 00:00:00+03:00,in,False,890404,False,3,903,934,31
166658,2019-10-08 00:00:00+03:00,out,False,890412,False,14,2532,2707,175
166658,2019-10-08 00:00:00+03:00,out,False,890416,False,11,644,824,180
166658,2019-10-08 00:00:00+03:00,out,False,890406,False,19,4500,4747,247
166658,2019-10-08 00:00:00+03:00,out,False,890410,False,26,8111,8608,497
166658,2019-10-08 00:00:00+03:00,out,False,890402,True,6,0,139,139
166658,2019-10-08 00:00:00+03:00,out,False,890404,False,10,4493,4626,133
166658,2019-10-08 00:00:00+03:00,out,False,890420,True,4,0,99,99
166658,2019-10-08 00:00:00+03:00,out,False,890410,True,7,0,259,259
166658,2019-10-08 00:00:00+03:00,out,False,891160,False,1,370,381,11
166658,2019-10-08 00:00:00+03:00,in,False,890406,False,8,1069,1130,61
166658,2019-10-08 00:00:00+03:00,out,False,891152,True,2,0,115,115
166658,2019-10-08 00:00:00+03:00,out,False,891152,False,4,2176,2240,64
166658,2019-10-08 00:00:00+03:00,out,False,890412,False,14,2532,2707,175
166658,2019-10-08 00:00:00+03:00,out,False,890404,False,10,4493,4626,133
166658,2019-10-08 00:00:00+03:00,out,False,890406,False,19,4500,4747,247
166658,2019-10-08 00:00:00+03:00,out,False,890404,True,11,0,354,354
166658,2019-10-09 00:00:00+03:00,out,False,890402,True,5,0,135,135
166658,2019-10-09 00:00:00+03:00,in,False,890404,False,8,3614,3667,53
166658,2019-10-09 00:00:00+03:00,in,False,890406,False,4,2269,2308,39
166658,2019-10-09 00:00:00+03:00,out,False,890422,False,1,36,41,5
166658,2019-10-09 00:00:00+03:00,out,False,891158,True,5,0,141,141
166658,2019-10-09 00:00:00+03:00,out,False,890412,False,21,2198,2461,263
166658,2019-10-09 00:00:00+03:00,out,False,890420,True,6,0,131,131
166658,2019-10-09 00:00:00+03:00,out,False,890402,False,22,5562,5838,276
166658,2019-10-09 00:00:00+03:00,out,False,891160,False,6,1208,1291,83
166658,2019-10-09 00:00:00+03:00,out,False,890416,True,3,0,36,36
166658,2019-10-09 00:00:00+03:00,in,False,890402,False,6,869,930,61
166658,2019-10-09 00:00:00+03:00,out,False,890404,False,10,2750,2845,95
166658,2019-10-09 00:00:00+03:00,out,False,890410,True,5,0,111,111
166658,2019-10-09 00:00:00+03:00,out,False,890412,True,15,0,506,506
166658,2019-10-09 00:00:00+03:00,out,False,891158,False,1,1113,1128,15
166658,2019-10-09 00:00:00+03:00,out,False,891154,True,4,0,91,91
166658,2019-10-09 00:00:00+03:00,out,False,890410,False,6,435,528,93
166658,2019-10-09 00:00:00+03:00,out,False,891154,False,4,5464,5507,43
166658,2019-10-09 00:00:00+03:00,out,False,890406,True,4,0,51,51
166658,2019-10-09 00:00:00+03:00,out,False,890404,True,2,0,14,14
166658,2019-10-09 00:00:00+03:00,in,False,-1,True,20,0,245,245
166658,2019-10-09 00:00:00+03:00,out,False,890416,False,10,1046,1172,126
166658,2019-10-09 00:00:00+03:00,out,False,890420,False,13,8957,9128,171
166658,2019-10-09 00:00:00+03:00,out,False,891152,False,4,1512,1544,32
166658,2019-10-09 00:00:00+03:00,out,False,890406,False,14,4918,5130,212
166658,2019-10-09 00:00:00+03:00,out,False,891160,False,6,1208,1291,83
166658,2019-10-09 00:00:00+03:00,in,False,890404,False,8,3614,3667,53
166658,2019-10-09 00:00:00+03:00,out,False,891154,True,4,0,91,91
166658,2019-10-09 00:00:00+03:00,out,False,890410,False,6,435,528,93
166658,2019-10-09 00:00:00+03:00,out,False,890412,False,21,2198,2461,263
166658,2019-10-10 00:00:00+03:00,out,False,891160,True,2,0,8,8
166658,2019-10-10 00:00:00+03:00,out,False,890410,True,10,0,225,225
166658,2019-10-10 00:00:00+03:00,out,False,890404,False,11,2771,2926,155
166658,2019-10-10 00:00:00+03:00,out,False,890404,True,9,0,219,219
166658,2019-10-10 00:00:00+03:00,in,False,-1,True,6,0,17,17
166658,2019-10-10 00:00:00+03:00,out,False,890406,False,6,2154,2240,86
166658,2019-10-10 00:00:00+03:00,out,False,891162,False,3,1853,1885,32
166658,2019-10-10 00:00:00+03:00,out,False,890402,True,3,0,110,110
166658,2019-10-10 00:00:00+03:00,out,False,890420,True,2,0,80,80
166658,2019-10-10 00:00:00+03:00,out,False,890406,True,3,0,10,10
166658,2019-10-10 00:00:00+03:00,out,False,890412,True,14,0,317,317
166658,2019-10-10 00:00:00+03:00,out,False,891166,False,1,2607,2618,11
166658,2019-10-10 00:00:00+03:00,out,False,890420,False,6,2699,2751,52
166658,2019-10-10 00:00:00+03:00,out,False,890410,False,20,1197,1513,316
166658,2019-10-10 00:00:00+03:00,in,False,890404,False,7,1894,1940,46
166658,2019-10-10 00:00:00+03:00,out,False,890416,True,3,0,112,112
166658,2019-10-10 00:00:00+03:00,out,False,890402,False,8,3130,3256,126
166658,2019-10-10 00:00:00+03:00,out,False,891154,False,6,6426,6539,113
166658,2019-10-10 00:00:00+03:00,in,False,890406,False,7,1869,1949,80
166658,2019-10-10 00:00:00+03:00,out,False,891158,False,2,2640,2654,14
166658,2019-10-10 00:00:00+03:00,out,False,891152,False,1,1435,1449,14
166658,2019-10-10 00:00:00+03:00,out,False,891162,True,1,0,8,8
166658,2019-10-10 00:00:00+03:00,out,False,890412,False,9,1421,1566,145
166658,2019-10-10 00:00:00+03:00,in,False,890402,False,11,1435,1550,115
166658,2019-10-10 00:00:00+03:00,out,False,890416,False,9,644,798,154
166658,2019-10-10 00:00:00+03:00,out,False,890420,False,6,2699,2751,52
166658,2019-10-10 00:00:00+03:00,out,False,890416,True,3,0,112,112
166658,2019-10-10 00:00:00+03:00,in,False,890404,False,7,1894,1940,46
166658,2019-10-10 00:00:00+03:00,out,False,890410,True,10,0,225,225
166658,2019-10-11 00:00:00+03:00,out,False,891158,True,1,0,41,41
166658,2019-10-11 00:00:00+03:00,in,False,890402,False,5,317,356,39
166658,2019-10-11 00:00:00+03:00,out,False,891166,False,1,227,242,15
166658,2019-10-11 00:00:00+03:00,out,False,891152,False,1,55,62,7
166658,2019-10-11 00:00:00+03:00,out,False,890406,True,4,0,121,121
166658,2019-10-11 00:00:00+03:00,out,False,890402,False,10,864,1010,146
166658,2019-10-11 00:00:00+03:00,out,False,891160,False,1,80,96,16
166658,2019-10-11 00:00:00+03:00,out,False,890404,True,1,0,38,38
166658,2019-10-11 00:00:00+03:00,out,False,890416,True,3,0,124,124
166658,2019-10-11 00:00:00+03:00,out,False,891154,False,1,2236,2247,11
166658,2019-10-11 00:00:00+03:00,out,False,890410,False,15,6863,7063,200
166658,2019-10-11 00:00:00+03:00,out,False,890402,True,13,0,329,329
166658,2019-10-11 00:00:00+03:00,out,False,890404,False,1,735,741,6
166658,2019-10-11 00:00:00+03:00,out,False,890416,False,5,2850,2881,31
166658,2019-10-11 00:00:00+03:00,out,False,890412,True,3,0,64,64
166658,2019-10-11 00:00:00+03:00,out,False,890412,False,5,1310,1379,69
166658,2019-10-11 00:00:00+03:00,out,False,891158,False,2,1448,1480,32
166658,2019-10-11 00:00:00+03:00,out,False,890420,False,32,4224,4697,473
166658,2019-10-11 00:00:00+03:00,out,False,890410,True,6,0,154,154
166658,2019-10-11 00:00:00+03:00,in,False,-1,True,6,0,27,27
166658,2019-10-11 00:00:00+03:00,in,False,890404,False,1,1169,1183,14
166658,2019-10-11 00:00:00+03:00,out,False,890420,True,17,0,464,464
166658,2019-10-11 00:00:00+03:00,in,False,890406,False,6,369,413,44
166658,2019-10-11 00:00:00+03:00,out,False,890406,False,14,4433,4627,194
166658,2019-10-11 00:00:00+03:00,out,False,890412,False,5,1310,1379,69
166658,2019-10-11 00:00:00+03:00,out,False,890410,True,6,0,154,154
166658,2019-10-11 00:00:00+03:00,out,False,890404,False,1,735,741,6
166658,2019-10-11 00:00:00+03:00,in,False,890404,False,1,1169,1183,14
166658,2019-10-12 00:00:00+03:00,in,False,-1,True,6,0,3,3
166658,2019-10-14 00:00:00+03:00,out,False,890404,True,7,0,301,301
166658,2019-10-14 00:00:00+03:00,in,False,890406,False,7,1328,1382,54
166658,2019-10-14 00:00:00+03:00,out,False,891166,False,7,1402,1467,65
166658,2019-10-14 00:00:00+03:00,out,False,891154,False,7,1265,1328,63
166658,2019-10-14 00:00:00+03:00,in,False,890404,True,1,0,5,5
166658,2019-10-14 00:00:00+03:00,in,False,890406,True,1,0,12,12
166658,2019-10-14 00:00:00+03:00,out,False,891158,False,5,5487,5544,57
166658,2019-10-14 00:00:00+03:00,out,False,891152,False,2,521,553,32
166658,2019-10-14 00:00:00+03:00,out,False,890420,True,12,0,417,417
166658,2019-10-14 00:00:00+03:00,out,False,890406,False,12,1549,1699,150
166658,2019-10-14 00:00:00+03:00,out,False,891162,True,1,0,40,40
166658,2019-10-14 00:00:00+03:00,in,False,890402,False,5,1528,1556,28
166658,2019-10-14 00:00:00+03:00,out,False,890412,True,4,0,101,101
166658,2019-10-14 00:00:00+03:00,out,False,890404,False,8,1340,1526,186
166658,2019-10-14 00:00:00+03:00,out,False,890416,False,1,686,695,9
166658,2019-10-14 00:00:00+03:00,out,False,890422,True,2,0,16,16
166658,2019-10-14 00:00:00+03:00,out,False,890406,True,10,0,178,178
166658,2019-10-14 00:00:00+03:00,out,False,891162,False,3,178,208,30
166658,2019-10-14 00:00:00+03:00,out,False,890412,False,9,4585,4694,109
166658,2019-10-14 00:00:00+03:00,out,False,891166,True,2,0,48,48
166658,2019-10-14 00:00:00+03:00,out,False,890402,True,3,0,67,67
166658,2019-10-14 00:00:00+03:00,out,False,890420,False,24,2030,2378,348
166658,2019-10-14 00:00:00+03:00,out,False,890410,True,7,0,100,100
166658,2019-10-14 00:00:00+03:00,out,False,891154,True,3,0,131,131
166658,2019-10-14 00:00:00+03:00,out,False,890402,False,5,504,577,73
166658,2019-10-14 00:00:00+03:00,out,False,890410,False,14,3162,3413,251
166658,2019-10-14 00:00:00+03:00,in,False,890404,False,12,2943,3014,71
166658,2019-10-14 00:00:00+03:00,in,False,-1,True,6,0,10,10
166658,2019-10-14 00:00:00+03:00,out,False,891166,True,2,0,48,48
166658,2019-10-14 00:00:00+03:00,out,False,891154,True,3,0,131,131
166658,2019-10-14 00:00:00+03:00,out,False,890416,False,1,686,695,9
166658,2019-10-14 00:00:00+03:00,out,False,890404,False,8,1340,1526,186
166658,2019-10-14 00:00:00+03:00,out,False,890422,True,2,0,16,16
166658,2019-10-14 00:00:00+03:00,in,False,890406,True,1,0,12,12
166658,2019-10-15 00:00:00+03:00,out,False,891158,True,1,0,60,60
166658,2019-10-15 00:00:00+03:00,out,False,890420,False,16,1463,1746,283
166658,2019-10-15 00:00:00+03:00,out,False,890406,True,14,0,249,249
166658,2019-10-15 00:00:00+03:00,out,False,890412,False,9,1039,1156,117
166658,2019-10-15 00:00:00+03:00,out,False,890416,True,2,0,11,11
166658,2019-10-15 00:00:00+03:00,in,False,890402,False,9,3550,3639,89
166658,2019-10-15 00:00:00+03:00,out,False,890420,True,8,0,174,174
166658,2019-10-15 00:00:00+03:00,out,False,890410,True,3,0,140,140
166658,2019-10-15 00:00:00+03:00,out,False,890402,True,14,0,143,143
166658,2019-10-15 00:00:00+03:00,out,False,890416,False,4,708,766,58
166658,2019-10-15 00:00:00+03:00,in,False,890404,False,8,3095,3178,83
166658,2019-10-15 00:00:00+03:00,out,False,890410,False,4,965,1004,39
166658,2019-10-15 00:00:00+03:00,out,False,891154,False,6,7811,7914,103
166658,2019-10-15 00:00:00+03:00,out,False,891154,True,3,0,142,142
166658,2019-10-15 00:00:00+03:00,out,False,890412,True,5,0,108,108
166658,2019-10-15 00:00:00+03:00,out,False,890406,False,10,944,1080,136
166658,2019-10-15 00:00:00+03:00,in,False,-1,True,13,0,50,50
166658,2019-10-15 00:00:00+03:00,out,False,890402,False,8,2133,2253,120
166658,2019-10-15 00:00:00+03:00,out,False,890404,False,21,1762,2093,331
166658,2019-10-15 00:00:00+03:00,out,False,891152,False,1,412,425,13
166658,2019-10-15 00:00:00+03:00,out,False,891152,True,2,0,20,20
166658,2019-10-15 00:00:00+03:00,in,False,890406,False,11,3173,3277,104
166658,2019-10-15 00:00:00+03:00,out,False,890404,True,12,0,367,367
166658,2019-10-15 00:00:00+03:00,out,False,891158,False,2,376,404,28
166658,2019-10-15 00:00:00+03:00,out,False,891158,False,2,376,404,28
166658,2019-10-15 00:00:00+03:00,out,False,890406,True,14,0,249,249
166658,2019-10-15 00:00:00+03:00,out,False,890404,True,12,0,367,367
166658,2019-10-16 00:00:00+03:00,out,False,890404,True,9,0,111,111
166658,2019-10-16 00:00:00+03:00,out,False,890410,False,8,3169,3264,95
166658,2019-10-16 00:00:00+03:00,out,False,890412,False,12,2878,3048,170
166658,2019-10-16 00:00:00+03:00,in,False,890402,False,7,1181,1246,65
166658,2019-10-16 00:00:00+03:00,out,False,891152,False,2,469,505,36
166658,2019-10-16 00:00:00+03:00,out,False,890402,True,3,0,87,87
166658,2019-10-16 00:00:00+03:00,out,False,891158,False,3,259,339,80
166658,2019-10-16 00:00:00+03:00,out,False,890420,False,7,974,1070,96
166658,2019-10-16 00:00:00+03:00,out,False,890416,False,6,5963,6021,58
166658,2019-10-16 00:00:00+03:00,in,False,-1,True,4,0,17,17
166658,2019-10-16 00:00:00+03:00,in,False,890404,False,8,1370,1477,107
166658,2019-10-16 00:00:00+03:00,out,False,890410,True,2,0,72,72
166658,2019-10-16 00:00:00+03:00,in,False,890406,False,11,1106,1277,171
166658,2019-10-16 00:00:00+03:00,out,False,890406,False,4,1082,1143,61
166658,2019-10-16 00:00:00+03:00,out,False,891154,True,2,0,78,78
166658,2019-10-16 00:00:00+03:00,out,False,891160,True,1,0,9,9
166658,2019-10-16 00:00:00+03:00,out,False,890404,False,13,1006,1201,195
166658,2019-10-16 00:00:00+03:00,out,False,890422,True,1,0,61,61
166658,2019-10-16 00:00:00+03:00,out,False,890422,False,10,2738,2921,183
166658,2019-10-16 00:00:00+03:00,out,False,891158,True,2,0,73,73
166658,2019-10-16 00:00:00+03:00,out,False,891166,False,11,4265,4399,134
166658,2019-10-16 00:00:00+03:00,out,False,891154,False,10,7639,7802,163
166658,2019-10-16 00:00:00+03:00,out,False,890406,True,1,0,35,35
166658,2019-10-16 00:00:00+03:00,out,False,890402,False,4,539,590,51
166658,2019-10-16 00:00:00+03:00,out,False,890412,True,1,0,1,1
166658,2019-10-16 00:00:00+03:00,out,False,890420,True,3,0,86,86
166658,2019-10-16 00:00:00+03:00,out,False,891166,True,4,0,96,96
166658,2019-10-16 00:00:00+03:00,out,False,891166,False,11,4265,4399,134
166658,2019-10-16 00:00:00+03:00,out,False,891158,True,2,0,73,73
166658,2019-10-16 00:00:00+03:00,out,False,890420,True,3,0,86,86
166658,2019-10-16 00:00:00+03:00,in,False,-1,True,4,0,17,17
166658,2019-10-17 00:00:00+03:00,out,False,891152,False,3,3105,3156,51
166658,2019-10-17 00:00:00+03:00,out,False,890422,False,8,2734,2884,150
166658,2019-10-17 00:00:00+03:00,out,False,891160,True,1,0,54,54
166658,2019-10-17 00:00:00+03:00,out,False,890420,True,3,0,68,68
166658,2019-10-17 00:00:00+03:00,out,False,891158,False,5,6919,6984,65
166658,2019-10-17 00:00:00+03:00,out,False,890416,True,5,0,120,120
166658,2019-10-17 00:00:00+03:00,out,False,891152,True,1,0,9,9
166658,2019-10-17 00:00:00+03:00,out,False,890406,False,20,2905,3139,234
166658,2019-10-17 00:00:00+03:00,out,False,890410,False,5,3630,3680,50
166658,2019-10-17 00:00:00+03:00,out,False,890404,False,8,1980,2067,87
166658,2019-10-17 00:00:00+03:00,out,False,890402,False,15,1061,1234,173
166658,2019-10-17 00:00:00+03:00,in,False,890406,False,3,1491,1520,29
166658,2019-10-17 00:00:00+03:00,out,False,891154,True,4,0,127,127
166658,2019-10-17 00:00:00+03:00,in,False,890404,False,11,1288,1360,72
166658,2019-10-17 00:00:00+03:00,out,False,890402,True,6,0,123,123
166658,2019-10-17 00:00:00+03:00,out,False,890410,True,2,0,36,36
166658,2019-10-17 00:00:00+03:00,out,False,890420,False,8,3219,3335,116
166658,2019-10-17 00:00:00+03:00,out,False,890404,True,8,0,217,217
166658,2019-10-17 00:00:00+03:00,out,False,890422,True,5,0,58,58
166658,2019-10-17 00:00:00+03:00,in,False,890402,False,10,1323,1417,94
166658,2019-10-17 00:00:00+03:00,in,False,-1,True,5,0,69,69
166658,2019-10-17 00:00:00+03:00,out,False,890412,True,5,0,127,127
166658,2019-10-17 00:00:00+03:00,out,False,890412,False,7,1557,1621,64
166658,2019-10-17 00:00:00+03:00,out,False,890416,False,8,448,577,129
166658,2019-10-17 00:00:00+03:00,out,False,891160,False,1,25,49,24
166658,2019-10-17 00:00:00+03:00,out,False,891166,False,3,2247,2280,33
166658,2019-10-17 00:00:00+03:00,out,False,891154,False,4,4161,4235,74
166658,2019-10-17 00:00:00+03:00,out,False,890406,True,4,0,73,73
166658,2019-10-17 00:00:00+03:00,out,False,891152,True,1,0,9,9
166658,2019-10-17 00:00:00+03:00,out,False,890416,False,8,448,577,129
166658,2019-10-17 00:00:00+03:00,out,False,891160,False,1,25,49,24
166658,2019-10-17 00:00:00+03:00,out,False,890420,False,8,3219,3335,116
166658,2019-10-17 00:00:00+03:00,in,False,890406,False,3,1491,1520,29
166658,2019-10-17 00:00:00+03:00,out,False,891166,False,3,2247,2280,33
166658,2019-10-18 00:00:00+03:00,out,False,891154,True,4,0,60,60
166658,2019-10-18 00:00:00+03:00,out,False,890412,True,3,0,26,26
166658,2019-10-18 00:00:00+03:00,out,False,890410,False,3,1400,1420,20
166658,2019-10-18 00:00:00+03:00,out,False,890402,True,9,0,374,374
166658,2019-10-18 00:00:00+03:00,out,False,891158,True,1,0,50,50
166658,2019-10-18 00:00:00+03:00,out,False,891152,True,1,0,60,60
166658,2019-10-18 00:00:00+03:00,out,False,891158,False,2,106,128,22
166658,2019-10-18 00:00:00+03:00,out,False,890406,False,7,1622,1755,133
166658,2019-10-18 00:00:00+03:00,out,False,890404,False,3,614,659,45
166658,2019-10-18 00:00:00+03:00,in,False,-1,True,3,0,41,41
166658,2019-10-18 00:00:00+03:00,in,False,890402,False,3,2603,2681,78
166658,2019-10-18 00:00:00+03:00,in,False,890404,False,3,352,369,17
166658,2019-10-18 00:00:00+03:00,out,False,890412,False,5,3769,3846,77
166658,2019-10-18 00:00:00+03:00,out,False,890416,True,7,0,126,126
166658,2019-10-18 00:00:00+03:00,in,False,890406,False,4,384,425,41
166658,2019-10-18 00:00:00+03:00,out,False,890416,False,15,5051,5238,187
166658,2019-10-18 00:00:00+03:00,out,False,890402,False,11,1046,1190,144
166658,2019-10-18 00:00:00+03:00,out,False,891160,False,7,3169,3260,91
166658,2019-10-18 00:00:00+03:00,out,False,891160,True,5,0,119,119
166658,2019-10-18 00:00:00+03:00,out,False,890404,True,3,0,123,123
166658,2019-10-18 00:00:00+03:00,out,False,890410,True,3,0,119,119
166658,2019-10-18 00:00:00+03:00,out,False,891166,False,1,483,495,12
166658,2019-10-18 00:00:00+03:00,out,False,891154,False,5,2277,2375,98
166658,2019-10-18 00:00:00+03:00,out,False,890406,True,3,0,82,82
166658,2019-10-18 00:00:00+03:00,out,False,891152,True,1,0,60,60
166658,2019-10-18 00:00:00+03:00,out,False,890402,True,9,0,374,374
166658,2019-10-18 00:00:00+03:00,out,False,890410,True,3,0,119,119
166658,2019-10-19 00:00:00+03:00,in,False,-1,True,5,0,3,3
166658,2019-10-21 00:00:00+03:00,out,False,891160,False,7,3457,3535,78
166658,2019-10-21 00:00:00+03:00,out,False,890402,False,11,6108,6246,138
166658,2019-10-21 00:00:00+03:00,out,False,891152,False,2,93,125,32
166658,2019-10-21 00:00:00+03:00,out,False,891152,True,1,0,32,32
166658,2019-10-21 00:00:00+03:00,out,False,890420,False,5,986,1028,42
166658,2019-10-21 00:00:00+03:00,in,False,890404,False,4,1115,1143,28
166658,2019-10-21 00:00:00+03:00,out,False,890406,False,12,844,1041,197
166658,2019-10-21 00:00:00+03:00,out,False,891154,False,2,588,604,16
166658,2019-10-21 00:00:00+03:00,out,False,890420,True,2,0,18,18
166658,2019-10-21 00:00:00+03:00,in,False,-1,True,1,0,1,1
166658,2019-10-21 00:00:00+03:00,out,False,890410,True,7,0,195,195
166658,2019-10-21 00:00:00+03:00,out,False,890412,False,6,2994,3071,77
166658,2019-10-21 00:00:00+03:00,in,False,890402,False,4,1386,1426,40
166658,2019-10-21 00:00:00+03:00,out,False,890422,True,1,0,3,3
166658,2019-10-21 00:00:00+03:00,in,False,890406,False,9,1484,1571,87
166658,2019-10-21 00:00:00+03:00,out,False,891158,False,1,415,428,13
166658,2019-10-21 00:00:00+03:00,out,False,891166,False,5,1301,1360,59
166658,2019-10-21 00:00:00+03:00,out,False,890416,False,14,2457,2689,232
166658,2019-10-21 00:00:00+03:00,out,False,890412,True,8,0,10,10
166658,2019-10-21 00:00:00+03:00,out,False,891160,True,1,0,10,10
166658,2019-10-21 00:00:00+03:00,out,False,890422,False,3,54,95,41
166658,2019-10-21 00:00:00+03:00,out,False,890410,False,7,1420,1488,68
166658,2019-10-21 00:00:00+03:00,out,False,890416,True,12,0,480,480
166658,2019-10-21 00:00:00+03:00,out,False,890406,True,4,0,115,115
166658,2019-10-21 00:00:00+03:00,out,False,890402,True,8,0,142,142
166658,2019-10-21 00:00:00+03:00,out,False,890404,True,8,0,88,88
166658,2019-10-21 00:00:00+03:00,out,False,890404,False,3,2599,2627,28
166658,2019-10-21 00:00:00+03:00,out,False,891162,False,1,37,39,2
166658,2019-10-21 00:00:00+03:00,out,False,890416,True,12,0,480,480
166658,2019-10-21 00:00:00+03:00,out,False,890422,True,1,0,3,3
166658,2019-10-21 00:00:00+03:00,out,False,890402,True,8,0,142,142
166658,2019-10-21 00:00:00+03:00,out,False,890404,True,8,0,88,88
166658,2019-10-22 00:00:00+03:00,out,False,890404,False,11,1364,1519,155
166658,2019-10-22 00:00:00+03:00,out,False,890404,True,6,0,29,29
166658,2019-10-22 00:00:00+03:00,out,False,890410,True,2,0,10,10
166658,2019-10-22 00:00:00+03:00,out,False,891152,False,2,1024,1060,36
166658,2019-10-22 00:00:00+03:00,out,False,890420,False,1,165,175,10
166658,2019-10-22 00:00:00+03:00,out,False,890412,False,2,461,507,46
166658,2019-10-22 00:00:00+03:00,out,False,890402,False,10,2492,2661,169
166658,2019-10-22 00:00:00+03:00,out,False,890406,False,8,1947,2082,135
166658,2019-10-22 00:00:00+03:00,out,False,890410,False,4,985,1105,120
166658,2019-10-22 00:00:00+03:00,out,False,890416,True,5,0,170,170
166658,2019-10-22 00:00:00+03:00,in,False,890402,False,3,1539,1626,87
166658,2019-10-22 00:00:00+03:00,out,False,890416,False,6,537,630,93
166658,2019-10-22 00:00:00+03:00,in,False,-1,True,3,0,61,61
166658,2019-10-22 00:00:00+03:00,out,False,890406,True,1,0,44,44
166658,2019-10-22 00:00:00+03:00,in,False,890404,False,8,1912,1972,60
166658,2019-10-22 00:00:00+03:00,out,False,891170,False,4,569,616,47
166658,2019-10-22 00:00:00+03:00,out,False,890402,True,3,0,91,91
166658,2019-10-22 00:00:00+03:00,out,False,891166,True,1,0,56,56
166658,2019-10-22 00:00:00+03:00,in,False,890406,False,7,1574,1623,49
166658,2019-10-22 00:00:00+03:00,out,False,891154,False,2,1112,1150,38
166658,2019-10-22 00:00:00+03:00,out,False,890422,False,1,369,384,15
166658,2019-10-22 00:00:00+03:00,out,False,890406,True,1,0,44,44
166658,2019-10-22 00:00:00+03:00,in,False,890404,False,8,1912,1972,60
166658,2019-10-23 00:00:00+03:00,out,False,890416,False,18,3704,3970,266
166658,2019-10-23 00:00:00+03:00,out,False,891152,False,2,393,411,18
166658,2019-10-23 00:00:00+03:00,out,False,890404,False,8,3476,3594,118
166658,2019-10-23 00:00:00+03:00,out,False,890406,True,6,0,220,220
166658,2019-10-23 00:00:00+03:00,out,False,890410,False,4,675,774,99
166658,2019-10-23 00:00:00+03:00,out,False,890422,False,3,146,242,96
166658,2019-10-23 00:00:00+03:00,out,False,890420,False,22,3301,3608,307
166658,2019-10-23 00:00:00+03:00,out,False,891154,False,2,2012,2039,27
166658,2019-10-23 00:00:00+03:00,in,False,890406,False,8,1174,1261,87
166658,2019-10-23 00:00:00+03:00,out,False,890402,False,9,3486,3599,113
166658,2019-10-23 00:00:00+03:00,out,False,891170,False,2,442,467,25
166658,2019-10-23 00:00:00+03:00,out,False,891166,False,4,1853,1915,62
166658,2019-10-23 00:00:00+03:00,out,False,890416,True,8,0,232,232
166658,2019-10-23 00:00:00+03:00,out,False,891158,False,2,1847,1876,29
166658,2019-10-23 00:00:00+03:00,out,False,890420,True,10,0,215,215
166658,2019-10-23 00:00:00+03:00,out,False,890412,True,2,0,38,38
166658,2019-10-23 00:00:00+03:00,in,False,-1,True,8,0,5,5
166658,2019-10-23 00:00:00+03:00,out,False,891152,True,4,0,149,149
166658,2019-10-23 00:00:00+03:00,in,False,890402,False,2,1684,1703,19
166658,2019-10-23 00:00:00+03:00,out,False,890402,True,2,0,18,18
166658,2019-10-23 00:00:00+03:00,out,False,890406,False,21,3259,3558,299
166658,2019-10-23 00:00:00+03:00,out,False,891158,True,1,0,20,20
166658,2019-10-23 00:00:00+03:00,out,False,890404,True,2,0,70,70
166658,2019-10-23 00:00:00+03:00,out,False,890410,True,18,0,468,468
166658,2019-10-23 00:00:00+03:00,out,False,890412,False,5,5382,5418,36
166658,2019-10-23 00:00:00+03:00,in,False,890404,False,9,1381,1451,70
166658,2019-10-23 00:00:00+03:00,out,False,890402,False,9,3486,3599,113
166658,2019-10-23 00:00:00+03:00,out,False,890420,True,10,0,215,215
166658,2019-10-23 00:00:00+03:00,out,False,890406,True,6,0,220,220
166658,2019-10-23 00:00:00+03:00,out,False,891152,False,2,393,411,18
166658,2019-10-23 00:00:00+03:00,out,False,890412,True,2,0,38,38
166658,2019-10-23 00:00:00+03:00,out,False,890412,False,5,5382,5418,36
166658,2019-10-23 00:00:00+03:00,out,False,890402,True,2,0,18,18
166658,2019-10-23 00:00:00+03:00,out,False,890404,False,8,3476,3594,118
166658,2019-10-24 00:00:00+03:00,out,False,891160,False,1,871,891,20
166658,2019-10-24 00:00:00+03:00,in,False,890406,False,6,1868,1911,43
166658,2019-10-24 00:00:00+03:00,out,False,890410,False,11,3424,3543,119
166658,2019-10-24 00:00:00+03:00,out,False,891160,True,1,0,4,4
166658,2019-10-24 00:00:00+03:00,out,False,891166,False,2,657,673,16
166658,2019-10-24 00:00:00+03:00,out,False,890410,True,12,0,287,287
166658,2019-10-24 00:00:00+03:00,out,False,890404,True,5,0,138,138
166658,2019-10-24 00:00:00+03:00,out,False,891158,False,6,2557,2654,97
166658,2019-10-24 00:00:00+03:00,out,False,890404,False,7,1156,1255,99
166658,2019-10-24 00:00:00+03:00,out,False,890412,False,25,2370,2702,332
166658,2019-10-24 00:00:00+03:00,out,False,891152,True,1,0,41,41
166658,2019-10-24 00:00:00+03:00,in,False,890404,False,5,1185,1241,56
166658,2019-10-24 00:00:00+03:00,out,False,890416,False,1,16,39,23
166658,2019-10-24 00:00:00+03:00,out,False,891154,True,2,0,102,102
166658,2019-10-24 00:00:00+03:00,in,False,-1,True,12,0,10,10
166658,2019-10-24 00:00:00+03:00,out,False,891158,True,3,0,86,86
166658,2019-10-24 00:00:00+03:00,out,False,890406,False,6,1584,1669,85
166658,2019-10-24 00:00:00+03:00,out,False,890402,True,8,0,203,203
166658,2019-10-24 00:00:00+03:00,out,False,891152,False,3,890,954,64
166658,2019-10-24 00:00:00+03:00,out,False,890402,False,10,2359,2470,111
166658,2019-10-24 00:00:00+03:00,out,False,891154,False,1,38,53,15
166658,2019-10-24 00:00:00+03:00,out,False,890412,True,7,0,189,189
166658,2019-10-24 00:00:00+03:00,in,False,890402,False,10,1894,1956,62
166658,2019-10-24 00:00:00+03:00,out,False,891152,True,1,0,41,41
166658,2019-10-25 00:00:00+03:00,out,False,891154,True,17,0,416,416
166658,2019-10-25 00:00:00+03:00,out,False,890416,True,1,0,12,12
166658,2019-10-25 00:00:00+03:00,out,False,891162,True,2,0,86,86
166658,2019-10-25 00:00:00+03:00,out,False,890402,False,12,2543,2707,164
166658,2019-10-25 00:00:00+03:00,out,False,890406,False,5,451,526,75
166658,2019-10-25 00:00:00+03:00,out,False,890404,False,10,1093,1209,116
166658,2019-10-25 00:00:00+03:00,out,False,891152,True,2,0,23,23
166658,2019-10-25 00:00:00+03:00,in,False,890404,False,3,1650,1672,22
166658,2019-10-25 00:00:00+03:00,out,False,890412,False,4,999,1059,60
166658,2019-10-25 00:00:00+03:00,out,False,891154,False,29,5718,6094,376
166658,2019-10-25 00:00:00+03:00,out,False,890404,True,1,0,6,6
166658,2019-10-25 00:00:00+03:00,out,False,890410,True,3,0,42,42
166658,2019-10-25 00:00:00+03:00,in,False,890406,False,7,1250,1334,84
166658,2019-10-25 00:00:00+03:00,out,False,891160,True,14,0,473,473
166658,2019-10-25 00:00:00+03:00,out,False,891160,False,6,112,234,122
166658,2019-10-25 00:00:00+03:00,out,False,891166,True,1,0,44,44
166658,2019-10-25 00:00:00+03:00,in,False,890402,False,6,1665,1717,52
166658,2019-10-25 00:00:00+03:00,out,False,891166,False,4,3355,3398,43
166658,2019-10-25 00:00:00+03:00,out,False,891162,False,22,1263,1580,317
166658,2019-10-25 00:00:00+03:00,out,False,891158,False,3,2941,2985,44
166658,2019-10-25 00:00:00+03:00,out,False,891152,False,3,2637,2664,27
166658,2019-10-25 00:00:00+03:00,out,False,891158,True,1,0,2,2
166658,2019-10-25 00:00:00+03:00,out,False,891170,True,1,0,8,8
166658,2019-10-25 00:00:00+03:00,out,False,890416,False,2,1582,1610,28
166658,2019-10-25 00:00:00+03:00,out,False,890402,True,10,0,230,230
166658,2019-10-25 00:00:00+03:00,out,False,891170,False,1,157,169,12
166658,2019-10-25 00:00:00+03:00,out,False,890410,False,9,5684,5776,92
166658,2019-10-25 00:00:00+03:00,out,False,890410,False,9,5684,5776,92
166658,2019-10-25 00:00:00+03:00,out,False,891152,True,2,0,23,23
166658,2019-10-26 00:00:00+03:00,in,False,-1,True,6,0,2,2
166658,2019-10-27 00:00:00+03:00,out,False,891162,False,1,6,44,38
166658,2019-10-27 00:00:00+03:00,in,False,-1,True,2,0,1,1
166658,2019-10-28 00:00:00+03:00,out,False,891160,False,1,331,356,25
166658,2019-10-28 00:00:00+03:00,out,False,890410,False,8,3121,3232,111
166658,2019-10-28 00:00:00+03:00,out,False,891156,True,1,0,39,39
166658,2019-10-28 00:00:00+03:00,out,False,890410,True,5,0,99,99
166658,2019-10-28 00:00:00+03:00,out,False,890406,True,9,0,130,130
166658,2019-10-28 00:00:00+03:00,out,False,890416,True,13,0,513,513
166658,2019-10-28 00:00:00+03:00,out,False,890402,False,12,7396,7601,205
166658,2019-10-28 00:00:00+03:00,in,False,-1,True,3,0,1,1
166658,2019-10-28 00:00:00+03:00,in,False,890404,False,11,938,1048,110
166658,2019-10-28 00:00:00+03:00,out,False,890402,True,10,0,127,127
166658,2019-10-28 00:00:00+03:00,in,False,890406,False,5,1503,1535,32
166658,2019-10-28 00:00:00+03:00,out,False,890404,False,16,4691,4855,164
166658,2019-10-28 00:00:00+03:00,out,False,890412,True,22,0,600,600
166658,2019-10-28 00:00:00+03:00,out,False,890406,False,12,1547,1698,151
166658,2019-10-28 00:00:00+03:00,out,False,891154,False,5,2497,2561,64
166658,2019-10-28 00:00:00+03:00,out,False,890412,False,38,1585,2141,556
166658,2019-10-28 00:00:00+03:00,out,False,890404,True,1,0,37,37
166658,2019-10-28 00:00:00+03:00,out,False,891170,False,1,332,335,3
166658,2019-10-28 00:00:00+03:00,out,False,891156,False,1,709,717,8
166658,2019-10-28 00:00:00+03:00,out,False,890416,False,35,2498,3120,622
166658,2019-10-28 00:00:00+03:00,in,False,890402,False,6,1493,1531,38
166658,2019-10-28 00:00:00+03:00,out,False,891162,True,1,0,8,8
166658,2019-10-28 00:00:00+03:00,out,False,891158,False,2,1163,1179,16
166658,2019-10-28 00:00:00+03:00,out,False,891158,True,1,0,36,36
166658,2019-10-28 00:00:00+03:00,out,False,891166,False,2,534,556,22
166658,2019-10-28 00:00:00+03:00,out,False,890412,False,38,1585,2141,556
166658,2019-10-28 00:00:00+03:00,out,False,891156,True,1,0,39,39
166658,2019-10-28 00:00:00+03:00,out,False,890412,True,22,0,600,600
166658,2019-10-28 00:00:00+03:00,in,False,890406,False,5,1503,1535,32
166658,2019-10-29 00:00:00+03:00,out,False,890406,False,7,1116,1257,141
166658,2019-10-29 00:00:00+03:00,out,False,891156,False,3,1545,1582,37
166658,2019-10-29 00:00:00+03:00,out,False,891152,False,2,91,103,12
166658,2019-10-29 00:00:00+03:00,out,False,890404,True,9,0,239,239
166658,2019-10-29 00:00:00+03:00,out,False,891154,True,5,0,95,95
166658,2019-10-29 00:00:00+03:00,out,False,890416,True,11,0,289,289
166658,2019-10-29 00:00:00+03:00,out,False,890406,True,10,0,183,183
166658,2019-10-29 00:00:00+03:00,out,False,890404,False,12,1254,1445,191
166658,2019-10-29 00:00:00+03:00,out,False,890402,False,17,4977,5222,245
166658,2019-10-29 00:00:00+03:00,in,False,890402,False,9,2605,2686,81
166658,2019-10-29 00:00:00+03:00,out,False,890402,True,7,0,229,229
166658,2019-10-29 00:00:00+03:00,out,False,891166,True,2,0,88,88
166658,2019-10-29 00:00:00+03:00,out,False,891170,True,1,0,42,42
166658,2019-10-29 00:00:00+03:00,in,False,890404,False,12,1715,1832,117
166658,2019-10-29 00:00:00+03:00,out,False,890410,False,9,2631,2722,91
166658,2019-10-29 00:00:00+03:00,out,False,891166,False,1,7,23,16
166658,2019-10-29 00:00:00+03:00,out,False,891170,False,4,4270,4303,33
166658,2019-10-29 00:00:00+03:00,in,False,890406,False,11,1843,1946,103
166658,2019-10-29 00:00:00+03:00,out,False,891158,False,3,905,927,22
166658,2019-10-29 00:00:00+03:00,in,False,-1,True,6,0,1,1
166658,2019-10-29 00:00:00+03:00,out,False,891160,False,5,775,847,72
166658,2019-10-29 00:00:00+03:00,out,False,891160,True,4,0,48,48
166658,2019-10-29 00:00:00+03:00,out,False,890412,True,3,0,97,97
166658,2019-10-29 00:00:00+03:00,out,False,890410,True,4,0,138,138
166658,2019-10-29 00:00:00+03:00,out,False,890412,False,10,468,597,129
166658,2019-10-29 00:00:00+03:00,out,False,890416,False,14,3539,3747,208
166658,2019-10-29 00:00:00+03:00,out,False,891154,False,5,3517,3595,78
166658,2019-10-29 00:00:00+03:00,out,False,890410,True,4,0,138,138
166658,2019-10-29 00:00:00+03:00,out,False,891156,False,3,1545,1582,37
166658,2019-10-30 00:00:00+03:00,out,False,891170,True,1,0,39,39
166658,2019-10-30 00:00:00+03:00,out,False,890412,True,7,0,210,210
166658,2019-10-30 00:00:00+03:00,out,False,890404,True,1,0,2,2
166658,2019-10-30 00:00:00+03:00,out,False,891154,True,1,0,7,7
166658,2019-10-30 00:00:00+03:00,out,False,890412,False,11,2291,2419,128
166658,2019-10-30 00:00:00+03:00,out,False,891158,False,4,5354,5393,39
166658,2019-10-30 00:00:00+03:00,out,False,891152,False,3,861,895,34
166658,2019-10-30 00:00:00+03:00,out,False,890402,True,9,0,102,102
166658,2019-10-30 00:00:00+03:00,out,False,890406,False,10,4432,4599,167
166658,2019-10-30 00:00:00+03:00,out,False,890406,True,3,0,84,84
166658,2019-10-30 00:00:00+03:00,out,False,891160,False,4,1316,1352,36
166658,2019-10-30 00:00:00+03:00,out,False,891152,True,1,0,9,9
166658,2019-10-30 00:00:00+03:00,out,False,890404,False,5,1006,1055,49
166658,2019-10-30 00:00:00+03:00,in,False,890402,False,9,1347,1435,88
166658,2019-10-30 00:00:00+03:00,in,False,890406,False,7,1952,2008,56
166658,2019-10-30 00:00:00+03:00,in,False,890404,False,4,1399,1425,26
166658,2019-10-30 00:00:00+03:00,out,False,890410,False,4,1087,1142,55
166658,2019-10-30 00:00:00+03:00,out,False,890416,False,5,677,735,58
166658,2019-10-30 00:00:00+03:00,in,False,-1,True,12,0,9,9
166658,2019-10-30 00:00:00+03:00,out,False,890402,False,10,2587,2710,123
166658,2019-10-30 00:00:00+03:00,out,False,891170,False,2,1332,1356,24
166658,2019-10-31 00:00:00+03:00,out,False,890416,True,12,0,337,337
166658,2019-10-31 00:00:00+03:00,out,False,891160,True,1,0,7,7
166658,2019-10-31 00:00:00+03:00,out,False,891154,False,2,2908,2935,27
166658,2019-10-31 00:00:00+03:00,out,False,891166,False,1,1942,1950,8
166658,2019-10-31 00:00:00+03:00,out,False,890404,False,16,7114,7340,226
166658,2019-10-31 00:00:00+03:00,out,False,890410,False,19,6884,7157,273
166658,2019-10-31 00:00:00+03:00,out,False,890402,True,4,0,93,93
166658,2019-10-31 00:00:00+03:00,out,False,891152,False,2,1029,1041,12
166658,2019-10-31 00:00:00+03:00,out,False,891162,True,2,0,37,37
166658,2019-10-31 00:00:00+03:00,out,False,890412,False,1,59,69,10
166658,2019-10-31 00:00:00+03:00,out,False,890404,True,21,0,388,388
166658,2019-10-31 00:00:00+03:00,in,False,890404,False,6,917,979,62
166658,2019-10-31 00:00:00+03:00,out,False,890410,True,5,0,85,85
166658,2019-10-31 00:00:00+03:00,out,False,891158,True,2,0,53,53
166658,2019-10-31 00:00:00+03:00,out,False,890402,False,9,2932,3028,96
166658,2019-10-31 00:00:00+03:00,in,False,-1,True,8,0,2,2
166658,2019-10-31 00:00:00+03:00,out,False,890406,False,8,2884,3009,125
166658,2019-10-31 00:00:00+03:00,in,False,890402,False,7,1388,1439,51
166658,2019-10-31 00:00:00+03:00,out,False,891158,False,3,2971,3002,31
166658,2019-10-31 00:00:00+03:00,out,False,890406,True,4,0,99,99
166658,2019-10-31 00:00:00+03:00,in,False,890406,False,7,1808,1856,48
166658,2019-10-31 00:00:00+03:00,out,False,890416,False,18,850,1135,285
166658,2019-10-31 00:00:00+03:00,out,False,891162,False,1,25,35,10
166658,2019-10-31 00:00:00+03:00,out,False,891160,False,1,56,68,12
166658,2019-10-31 00:00:00+03:00,out,False,890416,False,18,850,1135,285
166658,2019-10-31 00:00:00+03:00,in,False,-1,True,8,0,2,2
166658,2019-10-31 00:00:00+03:00,out,False,890406,True,4,0,99,99
166658,2019-11-01 00:00:00+03:00,in,False,-1,True,5,0,37,37
166658,2019-11-01 00:00:00+03:00,in,False,890402,False,4,810,840,30
166658,2019-11-01 00:00:00+03:00,out,False,890412,False,3,1991,2019,28
166658,2019-11-01 00:00:00+03:00,out,False,890416,False,1,398,408,10
166658,2019-11-01 00:00:00+03:00,out,False,890402,True,7,0,134,134
166658,2019-11-01 00:00:00+03:00,in,False,890404,False,3,783,810,27
166658,2019-11-01 00:00:00+03:00,out,False,890412,True,3,0,58,58
166658,2019-11-01 00:00:00+03:00,out,False,891152,True,4,0,138,138
166658,2019-11-01 00:00:00+03:00,out,False,891154,False,3,3949,3979,30
166658,2019-11-01 00:00:00+03:00,out,False,891158,False,1,783,793,10
166658,2019-11-01 00:00:00+03:00,out,False,890404,False,8,563,749,186
166658,2019-11-01 00:00:00+03:00,out,False,890410,True,3,0,91,91
166658,2019-11-01 00:00:00+03:00,out,False,890402,False,17,1114,1443,329
166658,2019-11-01 00:00:00+03:00,in,False,890406,False,5,848,882,34
166658,2019-11-01 00:00:00+03:00,out,False,890404,True,7,0,190,190
166658,2019-11-01 00:00:00+03:00,out,False,890406,True,1,0,4,4
166658,2019-11-01 00:00:00+03:00,out,False,891152,False,4,4885,4932,47
166658,2019-11-01 00:00:00+03:00,out,False,890406,False,12,1588,1753,165
166658,2019-11-01 00:00:00+03:00,out,False,890410,False,13,4331,4492,161
166658,2019-11-01 00:00:00+03:00,out,False,891154,True,1,0,6,6
166658,2019-11-01 00:00:00+03:00,out,False,890416,True,2,0,73,73
166658,2019-11-01 00:00:00+03:00,out,False,890406,False,12,1588,1753,165
166658,2019-11-01 00:00:00+03:00,out,False,890410,False,13,4331,4492,161
166658,2019-11-01 00:00:00+03:00,out,False,890416,False,1,398,408,10
166658,2019-11-01 00:00:00+03:00,out,False,890410,True,3,0,91,91
166658,2019-11-02 00:00:00+03:00,in,False,-1,True,2,0,0,0
166658,2019-11-03 00:00:00+03:00,out,False,890402,True,3,0,23,23
166658,2019-11-03 00:00:00+03:00,out,False,891160,True,1,0,14,14
166658,2019-11-03 00:00:00+03:00,in,False,-1,True,4,0,1,1
166658,2019-11-03 00:00:00+03:00,out,False,890402,False,1,249,256,7
166658,2019-11-03 00:00:00+03:00,out,False,891162,True,2,0,31,31
166658,2019-11-03 00:00:00+03:00,out,False,891170,True,1,0,16,16
166658,2019-11-04 00:00:00+03:00,in,False,890402,False,1,433,448,15
166658,2019-11-04 00:00:00+03:00,in,False,-1,True,1,0,60,60
166658,2019-11-05 00:00:00+03:00,out,False,890412,False,19,4408,4648,240
166658,2019-11-05 00:00:00+03:00,out,True,890410,True,1,0,0,0
166658,2019-11-05 00:00:00+03:00,out,False,890416,False,7,1588,1668,80
166658,2019-11-05 00:00:00+03:00,out,False,890412,True,13,0,305,305
166658,2019-11-05 00:00:00+03:00,in,False,890406,False,10,1280,1354,74
166658,2019-11-05 00:00:00+03:00,out,False,890404,False,12,1464,1631,167
166658,2019-11-05 00:00:00+03:00,out,False,890416,True,3,0,109,109
166658,2019-11-05 00:00:00+03:00,out,False,891160,False,26,2524,2890,366
166658,2019-11-05 00:00:00+03:00,in,False,890404,False,5,1658,1694,36
166658,2019-11-05 00:00:00+03:00,out,False,890406,False,7,3669,3748,79
166658,2019-11-05 00:00:00+03:00,out,False,890402,False,6,578,641,63
166658,2019-11-05 00:00:00+03:00,out,False,891160,True,2,0,14,14
166658,2019-11-05 00:00:00+03:00,out,False,890406,True,6,0,204,204
166658,2019-11-05 00:00:00+03:00,out,False,890404,True,8,0,134,134
166658,2019-11-05 00:00:00+03:00,out,False,890410,False,11,4208,4365,157
166658,2019-11-05 00:00:00+03:00,out,False,891152,False,3,1391,1450,59
166658,2019-11-05 00:00:00+03:00,out,False,891154,False,2,3561,3586,25
166658,2019-11-05 00:00:00+03:00,out,False,890402,True,4,0,14,14
166658,2019-11-05 00:00:00+03:00,in,False,890402,False,5,1391,1428,37
166658,2019-11-05 00:00:00+03:00,out,False,890410,True,10,0,262,262
166658,2019-11-05 00:00:00+03:00,out,False,891158,False,1,63,64,1
166658,2019-11-05 00:00:00+03:00,in,False,-1,True,4,0,1,1
166658,2019-11-05 00:00:00+03:00,out,False,891156,True,1,0,13,13
166658,2019-11-05 00:00:00+03:00,out,False,891156,False,4,824,916,92
166658,2019-11-05 00:00:00+03:00,out,False,891152,True,1,0,17,17
166658,2019-11-05 00:00:00+03:00,out,False,891160,False,26,2524,2890,366
166658,2019-11-05 00:00:00+03:00,out,False,890416,True,3,0,109,109
166658,2019-11-06 00:00:00+03:00,out,False,890402,True,1,0,2,2
166658,2019-11-06 00:00:00+03:00,out,False,890404,True,3,0,90,90
166658,2019-11-06 00:00:00+03:00,in,False,890406,False,12,1597,1698,101
166658,2019-11-06 00:00:00+03:00,out,False,890416,False,18,1040,1307,267
166658,2019-11-06 00:00:00+03:00,out,False,890412,True,5,0,150,150
166658,2019-11-06 00:00:00+03:00,out,False,891154,True,1,0,21,21
166658,2019-11-06 00:00:00+03:00,out,False,891158,False,1,1559,1560,1
166658,2019-11-06 00:00:00+03:00,in,False,890402,False,8,1377,1444,67
166658,2019-11-06 00:00:00+03:00,out,False,890404,False,12,3443,3567,124
166658,2019-11-06 00:00:00+03:00,out,False,891160,False,50,4091,4871,780
166658,2019-11-06 00:00:00+03:00,out,False,891160,True,15,0,652,652
166658,2019-11-06 00:00:00+03:00,out,False,890410,True,22,0,572,572
166658,2019-11-06 00:00:00+03:00,out,False,890402,False,11,5060,5160,100
166658,2019-11-06 00:00:00+03:00,in,False,890404,False,15,1310,1435,125
166658,2019-11-06 00:00:00+03:00,in,False,-1,True,12,0,74,74
166658,2019-11-06 00:00:00+03:00,out,False,890406,True,15,0,264,264
166658,2019-11-06 00:00:00+03:00,out,False,890410,False,26,3202,3619,417
166658,2019-11-06 00:00:00+03:00,out,False,890416,True,10,0,298,298
166658,2019-11-06 00:00:00+03:00,in,False,-1,True,1,0,4,4
166658,2019-11-06 00:00:00+03:00,out,False,890412,False,8,8742,8824,82
166658,2019-11-06 00:00:00+03:00,out,True,890410,False,1,0,0,0
166658,2019-11-06 00:00:00+03:00,out,False,891154,False,2,3484,3501,17
166658,2019-11-06 00:00:00+03:00,out,False,890406,False,14,3409,3592,183
166658,2019-11-06 00:00:00+03:00,in,False,-1,True,12,0,74,74
166658,2019-11-07 00:00:00+03:00,in,False,890406,False,6,2896,2927,31
166658,2019-11-07 00:00:00+03:00,out,False,890404,False,8,3079,3179,100
166658,2019-11-07 00:00:00+03:00,out,False,891156,True,2,0,33,33
166658,2019-11-07 00:00:00+03:00,out,False,890412,True,10,0,322,322
166658,2019-11-07 00:00:00+03:00,out,False,891154,False,5,3428,3530,102
166658,2019-11-07 00:00:00+03:00,out,False,891158,True,3,0,37,37
166658,2019-11-07 00:00:00+03:00,out,False,891156,False,1,211,221,10
166658,2019-11-07 00:00:00+03:00,in,False,-1,True,5,0,34,34
166658,2019-11-07 00:00:00+03:00,out,False,891160,True,5,0,74,74
166658,2019-11-07 00:00:00+03:00,in,False,890404,False,10,1724,1799,75
166658,2019-11-07 00:00:00+03:00,out,False,890416,False,27,3429,3835,406
166658,2019-11-07 00:00:00+03:00,out,False,890410,True,8,0,272,272
166658,2019-11-07 00:00:00+03:00,out,False,890404,True,11,0,305,305
166658,2019-11-07 00:00:00+03:00,out,False,891158,False,2,459,470,11
166658,2019-11-07 00:00:00+03:00,out,False,890406,True,2,0,69,69
166658,2019-11-07 00:00:00+03:00,in,False,890402,False,5,1901,1956,55
166658,2019-11-07 00:00:00+03:00,out,False,891160,False,18,1409,1688,279
166658,2019-11-07 00:00:00+03:00,out,False,890416,True,13,0,256,256
166658,2019-11-07 00:00:00+03:00,out,False,891154,True,1,0,44,44
166658,2019-11-07 00:00:00+03:00,out,False,890412,False,14,1082,1213,131
166658,2019-11-07 00:00:00+03:00,out,False,890406,False,15,3726,3907,181
166658,2019-11-07 00:00:00+03:00,out,False,890402,True,12,0,212,212
166658,2019-11-07 00:00:00+03:00,out,False,890402,False,24,2840,3195,355
166658,2019-11-07 00:00:00+03:00,out,False,891166,True,2,0,31,31
166658,2019-11-07 00:00:00+03:00,out,False,890410,False,17,1686,1966,280
166658,2019-11-07 00:00:00+03:00,out,False,891166,False,5,199,253,54
166658,2019-11-07 00:00:00+03:00,out,False,891152,True,1,0,55,55
166658,2019-11-07 00:00:00+03:00,out,False,890416,True,13,0,256,256
166658,2019-11-07 00:00:00+03:00,out,False,890410,False,17,1686,1966,280
166658,2019-11-07 00:00:00+03:00,in,False,-1,True,5,0,34,34
166658,2019-11-07 00:00:00+03:00,out,False,891158,True,3,0,37,37
166658,2019-11-07 00:00:00+03:00,out,False,891156,False,1,211,221,10
166658,2019-11-07 00:00:00+03:00,out,False,890412,False,14,1082,1213,131
166658,2019-11-07 00:00:00+03:00,out,False,890406,False,15,3726,3907,181
166658,2019-11-08 00:00:00+03:00,out,False,891154,False,4,3997,4042,45
166658,2019-11-08 00:00:00+03:00,out,False,890404,False,13,2616,2845,229
166658,2019-11-08 00:00:00+03:00,out,False,890416,True,10,0,92,92
166658,2019-11-08 00:00:00+03:00,out,False,890402,True,2,0,9,9
166658,2019-11-08 00:00:00+03:00,out,False,890410,False,5,1932,1998,66
166658,2019-11-08 00:00:00+03:00,in,False,890406,False,8,2159,2248,89
166658,2019-11-08 00:00:00+03:00,out,False,891154,True,1,0,8,8
166658,2019-11-08 00:00:00+03:00,in,False,890402,False,11,3200,3306,106
166658,2019-11-08 00:00:00+03:00,out,False,891160,False,14,1068,1278,210
166658,2019-11-08 00:00:00+03:00,out,False,890412,False,5,5365,5436,71
166658,2019-11-08 00:00:00+03:00,out,False,890402,False,8,7746,7867,121
166658,2019-11-08 00:00:00+03:00,out,False,890410,True,3,0,9,9
166658,2019-11-08 00:00:00+03:00,out,False,890406,False,8,3111,3194,83
166658,2019-11-08 00:00:00+03:00,out,False,891160,True,8,0,326,326
166658,2019-11-08 00:00:00+03:00,in,False,-1,True,2,0,24,24
166658,2019-11-08 00:00:00+03:00,out,False,890416,False,12,5708,5854,146
166658,2019-11-08 00:00:00+03:00,out,False,890406,True,7,0,148,148
166658,2019-11-08 00:00:00+03:00,out,False,890404,True,7,0,132,132
166658,2019-11-08 00:00:00+03:00,out,False,891166,False,1,733,744,11
166658,2019-11-08 00:00:00+03:00,out,False,891166,True,1,0,45,45
166658,2019-11-08 00:00:00+03:00,out,True,890406,True,1,0,0,0
166658,2019-11-08 00:00:00+03:00,in,False,890404,False,14,2218,2313,95
166658,2019-11-08 00:00:00+03:00,out,False,891154,True,1,0,8,8
166658,2019-11-08 00:00:00+03:00,out,True,890406,True,1,0,0,0
166658,2019-11-08 00:00:00+03:00,out,False,891160,False,14,1068,1278,210
166658,2019-11-09 00:00:00+03:00,in,False,-1,True,1,0,1,1
166658,2019-11-10 00:00:00+03:00,out,False,890416,False,11,248,556,308
166658,2019-11-10 00:00:00+03:00,out,True,890404,True,1,0,0,0
166658,2019-11-10 00:00:00+03:00,out,False,890416,True,12,0,452,452
166658,2019-11-10 00:00:00+03:00,out,False,890404,True,4,0,92,92
166658,2019-11-10 00:00:00+03:00,out,False,890404,False,7,291,426,135
166658,2019-11-10 00:00:00+03:00,in,False,-1,True,3,0,2,2
166658,2019-11-11 00:00:00+03:00,in,False,890404,False,6,1892,1953,61
166658,2019-11-11 00:00:00+03:00,out,False,891160,False,27,2024,2503,479
166658,2019-11-11 00:00:00+03:00,out,False,890402,False,17,2368,2578,210
166658,2019-11-11 00:00:00+03:00,out,False,890416,False,11,8241,8370,129
166658,2019-11-11 00:00:00+03:00,out,False,891166,False,3,312,367,55
166658,2019-11-11 00:00:00+03:00,out,False,891158,False,1,798,802,4
166658,2019-11-11 00:00:00+03:00,in,False,-1,True,8,0,4,4
166658,2019-11-11 00:00:00+03:00,out,False,890406,True,10,0,178,178
166658,2019-11-11 00:00:00+03:00,out,False,890412,False,16,5076,5266,190
166658,2019-11-11 00:00:00+03:00,out,False,891162,True,1,0,1,1
166658,2019-11-11 00:00:00+03:00,out,False,891162,False,1,44,52,8
166658,2019-11-11 00:00:00+03:00,out,False,891154,False,7,6636,6716,80
166658,2019-11-11 00:00:00+03:00,in,False,890406,False,7,1826,1871,45
166658,2019-11-11 00:00:00+03:00,out,False,890404,True,10,0,273,273
166658,2019-11-11 00:00:00+03:00,in,False,890402,False,13,2330,2414,84
166658,2019-11-11 00:00:00+03:00,out,False,890416,True,8,0,129,129
166658,2019-11-11 00:00:00+03:00,out,False,890404,False,15,1511,1734,223
166658,2019-11-11 00:00:00+03:00,out,False,890412,True,9,0,155,155
166658,2019-11-11 00:00:00+03:00,out,False,891160,True,11,0,165,165
166658,2019-11-11 00:00:00+03:00,out,False,891154,True,5,0,52,52
166658,2019-11-11 00:00:00+03:00,out,False,890406,False,11,4289,4414,125
166658,2019-11-11 00:00:00+03:00,out,False,890402,True,5,0,129,129
166658,2019-11-11 00:00:00+03:00,in,False,890406,False,7,1826,1871,45
166658,2019-11-11 00:00:00+03:00,out,False,891158,False,1,798,802,4
166658,2019-11-11 00:00:00+03:00,out,False,890402,False,17,2368,2578,210
166658,2019-11-12 00:00:00+03:00,out,False,890406,False,16,3851,4053,202
166658,2019-11-12 00:00:00+03:00,out,False,890412,False,18,7309,7554,245
166658,2019-11-12 00:00:00+03:00,out,False,891162,False,4,692,730,38
166658,2019-11-12 00:00:00+03:00,out,False,890402,True,7,0,232,232
166658,2019-11-12 00:00:00+03:00,out,False,890416,False,3,2122,2151,29
166658,2019-11-12 00:00:00+03:00,out,False,891162,True,2,0,84,84
166658,2019-11-12 00:00:00+03:00,in,False,890406,False,9,2068,2131,63
166658,2019-11-12 00:00:00+03:00,out,False,891170,True,4,0,53,53
166658,2019-11-12 00:00:00+03:00,out,False,891166,True,1,0,0,0
166658,2019-11-12 00:00:00+03:00,in,False,-1,True,2,0,18,18
166658,2019-11-12 00:00:00+03:00,out,False,890406,True,4,0,53,53
166658,2019-11-12 00:00:00+03:00,out,False,891160,False,11,1055,1240,185
166658,2019-11-12 00:00:00+03:00,in,False,890402,False,7,1664,1723,59
166658,2019-11-12 00:00:00+03:00,out,False,891170,False,7,1423,1471,48
166658,2019-11-12 00:00:00+03:00,out,False,890404,True,5,0,102,102
166658,2019-11-12 00:00:00+03:00,out,False,890402,False,15,3655,3914,259
166658,2019-11-12 00:00:00+03:00,in,False,890404,False,12,1997,2070,73
166658,2019-11-12 00:00:00+03:00,out,False,890404,False,18,5547,5760,213
166658,2019-11-12 00:00:00+03:00,out,False,891154,False,8,9739,9831,92
166658,2019-11-12 00:00:00+03:00,out,False,890416,True,3,0,109,109
166658,2019-11-12 00:00:00+03:00,out,False,891166,False,8,1708,1777,69
166658,2019-11-12 00:00:00+03:00,out,False,891158,False,3,254,312,58
166658,2019-11-12 00:00:00+03:00,out,False,890412,True,3,0,58,58
166658,2019-11-12 00:00:00+03:00,out,False,891160,True,8,0,344,344
166658,2019-11-12 00:00:00+03:00,out,False,890404,False,18,5547,5760,213
166658,2019-11-12 00:00:00+03:00,in,False,-1,True,2,0,18,18
166658,2019-11-12 00:00:00+03:00,in,False,890404,False,12,1997,2070,73
166658,2019-11-12 00:00:00+03:00,out,False,891166,True,1,0,0,0
166658,2019-11-13 00:00:00+03:00,out,False,890410,True,3,0,9,9
166658,2019-11-13 00:00:00+03:00,out,False,891154,False,8,2078,2204,126
166658,2019-11-13 00:00:00+03:00,out,False,890416,False,11,8431,8566,135
166658,2019-11-13 00:00:00+03:00,out,False,890404,True,3,0,20,20
166658,2019-11-13 00:00:00+03:00,in,False,890406,False,9,2252,2309,57
166658,2019-11-13 00:00:00+03:00,out,False,890404,False,10,3020,3115,95
166658,2019-11-13 00:00:00+03:00,out,False,891166,True,2,0,47,47
166658,2019-11-13 00:00:00+03:00,out,False,890402,False,10,3346,3458,112
166658,2019-11-13 00:00:00+03:00,out,False,890406,False,8,1856,1979,123
166658,2019-11-13 00:00:00+03:00,out,False,890402,True,3,0,45,45
166658,2019-11-13 00:00:00+03:00,out,False,891170,True,1,0,60,60
166658,2019-11-13 00:00:00+03:00,out,False,891170,False,3,729,765,36
166658,2019-11-13 00:00:00+03:00,out,False,891154,True,1,0,19,19
166658,2019-11-13 00:00:00+03:00,in,False,-1,True,5,0,2,2
166658,2019-11-13 00:00:00+03:00,out,False,891160,True,6,0,191,191
166658,2019-11-13 00:00:00+03:00,out,False,891158,True,1,0,20,20
166658,2019-11-13 00:00:00+03:00,out,False,890406,True,6,0,161,161
166658,2019-11-13 00:00:00+03:00,out,False,890416,True,5,0,116,116
166658,2019-11-13 00:00:00+03:00,out,False,890412,False,4,321,383,62
166658,2019-11-13 00:00:00+03:00,in,False,890404,False,5,2297,2323,26
166658,2019-11-13 00:00:00+03:00,out,False,891166,False,1,137,165,28
166658,2019-11-13 00:00:00+03:00,out,False,890410,False,7,3206,3286,80
166658,2019-11-13 00:00:00+03:00,out,False,891160,False,9,1379,1505,126
166658,2019-11-13 00:00:00+03:00,in,False,890402,False,7,2068,2136,68
166658,2019-11-13 00:00:00+03:00,out,False,890412,True,3,0,29,29
166658,2019-11-14 00:00:00+03:00,out,False,891154,True,1,0,20,20
166658,2019-11-14 00:00:00+03:00,in,False,-1,True,2,0,0,0
166658,2019-11-14 00:00:00+03:00,out,False,890402,True,2,0,37,37
166658,2019-11-14 00:00:00+03:00,in,False,890402,False,3,735,756,21
166658,2019-11-14 00:00:00+03:00,out,False,891166,False,2,339,358,19
166658,2019-11-14 00:00:00+03:00,out,False,890412,False,5,3095,3161,66
166658,2019-11-14 00:00:00+03:00,out,False,890416,False,6,7493,7558,65
166658,2019-11-14 00:00:00+03:00,out,False,890406,True,4,0,127,127
166658,2019-11-14 00:00:00+03:00,out,False,890406,False,12,2664,2818,154
166658,2019-11-14 00:00:00+03:00,out,False,890416,True,5,0,49,49
166658,2019-11-14 00:00:00+03:00,in,False,890404,False,6,391,436,45
166658,2019-11-14 00:00:00+03:00,out,False,890404,False,12,3509,3627,118
166658,2019-11-14 00:00:00+03:00,out,False,891166,True,1,0,40,40
166658,2019-11-14 00:00:00+03:00,out,False,890410,False,12,874,1035,161
166658,2019-11-14 00:00:00+03:00,in,False,890406,False,2,816,829,13
166658,2019-11-14 00:00:00+03:00,out,False,890404,True,4,0,77,77
166658,2019-11-14 00:00:00+03:00,out,False,891154,False,2,460,503,43
166658,2019-11-14 00:00:00+03:00,out,False,891170,False,15,1167,1484,317
166658,2019-11-14 00:00:00+03:00,out,False,890402,False,8,797,874,77
166658,2019-11-14 00:00:00+03:00,out,False,891160,False,1,149,158,9
166658,2019-11-14 00:00:00+03:00,out,False,890412,True,8,0,152,152
166658,2019-11-14 00:00:00+03:00,out,False,890410,True,5,0,97,97
166658,2019-11-14 00:00:00+03:00,out,False,891170,False,15,1167,1484,317
166658,2019-11-14 00:00:00+03:00,out,False,890410,True,5,0,97,97
166658,2019-11-14 00:00:00+03:00,out,False,891154,True,1,0,20,20
166658,2019-11-15 00:00:00+03:00,in,False,890406,False,2,1450,1470,20
166658,2019-11-15 00:00:00+03:00,in,False,890404,False,8,1439,1520,81
166658,2019-11-15 00:00:00+03:00,out,False,890402,False,7,810,905,95
166658,2019-11-15 00:00:00+03:00,out,False,890412,True,2,0,78,78
166658,2019-11-15 00:00:00+03:00,out,False,891160,True,4,0,87,87
166658,2019-11-15 00:00:00+03:00,out,False,890412,False,1,176,188,12
166658,2019-11-15 00:00:00+03:00,out,False,890410,True,1,0,18,18
166658,2019-11-15 00:00:00+03:00,out,False,890402,True,4,0,107,107
166658,2019-11-15 00:00:00+03:00,out,False,890410,False,9,2760,2849,89
166658,2019-11-15 00:00:00+03:00,out,False,891158,False,2,3705,3717,12
166658,2019-11-15 00:00:00+03:00,out,False,890406,True,2,0,59,59
166658,2019-11-15 00:00:00+03:00,out,False,891166,True,5,0,105,105
166658,2019-11-15 00:00:00+03:00,out,False,890404,False,9,2371,2486,115
166658,2019-11-15 00:00:00+03:00,out,False,890404,True,11,0,235,235
166658,2019-11-15 00:00:00+03:00,out,False,891170,True,2,0,89,89
166658,2019-11-15 00:00:00+03:00,out,False,890416,True,4,0,54,54
166658,2019-11-15 00:00:00+03:00,out,False,891170,False,6,439,504,65
166658,2019-11-15 00:00:00+03:00,out,False,890416,False,10,3404,3514,110
166658,2019-11-15 00:00:00+03:00,out,False,890406,False,12,2418,2570,152
166658,2019-11-15 00:00:00+03:00,out,False,891160,False,2,79,102,23
166658,2019-11-15 00:00:00+03:00,out,True,890410,True,1,0,0,0
166658,2019-11-15 00:00:00+03:00,in,False,890402,False,9,1516,1594,78
166658,2019-11-15 00:00:00+03:00,out,False,891154,False,2,3740,3765,25
166658,2019-11-15 00:00:00+03:00,out,False,891166,False,6,1311,1373,62
166658,2019-11-15 00:00:00+03:00,in,False,-1,True,2,0,68,68
166658,2019-11-15 00:00:00+03:00,out,False,891162,False,1,695,699,4
166658,2019-11-15 00:00:00+03:00,out,False,891162,False,1,695,699,4
166658,2019-11-15 00:00:00+03:00,out,False,891166,True,5,0,105,105
166658,2019-11-15 00:00:00+03:00,out,False,891166,False,6,1311,1373,62
166658,2019-11-16 00:00:00+03:00,in,False,-1,True,16,0,11,11
166658,2019-11-18 00:00:00+03:00,out,False,891160,False,1,11,20,9
166658,2019-11-18 00:00:00+03:00,out,False,890404,True,7,0,170,170
166658,2019-11-18 00:00:00+03:00,out,False,891162,False,14,1634,1789,155
166658,2019-11-18 00:00:00+03:00,in,False,890406,False,5,1428,1456,28
166658,2019-11-18 00:00:00+03:00,in,False,890404,False,5,1340,1394,54
166658,2019-11-18 00:00:00+03:00,out,False,891152,False,21,1308,1522,214
166658,2019-11-18 00:00:00+03:00,out,False,890404,False,21,4225,4494,269
166658,2019-11-18 00:00:00+03:00,out,False,890402,False,9,1484,1607,123
166658,2019-11-18 00:00:00+03:00,out,False,891154,False,3,152,175,23
166658,2019-11-18 00:00:00+03:00,out,False,890406,True,11,0,179,179
166658,2019-11-18 00:00:00+03:00,out,False,891158,True,5,0,131,131
166658,2019-11-18 00:00:00+03:00,out,False,890406,False,8,1822,1909,87
166658,2019-11-18 00:00:00+03:00,out,False,890402,True,9,0,219,219
166658,2019-11-18 00:00:00+03:00,out,False,890416,True,10,0,283,283
166658,2019-11-18 00:00:00+03:00,out,False,891170,True,2,0,46,46
166658,2019-11-18 00:00:00+03:00,out,False,891152,True,14,0,389,389
166658,2019-11-18 00:00:00+03:00,in,False,890402,False,14,1725,1807,82
166658,2019-11-18 00:00:00+03:00,out,False,891166,False,4,479,520,41
166658,2019-11-18 00:00:00+03:00,out,False,891162,True,6,0,175,175
166658,2019-11-18 00:00:00+03:00,out,False,891166,True,1,0,27,27
166658,2019-11-18 00:00:00+03:00,out,False,891158,False,11,698,798,100
166658,2019-11-18 00:00:00+03:00,out,False,890412,True,5,0,145,145
166658,2019-11-18 00:00:00+03:00,out,False,890410,True,6,0,109,109
166658,2019-11-18 00:00:00+03:00,out,False,890410,False,14,2368,2574,206
166658,2019-11-18 00:00:00+03:00,out,False,891170,False,9,1089,1221,132
166658,2019-11-18 00:00:00+03:00,out,False,890412,False,16,2900,3086,186
166658,2019-11-18 00:00:00+03:00,out,False,890416,False,19,4933,5188,255
166658,2019-11-18 00:00:00+03:00,in,False,-1,True,10,0,18,18
166658,2019-11-18 00:00:00+03:00,out,False,891154,False,3,152,175,23
166658,2019-11-18 00:00:00+03:00,out,False,890412,False,16,2900,3086,186
166658,2019-11-18 00:00:00+03:00,out,False,891158,False,11,698,798,100
166658,2019-11-19 00:00:00+03:00,out,False,891152,True,7,0,217,217
166658,2019-11-19 00:00:00+03:00,out,False,891166,False,5,434,512,78
166658,2019-11-19 00:00:00+03:00,out,False,891154,True,2,0,79,79
166658,2019-11-19 00:00:00+03:00,out,False,890406,True,7,0,115,115
166658,2019-11-19 00:00:00+03:00,out,False,891170,True,7,0,173,173
166658,2019-11-19 00:00:00+03:00,out,False,891154,False,4,3189,3245,56
166658,2019-11-19 00:00:00+03:00,out,False,890416,False,23,2196,2518,322
166658,2019-11-19 00:00:00+03:00,in,False,890406,False,3,2669,2686,17
166658,2019-11-19 00:00:00+03:00,out,False,890406,False,22,6283,6565,282
166658,2019-11-19 00:00:00+03:00,out,False,890402,False,12,2300,2463,163
166658,2019-11-19 00:00:00+03:00,in,False,-1,True,26,0,218,218
166658,2019-11-19 00:00:00+03:00,out,False,890416,True,14,0,360,360
166658,2019-11-19 00:00:00+03:00,out,False,890404,False,17,2000,2208,208
166658,2019-11-19 00:00:00+03:00,in,False,890402,False,7,645,685,40
166658,2019-11-19 00:00:00+03:00,out,False,890404,True,11,0,308,308
166658,2019-11-19 00:00:00+03:00,out,False,891170,False,11,2335,2524,189
166658,2019-11-19 00:00:00+03:00,out,False,890412,False,36,3721,4163,442
166658,2019-11-19 00:00:00+03:00,out,False,891162,False,6,552,617,65
166658,2019-11-19 00:00:00+03:00,out,False,891156,True,1,0,12,12
166658,2019-11-19 00:00:00+03:00,out,False,891152,False,18,554,835,281
166658,2019-11-19 00:00:00+03:00,out,False,891162,True,4,0,66,66
166658,2019-11-19 00:00:00+03:00,in,False,890404,False,11,1248,1401,153
166658,2019-11-19 00:00:00+03:00,out,False,890412,True,17,0,389,389
166658,2019-11-19 00:00:00+03:00,in,False,890410,False,3,345,362,17
166658,2019-11-19 00:00:00+03:00,out,False,890402,True,11,0,322,322
166658,2019-11-19 00:00:00+03:00,out,False,890410,True,7,0,141,141
166658,2019-11-19 00:00:00+03:00,out,False,890410,False,4,1641,1682,41
166658,2019-11-19 00:00:00+03:00,out,False,891158,True,6,0,213,213
166658,2019-11-19 00:00:00+03:00,out,False,890404,True,11,0,308,308
166658,2019-11-19 00:00:00+03:00,out,False,891156,True,1,0,12,12
166658,2019-11-19 00:00:00+03:00,out,False,891162,False,6,552,617,65
166658,2019-11-19 00:00:00+03:00,in,False,890406,False,3,2669,2686,17
166658,2019-11-19 00:00:00+03:00,out,False,890406,True,7,0,115,115
166658,2019-11-20 00:00:00+03:00,in,False,890406,False,4,234,270,36
166658,2019-11-20 00:00:00+03:00,out,False,890416,False,23,3169,3509,340
166658,2019-11-20 00:00:00+03:00,out,False,891154,False,2,3865,3893,28
166658,2019-11-20 00:00:00+03:00,out,False,890412,False,9,3401,3516,115
166658,2019-11-20 00:00:00+03:00,in,False,-1,True,8,0,115,115
166658,2019-11-20 00:00:00+03:00,out,False,890402,True,3,0,47,47
166658,2019-11-20 00:00:00+03:00,out,False,890406,True,4,0,100,100
166658,2019-11-20 00:00:00+03:00,out,False,890410,True,3,0,74,74
166658,2019-11-20 00:00:00+03:00,out,False,891160,False,1,15,36,21
166658,2019-11-20 00:00:00+03:00,out,False,891166,False,2,4319,4338,19
166658,2019-11-20 00:00:00+03:00,out,False,891166,True,1,0,36,36
166658,2019-11-20 00:00:00+03:00,out,False,891170,True,3,0,69,69
166658,2019-11-20 00:00:00+03:00,out,False,890404,False,20,2198,2501,303
166658,2019-11-20 00:00:00+03:00,out,False,890410,False,13,1993,2197,204
166658,2019-11-20 00:00:00+03:00,out,False,890416,True,9,0,205,205
166658,2019-11-20 00:00:00+03:00,out,False,891170,False,13,2334,2474,140
166658,2019-11-20 00:00:00+03:00,out,False,890402,False,6,2125,2214,89
166658,2019-11-20 00:00:00+03:00,out,False,890406,False,8,2699,2813,114
166658,2019-11-20 00:00:00+03:00,in,False,890404,False,5,511,539,28
166658,2019-11-20 00:00:00+03:00,in,False,955436,False,1,120,143,23
166658,2019-11-20 00:00:00+03:00,out,False,891158,False,2,208,246,38
166658,2019-11-20 00:00:00+03:00,in,False,890406,True,1,1,13,12
166658,2019-11-20 00:00:00+03:00,out,False,890404,True,10,0,296,296
166658,2019-11-20 00:00:00+03:00,out,False,891152,False,2,2427,2458,31
166658,2019-11-20 00:00:00+03:00,out,False,890412,True,5,0,114,114
166658,2019-11-20 00:00:00+03:00,in,False,890410,False,5,1405,1442,37
166658,2019-11-20 00:00:00+03:00,out,False,891170,True,3,0,69,69
166658,2019-11-20 00:00:00+03:00,out,False,890406,False,8,2699,2813,114
166658,2019-11-20 00:00:00+03:00,out,False,891152,False,2,2427,2458,31
166658,2019-11-20 00:00:00+03:00,out,False,891160,False,1,15,36,21
166658,2019-11-21 00:00:00+03:00,out,False,891156,True,1,0,1,1
166658,2019-11-21 00:00:00+03:00,out,False,891170,True,5,0,128,128
166658,2019-11-21 00:00:00+03:00,out,False,890404,False,13,4269,4446,177
166658,2019-11-21 00:00:00+03:00,in,False,890404,False,8,2701,2776,75
166658,2019-11-21 00:00:00+03:00,in,False,890402,False,10,3603,3900,297
166658,2019-11-21 00:00:00+03:00,out,False,890404,True,6,0,180,180
166658,2019-11-21 00:00:00+03:00,out,False,890412,False,18,1394,1710,316
166658,2019-11-21 00:00:00+03:00,out,False,890406,True,12,0,333,333
166658,2019-11-21 00:00:00+03:00,out,False,891152,False,1,789,798,9
166658,2019-11-21 00:00:00+03:00,out,False,890416,True,2,0,26,26
166658,2019-11-21 00:00:00+03:00,out,False,890406,False,15,3797,4059,262
166658,2019-11-21 00:00:00+03:00,out,False,891154,True,3,0,107,107
166658,2019-11-21 00:00:00+03:00,out,False,890402,False,13,6474,6646,172
166658,2019-11-21 00:00:00+03:00,in,False,890410,False,8,1452,1506,54
166658,2019-11-21 00:00:00+03:00,out,False,890402,True,3,0,138,138
166658,2019-11-21 00:00:00+03:00,in,False,-1,True,21,0,505,505
166658,2019-11-21 00:00:00+03:00,out,False,891170,False,8,869,992,123
166658,2019-11-21 00:00:00+03:00,out,False,890416,False,8,3678,3748,70
166658,2019-11-21 00:00:00+03:00,out,False,891154,False,6,3297,3378,81
166658,2019-11-21 00:00:00+03:00,out,False,891158,True,1,0,24,24
166658,2019-11-21 00:00:00+03:00,out,False,890410,False,9,3494,3617,123
166658,2019-11-21 00:00:00+03:00,out,False,890410,True,12,0,287,287
166658,2019-11-21 00:00:00+03:00,out,False,890412,True,8,0,259,259
166658,2019-11-21 00:00:00+03:00,in,False,890406,False,4,300,332,32
166658,2019-11-21 00:00:00+03:00,out,False,891156,False,2,255,279,24
166658,2019-11-21 00:00:00+03:00,out,False,891158,False,3,624,669,45
166658,2019-11-21 00:00:00+03:00,out,False,891154,True,3,0,107,107
166658,2019-11-21 00:00:00+03:00,out,False,891154,False,6,3297,3378,81
166658,2019-11-21 00:00:00+03:00,out,False,890416,True,2,0,26,26
166658,2019-11-21 00:00:00+03:00,out,False,890410,True,12,0,287,287
166658,2019-11-22 00:00:00+03:00,out,False,891162,False,3,1789,1854,65
166658,2019-11-22 00:00:00+03:00,in,False,-1,True,4,0,58,58
166658,2019-11-22 00:00:00+03:00,out,False,891160,True,1,0,21,21
166658,2019-11-22 00:00:00+03:00,out,False,891158,False,4,3116,3187,71
166658,2019-11-22 00:00:00+03:00,out,False,891162,True,2,0,25,25
166658,2019-11-22 00:00:00+03:00,in,False,890404,False,5,390,459,69
166658,2019-11-22 00:00:00+03:00,out,False,891160,False,2,27,45,18
166658,2019-11-22 00:00:00+03:00,out,False,890406,False,9,7262,7362,100
166658,2019-11-22 00:00:00+03:00,out,False,890412,True,2,0,104,104
166658,2019-11-22 00:00:00+03:00,out,False,890404,False,7,1822,1905,83
166658,2019-11-22 00:00:00+03:00,out,False,890402,False,6,1164,1215,51
166658,2019-11-22 00:00:00+03:00,out,False,890416,False,13,5399,5555,156
166658,2019-11-22 00:00:00+03:00,out,False,891166,False,3,759,789,30
166658,2019-11-22 00:00:00+03:00,out,False,891170,True,1,0,58,58
166658,2019-11-22 00:00:00+03:00,out,False,890406,True,2,0,45,45
166658,2019-11-22 00:00:00+03:00,out,False,890402,True,4,0,105,105
166658,2019-11-22 00:00:00+03:00,out,False,890410,True,4,0,39,39
166658,2019-11-22 00:00:00+03:00,out,False,890416,True,6,0,89,89
166658,2019-11-22 00:00:00+03:00,out,False,890404,True,5,0,181,181
166658,2019-11-22 00:00:00+03:00,out,False,891158,True,1,0,60,60
166658,2019-11-22 00:00:00+03:00,out,False,891170,False,6,972,1078,106
166658,2019-11-22 00:00:00+03:00,in,False,890402,False,14,1817,1913,96
166658,2019-11-22 00:00:00+03:00,out,False,890412,False,10,6936,7047,111
166658,2019-11-22 00:00:00+03:00,out,False,890410,False,14,4033,4200,167
166658,2019-11-22 00:00:00+03:00,out,False,891158,False,4,3116,3187,71
166658,2019-11-22 00:00:00+03:00,out,False,890412,False,10,6936,7047,111
166658,2019-11-22 00:00:00+03:00,out,False,891160,True,1,0,21,21
166658,2019-11-23 00:00:00+03:00,in,False,-1,True,6,0,2,2
166658,2019-11-24 00:00:00+03:00,out,False,890416,False,5,808,881,73
166658,2019-11-24 00:00:00+03:00,out,False,890416,True,8,0,242,242
166658,2019-11-24 00:00:00+03:00,in,False,-1,True,7,0,2,2
166658,2019-11-24 00:00:00+03:00,out,False,890416,False,5,808,881,73
166658,2019-11-25 00:00:00+03:00,out,False,890404,True,7,0,94,94
166658,2019-11-25 00:00:00+03:00,out,False,890416,False,15,2749,2979,230
166658,2019-11-25 00:00:00+03:00,in,False,890402,False,15,4948,5052,104
166658,2019-11-25 00:00:00+03:00,out,False,891160,False,1,9,28,19
166658,2019-11-25 00:00:00+03:00,out,False,891170,False,8,498,628,130
166658,2019-11-25 00:00:00+03:00,out,False,891166,False,4,557,613,56
166658,2019-11-25 00:00:00+03:00,out,False,890406,True,6,0,175,175
166658,2019-11-25 00:00:00+03:00,out,False,890402,False,21,3663,3931,268
166658,2019-11-25 00:00:00+03:00,in,False,890404,True,1,0,12,12
166658,2019-11-25 00:00:00+03:00,out,False,890410,True,3,0,110,110
166658,2019-11-25 00:00:00+03:00,in,False,890404,False,3,470,510,40
166658,2019-11-25 00:00:00+03:00,out,False,890416,True,7,0,223,223
166658,2019-11-25 00:00:00+03:00,out,False,891154,False,3,1858,1893,35
166658,2019-11-25 00:00:00+03:00,out,False,890402,True,11,0,391,391
166658,2019-11-25 00:00:00+03:00,out,False,891154,True,3,0,82,82
166658,2019-11-25 00:00:00+03:00,out,False,890410,False,10,1047,1209,162
166658,2019-11-25 00:00:00+03:00,out,False,890412,False,6,2769,2850,81
166658,2019-11-25 00:00:00+03:00,out,True,890410,True,1,0,0,0
166658,2019-11-25 00:00:00+03:00,out,False,891170,True,2,0,44,44
166658,2019-11-25 00:00:00+03:00,in,False,890406,False,1,134,141,7
166658,2019-11-25 00:00:00+03:00,out,False,890404,False,4,4113,4186,73
166658,2019-11-25 00:00:00+03:00,out,False,890406,False,4,179,247,68
166658,2019-11-25 00:00:00+03:00,out,False,890412,True,5,0,130,130
166658,2019-11-25 00:00:00+03:00,in,False,890404,False,3,470,510,40
166658,2019-11-25 00:00:00+03:00,out,False,891160,False,1,9,28,19
166658,2019-11-26 00:00:00+03:00,out,False,891152,True,1,0,35,35
166658,2019-11-26 00:00:00+03:00,out,False,890412,True,1,0,27,27
166658,2019-11-26 00:00:00+03:00,out,False,890416,False,4,3628,3729,101
166658,2019-11-26 00:00:00+03:00,out,False,890404,True,6,0,157,157
166658,2019-11-26 00:00:00+03:00,out,False,890404,False,8,10663,10772,109
166658,2019-11-26 00:00:00+03:00,out,False,890402,False,10,748,851,103
166658,2019-11-26 00:00:00+03:00,in,False,890406,False,2,268,289,21
166658,2019-11-26 00:00:00+03:00,out,False,891170,True,2,0,34,34
166658,2019-11-26 00:00:00+03:00,out,False,890406,True,5,0,152,152
166658,2019-11-26 00:00:00+03:00,out,False,890402,True,6,0,175,175
166658,2019-11-26 00:00:00+03:00,out,False,891158,False,5,1777,1840,63
166658,2019-11-26 00:00:00+03:00,in,False,-1,True,2,0,4,4
166658,2019-11-26 00:00:00+03:00,out,False,890406,False,8,1249,1367,118
166658,2019-11-26 00:00:00+03:00,out,False,890410,True,3,0,57,57
166658,2019-11-26 00:00:00+03:00,in,False,890404,False,6,378,423,45
166658,2019-11-26 00:00:00+03:00,out,False,891154,True,1,0,30,30
166658,2019-11-26 00:00:00+03:00,out,False,890410,False,10,4050,4161,111
166658,2019-11-26 00:00:00+03:00,out,False,891166,False,2,1117,1148,31
166658,2019-11-26 00:00:00+03:00,out,False,890416,True,1,0,40,40
166658,2019-11-26 00:00:00+03:00,in,False,890402,False,23,7380,7537,157
166658,2019-11-26 00:00:00+03:00,out,False,891154,False,6,1822,1889,67
166658,2019-11-26 00:00:00+03:00,out,False,891162,True,2,0,38,38
166658,2019-11-26 00:00:00+03:00,out,False,890412,False,7,4684,4761,77
166658,2019-11-26 00:00:00+03:00,out,False,891152,False,2,437,475,38
166658,2019-11-26 00:00:00+03:00,out,False,891170,False,5,630,690,60
166658,2019-11-26 00:00:00+03:00,in,False,-1,True,2,0,4,4
166658,2019-11-26 00:00:00+03:00,out,False,891158,False,5,1777,1840,63
166658,2019-11-26 00:00:00+03:00,out,False,890402,True,6,0,175,175
166658,2019-11-27 00:00:00+03:00,out,False,890416,True,3,0,60,60
166658,2019-11-27 00:00:00+03:00,out,False,891170,False,11,1964,2119,155
166658,2019-11-27 00:00:00+03:00,out,False,890410,False,6,1568,1653,85
166658,2019-11-27 00:00:00+03:00,out,False,891162,False,1,70,78,8
166658,2019-11-27 00:00:00+03:00,in,False,-1,True,3,0,0,0
166658,2019-11-27 00:00:00+03:00,in,False,890404,False,2,1188,1198,10
166658,2019-11-27 00:00:00+03:00,out,False,890406,True,2,0,97,97
166658,2019-11-27 00:00:00+03:00,in,False,890406,False,1,980,987,7
166658,2019-11-27 00:00:00+03:00,out,False,890402,False,13,2162,2362,200
166658,2019-11-27 00:00:00+03:00,out,False,890416,False,12,4693,4831,138
166658,2019-11-27 00:00:00+03:00,out,False,890404,True,4,0,148,148
166658,2019-11-27 00:00:00+03:00,out,False,890410,True,1,0,6,6
166658,2019-11-27 00:00:00+03:00,out,False,890402,True,5,0,173,173
166658,2019-11-27 00:00:00+03:00,out,False,890404,False,15,5920,6125,205
166658,2019-11-27 00:00:00+03:00,out,False,891170,True,4,0,172,172
166658,2019-11-27 00:00:00+03:00,out,False,890406,False,12,2692,2867,175
166658,2019-11-27 00:00:00+03:00,in,False,890402,False,19,4824,4957,133
166658,2019-11-27 00:00:00+03:00,out,False,891166,True,2,0,71,71
166658,2019-11-27 00:00:00+03:00,out,False,891154,False,1,158,170,12
166658,2019-11-27 00:00:00+03:00,out,False,890402,True,5,0,173,173
166658,2019-11-27 00:00:00+03:00,out,False,891170,True,4,0,172,172
166658,2019-11-27 00:00:00+03:00,out,False,890406,False,12,2692,2867,175
166658,2019-11-28 00:00:00+03:00,in,False,890406,False,1,234,286,52
166658,2019-11-28 00:00:00+03:00,out,False,891154,False,3,3423,3456,33
166658,2019-11-28 00:00:00+03:00,out,False,890410,False,21,3818,4031,213
166658,2019-11-28 00:00:00+03:00,in,False,-1,True,1,0,22,22
166658,2019-11-28 00:00:00+03:00,out,False,891170,True,9,0,188,188
166658,2019-11-28 00:00:00+03:00,in,False,890402,False,12,3093,3186,93
166658,2019-11-28 00:00:00+03:00,out,False,890416,False,7,3198,3290,92
166658,2019-11-28 00:00:00+03:00,out,False,890404,False,5,4283,4339,56
166658,2019-11-28 00:00:00+03:00,out,False,890410,True,9,0,307,307
166658,2019-11-28 00:00:00+03:00,out,False,890406,True,1,0,22,22
166658,2019-11-28 00:00:00+03:00,out,False,891152,False,1,26,39,13
166658,2019-11-28 00:00:00+03:00,out,False,890402,False,15,3153,3391,238
166658,2019-11-28 00:00:00+03:00,out,False,891166,True,1,0,39,39
166658,2019-11-28 00:00:00+03:00,out,False,890404,True,3,0,89,89
166658,2019-11-28 00:00:00+03:00,out,False,891166,False,1,72,87,15
166658,2019-11-28 00:00:00+03:00,out,False,890402,True,3,0,72,72
166658,2019-11-28 00:00:00+03:00,out,False,891156,False,1,987,1005,18
166658,2019-11-28 00:00:00+03:00,out,False,891170,False,16,3137,3334,197
166658,2019-11-28 00:00:00+03:00,out,False,891162,True,2,0,15,15
166658,2019-11-28 00:00:00+03:00,out,False,891154,True,2,0,91,91
166658,2019-11-28 00:00:00+03:00,in,False,890404,False,2,23,62,39
166658,2019-11-28 00:00:00+03:00,out,False,890406,False,8,4588,4700,112
166658,2019-11-28 00:00:00+03:00,out,False,890416,True,6,0,173,173
166658,2019-11-28 00:00:00+03:00,out,False,890406,True,1,0,22,22
166658,2019-11-28 00:00:00+03:00,out,False,890402,True,3,0,72,72
166658,2019-11-28 00:00:00+03:00,out,False,891162,True,2,0,15,15
166660,2019-08-23 00:00:00+03:00,in,False,-1,True,3,0,7,7
166660,2019-08-23 00:00:00+03:00,out,False,887802,True,1,0,10,10
166660,2019-08-26 00:00:00+03:00,in,False,-1,True,2,0,4,4
166660,2019-08-26 00:00:00+03:00,out,False,887802,True,9,0,127,127
166660,2019-08-27 00:00:00+03:00,in,False,-1,True,1,0,30,30
166660,2019-08-27 00:00:00+03:00,in,False,-1,True,1,0,30,30
166660,2019-08-28 00:00:00+03:00,out,False,887802,False,1,6,12,6
166660,2019-08-28 00:00:00+03:00,in,False,887802,False,1,3,13,10
166660,2019-08-30 00:00:00+03:00,in,False,-1,True,1,0,67,67
166660,2019-09-09 00:00:00+03:00,in,False,-1,True,1,0,5,5
166660,2019-09-16 00:00:00+03:00,out,False,887802,True,4,0,12,12
166660,2019-09-17 00:00:00+03:00,out,False,887802,True,6,0,19,19
166660,2019-09-17 00:00:00+03:00,out,False,887802,False,2,224,257,33
166660,2019-09-18 00:00:00+03:00,in,False,-1,True,6,0,35,35
166660,2019-09-18 00:00:00+03:00,out,False,887802,False,1,87,98,11
166660,2019-09-18 00:00:00+03:00,out,False,887802,True,2,0,10,10
166660,2019-09-20 00:00:00+03:00,out,False,887802,False,1,12,25,13
166660,2019-09-23 00:00:00+03:00,out,False,887802,False,3,316,337,21
166660,2019-09-23 00:00:00+03:00,out,False,887802,True,2,0,40,40
166660,2019-09-23 00:00:00+03:00,in,False,887802,False,1,149,158,9
166660,2019-09-24 00:00:00+03:00,out,False,887802,False,3,176,199,23
166660,2019-09-24 00:00:00+03:00,in,False,-1,True,2,0,32,32
166660,2019-09-24 00:00:00+03:00,out,False,887802,True,4,0,36,36
166660,2019-09-24 00:00:00+03:00,in,False,-1,True,2,0,32,32
166660,2019-09-25 00:00:00+03:00,out,False,887802,False,6,428,474,46
166660,2019-09-26 00:00:00+03:00,out,False,887802,False,7,2341,2396,55
166660,2019-09-26 00:00:00+03:00,out,True,887802,True,1,0,2,2
166660,2019-09-27 00:00:00+03:00,out,False,887802,False,2,70,98,28
166660,2019-09-30 00:00:00+03:00,out,False,887802,False,1,163,182,19
166660,2019-10-01 00:00:00+03:00,out,False,887802,False,1,48,62,14
166660,2019-10-01 00:00:00+03:00,in,False,887802,False,3,459,498,39
166660,2019-10-01 00:00:00+03:00,out,False,887802,True,1,0,33,33
166660,2019-10-01 00:00:00+03:00,in,False,887802,False,3,459,498,39
166660,2019-10-02 00:00:00+03:00,out,False,887802,False,1,46,60,14
166660,2019-10-02 00:00:00+03:00,out,False,887802,True,1,0,11,11
166660,2019-10-04 00:00:00+03:00,out,False,887802,False,1,145,166,21
166660,2019-10-07 00:00:00+03:00,out,False,887802,False,4,168,228,60
166660,2019-10-07 00:00:00+03:00,out,False,887802,True,2,0,24,24
166660,2019-10-07 00:00:00+03:00,in,False,887802,False,2,50,67,17
166660,2019-10-08 00:00:00+03:00,out,False,887802,False,6,282,359,77
166660,2019-10-08 00:00:00+03:00,out,False,887802,True,1,0,19,19
166660,2019-10-08 00:00:00+03:00,in,False,-1,True,1,0,19,19
166660,2019-10-08 00:00:00+03:00,in,False,887802,False,1,119,129,10
166660,2019-10-08 00:00:00+03:00,in,False,887802,False,1,119,129,10
166660,2019-10-09 00:00:00+03:00,in,False,-1,True,2,0,85,85
166660,2019-10-09 00:00:00+03:00,in,False,887802,False,8,577,701,124
166660,2019-10-09 00:00:00+03:00,out,False,887802,True,3,0,64,64
166660,2019-10-09 00:00:00+03:00,out,False,887802,False,1,147,164,17
166660,2019-10-10 00:00:00+03:00,in,False,932460,False,2,67,113,46
166660,2019-10-10 00:00:00+03:00,out,False,887802,False,1,83,98,15
166660,2019-10-10 00:00:00+03:00,in,False,-1,True,1,0,52,52
166660,2019-10-10 00:00:00+03:00,in,False,932460,False,2,67,113,46
166660,2019-10-11 00:00:00+03:00,out,False,887802,False,2,115,140,25
166660,2019-10-11 00:00:00+03:00,in,False,932460,False,2,320,347,27
166660,2019-10-14 00:00:00+03:00,in,False,-1,True,2,0,90,90
166660,2019-10-14 00:00:00+03:00,in,False,932460,False,2,163,199,36
166660,2019-10-14 00:00:00+03:00,out,False,887802,False,4,668,724,56
166660,2019-10-15 00:00:00+03:00,in,False,932460,False,5,260,337,77
166660,2019-10-15 00:00:00+03:00,out,False,887802,False,1,17,39,22
166660,2019-10-15 00:00:00+03:00,in,False,-1,True,1,0,62,62
166660,2019-10-15 00:00:00+03:00,in,False,-1,True,1,0,62,62
166660,2019-10-16 00:00:00+03:00,out,False,887802,True,1,0,27,27
166660,2019-10-16 00:00:00+03:00,in,False,932460,False,3,831,900,69
166660,2019-10-17 00:00:00+03:00,out,False,887802,False,1,36,44,8
166660,2019-10-17 00:00:00+03:00,out,False,887802,True,1,0,25,25
166660,2019-10-17 00:00:00+03:00,out,False,887802,False,1,36,44,8
166660,2019-10-18 00:00:00+03:00,out,False,887802,True,1,0,40,40
166660,2019-10-18 00:00:00+03:00,out,False,887802,False,1,44,49,5
166660,2019-10-22 00:00:00+03:00,in,False,932460,False,1,209,224,15
166660,2019-10-22 00:00:00+03:00,out,False,887802,True,1,0,5,5
166660,2019-10-24 00:00:00+03:00,in,False,932460,True,1,0,18,18
166660,2019-10-24 00:00:00+03:00,out,False,887802,False,1,51,63,12
166660,2019-10-24 00:00:00+03:00,in,False,932460,False,1,85,98,13
166660,2019-10-25 00:00:00+03:00,out,False,887802,False,2,299,334,35
166660,2019-10-25 00:00:00+03:00,in,False,932460,False,1,224,237,13
166660,2019-10-25 00:00:00+03:00,out,False,887802,True,1,0,31,31
166660,2019-10-25 00:00:00+03:00,in,False,932460,False,1,224,237,13
166660,2019-10-29 00:00:00+03:00,out,False,887802,False,1,120,134,14
166660,2019-10-29 00:00:00+03:00,in,False,932460,False,1,136,167,31
166660,2019-10-29 00:00:00+03:00,in,False,-1,True,1,0,61,61
166660,2019-11-05 00:00:00+03:00,out,False,887802,False,1,27,50,23
166660,2019-11-05 00:00:00+03:00,in,False,932460,False,1,109,122,13
166660,2019-11-06 00:00:00+03:00,out,False,887802,False,2,617,646,29
166660,2019-11-06 00:00:00+03:00,in,False,932460,False,2,463,487,24
166660,2019-11-06 00:00:00+03:00,in,False,-1,True,2,0,14,14
166660,2019-11-08 00:00:00+03:00,in,False,932460,False,1,172,185,13
166660,2019-11-08 00:00:00+03:00,out,False,887802,True,1,0,40,40
166660,2019-11-15 00:00:00+03:00,in,False,932460,False,1,12,24,12
166660,2019-11-15 00:00:00+03:00,in,False,932460,False,1,12,24,12
166660,2019-11-18 00:00:00+03:00,out,False,887802,False,1,82,100,18
166660,2019-11-20 00:00:00+03:00,out,False,887802,False,1,5,40,35
166660,2019-11-20 00:00:00+03:00,out,False,887802,True,2,0,45,45
166660,2019-11-20 00:00:00+03:00,out,False,887802,False,1,5,40,35
166660,2019-11-25 00:00:00+03:00,out,False,887802,False,10,983,1058,75
166660,2019-11-25 00:00:00+03:00,in,False,932460,False,1,88,99,11
166660,2019-11-25 00:00:00+03:00,out,False,887802,True,2,0,24,24
166660,2019-11-25 00:00:00+03:00,out,False,887802,True,2,0,24,24
166660,2019-11-26 00:00:00+03:00,in,False,-1,True,1,0,68,68
166660,2019-11-28 00:00:00+03:00,out,False,887802,False,4,437,456,19
166666,2019-08-16 00:00:00+03:00,in,False,889640,False,1,20,30,10
166666,2019-08-16 00:00:00+03:00,in,False,-1,True,4,0,9,9
166666,2019-08-16 00:00:00+03:00,in,False,-1,True,1,0,0,0
166666,2019-08-17 00:00:00+03:00,in,False,889640,False,1,30,47,17
166666,2019-10-11 00:00:00+03:00,in,False,-1,True,1,0,2,2
166666,2019-10-11 00:00:00+03:00,in,False,-1,True,1,0,2,2
166666,2019-10-19 00:00:00+03:00,in,False,-1,True,3,0,3,3
166666,2019-10-20 00:00:00+03:00,in,False,-1,True,1,0,2,2
166666,2019-10-22 00:00:00+03:00,in,False,-1,True,1,0,2,2
166666,2019-10-25 00:00:00+03:00,in,False,-1,True,2,0,4,4
166669,2019-08-14 00:00:00+03:00,out,False,888406,True,1,0,22,22
166669,2019-08-14 00:00:00+03:00,in,False,-1,True,5,0,102,102
166669,2019-08-14 00:00:00+03:00,in,False,888406,False,1,6,37,31
166669,2019-08-15 00:00:00+03:00,in,False,-1,True,1,0,1,1
166669,2019-08-17 00:00:00+03:00,in,False,-1,True,4,0,41,41
166669,2019-08-21 00:00:00+03:00,in,False,-1,True,1,0,16,16
166669,2019-08-23 00:00:00+03:00,in,False,888406,False,1,4,53,49
166669,2019-08-25 00:00:00+03:00,out,False,888406,True,1,0,11,11
166669,2019-08-25 00:00:00+03:00,in,False,-1,True,1,0,16,16
166669,2019-08-26 00:00:00+03:00,in,False,888406,False,3,85,154,69
166669,2019-08-30 00:00:00+03:00,in,False,-1,True,1,0,11,11
166669,2019-08-30 00:00:00+03:00,out,False,888406,True,1,0,6,6
166669,2019-09-09 00:00:00+03:00,in,False,888406,False,1,8,26,18
166669,2019-09-19 00:00:00+03:00,in,False,-1,True,1,0,25,25
166669,2019-09-19 00:00:00+03:00,in,False,-1,True,1,0,25,25
166669,2019-09-20 00:00:00+03:00,out,False,888406,False,1,241,257,16
166669,2019-09-23 00:00:00+03:00,in,False,888406,True,1,0,17,17
166669,2019-10-08 00:00:00+03:00,in,False,-1,True,1,0,2,2
166669,2019-10-10 00:00:00+03:00,in,False,-1,True,1,0,2,2
166669,2019-10-16 00:00:00+03:00,in,False,-1,True,1,0,8,8
166669,2019-10-16 00:00:00+03:00,in,False,-1,True,1,0,8,8
166669,2019-10-18 00:00:00+03:00,out,False,888406,True,1,0,3,3
166669,2019-10-26 00:00:00+03:00,in,False,-1,True,3,0,46,46
166669,2019-10-29 00:00:00+03:00,in,False,888406,False,1,372,389,17
166669,2019-10-30 00:00:00+03:00,in,False,-1,True,1,0,15,15
166669,2019-10-30 00:00:00+03:00,in,False,888406,False,1,24,78,54
166669,2019-11-12 00:00:00+03:00,in,False,-1,True,1,0,5,5
166669,2019-11-16 00:00:00+03:00,out,False,888406,True,1,0,15,15
166671,2019-08-14 00:00:00+03:00,in,False,-1,True,1,0,4,4
166671,2019-08-25 00:00:00+03:00,in,False,888520,False,2,316,353,37
166671,2019-09-03 00:00:00+03:00,in,False,-1,True,1,0,1,1
166671,2019-09-12 00:00:00+03:00,in,False,888520,False,1,521,541,20
166671,2019-09-21 00:00:00+03:00,in,False,888520,False,1,47,59,12
166671,2019-09-23 00:00:00+03:00,in,False,888520,False,1,43,54,11
166671,2019-09-23 00:00:00+03:00,in,False,-1,True,1,0,13,13
166671,2019-10-14 00:00:00+03:00,in,False,888520,False,1,231,245,14
166677,2019-08-19 00:00:00+03:00,in,False,890618,True,1,1,2,1
166677,2019-08-19 00:00:00+03:00,in,False,-1,True,28,0,5,5
166677,2019-08-19 00:00:00+03:00,in,False,890618,False,6,20,27,7
166677,2019-08-21 00:00:00+03:00,in,False,890618,False,8,1008,1019,11
166677,2019-08-21 00:00:00+03:00,out,False,890618,False,9,793,946,153
166677,2019-08-21 00:00:00+03:00,out,False,890618,True,8,0,202,202
166677,2019-08-22 00:00:00+03:00,in,False,890618,False,5,722,727,5
166677,2019-08-22 00:00:00+03:00,out,False,890618,False,5,123,188,65
166677,2019-08-22 00:00:00+03:00,out,False,890618,True,32,0,892,892
166677,2019-08-23 00:00:00+03:00,out,False,890618,False,4,160,208,48
166677,2019-08-23 00:00:00+03:00,out,False,890618,True,8,0,341,341
166677,2019-08-26 00:00:00+03:00,out,False,890618,True,4,0,183,183
166677,2019-08-27 00:00:00+03:00,out,False,890618,True,1,0,34,34
166677,2019-08-28 00:00:00+03:00,out,False,890618,True,11,0,89,89
166677,2019-08-28 00:00:00+03:00,in,False,890618,False,1,53,54,1
166677,2019-08-28 00:00:00+03:00,out,False,890618,False,5,493,592,99
166677,2019-08-29 00:00:00+03:00,in,False,890618,False,1,363,364,1
166677,2019-08-29 00:00:00+03:00,out,False,890618,True,6,0,41,41
166677,2019-08-29 00:00:00+03:00,out,False,890618,False,4,94,187,93
166677,2019-08-30 00:00:00+03:00,out,False,890618,False,3,156,231,75
166677,2019-08-30 00:00:00+03:00,out,False,890618,True,5,0,35,35
166677,2019-09-02 00:00:00+03:00,in,False,890618,False,1,368,369,1
166677,2019-09-02 00:00:00+03:00,out,False,890618,True,6,0,181,181
166677,2019-09-02 00:00:00+03:00,out,False,890618,False,9,789,943,154
166677,2019-09-03 00:00:00+03:00,out,False,890618,True,10,0,299,299
166677,2019-09-03 00:00:00+03:00,out,False,890618,False,19,2411,2673,262
166677,2019-09-03 00:00:00+03:00,in,False,890618,False,3,432,435,3
166677,2019-09-03 00:00:00+03:00,in,False,890618,False,3,432,435,3
166677,2019-09-04 00:00:00+03:00,out,False,890618,True,12,0,430,430
166677,2019-09-04 00:00:00+03:00,out,False,890618,False,6,603,687,84
166677,2019-09-09 00:00:00+03:00,in,False,890618,False,1,247,248,1
166677,2019-09-12 00:00:00+03:00,out,False,890618,True,1,0,11,11
166677,2019-09-12 00:00:00+03:00,out,False,890618,False,2,209,236,27
166677,2019-09-13 00:00:00+03:00,out,False,890618,True,1,0,4,4
166677,2019-09-13 00:00:00+03:00,out,False,890618,False,2,195,216,21
166677,2019-09-13 00:00:00+03:00,out,False,890618,False,2,195,216,21
166677,2019-09-13 00:00:00+03:00,out,False,890618,True,1,0,4,4
166677,2019-09-14 00:00:00+03:00,in,False,890618,False,3,500,503,3
166677,2019-09-21 00:00:00+03:00,in,False,890618,False,1,37,38,1
166677,2019-09-25 00:00:00+03:00,in,False,890618,False,13,790,805,15
166677,2019-09-27 00:00:00+03:00,out,False,890618,False,1,43,60,17
166677,2019-09-27 00:00:00+03:00,out,False,890618,True,2,0,69,69
166677,2019-09-27 00:00:00+03:00,out,False,890618,False,1,43,60,17
166677,2019-09-30 00:00:00+03:00,out,False,890618,False,2,1204,1231,27
166677,2019-10-01 00:00:00+03:00,in,False,890618,False,1,90,92,2
166677,2019-10-07 00:00:00+03:00,in,False,890618,False,1,222,224,2
166677,2019-10-08 00:00:00+03:00,in,False,890618,False,1,54,55,1
166677,2019-10-08 00:00:00+03:00,in,False,890618,False,1,54,55,1
166677,2019-10-09 00:00:00+03:00,in,False,890618,False,1,113,114,1
166677,2019-10-13 00:00:00+03:00,in,False,890618,False,2,754,756,2
166677,2019-10-14 00:00:00+03:00,out,False,890618,False,1,172,181,9
166677,2019-10-16 00:00:00+03:00,in,False,890618,False,2,62,64,2
166677,2019-10-16 00:00:00+03:00,out,False,890618,False,5,311,396,85
166677,2019-10-17 00:00:00+03:00,out,False,890618,False,4,178,237,59
166677,2019-10-17 00:00:00+03:00,out,False,890618,True,2,0,55,55
166677,2019-10-18 00:00:00+03:00,in,False,890618,False,1,39,40,1
166677,2019-10-19 00:00:00+03:00,out,False,890618,True,4,0,63,63
166677,2019-10-19 00:00:00+03:00,out,False,890618,False,6,1320,1416,96
166677,2019-10-19 00:00:00+03:00,in,False,890618,False,1,34,35,1
166677,2019-10-21 00:00:00+03:00,out,False,890618,False,6,1123,1188,65
166677,2019-10-21 00:00:00+03:00,out,False,890618,True,4,0,162,162
166677,2019-10-23 00:00:00+03:00,out,False,890618,True,7,0,245,245
166677,2019-10-23 00:00:00+03:00,out,False,890618,False,9,1478,1613,135
166677,2019-10-24 00:00:00+03:00,out,False,890618,False,5,1729,1809,80
166677,2019-10-24 00:00:00+03:00,out,False,890618,True,2,0,114,114
166677,2019-10-24 00:00:00+03:00,out,False,890618,False,5,1729,1809,80
166677,2019-10-25 00:00:00+03:00,out,False,890618,False,7,635,742,107
166677,2019-10-28 00:00:00+03:00,out,False,890618,True,5,0,148,148
166677,2019-10-28 00:00:00+03:00,out,False,890618,False,7,1068,1146,78
166677,2019-10-28 00:00:00+03:00,in,False,890618,False,2,187,189,2
166677,2019-10-29 00:00:00+03:00,in,False,890618,False,7,811,821,10
166677,2019-10-29 00:00:00+03:00,out,False,890618,False,9,1511,1634,123
166677,2019-10-29 00:00:00+03:00,out,False,890618,True,2,0,60,60
166677,2019-10-30 00:00:00+03:00,out,False,890618,False,2,369,435,66
166677,2019-10-30 00:00:00+03:00,out,False,890618,True,5,0,105,105
166677,2019-10-30 00:00:00+03:00,in,False,890618,False,1,257,258,1
166677,2019-10-31 00:00:00+03:00,in,False,890618,False,2,43,45,2
166677,2019-11-01 00:00:00+03:00,in,False,890618,False,1,170,171,1
166677,2019-11-08 00:00:00+03:00,in,False,890618,False,1,11,12,1
166677,2019-11-10 00:00:00+03:00,in,False,890618,False,1,5,6,1
166677,2019-11-11 00:00:00+03:00,in,False,890618,False,1,4,5,1
166677,2019-11-14 00:00:00+03:00,in,False,890618,False,1,7,8,1
166677,2019-11-20 00:00:00+03:00,in,False,890618,False,1,153,154,1
166677,2019-11-20 00:00:00+03:00,in,False,890618,False,1,153,154,1
166677,2019-11-23 00:00:00+03:00,in,False,890618,False,1,47,48,1
166678,2019-08-30 00:00:00+03:00,in,False,-1,True,1,0,2,2
166678,2019-08-31 00:00:00+03:00,out,False,888868,False,3,51,91,40
166678,2019-08-31 00:00:00+03:00,out,False,900892,False,4,342,392,50
166678,2019-08-31 00:00:00+03:00,out,True,888868,True,6,0,181,181
166678,2019-08-31 00:00:00+03:00,in,False,-1,True,2,0,47,47
166678,2019-08-31 00:00:00+03:00,out,True,888868,False,3,54,124,70
166678,2019-08-31 00:00:00+03:00,in,False,888868,False,1,34,42,8
166678,2019-08-31 00:00:00+03:00,in,True,900892,False,4,126,140,14
166678,2019-08-31 00:00:00+03:00,in,False,900892,False,4,355,387,32
166678,2019-08-31 00:00:00+03:00,out,False,900892,True,4,0,54,54
166678,2019-08-31 00:00:00+03:00,out,True,900892,False,1,66,76,10
166678,2019-08-31 00:00:00+03:00,in,False,-1,True,2,0,40,40
166678,2019-08-31 00:00:00+03:00,in,False,888868,False,1,34,42,8
166678,2019-09-01 00:00:00+03:00,in,False,900892,False,2,526,533,7
166678,2019-09-01 00:00:00+03:00,out,True,900894,False,1,54,68,14
166678,2019-09-01 00:00:00+03:00,out,True,900892,False,1,4,15,11
166678,2019-09-01 00:00:00+03:00,out,True,900892,True,4,0,0,0
166678,2019-09-01 00:00:00+03:00,in,True,900892,False,1,20,24,4
166678,2019-09-01 00:00:00+03:00,out,False,900892,True,7,0,62,62
166678,2019-09-01 00:00:00+03:00,out,False,900892,False,2,616,642,26
166678,2019-09-01 00:00:00+03:00,out,True,900894,True,1,0,0,0
166678,2019-09-01 00:00:00+03:00,out,False,888868,True,2,0,0,0
166678,2019-09-01 00:00:00+03:00,out,False,888868,True,2,0,0,0
166678,2019-09-02 00:00:00+03:00,out,False,900892,False,5,204,258,54
166678,2019-09-02 00:00:00+03:00,in,False,900892,False,1,142,146,4
166678,2019-09-02 00:00:00+03:00,out,False,900892,True,5,0,113,113
166678,2019-09-02 00:00:00+03:00,out,False,888868,False,4,277,351,74
166678,2019-09-02 00:00:00+03:00,out,False,900894,False,5,132,222,90
166678,2019-09-03 00:00:00+03:00,out,True,900892,True,1,0,8,8
166678,2019-09-03 00:00:00+03:00,out,False,900892,True,24,0,402,402
166678,2019-09-03 00:00:00+03:00,in,False,888868,False,1,34,41,7
166678,2019-09-03 00:00:00+03:00,in,False,-1,True,3,0,53,53
166678,2019-09-03 00:00:00+03:00,out,False,888868,False,6,364,422,58
166678,2019-09-03 00:00:00+03:00,out,True,888868,True,1,0,0,0
166678,2019-09-03 00:00:00+03:00,out,False,888868,True,1,0,10,10
166678,2019-09-03 00:00:00+03:00,in,False,900892,False,2,95,106,11
166678,2019-09-03 00:00:00+03:00,out,False,900892,False,31,1604,1980,376
166678,2019-09-03 00:00:00+03:00,out,False,900892,False,31,1604,1980,376
166678,2019-09-04 00:00:00+03:00,in,False,900892,True,1,0,4,4
166678,2019-09-04 00:00:00+03:00,out,True,900892,False,1,85,109,24
166678,2019-09-04 00:00:00+03:00,out,False,900894,True,1,0,13,13
166678,2019-09-04 00:00:00+03:00,out,True,888868,True,4,0,0,0
166678,2019-09-04 00:00:00+03:00,in,False,900894,False,2,265,280,15
166678,2019-09-04 00:00:00+03:00,out,False,888868,True,2,0,107,107
166678,2019-09-04 00:00:00+03:00,out,True,888868,False,1,0,5,5
166678,2019-09-04 00:00:00+03:00,out,False,888868,False,6,445,548,103
166678,2019-09-04 00:00:00+03:00,out,False,900892,True,20,0,316,316
166678,2019-09-04 00:00:00+03:00,in,False,900892,False,5,205,238,33
166678,2019-09-04 00:00:00+03:00,out,True,900892,True,2,0,8,8
166678,2019-09-04 00:00:00+03:00,out,False,900892,False,10,472,577,105
166678,2019-09-05 00:00:00+03:00,out,True,888868,False,1,50,61,11
166678,2019-09-05 00:00:00+03:00,out,False,888868,False,3,677,756,79
166678,2019-09-05 00:00:00+03:00,in,False,888868,False,1,59,65,6
166678,2019-09-05 00:00:00+03:00,in,False,900894,False,1,25,35,10
166678,2019-09-05 00:00:00+03:00,out,False,888868,True,5,0,290,290
166678,2019-09-05 00:00:00+03:00,in,False,-1,True,1,0,31,31
166678,2019-09-05 00:00:00+03:00,out,False,900894,True,3,0,75,75
166678,2019-09-05 00:00:00+03:00,out,False,900894,False,2,47,68,21
166678,2019-09-05 00:00:00+03:00,in,False,-1,True,8,0,88,88
166678,2019-09-06 00:00:00+03:00,out,False,900894,True,3,0,52,52
166678,2019-09-06 00:00:00+03:00,in,False,888868,False,1,661,668,7
166678,2019-09-06 00:00:00+03:00,out,False,888868,False,1,375,428,53
166678,2019-09-06 00:00:00+03:00,out,False,900894,False,5,378,452,74
166678,2019-09-07 00:00:00+03:00,out,False,900894,True,3,0,96,96
166678,2019-09-07 00:00:00+03:00,in,False,900894,False,1,17,24,7
166678,2019-09-07 00:00:00+03:00,out,False,900894,False,4,167,219,52
166678,2019-09-07 00:00:00+03:00,in,False,-1,True,1,0,31,31
166678,2019-09-08 00:00:00+03:00,in,False,900892,False,3,383,403,20
166678,2019-09-08 00:00:00+03:00,out,False,900892,True,2,0,12,12
166678,2019-09-08 00:00:00+03:00,in,True,900892,False,1,37,40,3
166678,2019-09-08 00:00:00+03:00,out,True,888868,False,2,42,49,7
166678,2019-09-08 00:00:00+03:00,out,False,900892,False,3,206,247,41
166678,2019-09-09 00:00:00+03:00,in,False,900892,False,3,970,984,14
166678,2019-09-09 00:00:00+03:00,out,False,900892,False,4,167,208,41
166678,2019-09-09 00:00:00+03:00,out,False,900892,True,3,0,22,22
166678,2019-09-10 00:00:00+03:00,out,False,900892,False,9,986,1129,143
166678,2019-09-10 00:00:00+03:00,out,False,900894,False,1,501,508,7
166678,2019-09-10 00:00:00+03:00,out,False,900894,True,1,0,56,56
166678,2019-09-10 00:00:00+03:00,in,False,900894,False,1,38,51,13
166678,2019-09-10 00:00:00+03:00,in,False,900892,False,3,412,424,12
166678,2019-09-10 00:00:00+03:00,out,False,900892,True,4,0,118,118
166678,2019-09-11 00:00:00+03:00,out,False,900892,True,5,0,98,98
166678,2019-09-11 00:00:00+03:00,out,False,900894,True,1,0,41,41
166678,2019-09-11 00:00:00+03:00,out,False,900894,False,4,294,322,28
166678,2019-09-11 00:00:00+03:00,out,False,900892,False,9,468,583,115
166678,2019-09-11 00:00:00+03:00,in,False,900892,True,1,0,5,5
166678,2019-09-11 00:00:00+03:00,out,False,900894,True,1,0,41,41
166678,2019-09-12 00:00:00+03:00,in,True,900892,False,1,240,244,4
166678,2019-09-12 00:00:00+03:00,out,False,900894,False,1,23,35,12
166678,2019-09-12 00:00:00+03:00,in,False,900892,False,2,316,325,9
166678,2019-09-12 00:00:00+03:00,out,False,900894,True,3,0,16,16
166678,2019-09-12 00:00:00+03:00,in,False,-1,True,1,0,29,29
166678,2019-09-12 00:00:00+03:00,out,False,900892,False,6,286,359,73
166678,2019-09-12 00:00:00+03:00,out,False,900892,True,3,0,44,44
166678,2019-09-13 00:00:00+03:00,out,False,900894,True,1,0,33,33
166678,2019-09-13 00:00:00+03:00,out,False,900892,True,10,0,157,157
166678,2019-09-13 00:00:00+03:00,out,False,900892,False,7,673,753,80
166678,2019-09-13 00:00:00+03:00,in,False,900892,False,2,513,521,8
166678,2019-09-14 00:00:00+03:00,in,False,900894,False,1,92,97,5
166678,2019-09-14 00:00:00+03:00,in,False,900892,False,4,119,134,15
166678,2019-09-14 00:00:00+03:00,out,False,900892,False,15,631,803,172
166678,2019-09-14 00:00:00+03:00,out,False,900892,True,8,0,156,156
166678,2019-09-14 00:00:00+03:00,out,False,900894,True,1,0,39,39
166678,2019-09-14 00:00:00+03:00,out,False,900894,False,2,137,154,17
166678,2019-09-14 00:00:00+03:00,out,False,900892,True,8,0,156,156
166678,2019-09-15 00:00:00+03:00,out,False,900892,False,7,910,976,66
166678,2019-09-15 00:00:00+03:00,out,False,900894,True,2,0,40,40
166678,2019-09-15 00:00:00+03:00,in,False,900892,False,2,293,303,10
166678,2019-09-15 00:00:00+03:00,in,False,900894,False,2,257,276,19
166678,2019-09-15 00:00:00+03:00,out,False,900894,False,1,125,138,13
166678,2019-09-15 00:00:00+03:00,out,False,900894,False,1,125,138,13
166678,2019-09-16 00:00:00+03:00,in,False,900892,False,8,802,849,47
166678,2019-09-16 00:00:00+03:00,out,False,900892,False,7,521,575,54
166678,2019-09-16 00:00:00+03:00,out,False,900892,True,7,0,135,135
166678,2019-09-17 00:00:00+03:00,in,False,-1,True,2,0,19,19
166678,2019-09-17 00:00:00+03:00,in,False,900892,False,2,58,84,26
166678,2019-09-17 00:00:00+03:00,out,False,900892,False,4,144,218,74
166678,2019-09-17 00:00:00+03:00,out,False,900894,False,4,499,540,41
166678,2019-09-17 00:00:00+03:00,out,False,900892,True,11,0,270,270
166678,2019-09-18 00:00:00+03:00,out,False,900894,True,1,0,25,25
166678,2019-09-18 00:00:00+03:00,out,False,888868,False,1,124,160,36
166678,2019-09-18 00:00:00+03:00,out,False,900892,True,2,0,39,39
166678,2019-09-18 00:00:00+03:00,out,False,900892,False,4,281,324,43
166678,2019-09-18 00:00:00+03:00,in,False,900892,False,2,71,81,10
166678,2019-09-18 00:00:00+03:00,in,False,900892,False,2,71,81,10
166678,2019-09-19 00:00:00+03:00,out,False,900894,False,2,9,58,49
166678,2019-09-19 00:00:00+03:00,in,False,900894,False,1,19,26,7
166678,2019-09-19 00:00:00+03:00,in,False,900892,False,3,550,573,23
166678,2019-09-19 00:00:00+03:00,out,False,900892,False,6,459,541,82
166678,2019-09-19 00:00:00+03:00,out,False,900892,True,2,0,72,72
166678,2019-09-20 00:00:00+03:00,in,False,900892,False,3,351,365,14
166678,2019-09-20 00:00:00+03:00,out,False,900892,True,8,0,172,172
166678,2019-09-20 00:00:00+03:00,out,False,900892,False,7,190,259,69
166678,2019-09-21 00:00:00+03:00,out,False,900892,False,2,110,128,18
166678,2019-09-21 00:00:00+03:00,out,False,900892,True,2,0,43,43
166678,2019-09-21 00:00:00+03:00,in,False,900894,False,3,315,335,20
166678,2019-09-21 00:00:00+03:00,in,False,900892,False,4,560,581,21
166678,2019-09-21 00:00:00+03:00,out,False,900894,False,1,4,41,37
166678,2019-09-21 00:00:00+03:00,out,False,900894,True,2,0,11,11
166678,2019-09-22 00:00:00+03:00,in,False,-1,True,3,0,90,90
166678,2019-09-22 00:00:00+03:00,in,False,900892,False,5,650,709,59
166678,2019-09-22 00:00:00+03:00,out,False,900894,False,2,39,55,16
166678,2019-09-23 00:00:00+03:00,out,False,900892,False,5,245,338,93
166678,2019-09-23 00:00:00+03:00,out,False,900892,True,1,0,10,10
166678,2019-09-23 00:00:00+03:00,in,False,900892,False,2,193,203,10
166678,2019-09-23 00:00:00+03:00,out,False,900894,True,2,0,30,30
166678,2019-09-23 00:00:00+03:00,in,False,-1,True,1,0,30,30
166678,2019-09-23 00:00:00+03:00,in,False,-1,True,1,0,30,30
166678,2019-09-24 00:00:00+03:00,out,False,900892,False,3,986,1014,28
166678,2019-09-24 00:00:00+03:00,out,False,900892,True,2,0,33,33
166678,2019-09-24 00:00:00+03:00,in,False,-1,True,4,0,32,32
166678,2019-09-25 00:00:00+03:00,in,False,900892,False,4,1007,1026,19
166678,2019-09-25 00:00:00+03:00,out,False,900894,False,2,92,105,13
166678,2019-09-25 00:00:00+03:00,out,False,900892,True,3,0,67,67
166678,2019-09-25 00:00:00+03:00,out,False,900892,False,8,624,763,139
166678,2019-09-26 00:00:00+03:00,in,False,888868,False,1,367,375,8
166678,2019-09-26 00:00:00+03:00,in,False,900892,False,5,366,393,27
166678,2019-09-26 00:00:00+03:00,out,False,900892,True,3,0,73,73
166678,2019-09-26 00:00:00+03:00,out,False,900892,False,12,1013,1163,150
166678,2019-09-26 00:00:00+03:00,out,False,900892,False,12,1013,1163,150
166678,2019-09-27 00:00:00+03:00,out,False,900892,False,10,469,577,108
166678,2019-09-27 00:00:00+03:00,in,False,-1,True,1,0,24,24
166678,2019-09-27 00:00:00+03:00,out,False,900894,False,2,661,702,41
166678,2019-09-27 00:00:00+03:00,out,False,900892,True,5,0,89,89
166678,2019-09-27 00:00:00+03:00,in,False,900892,False,4,700,727,27
166678,2019-09-27 00:00:00+03:00,in,False,900892,True,1,0,5,5
166678,2019-09-28 00:00:00+03:00,in,False,900892,False,5,558,579,21
166678,2019-09-28 00:00:00+03:00,out,False,900892,True,7,0,167,167
166678,2019-09-28 00:00:00+03:00,out,False,900892,False,11,1264,1400,136
166678,2019-09-29 00:00:00+03:00,in,False,900894,False,2,404,431,27
166678,2019-09-29 00:00:00+03:00,in,False,-1,True,2,0,39,39
166678,2019-09-29 00:00:00+03:00,out,False,900892,True,3,0,51,51
166678,2019-09-29 00:00:00+03:00,in,False,900892,False,7,1113,1146,33
166678,2019-09-29 00:00:00+03:00,out,False,900894,False,5,982,1034,52
166678,2019-09-29 00:00:00+03:00,out,False,900894,True,1,0,4,4
166678,2019-09-29 00:00:00+03:00,out,False,900892,False,5,376,419,43
166678,2019-10-01 00:00:00+03:00,out,False,900892,True,6,0,96,96
166678,2019-10-01 00:00:00+03:00,in,False,900892,False,3,214,232,18
166678,2019-10-01 00:00:00+03:00,out,False,900892,False,14,1484,1629,145
166678,2019-10-02 00:00:00+03:00,in,True,900892,False,2,74,93,19
166678,2019-10-02 00:00:00+03:00,in,True,925808,False,1,49,68,19
166678,2019-10-02 00:00:00+03:00,out,False,900892,True,8,0,175,175
166678,2019-10-02 00:00:00+03:00,out,True,900892,False,4,360,418,58
166678,2019-10-02 00:00:00+03:00,out,False,900892,False,12,577,719,142
166678,2019-10-02 00:00:00+03:00,in,False,900892,False,8,708,759,51
166678,2019-10-02 00:00:00+03:00,in,False,900892,False,8,708,759,51
166678,2019-10-03 00:00:00+03:00,out,False,900892,False,2,163,199,36
166678,2019-10-03 00:00:00+03:00,out,False,900892,True,4,0,124,124
166678,2019-10-03 00:00:00+03:00,in,False,900892,False,2,264,274,10
166678,2019-10-03 00:00:00+03:00,out,False,900894,False,1,23,48,25
166678,2019-10-03 00:00:00+03:00,out,False,900892,True,4,0,124,124
166678,2019-10-04 00:00:00+03:00,out,False,900892,True,2,0,46,46
166678,2019-10-04 00:00:00+03:00,out,False,900894,True,1,0,60,60
166678,2019-10-04 00:00:00+03:00,in,False,900892,False,4,1187,1218,31
166678,2019-10-04 00:00:00+03:00,out,False,900892,False,4,317,364,47
166678,2019-10-05 00:00:00+03:00,in,False,-1,True,1,0,20,20
166678,2019-10-05 00:00:00+03:00,in,False,888868,False,3,120,251,131
166678,2019-10-05 00:00:00+03:00,in,False,900894,False,6,718,784,66
166678,2019-10-05 00:00:00+03:00,out,False,900894,True,1,0,40,40
166678,2019-10-05 00:00:00+03:00,in,False,925808,False,1,70,88,18
166678,2019-10-05 00:00:00+03:00,out,False,900894,False,4,371,421,50
166678,2019-10-06 00:00:00+03:00,out,False,900894,False,5,179,252,73
166678,2019-10-06 00:00:00+03:00,in,False,900894,False,3,538,553,15
166678,2019-10-06 00:00:00+03:00,out,False,900894,True,1,0,8,8
166678,2019-10-06 00:00:00+03:00,out,False,900892,False,6,294,369,75
166678,2019-10-06 00:00:00+03:00,in,False,900892,False,3,192,211,19
166678,2019-10-06 00:00:00+03:00,out,False,900892,True,4,0,95,95
166678,2019-10-07 00:00:00+03:00,in,False,925808,False,1,187,205,18
166678,2019-10-07 00:00:00+03:00,out,False,900892,False,8,337,405,68
166678,2019-10-07 00:00:00+03:00,out,False,900894,False,2,146,210,64
166678,2019-10-07 00:00:00+03:00,in,False,900892,False,3,161,186,25
166678,2019-10-07 00:00:00+03:00,out,False,900892,True,2,0,58,58
166678,2019-10-08 00:00:00+03:00,out,False,900892,False,1,344,350,6
166678,2019-10-08 00:00:00+03:00,in,False,925808,False,1,20,41,21
166678,2019-10-08 00:00:00+03:00,in,True,900892,False,2,3,30,27
166678,2019-10-08 00:00:00+03:00,in,False,900894,False,2,322,335,13
166678,2019-10-08 00:00:00+03:00,out,False,900894,False,3,291,367,76
166678,2019-10-08 00:00:00+03:00,in,False,900892,False,1,291,299,8
166678,2019-10-08 00:00:00+03:00,out,True,900892,False,1,14,25,11
166678,2019-10-08 00:00:00+03:00,in,False,900894,False,2,322,335,13
166678,2019-10-09 00:00:00+03:00,out,False,900892,True,6,0,117,117
166678,2019-10-09 00:00:00+03:00,out,False,900894,False,3,166,216,50
166678,2019-10-09 00:00:00+03:00,out,False,900892,False,13,1063,1230,167
166678,2019-10-09 00:00:00+03:00,in,False,-1,True,3,0,35,35
166678,2019-10-09 00:00:00+03:00,in,False,900894,False,3,453,474,21
166678,2019-10-09 00:00:00+03:00,in,False,900892,False,6,929,956,27
166678,2019-10-10 00:00:00+03:00,out,False,900892,True,4,0,140,140
166678,2019-10-10 00:00:00+03:00,out,False,900892,False,5,199,265,66
166678,2019-10-10 00:00:00+03:00,in,False,900892,False,2,116,126,10
166678,2019-10-10 00:00:00+03:00,in,False,-1,True,1,0,2,2
166678,2019-10-10 00:00:00+03:00,in,False,900894,False,1,729,737,8
166678,2019-10-10 00:00:00+03:00,out,False,900894,False,2,35,77,42
166678,2019-10-11 00:00:00+03:00,out,False,900894,True,2,0,114,114
166678,2019-10-11 00:00:00+03:00,in,False,900892,False,4,592,610,18
166678,2019-10-11 00:00:00+03:00,out,False,900894,False,3,121,187,66
166678,2019-10-11 00:00:00+03:00,out,False,900892,True,3,0,76,76
166678,2019-10-11 00:00:00+03:00,out,False,900892,False,2,89,124,35
166678,2019-10-11 00:00:00+03:00,out,False,900894,False,3,121,187,66
166678,2019-10-12 00:00:00+03:00,in,False,900892,False,3,205,219,14
166678,2019-10-12 00:00:00+03:00,in,False,-1,True,3,0,57,57
166678,2019-10-12 00:00:00+03:00,in,True,900892,False,1,28,33,5
166678,2019-10-12 00:00:00+03:00,out,True,900894,True,1,0,7,7
166678,2019-10-12 00:00:00+03:00,out,False,900892,True,6,0,175,175
166678,2019-10-12 00:00:00+03:00,in,True,925808,False,1,5,23,18
166678,2019-10-12 00:00:00+03:00,out,False,900892,False,3,80,123,43
166678,2019-10-12 00:00:00+03:00,in,False,925808,False,1,68,80,12
166678,2019-10-13 00:00:00+03:00,out,True,900892,True,1,0,4,4
166678,2019-10-13 00:00:00+03:00,in,False,900894,False,1,439,461,22
166678,2019-10-13 00:00:00+03:00,out,False,900892,False,4,131,227,96
166678,2019-10-13 00:00:00+03:00,in,False,900892,False,2,420,435,15
166678,2019-10-13 00:00:00+03:00,out,False,900892,True,7,0,218,218
166678,2019-10-14 00:00:00+03:00,in,False,900894,False,1,273,280,7
166678,2019-10-14 00:00:00+03:00,out,False,900894,False,1,56,68,12
166678,2019-10-15 00:00:00+03:00,in,False,900892,False,1,372,377,5
166678,2019-10-15 00:00:00+03:00,out,False,900894,True,2,0,74,74
166678,2019-10-15 00:00:00+03:00,in,False,925808,False,1,29,74,45
166678,2019-10-15 00:00:00+03:00,out,False,900894,False,6,321,410,89
166678,2019-10-16 00:00:00+03:00,out,False,900892,False,3,187,222,35
166678,2019-10-16 00:00:00+03:00,out,False,900894,False,4,232,280,48
166678,2019-10-16 00:00:00+03:00,out,False,900892,True,4,0,82,82
166678,2019-10-16 00:00:00+03:00,out,False,900894,True,3,0,47,47
166678,2019-10-16 00:00:00+03:00,in,False,900892,False,4,513,536,23
166678,2019-10-16 00:00:00+03:00,in,False,900894,False,1,149,157,8
166678,2019-10-17 00:00:00+03:00,out,False,900892,False,16,1126,1304,178
166678,2019-10-17 00:00:00+03:00,in,False,900892,False,11,1436,1490,54
166678,2019-10-17 00:00:00+03:00,out,False,900892,True,12,0,312,312
166678,2019-10-17 00:00:00+03:00,out,False,900894,False,1,59,68,9
166678,2019-10-17 00:00:00+03:00,in,False,925808,False,3,205,247,42
166678,2019-10-18 00:00:00+03:00,out,False,900894,True,1,0,3,3
166678,2019-10-18 00:00:00+03:00,in,False,-1,True,1,0,31,31
166678,2019-10-18 00:00:00+03:00,out,False,900892,True,2,0,4,4
166678,2019-10-18 00:00:00+03:00,in,False,900892,False,3,1161,1181,20
166678,2019-10-18 00:00:00+03:00,in,False,900894,False,3,296,319,23
166678,2019-10-18 00:00:00+03:00,out,False,900894,False,5,846,906,60
166678,2019-10-18 00:00:00+03:00,out,False,900892,False,4,257,326,69
166678,2019-10-18 00:00:00+03:00,out,False,900892,False,4,257,326,69
166678,2019-10-19 00:00:00+03:00,in,False,900892,False,4,355,377,22
166678,2019-10-19 00:00:00+03:00,out,False,900892,False,6,509,572,63
166678,2019-10-19 00:00:00+03:00,out,False,900892,True,3,0,92,92
166678,2019-10-20 00:00:00+03:00,in,False,900892,False,2,575,584,9
166678,2019-10-20 00:00:00+03:00,out,False,900894,False,3,232,264,32
166678,2019-10-20 00:00:00+03:00,out,False,900892,False,4,383,463,80
166678,2019-10-20 00:00:00+03:00,out,False,900892,True,4,0,39,39
166678,2019-10-20 00:00:00+03:00,out,False,900892,False,4,383,463,80
166678,2019-10-21 00:00:00+03:00,in,False,888868,False,1,85,128,43
166678,2019-10-21 00:00:00+03:00,in,False,-1,True,4,0,4,4
166678,2019-10-21 00:00:00+03:00,in,False,900894,False,7,2148,2213,65
166678,2019-10-21 00:00:00+03:00,out,False,900892,False,8,321,390,69
166678,2019-10-21 00:00:00+03:00,out,False,900894,False,4,286,324,38
166678,2019-10-21 00:00:00+03:00,out,False,900892,True,7,0,137,137
166678,2019-10-21 00:00:00+03:00,out,False,900894,True,1,0,6,6
166678,2019-10-22 00:00:00+03:00,out,False,900894,True,2,0,18,18
166678,2019-10-22 00:00:00+03:00,in,False,900892,False,8,348,384,36
166678,2019-10-22 00:00:00+03:00,out,False,900892,False,8,139,228,89
166678,2019-10-22 00:00:00+03:00,out,False,900892,True,6,0,111,111
166678,2019-10-22 00:00:00+03:00,out,False,900892,False,8,139,228,89
166678,2019-10-23 00:00:00+03:00,out,False,900892,True,1,0,8,8
166678,2019-10-23 00:00:00+03:00,in,False,925808,False,1,58,74,16
166678,2019-10-23 00:00:00+03:00,out,False,900892,False,7,418,487,69
166678,2019-10-23 00:00:00+03:00,in,False,900892,False,7,1273,1306,33
166678,2019-10-23 00:00:00+03:00,in,False,-1,True,1,0,0,0
166678,2019-10-23 00:00:00+03:00,in,False,900894,False,1,2,23,21
166678,2019-10-23 00:00:00+03:00,in,False,900892,False,7,1273,1306,33
166678,2019-10-24 00:00:00+03:00,out,False,900894,True,1,0,11,11
166678,2019-10-24 00:00:00+03:00,in,False,-1,True,3,0,3,3
166678,2019-10-24 00:00:00+03:00,in,True,900892,False,1,71,96,25
166678,2019-10-24 00:00:00+03:00,out,False,900892,True,3,0,111,111
166678,2019-10-24 00:00:00+03:00,in,True,900894,False,2,63,94,31
166678,2019-10-24 00:00:00+03:00,out,False,900892,False,3,98,142,44
166678,2019-10-24 00:00:00+03:00,in,False,900894,False,2,248,260,12
166678,2019-10-24 00:00:00+03:00,in,False,888868,False,2,157,182,25
166678,2019-10-24 00:00:00+03:00,out,False,900894,False,1,67,79,12
166678,2019-10-24 00:00:00+03:00,in,False,900892,False,1,16,27,11
166678,2019-10-24 00:00:00+03:00,out,False,900894,False,1,67,79,12
166678,2019-10-25 00:00:00+03:00,out,False,900894,True,2,0,68,68
166678,2019-10-25 00:00:00+03:00,out,False,900894,False,5,796,859,63
166678,2019-10-25 00:00:00+03:00,in,False,900894,False,4,723,786,63
166678,2019-10-25 00:00:00+03:00,in,False,888868,False,2,836,858,22
166678,2019-10-25 00:00:00+03:00,in,False,-1,True,4,0,23,23
166678,2019-10-25 00:00:00+03:00,out,False,900892,True,5,0,75,75
166678,2019-10-25 00:00:00+03:00,in,True,900894,False,1,19,33,14
166678,2019-10-25 00:00:00+03:00,out,False,900892,False,2,243,260,17
166678,2019-10-25 00:00:00+03:00,in,False,900892,False,4,507,529,22
166678,2019-10-25 00:00:00+03:00,in,True,900892,False,1,19,35,16
166678,2019-10-26 00:00:00+03:00,out,False,900892,True,2,0,56,56
166678,2019-10-26 00:00:00+03:00,in,False,900892,False,1,83,95,12
166678,2019-10-26 00:00:00+03:00,out,False,900894,False,3,418,471,53
166678,2019-10-26 00:00:00+03:00,out,False,900892,False,7,999,1071,72
166678,2019-10-26 00:00:00+03:00,in,False,-1,True,26,0,95,95
166678,2019-10-26 00:00:00+03:00,in,False,888868,False,3,410,470,60
166678,2019-10-26 00:00:00+03:00,in,False,-1,True,26,0,95,95
166678,2019-10-27 00:00:00+03:00,out,False,900894,False,9,1084,1162,78
166678,2019-10-27 00:00:00+03:00,in,False,-1,True,9,0,10,10
166678,2019-10-27 00:00:00+03:00,in,False,888868,True,1,1,16,15
166678,2019-10-27 00:00:00+03:00,in,False,888868,False,2,104,151,47
166678,2019-10-27 00:00:00+03:00,in,False,888868,False,2,104,151,47
166678,2019-10-28 00:00:00+03:00,out,False,900894,False,10,1416,1529,113
166678,2019-10-28 00:00:00+03:00,in,False,942214,False,1,63,75,12
166678,2019-10-28 00:00:00+03:00,in,True,900894,False,1,30,44,14
166678,2019-10-28 00:00:00+03:00,in,False,888868,False,1,898,922,24
166678,2019-10-28 00:00:00+03:00,in,False,-1,True,13,0,58,58
166678,2019-10-28 00:00:00+03:00,out,False,900894,True,2,0,82,82
166678,2019-10-28 00:00:00+03:00,in,False,900894,False,11,641,747,106
166678,2019-10-28 00:00:00+03:00,in,False,-1,True,13,0,58,58
166678,2019-10-29 00:00:00+03:00,in,False,900892,False,3,612,625,13
166678,2019-10-29 00:00:00+03:00,in,False,900894,False,2,65,74,9
166678,2019-10-29 00:00:00+03:00,in,True,900892,False,4,118,155,37
166678,2019-10-29 00:00:00+03:00,out,False,900894,False,2,538,556,18
166678,2019-10-29 00:00:00+03:00,in,True,942214,False,1,13,22,9
166678,2019-10-29 00:00:00+03:00,out,False,900892,False,4,495,530,35
166678,2019-10-29 00:00:00+03:00,out,False,900894,True,1,0,8,8
166678,2019-10-29 00:00:00+03:00,out,True,900892,True,1,0,0,0
166678,2019-10-29 00:00:00+03:00,in,True,942214,False,1,13,22,9
166678,2019-10-30 00:00:00+03:00,in,False,-1,True,2,0,24,24
166678,2019-10-30 00:00:00+03:00,out,False,900894,True,2,0,10,10
166678,2019-10-30 00:00:00+03:00,in,False,900894,False,3,13,45,32
166678,2019-10-30 00:00:00+03:00,in,False,900892,False,1,119,124,5
166678,2019-10-30 00:00:00+03:00,out,False,900892,True,2,0,37,37
166678,2019-10-30 00:00:00+03:00,out,False,900892,False,3,485,518,33
166678,2019-10-30 00:00:00+03:00,out,False,900894,False,3,129,151,22
166678,2019-10-31 00:00:00+03:00,out,False,900892,True,6,0,101,101
166678,2019-10-31 00:00:00+03:00,in,False,900892,False,3,977,1000,23
166678,2019-10-31 00:00:00+03:00,out,False,900892,False,9,489,612,123
166678,2019-11-01 00:00:00+03:00,in,False,900894,False,3,391,430,39
166678,2019-11-01 00:00:00+03:00,out,False,900894,False,5,371,428,57
166678,2019-11-01 00:00:00+03:00,in,False,-1,True,1,0,23,23
166678,2019-11-01 00:00:00+03:00,in,False,-1,True,1,0,1,1
166678,2019-11-01 00:00:00+03:00,out,False,900894,True,3,0,60,60
166678,2019-11-01 00:00:00+03:00,in,False,-1,True,1,0,23,23
166678,2019-11-02 00:00:00+03:00,out,False,900892,False,1,30,42,12
166678,2019-11-02 00:00:00+03:00,out,False,900892,True,3,0,89,89
166678,2019-11-02 00:00:00+03:00,in,False,900892,False,4,376,428,52
166678,2019-11-02 00:00:00+03:00,out,False,900892,True,3,0,89,89
166678,2019-11-03 00:00:00+03:00,in,False,-1,True,1,0,29,29
166678,2019-11-03 00:00:00+03:00,in,False,900892,False,3,472,490,18
166678,2019-11-03 00:00:00+03:00,out,False,900892,False,6,281,371,90
166678,2019-11-03 00:00:00+03:00,out,False,900894,False,1,84,93,9
166678,2019-11-03 00:00:00+03:00,out,False,900892,True,3,0,98,98
166678,2019-11-04 00:00:00+03:00,out,False,900892,False,3,59,112,53
166678,2019-11-04 00:00:00+03:00,in,False,900892,False,4,502,525,23
166678,2019-11-04 00:00:00+03:00,out,False,900892,True,2,0,71,71
166678,2019-11-04 00:00:00+03:00,out,False,900894,True,1,0,6,6
166678,2019-11-04 00:00:00+03:00,in,False,900894,False,1,77,89,12
166678,2019-11-04 00:00:00+03:00,in,False,-1,True,1,0,23,23
166678,2019-11-05 00:00:00+03:00,in,True,900894,False,1,18,55,37
166678,2019-11-05 00:00:00+03:00,out,True,900894,True,1,0,0,0
166678,2019-11-05 00:00:00+03:00,out,False,900892,False,2,276,306,30
166678,2019-11-05 00:00:00+03:00,in,False,900894,False,5,594,686,92
166678,2019-11-05 00:00:00+03:00,in,False,-1,True,2,0,48,48
166678,2019-11-05 00:00:00+03:00,out,False,900894,False,2,317,338,21
166678,2019-11-06 00:00:00+03:00,out,False,900892,False,6,453,531,78
166678,2019-11-06 00:00:00+03:00,out,False,900892,True,2,0,63,63
166678,2019-11-06 00:00:00+03:00,in,False,900892,False,19,2538,2699,161
166678,2019-11-06 00:00:00+03:00,in,False,934608,False,1,27,39,12
166678,2019-11-06 00:00:00+03:00,out,True,900892,True,3,0,0,0
166678,2019-11-07 00:00:00+03:00,out,False,900892,True,1,0,33,33
166678,2019-11-07 00:00:00+03:00,out,False,900894,True,1,0,60,60
166678,2019-11-07 00:00:00+03:00,in,False,934608,False,1,5,16,11
166678,2019-11-07 00:00:00+03:00,in,False,900892,False,1,2,5,3
166678,2019-11-07 00:00:00+03:00,out,False,900894,False,3,164,212,48
166678,2019-11-07 00:00:00+03:00,out,False,900892,False,1,321,331,10
166678,2019-11-07 00:00:00+03:00,in,False,900894,False,4,564,630,66
166678,2019-11-07 00:00:00+03:00,in,False,900892,False,1,2,5,3
166678,2019-11-07 00:00:00+03:00,out,False,900894,True,1,0,60,60
166678,2019-11-08 00:00:00+03:00,out,False,900892,False,12,1216,1339,123
166678,2019-11-08 00:00:00+03:00,out,False,900892,True,7,0,178,178
166678,2019-11-08 00:00:00+03:00,in,False,-1,True,4,0,80,80
166678,2019-11-08 00:00:00+03:00,in,False,900892,False,9,1865,1924,59
166678,2019-11-09 00:00:00+03:00,out,True,900894,True,1,0,0,0
166678,2019-11-09 00:00:00+03:00,out,False,900894,False,3,445,475,30
166678,2019-11-09 00:00:00+03:00,in,False,-1,True,15,0,33,33
166678,2019-11-09 00:00:00+03:00,out,False,900894,True,2,0,0,0
166678,2019-11-09 00:00:00+03:00,in,False,900894,False,1,16,25,9
166678,2019-11-09 00:00:00+03:00,in,False,-1,True,15,0,33,33
166678,2019-11-10 00:00:00+03:00,out,False,900892,False,5,400,458,58
166678,2019-11-10 00:00:00+03:00,in,False,900892,False,6,772,813,41
166678,2019-11-10 00:00:00+03:00,out,False,900892,True,2,0,59,59
166678,2019-11-11 00:00:00+03:00,out,False,900894,False,3,231,272,41
166678,2019-11-11 00:00:00+03:00,out,False,900892,False,5,256,305,49
166678,2019-11-11 00:00:00+03:00,in,False,-1,True,3,0,86,86
166678,2019-11-11 00:00:00+03:00,in,False,900894,False,8,1317,1449,132
166678,2019-11-11 00:00:00+03:00,out,False,900892,True,2,0,29,29
166678,2019-11-11 00:00:00+03:00,out,False,900894,True,3,0,87,87
166678,2019-11-11 00:00:00+03:00,in,False,-1,True,3,0,86,86
166678,2019-11-12 00:00:00+03:00,out,False,900892,False,5,357,419,62
166678,2019-11-12 00:00:00+03:00,out,False,900892,True,3,0,52,52
166678,2019-11-12 00:00:00+03:00,out,False,900894,False,1,80,95,15
166678,2019-11-12 00:00:00+03:00,in,False,900892,False,3,1478,1498,20
166678,2019-11-12 00:00:00+03:00,in,False,-1,True,2,0,43,43
166678,2019-11-13 00:00:00+03:00,in,False,900892,False,5,1048,1080,32
166678,2019-11-13 00:00:00+03:00,in,False,934608,False,1,84,99,15
166678,2019-11-13 00:00:00+03:00,in,False,-1,True,4,0,50,50
166678,2019-11-13 00:00:00+03:00,out,False,900892,True,13,0,273,273
166678,2019-11-13 00:00:00+03:00,out,False,900892,False,12,702,843,141
166678,2019-11-13 00:00:00+03:00,in,False,900894,False,2,103,119,16
166678,2019-11-13 00:00:00+03:00,in,False,934608,False,1,84,99,15
166678,2019-11-14 00:00:00+03:00,in,False,900892,False,4,825,867,42
166678,2019-11-14 00:00:00+03:00,out,False,900892,False,11,881,1012,131
166678,2019-11-14 00:00:00+03:00,in,False,900894,False,1,43,55,12
166678,2019-11-14 00:00:00+03:00,in,False,934608,False,2,124,151,27
166678,2019-11-14 00:00:00+03:00,out,False,900892,True,14,0,175,175
166678,2019-11-15 00:00:00+03:00,out,False,900892,False,6,930,998,68
166678,2019-11-15 00:00:00+03:00,out,False,900892,True,5,0,90,90
166678,2019-11-15 00:00:00+03:00,in,False,900892,False,7,1186,1223,37
166678,2019-11-16 00:00:00+03:00,out,False,900892,False,5,391,449,58
166678,2019-11-16 00:00:00+03:00,in,False,934608,False,2,218,245,27
166678,2019-11-16 00:00:00+03:00,in,False,900892,False,5,1143,1189,46
166678,2019-11-16 00:00:00+03:00,out,False,900892,True,5,0,93,93
166678,2019-11-16 00:00:00+03:00,in,False,900892,False,5,1143,1189,46
166678,2019-11-17 00:00:00+03:00,in,False,900892,False,7,1235,1302,67
166678,2019-11-17 00:00:00+03:00,out,False,900892,False,5,318,380,62
166678,2019-11-17 00:00:00+03:00,out,False,900892,True,2,0,60,60
166678,2019-11-17 00:00:00+03:00,in,False,-1,True,1,0,26,26
166678,2019-11-18 00:00:00+03:00,in,False,900894,False,7,1312,1397,85
166678,2019-11-18 00:00:00+03:00,out,False,900892,True,4,0,58,58
166678,2019-11-18 00:00:00+03:00,out,False,900894,False,6,443,504,61
166678,2019-11-18 00:00:00+03:00,in,False,900892,False,3,413,433,20
166678,2019-11-18 00:00:00+03:00,in,False,-1,True,1,0,10,10
166678,2019-11-18 00:00:00+03:00,out,False,900892,False,12,730,890,160
166678,2019-11-19 00:00:00+03:00,out,False,900892,True,7,0,110,110
166678,2019-11-19 00:00:00+03:00,out,False,900894,False,1,40,51,11
166678,2019-11-19 00:00:00+03:00,in,False,900892,False,14,1500,1609,109
166678,2019-11-19 00:00:00+03:00,out,False,900892,False,12,1895,2056,161
166678,2019-11-19 00:00:00+03:00,in,False,900894,False,1,58,76,18
166678,2019-11-20 00:00:00+03:00,out,False,900892,False,7,383,455,72
166678,2019-11-20 00:00:00+03:00,in,False,934608,False,1,112,126,14
166678,2019-11-20 00:00:00+03:00,out,False,900892,True,5,0,118,118
166678,2019-11-20 00:00:00+03:00,in,False,900892,False,2,66,91,25
166678,2019-11-20 00:00:00+03:00,out,False,900894,False,3,463,505,42
166678,2019-11-20 00:00:00+03:00,in,False,-1,True,6,0,160,160
166678,2019-11-20 00:00:00+03:00,out,False,900894,False,3,463,505,42
166678,2019-11-21 00:00:00+03:00,in,False,900892,False,5,937,988,51
166678,2019-11-21 00:00:00+03:00,out,False,900892,True,4,0,64,64
166678,2019-11-21 00:00:00+03:00,out,False,900892,False,10,2427,2559,132
166678,2019-11-21 00:00:00+03:00,in,False,934608,False,1,297,311,14
166678,2019-11-21 00:00:00+03:00,in,False,-1,True,4,0,81,81
166678,2019-11-21 00:00:00+03:00,out,False,900894,True,1,0,5,5
166678,2019-11-21 00:00:00+03:00,in,True,900892,False,1,21,33,12
166678,2019-11-21 00:00:00+03:00,in,False,900894,False,1,96,109,13
166678,2019-11-22 00:00:00+03:00,out,False,900892,False,12,654,829,175
166678,2019-11-22 00:00:00+03:00,out,False,900892,True,11,0,176,176
166678,2019-11-22 00:00:00+03:00,in,False,-1,True,2,0,35,35
166678,2019-11-22 00:00:00+03:00,in,False,900892,False,4,206,240,34
166678,2019-11-23 00:00:00+03:00,in,False,900894,False,2,71,107,36
166678,2019-11-23 00:00:00+03:00,out,False,900894,False,1,445,456,11
166678,2019-11-24 00:00:00+03:00,out,False,900892,False,16,1370,1558,188
166678,2019-11-24 00:00:00+03:00,out,False,900892,True,9,0,246,246
166678,2019-11-24 00:00:00+03:00,in,False,900892,False,5,246,293,47
166678,2019-11-24 00:00:00+03:00,out,False,900892,False,16,1370,1558,188
166678,2019-11-25 00:00:00+03:00,out,False,900894,False,2,72,87,15
166678,2019-11-25 00:00:00+03:00,in,False,-1,True,2,0,57,57
166678,2019-11-25 00:00:00+03:00,in,False,900894,True,1,0,12,12
166678,2019-11-26 00:00:00+03:00,out,False,900892,False,4,760,824,64
166678,2019-11-26 00:00:00+03:00,in,False,900892,False,6,1180,1249,69
166678,2019-11-26 00:00:00+03:00,in,False,900894,False,2,396,425,29
166678,2019-11-26 00:00:00+03:00,in,False,-1,True,1,0,26,26
166678,2019-11-26 00:00:00+03:00,out,False,900892,True,5,0,108,108
166678,2019-11-26 00:00:00+03:00,out,False,900894,False,1,41,53,12
166678,2019-11-26 00:00:00+03:00,in,False,900892,False,6,1180,1249,69
166678,2019-11-26 00:00:00+03:00,in,False,900894,False,2,396,425,29
166678,2019-11-27 00:00:00+03:00,out,False,900892,False,8,356,442,86
166678,2019-11-27 00:00:00+03:00,in,False,900894,False,1,340,376,36
166678,2019-11-27 00:00:00+03:00,in,False,900892,False,4,574,594,20
166678,2019-11-27 00:00:00+03:00,out,False,900892,True,7,0,171,171
166678,2019-11-28 00:00:00+03:00,in,False,-1,True,1,0,34,34
166678,2019-11-28 00:00:00+03:00,out,False,900892,True,9,0,229,229
166678,2019-11-28 00:00:00+03:00,in,False,900892,False,6,466,497,31
166678,2019-11-28 00:00:00+03:00,out,False,900892,False,8,1607,1696,89
166680,2019-08-19 00:00:00+03:00,in,False,-1,True,1,0,2,2
166680,2019-08-20 00:00:00+03:00,out,False,891744,True,1,0,18,18
166680,2019-08-20 00:00:00+03:00,in,False,891744,False,1,22,27,5
166680,2019-08-21 00:00:00+03:00,in,False,-1,True,1,0,37,37
166680,2019-08-21 00:00:00+03:00,out,False,891744,False,1,13,20,7
166680,2019-08-21 00:00:00+03:00,in,False,891744,False,1,10,35,25
166680,2019-08-22 00:00:00+03:00,out,False,891744,False,3,50,71,21
166680,2019-08-22 00:00:00+03:00,in,False,891744,False,2,32,55,23
166680,2019-08-22 00:00:00+03:00,out,False,891744,False,3,50,71,21
166680,2019-08-27 00:00:00+03:00,in,False,-1,True,1,0,6,6
166680,2019-09-10 00:00:00+03:00,in,False,-1,True,4,0,75,75
166680,2019-09-10 00:00:00+03:00,out,False,891744,True,1,0,18,18
166680,2019-09-11 00:00:00+03:00,out,False,891746,False,7,458,543,85
166680,2019-09-11 00:00:00+03:00,out,False,891746,True,6,0,223,223
166680,2019-09-11 00:00:00+03:00,out,False,908984,False,5,271,399,128
166680,2019-09-11 00:00:00+03:00,out,False,908984,True,3,0,80,80
166680,2019-09-11 00:00:00+03:00,out,False,908984,False,5,271,399,128
166680,2019-09-12 00:00:00+03:00,out,False,891746,False,9,374,495,121
166680,2019-09-12 00:00:00+03:00,in,False,-1,True,1,0,7,7
166680,2019-09-12 00:00:00+03:00,out,False,891746,True,7,0,353,353
166680,2019-09-13 00:00:00+03:00,out,False,891746,False,4,96,167,71
166680,2019-09-13 00:00:00+03:00,out,False,891746,False,4,96,167,71
166680,2019-09-20 00:00:00+03:00,out,False,915614,True,1,0,3,3
166680,2019-09-21 00:00:00+03:00,out,False,916596,False,1,29,53,24
166680,2019-09-23 00:00:00+03:00,out,False,916596,True,11,0,187,187
166680,2019-09-23 00:00:00+03:00,out,False,916596,False,18,1482,1642,160
166680,2019-09-24 00:00:00+03:00,out,False,917234,False,31,2654,2884,230
166680,2019-09-24 00:00:00+03:00,out,False,917234,True,20,0,492,492
166680,2019-09-24 00:00:00+03:00,in,False,915614,False,2,63,119,56
166680,2019-09-24 00:00:00+03:00,out,False,915614,False,7,370,417,47
166680,2019-09-24 00:00:00+03:00,in,False,-1,True,6,0,60,60
166680,2019-09-24 00:00:00+03:00,out,False,915614,True,2,0,76,76
166680,2019-09-25 00:00:00+03:00,out,False,919418,True,2,0,10,10
166680,2019-09-25 00:00:00+03:00,out,False,915614,False,2,76,84,8
166680,2019-09-25 00:00:00+03:00,out,False,915614,True,1,0,12,12
166680,2019-09-26 00:00:00+03:00,in,False,-1,True,3,0,29,29
166680,2019-10-08 00:00:00+03:00,out,False,915614,True,2,0,38,38
166680,2019-10-09 00:00:00+03:00,out,False,932050,True,4,0,1,1
166680,2019-10-09 00:00:00+03:00,in,False,-1,True,9,0,102,102
166680,2019-10-09 00:00:00+03:00,out,False,932050,False,1,7,45,38
166680,2019-10-09 00:00:00+03:00,out,False,917234,True,1,0,10,10
166680,2019-10-09 00:00:00+03:00,out,False,915614,False,4,220,252,32
166680,2019-10-09 00:00:00+03:00,out,False,915614,True,1,0,38,38
166680,2019-10-09 00:00:00+03:00,in,False,-1,True,9,0,102,102
166680,2019-10-10 00:00:00+03:00,out,False,915614,False,2,37,61,24
166680,2019-10-10 00:00:00+03:00,out,False,932088,False,8,1061,1179,118
166680,2019-10-10 00:00:00+03:00,out,False,915614,True,1,0,43,43
166680,2019-10-10 00:00:00+03:00,out,False,917234,True,12,0,246,246
166680,2019-10-10 00:00:00+03:00,out,False,932088,True,2,0,19,19
166680,2019-10-10 00:00:00+03:00,out,False,917234,False,17,1084,1299,215
166680,2019-10-10 00:00:00+03:00,in,False,-1,True,2,0,23,23
166680,2019-10-11 00:00:00+03:00,in,False,-1,True,2,0,16,16
166680,2019-10-11 00:00:00+03:00,out,False,917234,True,20,0,391,391
166680,2019-10-11 00:00:00+03:00,out,False,932502,False,38,2578,3134,556
166680,2019-10-11 00:00:00+03:00,out,False,917234,False,18,1317,1447,130
166680,2019-10-11 00:00:00+03:00,out,False,932500,True,33,0,754,754
166680,2019-10-11 00:00:00+03:00,out,False,915614,True,3,0,119,119
166680,2019-10-11 00:00:00+03:00,out,False,915614,False,9,503,631,128
166680,2019-10-11 00:00:00+03:00,out,False,932502,True,40,0,661,661
166680,2019-10-11 00:00:00+03:00,in,False,932502,False,1,128,146,18
166680,2019-10-11 00:00:00+03:00,out,False,932088,False,2,216,219,3
166680,2019-10-11 00:00:00+03:00,out,False,932500,False,29,2496,2969,473
166680,2019-10-11 00:00:00+03:00,in,False,932502,False,1,128,146,18
166680,2019-10-12 00:00:00+03:00,out,False,915614,False,1,31,49,18
166680,2019-10-12 00:00:00+03:00,in,False,-1,True,3,0,22,22
166680,2019-10-12 00:00:00+03:00,out,False,932502,False,38,3673,4199,526
166680,2019-10-12 00:00:00+03:00,out,False,932500,True,21,0,472,472
166680,2019-10-12 00:00:00+03:00,out,False,932500,False,28,2132,2624,492
166680,2019-10-12 00:00:00+03:00,out,False,915614,True,12,0,73,73
166680,2019-10-12 00:00:00+03:00,out,False,932502,True,18,0,449,449
166680,2019-10-12 00:00:00+03:00,out,False,915614,True,12,0,73,73
166680,2019-10-14 00:00:00+03:00,in,False,932502,False,1,95,119,24
166680,2019-10-14 00:00:00+03:00,out,False,932502,True,29,0,753,753
166680,2019-10-14 00:00:00+03:00,out,False,932500,False,43,3191,3847,656
166680,2019-10-14 00:00:00+03:00,in,False,932500,False,2,1208,1248,40
166680,2019-10-14 00:00:00+03:00,out,False,917234,False,38,3462,3764,302
166680,2019-10-14 00:00:00+03:00,out,False,917234,True,23,0,436,436
166680,2019-10-14 00:00:00+03:00,out,False,932502,False,45,3587,4177,590
166680,2019-10-14 00:00:00+03:00,out,False,932500,True,26,0,630,630
166680,2019-10-14 00:00:00+03:00,in,False,-1,True,3,0,64,64
166680,2019-10-15 00:00:00+03:00,out,False,932502,False,37,5577,6126,549
166680,2019-10-15 00:00:00+03:00,in,False,-1,True,2,0,11,11
166680,2019-10-15 00:00:00+03:00,in,False,932500,False,1,4,19,15
166680,2019-10-15 00:00:00+03:00,out,False,932502,True,16,0,497,497
166680,2019-10-15 00:00:00+03:00,out,False,917234,False,22,3122,3321,199
166680,2019-10-15 00:00:00+03:00,out,False,917234,True,15,0,525,525
166680,2019-10-15 00:00:00+03:00,out,False,932500,False,36,2380,2908,528
166680,2019-10-15 00:00:00+03:00,out,False,932500,True,23,0,788,788
166680,2019-10-15 00:00:00+03:00,out,False,932050,False,1,29,65,36
166680,2019-10-15 00:00:00+03:00,in,False,932500,False,1,4,19,15
166680,2019-10-15 00:00:00+03:00,in,False,-1,True,2,0,11,11
166680,2019-10-16 00:00:00+03:00,out,False,917234,True,25,0,746,746
166680,2019-10-16 00:00:00+03:00,out,False,932500,True,21,0,698,698
166680,2019-10-16 00:00:00+03:00,out,False,932502,True,17,0,587,587
166680,2019-10-16 00:00:00+03:00,out,False,932502,False,36,5417,5991,574
166680,2019-10-16 00:00:00+03:00,out,False,932050,False,15,2063,2278,215
166680,2019-10-16 00:00:00+03:00,out,False,932050,True,20,0,525,525
166680,2019-10-16 00:00:00+03:00,out,False,917234,False,21,2338,2622,284
166680,2019-10-16 00:00:00+03:00,in,False,932500,False,1,315,330,15
166680,2019-10-16 00:00:00+03:00,out,False,932500,False,27,2070,2491,421
166680,2019-10-16 00:00:00+03:00,in,False,-1,True,4,0,30,30
166680,2019-10-17 00:00:00+03:00,out,False,932502,True,3,0,107,107
166680,2019-10-17 00:00:00+03:00,out,False,932050,False,11,1167,1322,155
166680,2019-10-17 00:00:00+03:00,in,False,-1,True,1,0,7,7
166680,2019-10-17 00:00:00+03:00,out,False,917234,True,5,0,204,204
166680,2019-10-17 00:00:00+03:00,in,False,917234,False,1,109,125,16
166680,2019-10-17 00:00:00+03:00,out,False,917234,False,17,1292,1549,257
166680,2019-10-17 00:00:00+03:00,out,False,932500,False,1,28,36,8
166680,2019-10-17 00:00:00+03:00,out,False,932050,True,6,0,162,162
166680,2019-10-17 00:00:00+03:00,out,False,932502,False,6,751,880,129
166680,2019-10-18 00:00:00+03:00,out,False,932500,False,30,2395,2803,408
166680,2019-10-18 00:00:00+03:00,out,False,932500,True,29,0,740,740
166680,2019-10-18 00:00:00+03:00,out,False,932502,False,41,3570,4309,739
166680,2019-10-18 00:00:00+03:00,out,False,932050,True,1,0,45,45
166680,2019-10-18 00:00:00+03:00,out,False,917234,False,18,4378,4578,200
166680,2019-10-18 00:00:00+03:00,out,False,917234,True,12,0,196,196
166680,2019-10-18 00:00:00+03:00,out,False,932502,True,20,0,696,696
166680,2019-10-18 00:00:00+03:00,out,False,932050,False,4,563,606,43
166680,2019-10-18 00:00:00+03:00,out,False,917234,False,18,4378,4578,200
166680,2019-10-21 00:00:00+03:00,in,False,891744,False,1,3,57,54
166680,2019-10-21 00:00:00+03:00,out,False,932050,True,3,0,37,37
166680,2019-10-21 00:00:00+03:00,out,False,932500,True,25,0,298,298
166680,2019-10-21 00:00:00+03:00,out,False,917234,True,17,0,394,394
166680,2019-10-21 00:00:00+03:00,out,False,932500,False,25,1961,2263,302
166680,2019-10-21 00:00:00+03:00,out,False,917234,False,31,3298,3654,356
166680,2019-10-21 00:00:00+03:00,in,False,932500,False,1,131,144,13
166680,2019-10-21 00:00:00+03:00,out,False,932050,False,26,3625,4071,446
166680,2019-10-21 00:00:00+03:00,in,False,-1,True,3,0,31,31
166680,2019-10-21 00:00:00+03:00,out,False,932502,True,20,0,589,589
166680,2019-10-21 00:00:00+03:00,out,True,917234,True,2,0,0,0
166680,2019-10-21 00:00:00+03:00,out,False,932502,False,28,2257,2663,406
166680,2019-10-22 00:00:00+03:00,out,False,932498,True,11,0,188,188
166680,2019-10-22 00:00:00+03:00,out,False,917234,True,9,0,154,154
166680,2019-10-22 00:00:00+03:00,in,False,-1,True,1,0,7,7
166680,2019-10-22 00:00:00+03:00,out,False,932498,False,15,953,1215,262
166680,2019-10-22 00:00:00+03:00,out,False,943050,True,61,0,423,423
166680,2019-10-22 00:00:00+03:00,out,False,917234,False,8,527,631,104
166680,2019-10-22 00:00:00+03:00,out,False,932050,False,25,1149,1535,386
166680,2019-10-22 00:00:00+03:00,out,False,943050,False,12,986,1153,167
166680,2019-10-22 00:00:00+03:00,out,False,932050,True,28,0,545,545
166680,2019-10-22 00:00:00+03:00,out,False,943050,False,12,986,1153,167
166680,2019-10-22 00:00:00+03:00,out,False,917234,True,9,0,154,154
166680,2019-10-23 00:00:00+03:00,in,False,-1,True,2,0,30,30
166680,2019-10-24 00:00:00+03:00,out,False,917234,False,17,2260,2494,234
166680,2019-10-24 00:00:00+03:00,out,False,917234,True,18,0,357,357
166680,2019-10-25 00:00:00+03:00,out,False,917234,True,13,0,179,179
166680,2019-10-25 00:00:00+03:00,in,False,917234,False,1,16,33,17
166680,2019-10-25 00:00:00+03:00,in,False,-1,True,2,0,18,18
166680,2019-10-25 00:00:00+03:00,out,False,917234,False,15,939,1109,170
166680,2019-10-26 00:00:00+03:00,in,False,-1,True,2,0,11,11
166680,2019-10-28 00:00:00+03:00,in,False,-1,True,1,0,15,15
166680,2019-10-30 00:00:00+03:00,out,False,950444,False,3,2159,2216,57
166680,2019-10-30 00:00:00+03:00,in,False,-1,True,1,0,15,15
166680,2019-10-30 00:00:00+03:00,out,False,950444,True,5,0,32,32
166680,2019-10-31 00:00:00+03:00,out,False,950444,True,5,0,161,161
166680,2019-10-31 00:00:00+03:00,out,False,950444,False,8,2666,2771,105
166680,2019-10-31 00:00:00+03:00,in,False,-1,True,2,0,32,32
166680,2019-10-31 00:00:00+03:00,out,False,950444,False,8,2666,2771,105
166680,2019-11-01 00:00:00+03:00,out,False,950444,False,2,1137,1167,30
166680,2019-11-01 00:00:00+03:00,in,False,-1,True,1,0,10,10
166680,2019-11-01 00:00:00+03:00,out,False,950444,True,1,0,60,60
166680,2019-11-02 00:00:00+03:00,in,False,-1,True,2,0,19,19
166680,2019-11-03 00:00:00+03:00,in,False,-1,True,1,0,6,6
166680,2019-11-05 00:00:00+03:00,out,False,950444,False,2,240,277,37
166680,2019-11-06 00:00:00+03:00,out,False,917234,True,25,0,282,282
166680,2019-11-06 00:00:00+03:00,out,False,932498,True,17,0,363,363
166680,2019-11-06 00:00:00+03:00,out,False,941628,False,21,2763,2950,187
166680,2019-11-06 00:00:00+03:00,in,False,-1,True,5,0,104,104
166680,2019-11-06 00:00:00+03:00,out,False,917234,False,21,1792,2067,275
166680,2019-11-06 00:00:00+03:00,out,False,932500,False,38,2404,2991,587
166680,2019-11-06 00:00:00+03:00,out,False,915614,False,3,193,239,46
166680,2019-11-06 00:00:00+03:00,out,False,932500,True,9,0,151,151
166680,2019-11-06 00:00:00+03:00,out,False,-1,True,1,0,0,0
166680,2019-11-06 00:00:00+03:00,in,False,917234,False,1,20,29,9
166680,2019-11-06 00:00:00+03:00,out,False,941628,True,7,0,93,93
166680,2019-11-06 00:00:00+03:00,out,False,932498,False,17,1546,1804,258
166680,2019-11-06 00:00:00+03:00,out,False,950444,False,1,155,164,9
166680,2019-11-06 00:00:00+03:00,out,False,954642,False,29,2964,3317,353
166680,2019-11-06 00:00:00+03:00,out,False,954642,True,8,0,166,166
166680,2019-11-06 00:00:00+03:00,out,False,915614,True,9,0,39,39
166680,2019-11-06 00:00:00+03:00,out,False,932498,True,17,0,363,363
166680,2019-11-07 00:00:00+03:00,out,False,941628,False,12,954,1077,123
166680,2019-11-07 00:00:00+03:00,out,False,950444,False,6,3142,3203,61
166680,2019-11-07 00:00:00+03:00,out,False,917234,True,28,0,493,493
166680,2019-11-07 00:00:00+03:00,out,False,932500,False,29,1625,2050,425
166680,2019-11-07 00:00:00+03:00,out,False,941628,True,9,0,53,53
166680,2019-11-07 00:00:00+03:00,in,False,941628,False,1,99,118,19
166680,2019-11-07 00:00:00+03:00,out,False,917234,False,35,3892,4321,429
166680,2019-11-07 00:00:00+03:00,out,False,950444,True,5,0,53,53
166680,2019-11-07 00:00:00+03:00,out,False,954642,False,21,1319,1562,243
166680,2019-11-07 00:00:00+03:00,out,False,932498,True,12,0,337,337
166680,2019-11-07 00:00:00+03:00,out,False,932500,True,27,0,641,641
166680,2019-11-07 00:00:00+03:00,out,False,932498,False,27,1990,2413,423
166680,2019-11-07 00:00:00+03:00,out,False,954642,True,5,0,72,72
166680,2019-11-07 00:00:00+03:00,in,False,932500,False,1,125,146,21
166680,2019-11-07 00:00:00+03:00,in,False,-1,True,7,0,116,116
166680,2019-11-08 00:00:00+03:00,out,False,941628,True,4,0,130,130
166680,2019-11-08 00:00:00+03:00,out,False,932500,True,24,0,390,390
166680,2019-11-08 00:00:00+03:00,in,False,917234,False,1,16,28,12
166680,2019-11-08 00:00:00+03:00,out,False,941628,False,14,795,939,144
166680,2019-11-08 00:00:00+03:00,out,False,917234,False,56,4824,5880,1056
166680,2019-11-08 00:00:00+03:00,in,False,-1,True,6,0,140,140
166680,2019-11-08 00:00:00+03:00,in,False,932500,False,2,9,49,40
166680,2019-11-08 00:00:00+03:00,out,False,932498,True,26,0,882,882
166680,2019-11-08 00:00:00+03:00,out,False,932500,False,33,2310,2794,484
166680,2019-11-08 00:00:00+03:00,out,False,932498,False,25,2852,3235,383
166680,2019-11-08 00:00:00+03:00,out,False,917234,True,19,0,537,537
166680,2019-11-08 00:00:00+03:00,out,False,932498,True,26,0,882,882
166680,2019-11-08 00:00:00+03:00,out,False,917234,True,19,0,537,537
166680,2019-11-09 00:00:00+03:00,out,False,917234,False,4,116,201,85
166680,2019-11-09 00:00:00+03:00,out,False,917234,True,1,0,16,16
166680,2019-11-10 00:00:00+03:00,out,False,950444,True,1,0,1,1
166680,2019-11-11 00:00:00+03:00,out,False,932500,True,39,0,468,468
166680,2019-11-11 00:00:00+03:00,out,False,941628,False,37,3622,4089,467
166680,2019-11-11 00:00:00+03:00,out,False,941628,True,11,0,275,275
166680,2019-11-11 00:00:00+03:00,out,False,932498,True,24,0,482,482
166680,2019-11-11 00:00:00+03:00,in,False,932498,False,1,78,89,11
166680,2019-11-11 00:00:00+03:00,out,False,932500,False,25,2330,2715,385
166680,2019-11-11 00:00:00+03:00,out,False,932498,False,28,1964,2394,430
166680,2019-11-11 00:00:00+03:00,out,False,917234,False,57,6949,7817,868
166680,2019-11-11 00:00:00+03:00,in,False,-1,True,13,0,130,130
166680,2019-11-11 00:00:00+03:00,out,False,917234,True,39,0,1075,1075
166680,2019-11-11 00:00:00+03:00,out,False,932498,True,24,0,482,482
166680,2019-11-12 00:00:00+03:00,out,False,917234,True,38,0,1221,1221
166680,2019-11-12 00:00:00+03:00,out,False,932498,False,36,1187,1848,661
166680,2019-11-12 00:00:00+03:00,out,False,950444,False,3,2815,2845,30
166680,2019-11-12 00:00:00+03:00,out,False,917234,False,60,5633,6766,1133
166680,2019-11-12 00:00:00+03:00,out,False,932500,True,33,0,861,861
166680,2019-11-12 00:00:00+03:00,out,False,941628,False,13,2557,2778,221
166680,2019-11-12 00:00:00+03:00,out,False,950444,True,1,0,23,23
166680,2019-11-12 00:00:00+03:00,out,False,932498,True,25,0,529,529
166680,2019-11-12 00:00:00+03:00,out,False,932500,False,21,1555,1856,301
166680,2019-11-12 00:00:00+03:00,out,False,941628,True,19,0,391,391
166680,2019-11-12 00:00:00+03:00,in,False,-1,True,6,0,69,69
166680,2019-11-13 00:00:00+03:00,out,False,960296,False,1,29,52,23
166680,2019-11-13 00:00:00+03:00,out,False,932500,True,31,0,296,296
166680,2019-11-13 00:00:00+03:00,out,False,932500,False,25,2676,3041,365
166680,2019-11-13 00:00:00+03:00,out,False,917234,False,11,920,1106,186
166680,2019-11-13 00:00:00+03:00,out,False,917234,True,7,0,119,119
166680,2019-11-13 00:00:00+03:00,out,False,932498,True,7,0,151,151
166680,2019-11-13 00:00:00+03:00,out,False,932498,False,4,467,515,48
166680,2019-11-13 00:00:00+03:00,in,False,-1,True,3,0,23,23
166680,2019-11-14 00:00:00+03:00,out,False,950444,False,6,2751,2828,77
166680,2019-11-14 00:00:00+03:00,in,False,-1,True,3,0,22,22
166680,2019-11-14 00:00:00+03:00,out,False,950444,True,5,0,62,62
166680,2019-11-14 00:00:00+03:00,out,False,932500,False,8,319,529,210
166680,2019-11-14 00:00:00+03:00,out,False,932500,True,3,0,50,50
166680,2019-11-15 00:00:00+03:00,out,False,932500,True,1,0,34,34
166680,2019-11-15 00:00:00+03:00,out,False,950444,False,3,234,271,37
166680,2019-11-15 00:00:00+03:00,out,False,950444,True,2,0,63,63
166680,2019-11-18 00:00:00+03:00,out,False,950444,False,2,652,681,29
166680,2019-11-18 00:00:00+03:00,in,False,-1,True,3,0,29,29
166680,2019-11-18 00:00:00+03:00,out,False,950444,True,1,0,43,43
166680,2019-11-18 00:00:00+03:00,in,False,-1,True,3,0,29,29
166680,2019-11-19 00:00:00+03:00,out,False,950444,True,4,0,20,20
166680,2019-11-20 00:00:00+03:00,out,False,932500,False,10,565,723,158
166680,2019-11-20 00:00:00+03:00,out,False,960296,True,3,0,56,56
166680,2019-11-20 00:00:00+03:00,in,False,-1,True,2,0,11,11
166680,2019-11-20 00:00:00+03:00,out,False,932500,True,12,0,109,109
166680,2019-11-20 00:00:00+03:00,out,False,960294,True,5,0,119,119
166680,2019-11-20 00:00:00+03:00,out,True,950444,True,1,0,0,0
166680,2019-11-20 00:00:00+03:00,out,False,960296,False,5,688,753,65
166680,2019-11-20 00:00:00+03:00,out,False,932502,False,3,40,106,66
166680,2019-11-20 00:00:00+03:00,out,False,960294,False,5,173,230,57
166680,2019-11-20 00:00:00+03:00,out,False,950444,True,1,0,52,52
166680,2019-11-20 00:00:00+03:00,out,False,950444,False,6,4675,4739,64
166680,2019-11-20 00:00:00+03:00,out,False,917234,False,10,979,1110,131
166680,2019-11-20 00:00:00+03:00,out,False,917234,True,2,0,18,18
166680,2019-11-20 00:00:00+03:00,out,False,932502,True,1,0,25,25
166680,2019-11-20 00:00:00+03:00,out,False,932502,True,1,0,25,25
166680,2019-11-20 00:00:00+03:00,in,False,-1,True,2,0,11,11
166680,2019-11-21 00:00:00+03:00,in,False,-1,True,9,0,104,104
166680,2019-11-21 00:00:00+03:00,out,False,932500,False,33,2147,2672,525
166680,2019-11-21 00:00:00+03:00,out,False,932502,False,22,1598,1998,400
166680,2019-11-21 00:00:00+03:00,out,False,917234,False,37,2988,3544,556
166680,2019-11-21 00:00:00+03:00,out,False,954642,False,28,2521,2998,477
166680,2019-11-21 00:00:00+03:00,out,False,954642,True,11,0,440,440
166680,2019-11-21 00:00:00+03:00,out,False,960296,False,31,2054,2459,405
166680,2019-11-21 00:00:00+03:00,out,False,917234,True,15,0,242,242
166680,2019-11-21 00:00:00+03:00,out,False,960294,True,28,0,540,540
166680,2019-11-21 00:00:00+03:00,out,False,960296,True,17,0,400,400
166680,2019-11-21 00:00:00+03:00,out,False,960294,False,23,1230,1488,258
166680,2019-11-21 00:00:00+03:00,out,False,950444,False,2,761,806,45
166680,2019-11-21 00:00:00+03:00,out,False,932500,True,21,0,611,611
166680,2019-11-21 00:00:00+03:00,out,False,932502,True,16,0,391,391
166680,2019-11-21 00:00:00+03:00,out,False,960296,False,31,2054,2459,405
166680,2019-11-22 00:00:00+03:00,in,False,932502,False,1,137,149,12
166680,2019-11-22 00:00:00+03:00,out,False,917234,True,14,0,375,375
166680,2019-11-22 00:00:00+03:00,out,False,960294,False,18,1453,1656,203
166680,2019-11-22 00:00:00+03:00,out,False,960296,True,30,0,549,549
166680,2019-11-22 00:00:00+03:00,out,False,960296,False,26,2397,2681,284
166680,2019-11-22 00:00:00+03:00,out,False,960294,True,21,0,349,349
166680,2019-11-22 00:00:00+03:00,out,False,950444,False,4,2902,2963,61
166680,2019-11-22 00:00:00+03:00,out,False,954642,False,38,2582,3315,733
166680,2019-11-22 00:00:00+03:00,out,False,932502,True,27,0,549,549
166680,2019-11-22 00:00:00+03:00,out,False,932502,False,19,2159,2453,294
166680,2019-11-22 00:00:00+03:00,out,False,932500,False,33,1447,1910,463
166680,2019-11-22 00:00:00+03:00,out,False,954642,True,28,0,749,749
166680,2019-11-22 00:00:00+03:00,out,False,917234,False,37,3489,4161,672
166680,2019-11-22 00:00:00+03:00,out,False,932500,True,34,0,303,303
166680,2019-11-22 00:00:00+03:00,in,False,-1,True,12,0,93,93
166680,2019-11-22 00:00:00+03:00,out,False,950444,True,1,0,0,0
166680,2019-11-22 00:00:00+03:00,in,False,960296,False,1,173,184,11
166680,2019-11-23 00:00:00+03:00,out,False,917234,False,4,49,164,115
166680,2019-11-23 00:00:00+03:00,out,False,917234,True,1,0,23,23
166680,2019-11-25 00:00:00+03:00,out,False,960294,False,18,1631,1822,191
166680,2019-11-25 00:00:00+03:00,out,False,917234,False,33,1472,1858,386
166680,2019-11-25 00:00:00+03:00,out,False,932502,False,27,2806,3143,337
166680,2019-11-25 00:00:00+03:00,out,False,932500,False,28,1846,2172,326
166680,2019-11-25 00:00:00+03:00,out,False,960296,True,53,0,119,119
166680,2019-11-25 00:00:00+03:00,out,False,932502,True,23,0,408,408
166680,2019-11-25 00:00:00+03:00,in,False,960296,False,1,2,117,115
166680,2019-11-25 00:00:00+03:00,out,False,960294,True,25,0,325,325
166680,2019-11-25 00:00:00+03:00,out,False,954642,True,17,0,322,322
166680,2019-11-25 00:00:00+03:00,out,False,950444,False,1,837,852,15
166680,2019-11-25 00:00:00+03:00,out,False,917234,True,24,0,472,472
166680,2019-11-25 00:00:00+03:00,in,False,-1,True,3,0,29,29
166680,2019-11-25 00:00:00+03:00,out,False,932500,True,51,0,259,259
166680,2019-11-25 00:00:00+03:00,out,False,954642,False,34,1992,2636,644
166680,2019-11-25 00:00:00+03:00,out,False,960296,False,4,26,60,34
166680,2019-11-25 00:00:00+03:00,out,False,950444,False,1,837,852,15
166680,2019-11-26 00:00:00+03:00,out,False,960294,True,30,0,462,462
166680,2019-11-26 00:00:00+03:00,out,False,917234,True,23,0,539,539
166680,2019-11-26 00:00:00+03:00,out,False,954642,False,32,1277,1847,570
166680,2019-11-26 00:00:00+03:00,out,False,932502,False,37,2423,2885,462
166680,2019-11-26 00:00:00+03:00,out,False,954642,True,22,0,497,497
166680,2019-11-26 00:00:00+03:00,out,False,960294,False,20,2253,2506,253
166680,2019-11-26 00:00:00+03:00,out,False,932500,False,22,1259,1516,257
166680,2019-11-26 00:00:00+03:00,out,False,932500,True,42,0,340,340
166680,2019-11-26 00:00:00+03:00,out,False,917234,False,27,1766,2116,350
166680,2019-11-26 00:00:00+03:00,out,False,932502,True,25,0,492,492
166680,2019-11-26 00:00:00+03:00,in,False,-1,True,14,0,196,196
166680,2019-11-26 00:00:00+03:00,out,False,954642,False,32,1277,1847,570
166680,2019-11-27 00:00:00+03:00,out,False,972412,False,12,1450,1638,188
166680,2019-11-27 00:00:00+03:00,in,False,960294,False,1,41,77,36
166680,2019-11-27 00:00:00+03:00,out,False,915614,True,2,0,0,0
166680,2019-11-27 00:00:00+03:00,out,False,972408,False,4,200,215,15
166680,2019-11-27 00:00:00+03:00,in,False,917234,False,1,44,59,15
166680,2019-11-27 00:00:00+03:00,out,False,917234,True,24,0,337,337
166680,2019-11-27 00:00:00+03:00,in,False,972412,False,1,120,145,25
166680,2019-11-27 00:00:00+03:00,out,False,917234,False,27,1209,1494,285
166680,2019-11-27 00:00:00+03:00,out,False,932502,True,27,0,706,706
166680,2019-11-27 00:00:00+03:00,out,False,972410,True,11,0,224,224
166680,2019-11-27 00:00:00+03:00,in,False,-1,True,13,0,99,99
166680,2019-11-27 00:00:00+03:00,out,False,972410,False,14,1494,1681,187
166680,2019-11-27 00:00:00+03:00,out,False,932500,False,29,1861,2167,306
166680,2019-11-27 00:00:00+03:00,out,False,972408,True,2,0,30,30
166680,2019-11-27 00:00:00+03:00,out,False,932500,True,40,0,361,361
166680,2019-11-27 00:00:00+03:00,out,False,954642,False,29,2154,2708,554
166680,2019-11-27 00:00:00+03:00,out,False,960294,False,27,2149,2432,283
166680,2019-11-27 00:00:00+03:00,out,False,972412,True,14,0,354,354
166680,2019-11-27 00:00:00+03:00,in,False,932502,False,1,30,39,9
166680,2019-11-27 00:00:00+03:00,out,False,932502,False,34,2203,2669,466
166680,2019-11-27 00:00:00+03:00,out,False,960294,True,24,0,337,337
166680,2019-11-27 00:00:00+03:00,out,False,954642,True,24,0,714,714
166680,2019-11-27 00:00:00+03:00,out,False,915614,True,2,0,0,0
166680,2019-11-27 00:00:00+03:00,out,False,972408,True,2,0,30,30
166680,2019-11-27 00:00:00+03:00,in,False,-1,True,13,0,99,99
166680,2019-11-28 00:00:00+03:00,out,False,950444,True,4,0,175,175
166680,2019-11-28 00:00:00+03:00,out,False,932502,True,31,0,792,792
166680,2019-11-28 00:00:00+03:00,out,False,960294,False,20,1614,1810,196
166680,2019-11-28 00:00:00+03:00,out,False,954642,True,20,0,665,665
166680,2019-11-28 00:00:00+03:00,out,False,917234,True,11,0,205,205
166680,2019-11-28 00:00:00+03:00,out,False,917234,False,39,2665,3143,478
166680,2019-11-28 00:00:00+03:00,out,False,972412,True,11,0,228,228
166680,2019-11-28 00:00:00+03:00,in,False,-1,True,13,0,135,135
166680,2019-11-28 00:00:00+03:00,out,False,960294,True,32,0,463,463
166680,2019-11-28 00:00:00+03:00,out,False,932502,False,31,2319,2736,417
166680,2019-11-28 00:00:00+03:00,out,False,972412,False,23,1928,2183,255
166680,2019-11-28 00:00:00+03:00,out,False,972410,False,26,2283,2552,269
166680,2019-11-28 00:00:00+03:00,out,False,932500,False,22,1809,2125,316
166680,2019-11-28 00:00:00+03:00,out,False,972410,True,26,0,818,818
166680,2019-11-28 00:00:00+03:00,out,False,932500,True,47,0,221,221
166680,2019-11-28 00:00:00+03:00,out,False,954642,False,39,2532,3321,789
166680,2019-11-28 00:00:00+03:00,out,False,932500,False,22,1809,2125,316
166688,2019-08-17 00:00:00+03:00,in,False,890226,False,1,10,18,8
166688,2019-08-17 00:00:00+03:00,out,False,890228,True,3,0,0,0
166688,2019-08-17 00:00:00+03:00,out,False,890226,True,2,0,0,0
166688,2019-08-17 00:00:00+03:00,in,False,-1,True,8,0,78,78
166688,2019-08-17 00:00:00+03:00,in,False,-1,True,8,0,78,78
166688,2019-08-17 00:00:00+03:00,in,False,890226,False,1,10,18,8
166688,2019-08-20 00:00:00+03:00,in,False,-1,True,19,0,313,313
166688,2019-08-21 00:00:00+03:00,in,False,-1,True,2,0,133,133
166688,2019-08-22 00:00:00+03:00,in,False,-1,True,5,0,16,16
166688,2019-08-22 00:00:00+03:00,out,False,890228,True,1,0,0,0
166688,2019-08-23 00:00:00+03:00,in,False,890228,False,1,78,89,11
166688,2019-08-23 00:00:00+03:00,out,False,890228,True,1,0,0,0
166688,2019-08-23 00:00:00+03:00,in,False,-1,True,6,0,137,137
166688,2019-08-23 00:00:00+03:00,in,False,-1,True,6,0,137,137
166688,2019-08-24 00:00:00+03:00,in,False,-1,True,1,0,35,35
166688,2019-08-24 00:00:00+03:00,in,False,-1,True,1,0,35,35
166688,2019-08-27 00:00:00+03:00,in,False,-1,True,1,0,10,10
166688,2019-08-27 00:00:00+03:00,out,False,890228,True,1,0,0,0
166688,2019-09-03 00:00:00+03:00,in,False,-1,True,2,0,4,4
166688,2019-09-05 00:00:00+03:00,in,False,-1,True,2,0,4,4
166688,2019-09-06 00:00:00+03:00,in,False,-1,True,1,0,2,2
166688,2019-09-14 00:00:00+03:00,in,False,-1,True,2,0,4,4
166688,2019-09-23 00:00:00+03:00,out,False,890228,False,1,20,35,15
166688,2019-09-23 00:00:00+03:00,in,False,890226,False,1,19,56,37
166688,2019-09-23 00:00:00+03:00,in,False,-1,True,1,0,54,54
166688,2019-09-23 00:00:00+03:00,in,False,-1,True,1,0,9,9
166688,2019-09-24 00:00:00+03:00,in,False,890228,False,1,122,136,14
166688,2019-09-25 00:00:00+03:00,out,False,890226,True,1,0,42,42
166688,2019-09-27 00:00:00+03:00,in,False,890228,False,1,29,43,14
166688,2019-09-28 00:00:00+03:00,in,False,-1,True,1,0,4,4
166688,2019-10-10 00:00:00+03:00,out,False,890228,False,1,662,671,9
166688,2019-10-11 00:00:00+03:00,out,False,890228,False,2,175,204,29
166688,2019-10-12 00:00:00+03:00,out,False,890228,False,2,66,106,40
166688,2019-10-14 00:00:00+03:00,out,False,890228,False,3,293,365,72
166688,2019-10-14 00:00:00+03:00,out,False,890228,True,1,0,60,60
166688,2019-10-15 00:00:00+03:00,out,True,890228,True,1,0,13,13
166688,2019-10-15 00:00:00+03:00,out,False,890228,False,3,76,122,46
166688,2019-10-16 00:00:00+03:00,out,False,890228,False,2,70,95,25
166688,2019-10-26 00:00:00+03:00,out,False,890228,False,1,52,65,13
166688,2019-10-26 00:00:00+03:00,out,False,890228,True,1,0,60,60
166688,2019-10-28 00:00:00+03:00,out,False,890228,True,1,0,40,40
166688,2019-10-28 00:00:00+03:00,in,False,-1,True,2,0,10,10
166688,2019-10-28 00:00:00+03:00,out,False,890228,False,2,32,46,14
166688,2019-10-28 00:00:00+03:00,out,False,890228,False,2,32,46,14
166688,2019-10-30 00:00:00+03:00,out,False,890228,False,3,586,644,58
166688,2019-10-31 00:00:00+03:00,out,False,890228,False,1,20,28,8
166688,2019-10-31 00:00:00+03:00,out,False,890228,False,1,20,28,8
166688,2019-11-01 00:00:00+03:00,out,False,890228,False,1,14,22,8
166688,2019-11-01 00:00:00+03:00,out,False,890228,False,1,14,22,8
166688,2019-11-11 00:00:00+03:00,out,False,890228,False,1,69,77,8
166688,2019-11-11 00:00:00+03:00,in,False,890228,False,1,208,221,13
166688,2019-11-13 00:00:00+03:00,out,False,890228,False,1,55,78,23
166688,2019-11-13 00:00:00+03:00,out,False,890228,False,1,55,78,23
166688,2019-11-14 00:00:00+03:00,in,False,890228,False,1,69,84,15
166688,2019-11-14 00:00:00+03:00,out,False,890228,False,12,1135,1329,194
166688,2019-11-14 00:00:00+03:00,out,True,890228,False,2,53,70,17
166688,2019-11-14 00:00:00+03:00,in,False,890228,True,1,0,37,37
166688,2019-11-14 00:00:00+03:00,out,False,890228,True,5,0,150,150
166688,2019-11-15 00:00:00+03:00,out,False,890228,False,8,495,568,73
166688,2019-11-15 00:00:00+03:00,out,False,890228,False,8,495,568,73
166688,2019-11-19 00:00:00+03:00,out,False,890228,True,3,0,97,97
166688,2019-11-19 00:00:00+03:00,out,True,965328,True,1,0,11,11
166688,2019-11-19 00:00:00+03:00,out,False,890228,False,1,25,33,8
166688,2019-11-19 00:00:00+03:00,in,False,-1,True,1,0,16,16
166688,2019-11-20 00:00:00+03:00,in,False,-1,True,1,0,11,11
166688,2019-11-20 00:00:00+03:00,out,False,890228,True,9,0,284,284
166688,2019-11-20 00:00:00+03:00,out,False,890228,False,4,443,485,42
166688,2019-11-20 00:00:00+03:00,out,False,890228,False,4,443,485,42
166688,2019-11-21 00:00:00+03:00,out,False,965328,False,4,128,200,72
166688,2019-11-21 00:00:00+03:00,out,False,890228,False,1,225,237,12
166688,2019-11-22 00:00:00+03:00,out,False,965328,False,3,231,269,38
166688,2019-11-22 00:00:00+03:00,out,False,890228,True,1,0,45,45
166688,2019-11-25 00:00:00+03:00,out,False,890228,False,1,38,52,14
166688,2019-11-25 00:00:00+03:00,out,False,965328,False,1,83,97,14
166688,2019-11-25 00:00:00+03:00,out,False,890228,True,1,0,18,18
166688,2019-11-26 00:00:00+03:00,out,False,965328,False,3,172,224,52
166688,2019-11-26 00:00:00+03:00,out,False,965328,True,4,0,140,140
166688,2019-11-26 00:00:00+03:00,out,False,890228,True,2,0,116,116
166688,2019-11-27 00:00:00+03:00,in,False,890226,False,1,42,79,37
166688,2019-11-27 00:00:00+03:00,out,False,890228,False,1,298,328,30
166688,2019-11-27 00:00:00+03:00,in,False,-1,True,1,0,37,37
166688,2019-11-28 00:00:00+03:00,out,False,965328,False,9,519,612,93
166688,2019-11-28 00:00:00+03:00,out,False,890228,False,1,143,158,15
166688,2019-11-28 00:00:00+03:00,out,False,965328,True,3,0,95,95
166691,2019-08-16 00:00:00+03:00,in,False,-1,True,3,0,100,100
166691,2019-08-16 00:00:00+03:00,in,False,889410,False,2,44,54,10
166691,2019-08-16 00:00:00+03:00,out,False,889410,False,2,39,69,30
166691,2019-08-16 00:00:00+03:00,out,False,889410,True,3,0,89,89
166691,2019-08-17 00:00:00+03:00,out,False,889410,False,5,223,311,88
166691,2019-08-17 00:00:00+03:00,out,False,889410,True,2,0,56,56
166691,2019-08-19 00:00:00+03:00,out,False,889410,False,8,408,543,135
166691,2019-08-19 00:00:00+03:00,in,False,-1,True,1,0,0,0
166691,2019-08-19 00:00:00+03:00,out,False,889410,True,4,0,116,116
166691,2019-08-19 00:00:00+03:00,in,False,889410,False,6,413,435,22
166691,2019-08-19 00:00:00+03:00,out,False,889410,False,8,408,543,135
166691,2019-08-20 00:00:00+03:00,in,False,889410,False,4,1036,1056,20
166691,2019-08-20 00:00:00+03:00,in,False,-1,True,1,0,0,0
166691,2019-08-20 00:00:00+03:00,out,False,889410,False,3,53,79,26
166691,2019-08-20 00:00:00+03:00,out,False,889410,True,3,0,74,74
166691,2019-08-20 00:00:00+03:00,in,False,-1,True,1,0,0,0
166691,2019-08-21 00:00:00+03:00,in,False,889410,False,2,202,211,9
166691,2019-08-21 00:00:00+03:00,out,False,889410,False,3,277,303,26
166691,2019-08-21 00:00:00+03:00,out,False,889410,True,1,0,32,32
166691,2019-08-22 00:00:00+03:00,in,False,-1,True,1,0,56,56
166691,2019-08-22 00:00:00+03:00,in,False,889410,False,4,218,245,27
166691,2019-08-22 00:00:00+03:00,out,False,889410,False,8,340,427,87
166691,2019-08-23 00:00:00+03:00,out,False,889410,False,3,365,401,36
166691,2019-08-23 00:00:00+03:00,in,False,889410,False,2,32,50,18
166691,2019-08-24 00:00:00+03:00,in,False,-1,True,6,0,140,140
166691,2019-08-26 00:00:00+03:00,in,False,889410,False,4,339,379,40
166691,2019-08-26 00:00:00+03:00,out,False,889410,True,4,0,133,133
166691,2019-08-26 00:00:00+03:00,out,False,889410,False,5,170,235,65
166691,2019-08-27 00:00:00+03:00,out,False,889410,False,6,467,534,67
166691,2019-08-27 00:00:00+03:00,out,False,889410,True,4,0,115,115
166691,2019-08-27 00:00:00+03:00,in,False,889410,False,2,211,225,14
166691,2019-08-28 00:00:00+03:00,in,False,889410,False,6,213,238,25
166691,2019-08-28 00:00:00+03:00,out,False,889410,True,2,0,64,64
166691,2019-08-28 00:00:00+03:00,out,False,889410,False,3,44,103,59
166691,2019-08-28 00:00:00+03:00,out,False,889410,False,3,44,103,59
166691,2019-08-29 00:00:00+03:00,out,False,889410,False,9,172,292,120
166691,2019-08-29 00:00:00+03:00,in,False,889410,False,8,520,562,42
166691,2019-08-29 00:00:00+03:00,out,False,889410,True,1,0,29,29
166691,2019-08-30 00:00:00+03:00,out,False,889410,False,2,67,97,30
166691,2019-08-30 00:00:00+03:00,in,False,889410,False,4,437,458,21
166691,2019-08-30 00:00:00+03:00,out,False,889410,True,2,0,52,52
166691,2019-09-01 00:00:00+03:00,in,False,-1,True,5,0,102,102
166691,2019-09-02 00:00:00+03:00,in,False,-1,True,2,0,38,38
166691,2019-09-02 00:00:00+03:00,in,False,901734,False,1,144,152,8
166691,2019-09-02 00:00:00+03:00,out,False,889410,True,3,0,68,68
166691,2019-09-02 00:00:00+03:00,in,False,889410,False,2,71,81,10
166691,2019-09-02 00:00:00+03:00,out,False,889410,False,6,355,462,107
166691,2019-09-03 00:00:00+03:00,out,False,889410,False,8,493,608,115
166691,2019-09-03 00:00:00+03:00,out,False,889410,True,5,0,52,52
166691,2019-09-03 00:00:00+03:00,in,False,-1,True,2,0,5,5
166691,2019-09-03 00:00:00+03:00,in,False,889410,False,5,394,421,27
166691,2019-09-04 00:00:00+03:00,out,False,889410,False,5,287,377,90
166691,2019-09-04 00:00:00+03:00,in,False,889410,False,6,676,718,42
166691,2019-09-04 00:00:00+03:00,out,False,889410,True,3,0,11,11
166691,2019-09-05 00:00:00+03:00,out,False,889410,False,10,1025,1174,149
166691,2019-09-05 00:00:00+03:00,in,False,889410,False,8,834,879,45
166691,2019-09-05 00:00:00+03:00,in,False,-1,True,3,0,96,96
166691,2019-09-05 00:00:00+03:00,out,False,889410,True,4,0,57,57
166691,2019-09-06 00:00:00+03:00,in,False,-1,True,1,0,5,5
166691,2019-09-06 00:00:00+03:00,out,False,889410,True,5,0,165,165
166691,2019-09-06 00:00:00+03:00,out,False,889410,False,5,265,308,43
166691,2019-09-06 00:00:00+03:00,in,False,889410,False,7,667,743,76
166691,2019-09-06 00:00:00+03:00,out,False,889410,True,5,0,165,165
166691,2019-09-07 00:00:00+03:00,in,False,-1,True,3,0,121,121
166691,2019-09-08 00:00:00+03:00,in,False,-1,True,1,0,24,24
166691,2019-09-09 00:00:00+03:00,out,False,889410,False,7,276,403,127
166691,2019-09-09 00:00:00+03:00,in,False,-1,True,7,0,272,272
166691,2019-09-09 00:00:00+03:00,out,False,889410,False,7,276,403,127
166691,2019-09-10 00:00:00+03:00,in,False,-1,True,2,0,2,2
166691,2019-09-10 00:00:00+03:00,out,False,889410,False,11,554,714,160
166691,2019-09-10 00:00:00+03:00,in,False,889410,False,9,651,702,51
166691,2019-09-10 00:00:00+03:00,out,False,889410,True,4,0,104,104
166691,2019-09-11 00:00:00+03:00,in,False,889410,False,10,1524,1591,67
166691,2019-09-11 00:00:00+03:00,out,False,889410,True,4,0,65,65
166691,2019-09-11 00:00:00+03:00,in,False,-1,True,2,0,3,3
166691,2019-09-11 00:00:00+03:00,out,False,889410,False,8,508,653,145
166691,2019-09-12 00:00:00+03:00,out,False,889410,True,5,0,164,164
166691,2019-09-12 00:00:00+03:00,in,False,889410,False,9,471,522,51
166691,2019-09-12 00:00:00+03:00,in,False,-1,True,1,0,1,1
166691,2019-09-12 00:00:00+03:00,out,True,889410,True,1,0,2,2
166691,2019-09-12 00:00:00+03:00,out,False,889410,False,13,820,1058,238
166691,2019-09-12 00:00:00+03:00,out,False,889410,True,5,0,164,164
166691,2019-09-13 00:00:00+03:00,out,False,889410,False,6,211,343,132
166691,2019-09-13 00:00:00+03:00,in,False,889410,False,9,816,875,59
166691,2019-09-13 00:00:00+03:00,out,False,889410,True,1,0,16,16
166691,2019-09-15 00:00:00+03:00,in,False,-1,True,1,0,5,5
166691,2019-09-15 00:00:00+03:00,out,False,889410,True,3,0,74,74
166691,2019-09-15 00:00:00+03:00,out,False,889410,False,4,106,142,36
166691,2019-09-15 00:00:00+03:00,out,False,889410,True,3,0,74,74
166691,2019-09-16 00:00:00+03:00,out,False,889410,True,2,0,64,64
166691,2019-09-16 00:00:00+03:00,in,False,889410,False,11,1376,1460,84
166691,2019-09-16 00:00:00+03:00,out,False,889410,False,8,754,878,124
166691,2019-09-17 00:00:00+03:00,out,False,889410,True,3,0,65,65
166691,2019-09-17 00:00:00+03:00,out,False,889410,False,9,329,501,172
166691,2019-09-17 00:00:00+03:00,in,False,889410,False,7,484,527,43
166691,2019-09-18 00:00:00+03:00,in,False,-1,True,1,0,1,1
166691,2019-09-18 00:00:00+03:00,in,False,889410,False,6,515,557,42
166691,2019-09-18 00:00:00+03:00,out,False,889410,False,1,169,184,15
166691,2019-09-18 00:00:00+03:00,in,False,-1,True,1,0,1,1
166691,2019-09-19 00:00:00+03:00,out,False,889410,False,9,218,340,122
166691,2019-09-19 00:00:00+03:00,in,False,889410,False,6,362,404,42
166691,2019-09-19 00:00:00+03:00,out,False,889410,True,5,0,73,73
166691,2019-09-19 00:00:00+03:00,in,False,-1,True,1,0,0,0
166691,2019-09-20 00:00:00+03:00,out,False,889410,False,7,256,363,107
166691,2019-09-20 00:00:00+03:00,in,False,-1,True,2,0,56,56
166691,2019-09-20 00:00:00+03:00,out,False,889410,True,1,0,7,7
166691,2019-09-20 00:00:00+03:00,in,False,889410,False,9,455,517,62
166691,2019-09-21 00:00:00+03:00,in,False,889410,False,5,459,492,33
166691,2019-09-21 00:00:00+03:00,in,False,-1,True,4,0,45,45
166691,2019-09-21 00:00:00+03:00,out,False,889410,False,3,103,160,57
166691,2019-09-22 00:00:00+03:00,in,False,-1,True,2,0,29,29
166691,2019-09-23 00:00:00+03:00,out,False,889410,False,25,1768,2130,362
166691,2019-09-23 00:00:00+03:00,in,False,889410,False,9,887,946,59
166691,2019-09-23 00:00:00+03:00,out,False,889410,True,3,0,60,60
166691,2019-09-23 00:00:00+03:00,in,False,-1,True,2,0,36,36
166691,2019-09-24 00:00:00+03:00,in,False,-1,True,2,0,2,2
166691,2019-09-24 00:00:00+03:00,in,False,889410,False,12,701,775,74
166691,2019-09-24 00:00:00+03:00,out,False,889410,False,9,997,1131,134
166691,2019-09-24 00:00:00+03:00,out,False,889410,True,4,0,86,86
166691,2019-09-25 00:00:00+03:00,out,False,889410,False,10,395,534,139
166691,2019-09-25 00:00:00+03:00,in,False,889410,False,6,784,830,46
166691,2019-09-25 00:00:00+03:00,in,False,-1,True,1,0,2,2
166691,2019-09-26 00:00:00+03:00,out,False,889410,False,7,289,383,94
166691,2019-09-26 00:00:00+03:00,out,False,889410,True,3,0,84,84
166691,2019-09-26 00:00:00+03:00,in,False,-1,True,1,0,9,9
166691,2019-09-26 00:00:00+03:00,in,False,889410,False,9,400,454,54
166691,2019-09-27 00:00:00+03:00,out,False,889410,True,1,0,28,28
166691,2019-09-27 00:00:00+03:00,in,False,889410,False,10,628,687,59
166691,2019-09-28 00:00:00+03:00,in,False,889410,False,2,216,227,11
166691,2019-09-28 00:00:00+03:00,out,False,889410,False,4,282,381,99
166691,2019-09-28 00:00:00+03:00,out,False,889410,True,2,0,80,80
166691,2019-09-29 00:00:00+03:00,in,False,-1,True,1,0,25,25
166691,2019-09-30 00:00:00+03:00,out,False,889410,False,6,251,337,86
166691,2019-09-30 00:00:00+03:00,out,False,889410,True,1,0,28,28
166691,2019-09-30 00:00:00+03:00,in,False,889410,False,5,232,264,32
166691,2019-09-30 00:00:00+03:00,in,False,-1,True,1,0,1,1
166691,2019-09-30 00:00:00+03:00,in,False,889410,False,5,232,264,32
166691,2019-10-01 00:00:00+03:00,in,False,889410,False,5,207,248,41
166691,2019-10-01 00:00:00+03:00,in,False,-1,True,1,0,74,74
166691,2019-10-01 00:00:00+03:00,out,False,889410,False,7,310,394,84
166691,2019-10-01 00:00:00+03:00,out,False,889410,True,2,0,39,39
166691,2019-10-02 00:00:00+03:00,out,False,889410,True,1,0,34,34
166691,2019-10-02 00:00:00+03:00,in,False,889410,False,7,451,495,44
166691,2019-10-02 00:00:00+03:00,out,False,889410,False,8,1389,1513,124
166691,2019-10-03 00:00:00+03:00,in,False,889410,False,7,441,479,38
166691,2019-10-03 00:00:00+03:00,out,False,889410,True,10,0,257,257
166691,2019-10-03 00:00:00+03:00,out,False,889410,False,17,740,972,232
166691,2019-10-04 00:00:00+03:00,out,False,889410,True,1,0,18,18
166691,2019-10-04 00:00:00+03:00,in,False,-1,True,1,0,2,2
166691,2019-10-04 00:00:00+03:00,in,False,889410,False,3,144,163,19
166691,2019-10-04 00:00:00+03:00,out,False,889410,False,5,234,295,61
166691,2019-10-05 00:00:00+03:00,out,False,889410,True,3,0,87,87
166691,2019-10-05 00:00:00+03:00,in,False,-1,True,1,0,74,74
166691,2019-10-05 00:00:00+03:00,out,False,889410,False,8,389,522,133
166691,2019-10-05 00:00:00+03:00,in,False,889410,False,1,31,35,4
166691,2019-10-07 00:00:00+03:00,in,False,889410,False,5,240,268,28
166691,2019-10-07 00:00:00+03:00,out,False,889410,False,8,305,411,106
166691,2019-10-07 00:00:00+03:00,in,False,-1,True,1,0,2,2
166691,2019-10-07 00:00:00+03:00,out,False,889410,True,2,0,58,58
166691,2019-10-08 00:00:00+03:00,out,False,889410,True,5,0,182,182
166691,2019-10-08 00:00:00+03:00,out,False,889410,False,12,635,824,189
166691,2019-10-08 00:00:00+03:00,in,False,889410,False,7,921,962,41
166691,2019-10-09 00:00:00+03:00,in,False,889410,False,3,355,377,22
166691,2019-10-09 00:00:00+03:00,out,False,889410,True,2,0,56,56
166691,2019-10-09 00:00:00+03:00,out,False,889410,False,6,246,326,80
166691,2019-10-10 00:00:00+03:00,out,False,889410,True,2,0,95,95
166691,2019-10-10 00:00:00+03:00,in,False,889410,False,4,183,204,21
166691,2019-10-10 00:00:00+03:00,out,False,889410,False,18,814,1137,323
166691,2019-10-11 00:00:00+03:00,out,False,889410,True,3,0,63,63
166691,2019-10-11 00:00:00+03:00,in,False,889410,False,19,1016,1137,121
166691,2019-10-11 00:00:00+03:00,in,False,-1,True,1,0,2,2
166691,2019-10-11 00:00:00+03:00,out,False,889410,False,9,465,612,147
166691,2019-10-12 00:00:00+03:00,out,False,889410,False,4,208,263,55
166691,2019-10-12 00:00:00+03:00,in,False,889410,False,3,228,248,20
166691,2019-10-12 00:00:00+03:00,out,False,889410,True,1,0,26,26
166691,2019-10-14 00:00:00+03:00,in,False,-1,True,3,0,48,48
166691,2019-10-14 00:00:00+03:00,out,False,889410,False,17,1067,1301,234
166691,2019-10-14 00:00:00+03:00,in,False,889410,False,10,1134,1207,73
166691,2019-10-14 00:00:00+03:00,out,False,889410,True,4,0,88,88
166691,2019-10-15 00:00:00+03:00,out,False,889410,True,3,0,93,93
166691,2019-10-15 00:00:00+03:00,in,False,889410,False,15,1084,1177,93
166691,2019-10-15 00:00:00+03:00,out,False,889410,False,13,380,568,188
166691,2019-10-15 00:00:00+03:00,in,False,-1,True,4,0,11,11
166691,2019-10-15 00:00:00+03:00,in,False,-1,True,4,0,11,11
166691,2019-10-16 00:00:00+03:00,in,False,889410,False,14,719,828,109
166691,2019-10-16 00:00:00+03:00,out,False,889410,False,13,577,741,164
166691,2019-10-16 00:00:00+03:00,out,False,889410,True,6,0,184,184
166691,2019-10-16 00:00:00+03:00,in,False,-1,True,2,0,10,10
166691,2019-10-17 00:00:00+03:00,in,False,889410,False,15,1457,1567,110
166691,2019-10-17 00:00:00+03:00,in,False,-1,True,1,0,4,4
166691,2019-10-17 00:00:00+03:00,out,False,889410,False,13,368,520,152
166691,2019-10-17 00:00:00+03:00,out,False,889410,True,2,0,50,50
166691,2019-10-18 00:00:00+03:00,in,False,-1,True,5,0,106,106
166691,2019-10-18 00:00:00+03:00,out,False,889410,True,3,0,161,161
166691,2019-10-18 00:00:00+03:00,out,False,889410,False,12,539,763,224
166691,2019-10-18 00:00:00+03:00,in,False,901734,False,1,87,99,12
166691,2019-10-18 00:00:00+03:00,in,False,889410,False,12,787,878,91
166691,2019-10-18 00:00:00+03:00,in,False,-1,True,5,0,106,106
166691,2019-10-19 00:00:00+03:00,in,False,901734,False,2,256,289,33
166691,2019-10-19 00:00:00+03:00,in,False,901734,False,2,256,289,33
166691,2019-10-21 00:00:00+03:00,out,False,889410,True,4,0,60,60
166691,2019-10-21 00:00:00+03:00,in,False,901734,False,4,264,334,70
166691,2019-10-21 00:00:00+03:00,in,False,889410,False,1,106,109,3
166691,2019-10-21 00:00:00+03:00,in,False,-1,True,1,0,21,21
166691,2019-10-21 00:00:00+03:00,out,False,889410,False,9,492,679,187
166691,2019-10-21 00:00:00+03:00,out,False,889410,True,4,0,60,60
166691,2019-10-22 00:00:00+03:00,out,False,889410,True,6,0,123,123
166691,2019-10-22 00:00:00+03:00,in,False,889410,False,1,84,88,4
166691,2019-10-22 00:00:00+03:00,in,False,901734,False,1,46,56,10
166691,2019-10-22 00:00:00+03:00,out,False,889410,False,15,602,813,211
166691,2019-10-23 00:00:00+03:00,in,False,889410,False,1,174,176,2
166691,2019-10-23 00:00:00+03:00,in,False,901734,False,4,308,357,49
166691,2019-10-23 00:00:00+03:00,out,False,889410,True,4,0,118,118
166691,2019-10-23 00:00:00+03:00,out,False,889410,False,13,1008,1128,120
166691,2019-10-23 00:00:00+03:00,out,False,889410,False,13,1008,1128,120
166691,2019-10-24 00:00:00+03:00,out,False,889410,True,3,0,71,71
166691,2019-10-24 00:00:00+03:00,in,False,889410,False,2,157,165,8
166691,2019-10-24 00:00:00+03:00,out,False,889410,False,13,543,726,183
166691,2019-10-25 00:00:00+03:00,in,False,-1,True,1,0,141,141
166691,2019-10-25 00:00:00+03:00,in,False,889410,False,2,227,240,13
166691,2019-10-25 00:00:00+03:00,out,False,889410,True,1,0,5,5
166691,2019-10-25 00:00:00+03:00,out,False,889410,False,4,195,232,37
166691,2019-10-25 00:00:00+03:00,in,False,889410,False,2,227,240,13
166691,2019-10-25 00:00:00+03:00,out,False,889410,True,1,0,5,5
166691,2019-10-26 00:00:00+03:00,out,False,889410,True,5,0,75,75
166691,2019-10-26 00:00:00+03:00,out,False,889410,False,4,148,194,46
166691,2019-10-26 00:00:00+03:00,in,False,889410,False,3,258,273,15
166691,2019-10-26 00:00:00+03:00,out,False,889410,True,5,0,75,75
166691,2019-10-27 00:00:00+03:00,out,False,889410,False,2,62,87,25
166691,2019-10-27 00:00:00+03:00,out,False,889410,True,1,0,42,42
166691,2019-10-28 00:00:00+03:00,in,False,889410,False,1,37,40,3
166691,2019-10-28 00:00:00+03:00,out,False,889410,False,17,1111,1415,304
166691,2019-10-28 00:00:00+03:00,out,False,889410,True,3,0,44,44
166691,2019-10-28 00:00:00+03:00,in,False,889410,False,1,37,40,3
166691,2019-10-29 00:00:00+03:00,out,False,889410,False,14,753,972,219
166691,2019-10-29 00:00:00+03:00,out,False,889410,True,3,0,94,94
166691,2019-10-29 00:00:00+03:00,in,False,889410,False,7,329,366,37
166691,2019-10-29 00:00:00+03:00,in,False,889410,False,7,329,366,37
166691,2019-10-30 00:00:00+03:00,out,False,889410,True,4,0,133,133
166691,2019-10-30 00:00:00+03:00,out,False,889410,False,10,293,472,179
166691,2019-10-30 00:00:00+03:00,in,False,889410,False,3,248,272,24
166691,2019-10-30 00:00:00+03:00,out,False,889410,False,10,293,472,179
166691,2019-10-31 00:00:00+03:00,in,False,889410,False,4,230,260,30
166691,2019-10-31 00:00:00+03:00,out,False,889410,True,10,0,235,235
166691,2019-10-31 00:00:00+03:00,out,False,889410,False,12,287,464,177
166691,2019-11-01 00:00:00+03:00,out,False,889410,True,1,0,25,25
166691,2019-11-01 00:00:00+03:00,in,False,889410,False,4,325,344,19
166691,2019-11-01 00:00:00+03:00,out,False,889410,False,4,216,265,49
166691,2019-11-02 00:00:00+03:00,out,False,889410,True,2,0,66,66
166691,2019-11-02 00:00:00+03:00,out,False,889410,False,6,326,426,100
166691,2019-11-05 00:00:00+03:00,in,False,889410,False,3,199,213,14
166691,2019-11-05 00:00:00+03:00,out,False,889410,True,3,0,106,106
166691,2019-11-05 00:00:00+03:00,in,False,-1,True,1,0,1,1
166691,2019-11-05 00:00:00+03:00,in,False,901734,False,2,39,67,28
166691,2019-11-05 00:00:00+03:00,out,False,889410,False,14,530,745,215
166691,2019-11-05 00:00:00+03:00,out,False,889410,False,14,530,745,215
166691,2019-11-05 00:00:00+03:00,in,False,-1,True,1,0,1,1
166691,2019-11-06 00:00:00+03:00,out,False,889410,True,4,0,143,143
166691,2019-11-06 00:00:00+03:00,in,False,901734,False,7,589,682,93
166691,2019-11-06 00:00:00+03:00,out,False,889410,False,20,1195,1491,296
166691,2019-11-06 00:00:00+03:00,in,False,889410,False,1,75,79,4
166691,2019-11-07 00:00:00+03:00,out,False,889410,True,1,0,60,60
166691,2019-11-07 00:00:00+03:00,in,False,889410,False,2,91,100,9
166691,2019-11-07 00:00:00+03:00,out,False,889410,False,10,533,690,157
166691,2019-11-08 00:00:00+03:00,out,False,889410,False,1,24,43,19
166691,2019-11-08 00:00:00+03:00,in,False,889410,False,1,55,59,4
166691,2019-11-08 00:00:00+03:00,in,False,889410,False,1,55,59,4
166691,2019-11-09 00:00:00+03:00,in,False,-1,True,1,0,54,54
166691,2019-11-09 00:00:00+03:00,out,False,889410,False,2,257,277,20
166691,2019-11-09 00:00:00+03:00,in,False,-1,True,1,0,54,54
166691,2019-11-10 00:00:00+03:00,in,False,-1,True,1,0,37,37
166691,2019-11-11 00:00:00+03:00,in,False,889410,False,5,371,399,28
166691,2019-11-11 00:00:00+03:00,out,False,889410,False,10,999,1122,123
166691,2019-11-11 00:00:00+03:00,out,False,889410,True,1,0,58,58
166691,2019-11-12 00:00:00+03:00,out,False,889410,True,6,0,187,187
166691,2019-11-12 00:00:00+03:00,out,False,889410,False,20,1189,1512,323
166691,2019-11-12 00:00:00+03:00,in,False,889410,False,2,85,96,11
166691,2019-11-13 00:00:00+03:00,in,False,889410,False,7,560,593,33
166691,2019-11-13 00:00:00+03:00,out,False,889410,False,13,680,838,158
166691,2019-11-13 00:00:00+03:00,out,False,889410,True,3,0,65,65
166691,2019-11-13 00:00:00+03:00,in,False,901734,False,1,37,53,16
166691,2019-11-14 00:00:00+03:00,in,False,-1,True,1,0,15,15
166691,2019-11-14 00:00:00+03:00,in,False,889410,False,6,371,421,50
166691,2019-11-14 00:00:00+03:00,out,False,889410,True,8,0,208,208
166691,2019-11-14 00:00:00+03:00,out,False,889410,False,8,211,291,80
166691,2019-11-14 00:00:00+03:00,in,False,889410,False,6,371,421,50
166691,2019-11-15 00:00:00+03:00,out,False,889410,False,8,364,457,93
166691,2019-11-15 00:00:00+03:00,out,False,889410,True,4,0,91,91
166691,2019-11-15 00:00:00+03:00,in,False,889410,False,3,238,254,16
166691,2019-11-16 00:00:00+03:00,out,False,889410,False,2,24,64,40
166691,2019-11-17 00:00:00+03:00,in,False,-1,True,1,0,74,74
166691,2019-11-18 00:00:00+03:00,in,False,889410,False,5,484,519,35
166691,2019-11-18 00:00:00+03:00,out,False,889410,True,4,0,123,123
166691,2019-11-18 00:00:00+03:00,out,False,889410,False,20,1268,1549,281
166691,2019-11-19 00:00:00+03:00,out,False,889410,False,14,804,1004,200
166691,2019-11-19 00:00:00+03:00,out,False,889410,True,5,0,90,90
166691,2019-11-19 00:00:00+03:00,in,False,889410,False,4,160,176,16
166691,2019-11-20 00:00:00+03:00,out,False,889410,False,10,560,680,120
166691,2019-11-20 00:00:00+03:00,in,False,889410,False,6,407,435,28
166691,2019-11-20 00:00:00+03:00,out,False,889410,True,3,0,117,117
166691,2019-11-21 00:00:00+03:00,in,False,901734,False,1,107,117,10
166691,2019-11-21 00:00:00+03:00,out,False,889410,True,1,0,7,7
166691,2019-11-21 00:00:00+03:00,in,False,889410,False,2,144,152,8
166691,2019-11-21 00:00:00+03:00,out,False,889410,False,11,574,718,144
166691,2019-11-22 00:00:00+03:00,in,False,889410,False,3,553,569,16
166691,2019-11-22 00:00:00+03:00,out,False,889410,False,8,542,666,124
166691,2019-11-22 00:00:00+03:00,in,False,901734,False,1,66,78,12
166691,2019-11-22 00:00:00+03:00,in,False,889410,False,3,553,569,16
166691,2019-11-23 00:00:00+03:00,in,False,889410,False,1,45,49,4
166691,2019-11-23 00:00:00+03:00,out,False,889410,False,2,62,85,23
166691,2019-11-24 00:00:00+03:00,out,False,889410,True,6,0,176,176
166691,2019-11-24 00:00:00+03:00,in,False,-1,True,4,0,66,66
166691,2019-11-24 00:00:00+03:00,out,False,889410,False,11,276,476,200
166691,2019-11-24 00:00:00+03:00,out,False,889410,False,11,276,476,200
166691,2019-11-25 00:00:00+03:00,out,False,889410,False,8,435,551,116
166691,2019-11-25 00:00:00+03:00,out,False,889410,True,2,0,65,65
166691,2019-11-25 00:00:00+03:00,in,False,889410,False,6,361,410,49
166691,2019-11-26 00:00:00+03:00,out,False,889410,False,15,1049,1283,234
166691,2019-11-26 00:00:00+03:00,out,False,889410,True,5,0,124,124
166691,2019-11-26 00:00:00+03:00,in,False,889410,False,5,445,478,33
166691,2019-11-26 00:00:00+03:00,in,False,-1,True,3,0,70,70
166691,2019-11-27 00:00:00+03:00,out,False,889410,False,13,723,935,212
166691,2019-11-27 00:00:00+03:00,in,False,901734,False,1,133,153,20
166691,2019-11-27 00:00:00+03:00,out,False,889410,True,1,0,20,20
166691,2019-11-27 00:00:00+03:00,in,False,889410,False,5,380,421,41
166691,2019-11-28 00:00:00+03:00,out,False,889410,True,10,0,218,218
166691,2019-11-28 00:00:00+03:00,in,False,889410,False,7,617,645,28
166691,2019-11-28 00:00:00+03:00,in,False,-1,True,1,0,29,29
166691,2019-11-28 00:00:00+03:00,out,False,889410,False,11,899,1066,167
166691,2019-11-28 00:00:00+03:00,in,False,901734,False,2,224,256,32
166692,2019-08-23 00:00:00+03:00,in,False,-1,True,1,0,2,2
166692,2019-08-23 00:00:00+03:00,in,False,-1,True,1,0,2,2
166692,2019-08-28 00:00:00+03:00,in,False,-1,True,4,0,33,33
166692,2019-08-28 00:00:00+03:00,out,False,898892,False,1,1,25,24
166692,2019-08-29 00:00:00+03:00,out,False,898892,False,1,48,62,14
166692,2019-08-29 00:00:00+03:00,in,False,-1,True,1,0,14,14
166692,2019-08-29 00:00:00+03:00,out,False,898892,False,1,48,62,14
166692,2019-08-30 00:00:00+03:00,in,False,-1,True,1,0,19,19
166692,2019-09-03 00:00:00+03:00,in,False,-1,True,2,0,26,26
166692,2019-09-03 00:00:00+03:00,out,False,898892,False,2,398,465,67
166692,2019-09-03 00:00:00+03:00,out,False,898892,True,2,0,8,8
166692,2019-09-03 00:00:00+03:00,in,False,-1,True,4,0,83,83
166692,2019-09-04 00:00:00+03:00,out,False,898892,False,2,893,932,39
166692,2019-09-04 00:00:00+03:00,out,False,898892,True,1,0,14,14
166692,2019-09-05 00:00:00+03:00,out,False,898892,True,1,0,29,29
166692,2019-09-05 00:00:00+03:00,out,False,898892,False,3,175,275,100
166692,2019-09-06 00:00:00+03:00,out,False,898892,False,2,152,192,40
166692,2019-09-06 00:00:00+03:00,out,False,898892,True,2,0,66,66
166692,2019-09-09 00:00:00+03:00,out,False,898892,True,8,0,174,174
166692,2019-09-09 00:00:00+03:00,out,False,898892,False,7,218,385,167
166692,2019-09-09 00:00:00+03:00,in,False,-1,True,1,0,31,31
166692,2019-09-10 00:00:00+03:00,in,False,898892,False,1,44,58,14
166692,2019-09-10 00:00:00+03:00,out,False,898892,False,3,78,112,34
166692,2019-09-10 00:00:00+03:00,out,False,898892,True,1,0,36,36
166692,2019-09-11 00:00:00+03:00,out,False,898892,False,2,4,54,50
166692,2019-09-12 00:00:00+03:00,in,False,898892,False,1,217,235,18
166692,2019-09-13 00:00:00+03:00,out,False,898892,False,1,2,30,28
166692,2019-09-16 00:00:00+03:00,out,False,898892,False,4,117,197,80
166692,2019-09-16 00:00:00+03:00,out,False,898892,True,3,0,97,97
166692,2019-09-16 00:00:00+03:00,out,False,898892,False,4,117,197,80
166692,2019-09-18 00:00:00+03:00,out,False,898892,False,4,787,852,65
166692,2019-09-20 00:00:00+03:00,out,False,898892,True,2,0,73,73
166692,2019-09-20 00:00:00+03:00,out,False,898892,False,5,313,427,114
166692,2019-09-20 00:00:00+03:00,in,False,898892,False,1,121,130,9
166692,2019-09-23 00:00:00+03:00,out,False,898892,True,1,0,41,41
166692,2019-09-23 00:00:00+03:00,out,False,898892,False,3,32,79,47
166692,2019-09-23 00:00:00+03:00,in,False,898892,False,2,891,955,64
166692,2019-09-25 00:00:00+03:00,out,False,898892,False,2,126,151,25
166692,2019-09-25 00:00:00+03:00,out,False,898892,False,2,126,151,25
166692,2019-09-26 00:00:00+03:00,out,False,898892,True,2,0,42,42
166692,2019-09-26 00:00:00+03:00,out,False,898892,False,1,5,26,21
166692,2019-09-26 00:00:00+03:00,in,False,898892,False,1,29,34,5
166692,2019-09-27 00:00:00+03:00,out,False,898892,False,2,121,159,38
166692,2019-09-30 00:00:00+03:00,out,False,898892,True,1,0,4,4
166692,2019-10-01 00:00:00+03:00,in,False,898892,False,2,195,224,29
166692,2019-10-03 00:00:00+03:00,out,False,898892,False,2,67,92,25
166692,2019-10-04 00:00:00+03:00,out,False,898892,False,2,42,68,26
166692,2019-10-04 00:00:00+03:00,out,False,898892,True,1,0,35,35
166692,2019-10-04 00:00:00+03:00,out,False,898892,True,1,0,35,35
166692,2019-10-09 00:00:00+03:00,out,False,898892,False,1,42,53,11
166692,2019-10-09 00:00:00+03:00,out,False,898892,True,1,0,1,1
166692,2019-10-14 00:00:00+03:00,out,False,898892,False,4,81,180,99
166692,2019-10-16 00:00:00+03:00,out,False,898892,False,1,80,91,11
166692,2019-10-16 00:00:00+03:00,in,False,-1,True,1,0,20,20
166692,2019-10-22 00:00:00+03:00,in,False,-1,True,1,0,12,12
166692,2019-10-24 00:00:00+03:00,out,False,898892,False,1,109,125,16
166692,2019-10-25 00:00:00+03:00,in,False,898892,False,1,34,47,13
166692,2019-10-28 00:00:00+03:00,in,False,898892,False,1,30,43,13
166692,2019-11-01 00:00:00+03:00,in,False,898892,False,1,46,60,14
166692,2019-11-19 00:00:00+03:00,in,False,898892,False,1,142,162,20
166692,2019-11-19 00:00:00+03:00,in,False,-1,True,2,0,44,44
166697,2019-08-20 00:00:00+03:00,in,False,891646,False,1,17,33,16
166697,2019-08-30 00:00:00+03:00,in,False,891646,False,1,46,93,47
166697,2019-09-17 00:00:00+03:00,in,False,-1,True,1,0,11,11
166697,2019-09-17 00:00:00+03:00,in,False,-1,True,1,0,11,11
166697,2019-10-06 00:00:00+03:00,in,False,891646,False,2,24,67,43
166697,2019-10-10 00:00:00+03:00,in,False,891646,False,1,17,38,21
166697,2019-10-16 00:00:00+03:00,in,False,891646,False,1,17,32,15
166697,2019-11-06 00:00:00+03:00,in,False,891646,False,1,63,74,11
166697,2019-11-15 00:00:00+03:00,in,False,891646,False,1,25,36,11
166708,2019-08-27 00:00:00+03:00,in,False,-1,True,12,0,0,0
166708,2019-08-29 00:00:00+03:00,in,False,-1,True,16,0,2,2
166708,2019-08-30 00:00:00+03:00,in,False,-1,True,12,0,1,1
166708,2019-09-02 00:00:00+03:00,in,False,-1,True,4,0,0,0
166708,2019-09-03 00:00:00+03:00,in,False,-1,True,29,0,63,63
166708,2019-09-03 00:00:00+03:00,out,False,899082,True,1,0,5,5
166708,2019-09-04 00:00:00+03:00,in,False,-1,True,1,0,10,10
166708,2019-09-04 00:00:00+03:00,in,False,-1,True,1,0,10,10
166708,2019-09-06 00:00:00+03:00,in,False,-1,True,25,0,428,428
166708,2019-09-07 00:00:00+03:00,in,False,-1,True,13,0,287,287
166708,2019-09-08 00:00:00+03:00,in,False,-1,True,2,0,28,28
166708,2019-09-09 00:00:00+03:00,in,False,-1,True,7,0,213,213
166708,2019-09-09 00:00:00+03:00,in,False,899082,False,1,73,99,26
166708,2019-09-09 00:00:00+03:00,out,False,899082,True,1,0,6,6
166708,2019-09-10 00:00:00+03:00,in,False,899082,False,1,5,26,21
166708,2019-09-10 00:00:00+03:00,out,False,899082,True,2,0,8,8
166708,2019-09-10 00:00:00+03:00,in,False,-1,True,1,0,14,14
166708,2019-09-11 00:00:00+03:00,in,False,-1,True,8,0,180,180
166708,2019-09-11 00:00:00+03:00,out,False,899082,True,3,0,9,9
166708,2019-09-12 00:00:00+03:00,in,False,-1,True,1,0,14,14
166708,2019-09-12 00:00:00+03:00,out,False,899082,False,1,197,208,11
166708,2019-09-13 00:00:00+03:00,out,False,899082,True,6,0,26,26
166708,2019-09-13 00:00:00+03:00,in,False,899082,False,4,224,294,70
166708,2019-09-13 00:00:00+03:00,in,False,-1,True,4,0,124,124
166708,2019-09-14 00:00:00+03:00,in,False,-1,True,14,0,203,203
166708,2019-09-14 00:00:00+03:00,in,False,899082,False,3,410,478,68
166708,2019-09-14 00:00:00+03:00,out,False,899082,True,2,0,32,32
166708,2019-09-14 00:00:00+03:00,out,False,899082,False,3,334,386,52
166708,2019-09-16 00:00:00+03:00,out,False,899082,False,3,138,183,45
166708,2019-09-16 00:00:00+03:00,out,False,899082,True,3,0,18,18
166708,2019-09-16 00:00:00+03:00,in,False,-1,True,3,0,35,35
166708,2019-09-16 00:00:00+03:00,in,False,899082,False,6,584,733,149
166708,2019-09-17 00:00:00+03:00,out,False,899082,True,28,0,499,499
166708,2019-09-17 00:00:00+03:00,out,False,899082,False,11,498,671,173
166708,2019-09-17 00:00:00+03:00,in,False,-1,True,3,0,27,27
166708,2019-09-17 00:00:00+03:00,in,False,899082,False,11,1093,1286,193
166708,2019-09-17 00:00:00+03:00,out,False,899082,False,11,498,671,173
166708,2019-09-18 00:00:00+03:00,out,False,899082,True,11,0,147,147
166708,2019-09-18 00:00:00+03:00,in,False,-1,True,1,0,14,14
166708,2019-09-18 00:00:00+03:00,in,False,899082,False,9,750,916,166
166708,2019-09-18 00:00:00+03:00,out,False,899082,False,16,559,833,274
166708,2019-09-19 00:00:00+03:00,in,False,-1,True,3,0,96,96
166708,2019-09-19 00:00:00+03:00,out,False,899082,False,20,787,1137,350
166708,2019-09-19 00:00:00+03:00,out,False,899082,True,7,0,234,234
166708,2019-09-19 00:00:00+03:00,in,False,899082,False,11,862,1076,214
166708,2019-09-20 00:00:00+03:00,out,False,899082,True,2,0,68,68
166708,2019-09-20 00:00:00+03:00,in,False,-1,True,2,0,68,68
166708,2019-09-20 00:00:00+03:00,out,False,899082,False,9,266,382,116
166708,2019-09-20 00:00:00+03:00,in,False,899082,False,9,514,674,160
166708,2019-09-21 00:00:00+03:00,in,False,899082,False,7,405,557,152
166708,2019-09-21 00:00:00+03:00,out,False,899082,True,7,0,129,129
166708,2019-09-21 00:00:00+03:00,out,False,899082,False,4,89,154,65
166708,2019-09-21 00:00:00+03:00,in,False,-1,True,2,0,28,28
166708,2019-09-21 00:00:00+03:00,out,False,899082,True,7,0,129,129
166708,2019-09-22 00:00:00+03:00,in,False,-1,True,1,0,14,14
166708,2019-09-23 00:00:00+03:00,in,False,899082,False,16,1310,1637,327
166708,2019-09-23 00:00:00+03:00,in,False,-1,True,5,0,181,181
166708,2019-09-23 00:00:00+03:00,out,False,899082,True,11,0,192,192
166708,2019-09-23 00:00:00+03:00,out,False,899082,False,26,996,1414,418
166708,2019-09-24 00:00:00+03:00,in,False,899082,False,16,1817,2116,299
166708,2019-09-24 00:00:00+03:00,out,False,899082,True,11,0,276,276
166708,2019-09-24 00:00:00+03:00,in,False,-1,True,1,0,0,0
166708,2019-09-24 00:00:00+03:00,out,False,899082,False,27,1394,1881,487
166708,2019-09-25 00:00:00+03:00,in,False,899082,False,6,429,531,102
166708,2019-09-25 00:00:00+03:00,in,False,-1,True,1,0,28,28
166708,2019-09-25 00:00:00+03:00,out,False,899082,True,13,0,214,214
166708,2019-09-25 00:00:00+03:00,out,False,899082,False,15,626,905,279
166708,2019-09-26 00:00:00+03:00,in,False,899082,False,15,1001,1268,267
166708,2019-09-26 00:00:00+03:00,in,False,-1,True,3,0,7,7
166708,2019-09-26 00:00:00+03:00,out,False,899082,False,21,838,1161,323
166708,2019-09-26 00:00:00+03:00,out,False,899082,True,13,0,254,254
166708,2019-09-27 00:00:00+03:00,out,False,899082,True,1,0,60,60
166708,2019-09-27 00:00:00+03:00,in,False,-1,True,2,0,28,28
166708,2019-09-27 00:00:00+03:00,in,False,899082,False,9,940,1108,168
166708,2019-09-27 00:00:00+03:00,out,False,899082,False,3,86,130,44
166708,2019-09-27 00:00:00+03:00,in,False,-1,True,2,0,28,28
166708,2019-09-28 00:00:00+03:00,out,False,899082,False,9,231,365,134
166708,2019-09-28 00:00:00+03:00,out,False,899082,True,10,0,256,256
166708,2019-09-28 00:00:00+03:00,in,False,-1,True,7,0,168,168
166708,2019-09-28 00:00:00+03:00,in,False,899082,False,9,824,971,147
166708,2019-09-28 00:00:00+03:00,in,False,-1,True,7,0,168,168
166708,2019-09-30 00:00:00+03:00,in,False,899082,False,16,1572,1871,299
166708,2019-09-30 00:00:00+03:00,in,False,-1,True,7,0,270,270
166708,2019-09-30 00:00:00+03:00,out,False,899082,False,23,697,1118,421
166708,2019-09-30 00:00:00+03:00,out,False,899082,True,13,0,422,422
166708,2019-09-30 00:00:00+03:00,in,False,899082,False,16,1572,1871,299
166708,2019-10-01 00:00:00+03:00,in,False,-1,True,8,0,280,280
166708,2019-10-01 00:00:00+03:00,in,False,899082,False,9,865,1025,160
166708,2019-10-01 00:00:00+03:00,out,False,899082,False,14,448,679,231
166708,2019-10-01 00:00:00+03:00,out,False,899082,True,5,0,84,84
166708,2019-10-02 00:00:00+03:00,in,False,899082,False,13,1464,1729,265
166708,2019-10-02 00:00:00+03:00,out,False,899082,False,18,777,1056,279
166708,2019-10-02 00:00:00+03:00,out,False,899082,True,5,0,114,114
166708,2019-10-02 00:00:00+03:00,in,False,-1,True,3,0,88,88
166708,2019-10-03 00:00:00+03:00,out,False,899082,True,16,0,354,354
166708,2019-10-03 00:00:00+03:00,in,False,899082,False,9,541,734,193
166708,2019-10-03 00:00:00+03:00,out,False,899082,False,24,1097,1463,366
166708,2019-10-03 00:00:00+03:00,in,False,-1,True,4,0,123,123
166708,2019-10-04 00:00:00+03:00,in,False,-1,True,3,0,165,165
166708,2019-10-04 00:00:00+03:00,in,False,899082,False,8,784,928,144
166708,2019-10-04 00:00:00+03:00,out,False,899082,False,15,442,760,318
166708,2019-10-04 00:00:00+03:00,out,False,899082,True,2,0,2,2
166708,2019-10-05 00:00:00+03:00,out,False,899082,False,9,160,292,132
166708,2019-10-05 00:00:00+03:00,out,False,899082,True,1,0,15,15
166708,2019-10-05 00:00:00+03:00,in,False,-1,True,1,0,3,3
166708,2019-10-05 00:00:00+03:00,in,False,899082,False,4,177,239,62
166708,2019-10-07 00:00:00+03:00,in,False,899082,True,1,1,25,24
166708,2019-10-07 00:00:00+03:00,in,False,899082,False,12,1256,1508,252
166708,2019-10-07 00:00:00+03:00,out,False,899082,True,5,0,107,107
166708,2019-10-07 00:00:00+03:00,out,False,899082,False,13,551,750,199
166708,2019-10-07 00:00:00+03:00,in,False,-1,True,2,0,18,18
166708,2019-10-07 00:00:00+03:00,out,False,899082,False,13,551,750,199
166708,2019-10-08 00:00:00+03:00,out,False,899082,False,10,576,744,168
166708,2019-10-08 00:00:00+03:00,in,False,-1,True,1,0,27,27
166708,2019-10-08 00:00:00+03:00,in,False,899082,False,3,92,146,54
166708,2019-10-08 00:00:00+03:00,out,False,899082,True,5,0,78,78
166708,2019-10-09 00:00:00+03:00,in,False,899082,False,16,963,1264,301
166708,2019-10-09 00:00:00+03:00,out,False,899082,True,1,0,6,6
166708,2019-10-09 00:00:00+03:00,in,False,-1,True,3,0,103,103
166708,2019-10-09 00:00:00+03:00,out,False,899082,False,18,926,1175,249
166708,2019-10-09 00:00:00+03:00,out,False,899082,True,1,0,6,6
166708,2019-10-09 00:00:00+03:00,in,False,899082,False,16,963,1264,301
166708,2019-10-10 00:00:00+03:00,in,False,-1,True,3,0,57,57
166708,2019-10-10 00:00:00+03:00,out,False,899082,False,18,537,812,275
166708,2019-10-10 00:00:00+03:00,out,False,899082,True,7,0,156,156
166708,2019-10-10 00:00:00+03:00,in,False,899082,False,13,787,1036,249
166708,2019-10-10 00:00:00+03:00,in,False,899082,False,13,787,1036,249
166708,2019-10-11 00:00:00+03:00,out,False,899082,False,13,449,685,236
166708,2019-10-11 00:00:00+03:00,out,False,-1,True,1,0,0,0
166708,2019-10-11 00:00:00+03:00,in,False,899082,False,6,440,560,120
166708,2019-10-11 00:00:00+03:00,out,False,899082,True,6,0,178,178
166708,2019-10-11 00:00:00+03:00,in,False,-1,True,2,0,115,115
166708,2019-10-12 00:00:00+03:00,in,False,899082,False,4,480,563,83
166708,2019-10-12 00:00:00+03:00,out,False,899082,False,11,307,472,165
166708,2019-10-12 00:00:00+03:00,in,False,-1,True,1,0,58,58
166708,2019-10-12 00:00:00+03:00,out,False,899082,True,7,0,151,151
166708,2019-10-12 00:00:00+03:00,out,False,899082,False,11,307,472,165
166708,2019-10-14 00:00:00+03:00,in,False,-1,True,3,0,9,9
166708,2019-10-14 00:00:00+03:00,in,False,899082,False,10,774,959,185
166708,2019-10-14 00:00:00+03:00,out,False,899082,False,13,412,646,234
166708,2019-10-14 00:00:00+03:00,out,False,899082,True,3,0,87,87
166708,2019-10-15 00:00:00+03:00,out,False,899082,True,9,0,247,247
166708,2019-10-15 00:00:00+03:00,out,False,899082,False,24,706,1134,428
166708,2019-10-15 00:00:00+03:00,in,False,-1,True,4,0,131,131
166708,2019-10-15 00:00:00+03:00,in,False,899082,False,14,1127,1411,284
166708,2019-10-16 00:00:00+03:00,out,False,899082,False,16,580,882,302
166708,2019-10-16 00:00:00+03:00,in,False,-1,True,1,0,59,59
166708,2019-10-16 00:00:00+03:00,in,False,899082,False,8,684,830,146
166708,2019-10-16 00:00:00+03:00,out,False,899082,True,5,0,91,91
166708,2019-10-17 00:00:00+03:00,out,False,899082,True,7,0,125,125
166708,2019-10-17 00:00:00+03:00,in,False,899082,False,7,727,856,129
166708,2019-10-17 00:00:00+03:00,out,False,899082,False,15,494,725,231
166708,2019-10-17 00:00:00+03:00,in,False,-1,True,3,0,70,70
166708,2019-10-17 00:00:00+03:00,in,False,-1,True,3,0,70,70
166708,2019-10-18 00:00:00+03:00,out,False,899082,True,1,0,30,30
166708,2019-10-18 00:00:00+03:00,in,False,899082,False,4,306,380,74
166708,2019-10-18 00:00:00+03:00,out,False,899082,False,11,278,453,175
166708,2019-10-19 00:00:00+03:00,out,False,899082,True,10,0,244,244
166708,2019-10-19 00:00:00+03:00,out,False,899082,False,9,197,338,141
166708,2019-10-19 00:00:00+03:00,in,False,899082,False,2,72,111,39
166708,2019-10-20 00:00:00+03:00,in,False,-1,True,1,0,14,14
166708,2019-10-21 00:00:00+03:00,out,False,899082,False,15,444,677,233
166708,2019-10-21 00:00:00+03:00,in,False,899082,False,13,1127,1408,281
166708,2019-10-21 00:00:00+03:00,out,False,899082,True,12,0,224,224
166708,2019-10-21 00:00:00+03:00,in,False,-1,True,4,0,149,149
166708,2019-10-22 00:00:00+03:00,in,False,-1,True,3,0,122,122
166708,2019-10-22 00:00:00+03:00,in,False,899082,False,6,834,991,157
166708,2019-10-22 00:00:00+03:00,out,False,899082,True,5,0,161,161
166708,2019-10-22 00:00:00+03:00,out,False,899082,False,20,559,859,300
166708,2019-10-22 00:00:00+03:00,in,False,-1,True,3,0,122,122
166708,2019-10-23 00:00:00+03:00,out,False,899082,True,6,0,116,116
166708,2019-10-23 00:00:00+03:00,out,False,899082,False,12,347,551,204
166708,2019-10-23 00:00:00+03:00,in,False,899082,False,8,624,791,167
166708,2019-10-23 00:00:00+03:00,in,False,899082,False,8,624,791,167
166708,2019-10-24 00:00:00+03:00,in,False,899082,False,16,1467,1776,309
166708,2019-10-24 00:00:00+03:00,out,True,899082,True,1,0,0,0
166708,2019-10-24 00:00:00+03:00,in,False,-1,True,8,0,314,314
166708,2019-10-24 00:00:00+03:00,out,False,899082,False,11,658,809,151
166708,2019-10-25 00:00:00+03:00,in,False,-1,True,2,0,58,58
166708,2019-10-25 00:00:00+03:00,out,False,899082,False,22,1033,1402,369
166708,2019-10-25 00:00:00+03:00,in,False,899082,False,15,1401,1768,367
166708,2019-10-25 00:00:00+03:00,out,False,899082,True,13,0,292,292
166708,2019-10-26 00:00:00+03:00,in,False,899082,False,4,262,328,66
166708,2019-10-26 00:00:00+03:00,out,False,899082,True,9,0,181,181
166708,2019-10-26 00:00:00+03:00,out,False,899082,False,12,394,579,185
166708,2019-10-28 00:00:00+03:00,out,False,899082,True,3,0,108,108
166708,2019-10-28 00:00:00+03:00,in,False,899082,False,24,1525,1983,458
166708,2019-10-28 00:00:00+03:00,out,False,899082,False,4,243,285,42
166708,2019-10-28 00:00:00+03:00,in,False,-1,True,6,0,238,238
166708,2019-10-28 00:00:00+03:00,in,False,-1,True,6,0,238,238
166708,2019-10-29 00:00:00+03:00,out,False,899082,True,3,0,96,96
166708,2019-10-29 00:00:00+03:00,out,False,899082,False,18,627,907,280
166708,2019-10-29 00:00:00+03:00,in,False,-1,True,1,0,15,15
166708,2019-10-29 00:00:00+03:00,in,False,899082,False,7,289,410,121
166708,2019-10-30 00:00:00+03:00,out,False,899082,True,8,0,196,196
166708,2019-10-30 00:00:00+03:00,in,False,899082,False,13,751,978,227
166708,2019-10-30 00:00:00+03:00,out,False,899082,False,22,698,1056,358
166708,2019-10-30 00:00:00+03:00,in,False,-1,True,7,0,215,215
166708,2019-10-31 00:00:00+03:00,out,False,899082,True,3,0,104,104
166708,2019-10-31 00:00:00+03:00,out,False,899082,False,11,255,414,159
166708,2019-10-31 00:00:00+03:00,in,False,-1,True,2,0,43,43
166708,2019-10-31 00:00:00+03:00,in,False,899082,False,6,285,389,104
166708,2019-11-01 00:00:00+03:00,in,False,899082,False,5,344,421,77
166708,2019-11-01 00:00:00+03:00,out,False,899082,True,4,0,94,94
166708,2019-11-01 00:00:00+03:00,in,False,-1,True,2,0,76,76
166708,2019-11-01 00:00:00+03:00,out,False,899082,False,14,387,615,228
166708,2019-11-02 00:00:00+03:00,out,False,899082,False,12,371,576,205
166708,2019-11-02 00:00:00+03:00,out,False,899082,True,6,0,114,114
166708,2019-11-02 00:00:00+03:00,in,False,899082,False,4,257,317,60
166708,2019-11-02 00:00:00+03:00,out,False,899082,False,12,371,576,205
166708,2019-11-03 00:00:00+03:00,in,False,-1,True,2,0,28,28
166708,2019-11-04 00:00:00+03:00,in,False,899082,False,8,614,784,170
166708,2019-11-04 00:00:00+03:00,out,False,899082,False,12,603,773,170
166708,2019-11-04 00:00:00+03:00,in,False,-1,True,1,0,14,14
166708,2019-11-04 00:00:00+03:00,out,False,899082,True,10,0,198,198
166708,2019-11-05 00:00:00+03:00,in,False,899082,False,13,995,1301,306
166708,2019-11-05 00:00:00+03:00,out,False,899082,True,11,0,206,206
166708,2019-11-05 00:00:00+03:00,out,False,899082,False,26,813,1232,419
166708,2019-11-05 00:00:00+03:00,in,False,-1,True,5,0,212,212
166708,2019-11-06 00:00:00+03:00,out,False,899082,True,9,0,286,286
166708,2019-11-06 00:00:00+03:00,out,False,899082,False,17,392,683,291
166708,2019-11-06 00:00:00+03:00,in,False,-1,True,1,0,14,14
166708,2019-11-06 00:00:00+03:00,in,False,899082,False,9,635,776,141
166708,2019-11-07 00:00:00+03:00,in,False,899082,False,17,942,1248,306
166708,2019-11-07 00:00:00+03:00,out,False,899082,False,25,799,1212,413
166708,2019-11-07 00:00:00+03:00,in,False,-1,True,31,0,693,693
166708,2019-11-07 00:00:00+03:00,out,False,899082,True,14,0,395,395
166708,2019-11-08 00:00:00+03:00,in,False,-1,True,4,0,63,63
166708,2019-11-08 00:00:00+03:00,out,False,899082,True,10,0,172,172
166708,2019-11-08 00:00:00+03:00,out,False,899082,False,12,616,806,190
166708,2019-11-08 00:00:00+03:00,in,False,899082,False,5,252,360,108
166708,2019-11-09 00:00:00+03:00,in,False,-1,True,5,0,66,66
166708,2019-11-09 00:00:00+03:00,in,False,899082,False,11,1182,1476,294
166708,2019-11-09 00:00:00+03:00,out,False,899082,False,21,723,1049,326
166708,2019-11-09 00:00:00+03:00,out,False,899082,True,7,0,192,192
166708,2019-11-11 00:00:00+03:00,out,False,899082,False,19,999,1298,299
166708,2019-11-11 00:00:00+03:00,out,False,899082,True,3,0,84,84
166708,2019-11-11 00:00:00+03:00,in,False,899082,False,17,1788,2110,322
166708,2019-11-11 00:00:00+03:00,in,False,-1,True,2,0,55,55
166708,2019-11-12 00:00:00+03:00,in,False,899082,False,10,761,1078,317
166708,2019-11-12 00:00:00+03:00,out,False,899082,False,26,610,1016,406
166708,2019-11-12 00:00:00+03:00,out,False,899082,True,10,0,260,260
166708,2019-11-12 00:00:00+03:00,in,False,-1,True,2,0,11,11
166708,2019-11-12 00:00:00+03:00,out,False,899082,True,10,0,260,260
166708,2019-11-12 00:00:00+03:00,in,False,-1,True,2,0,11,11
166708,2019-11-12 00:00:00+03:00,out,False,899082,False,26,610,1016,406
166708,2019-11-13 00:00:00+03:00,out,False,899082,False,27,495,986,491
166708,2019-11-13 00:00:00+03:00,in,False,899082,False,5,302,400,98
166708,2019-11-13 00:00:00+03:00,out,False,899082,True,12,0,230,230
166708,2019-11-13 00:00:00+03:00,in,False,899082,False,5,302,400,98
166708,2019-11-14 00:00:00+03:00,out,False,899082,False,21,532,850,318
166708,2019-11-14 00:00:00+03:00,in,False,899082,False,8,984,1268,284
166708,2019-11-14 00:00:00+03:00,in,False,-1,True,13,0,317,317
166708,2019-11-14 00:00:00+03:00,out,False,899082,True,7,0,130,130
166708,2019-11-14 00:00:00+03:00,out,False,899082,False,21,532,850,318
166708,2019-11-15 00:00:00+03:00,out,False,899082,True,2,0,67,67
166708,2019-11-15 00:00:00+03:00,in,False,-1,True,2,0,97,97
166708,2019-11-15 00:00:00+03:00,out,False,899082,False,10,202,358,156
166708,2019-11-15 00:00:00+03:00,in,False,899082,False,8,602,792,190
166708,2019-11-16 00:00:00+03:00,out,False,899082,True,4,0,118,118
166708,2019-11-16 00:00:00+03:00,in,False,899082,False,2,107,137,30
166708,2019-11-16 00:00:00+03:00,out,False,899082,False,8,170,308,138
166708,2019-11-16 00:00:00+03:00,in,False,-1,True,2,0,142,142
166708,2019-11-17 00:00:00+03:00,in,False,-1,True,1,0,14,14
166708,2019-11-18 00:00:00+03:00,in,False,-1,True,3,0,42,42
166708,2019-11-18 00:00:00+03:00,in,False,899082,False,15,1458,1795,337
166708,2019-11-18 00:00:00+03:00,out,False,899082,False,20,755,990,235
166708,2019-11-18 00:00:00+03:00,out,False,899082,True,9,0,212,212
166708,2019-11-18 00:00:00+03:00,in,False,-1,True,3,0,42,42
166708,2019-11-19 00:00:00+03:00,out,False,899082,True,8,0,116,116
166708,2019-11-19 00:00:00+03:00,in,False,-1,True,5,0,161,161
166708,2019-11-19 00:00:00+03:00,in,False,899082,False,15,981,1341,360
166708,2019-11-19 00:00:00+03:00,out,False,899082,False,21,666,1056,390
166708,2019-11-20 00:00:00+03:00,out,False,899082,False,21,495,855,360
166708,2019-11-20 00:00:00+03:00,out,False,899082,True,4,0,52,52
166708,2019-11-20 00:00:00+03:00,in,False,899082,False,10,675,874,199
166708,2019-11-21 00:00:00+03:00,out,False,899082,True,6,0,156,156
166708,2019-11-21 00:00:00+03:00,out,False,899082,False,25,782,1160,378
166708,2019-11-21 00:00:00+03:00,in,False,899082,False,23,1203,1782,579
166708,2019-11-21 00:00:00+03:00,in,False,-1,True,6,0,251,251
166708,2019-11-21 00:00:00+03:00,out,False,899082,True,6,0,156,156
166708,2019-11-22 00:00:00+03:00,in,False,-1,True,1,0,48,48
166708,2019-11-22 00:00:00+03:00,out,False,899082,False,8,184,279,95
166708,2019-11-22 00:00:00+03:00,out,False,899082,True,5,0,135,135
166708,2019-11-22 00:00:00+03:00,in,False,899082,False,12,884,1209,325
166708,2019-11-22 00:00:00+03:00,out,False,899082,True,5,0,135,135
166708,2019-11-23 00:00:00+03:00,out,False,899082,True,9,0,229,229
166708,2019-11-23 00:00:00+03:00,out,False,899082,False,13,272,475,203
166708,2019-11-23 00:00:00+03:00,in,False,899082,False,8,911,1119,208
166708,2019-11-23 00:00:00+03:00,in,False,-1,True,3,0,61,61
166708,2019-11-23 00:00:00+03:00,out,False,899082,True,9,0,229,229
166708,2019-11-24 00:00:00+03:00,in,False,-1,True,1,0,7,7
166708,2019-11-25 00:00:00+03:00,in,False,899082,False,16,1614,1860,246
166708,2019-11-25 00:00:00+03:00,out,False,899082,True,4,0,124,124
166708,2019-11-25 00:00:00+03:00,in,False,-1,True,1,0,48,48
166708,2019-11-25 00:00:00+03:00,out,False,899082,False,18,412,669,257
166708,2019-11-26 00:00:00+03:00,out,False,899082,True,3,0,105,105
166708,2019-11-26 00:00:00+03:00,in,False,-1,True,4,0,120,120
166708,2019-11-26 00:00:00+03:00,in,False,899082,False,9,572,718,146
166708,2019-11-26 00:00:00+03:00,out,False,899082,False,26,607,1045,438
166708,2019-11-26 00:00:00+03:00,out,False,899082,True,3,0,105,105
166708,2019-11-27 00:00:00+03:00,out,False,899082,False,24,942,1351,409
166708,2019-11-27 00:00:00+03:00,in,False,-1,True,6,0,215,215
166708,2019-11-27 00:00:00+03:00,out,False,899082,True,6,0,186,186
166708,2019-11-27 00:00:00+03:00,in,False,899082,False,8,632,824,192
166708,2019-11-28 00:00:00+03:00,out,False,899082,False,17,499,759,260
166708,2019-11-28 00:00:00+03:00,out,False,899082,True,13,0,262,262
166708,2019-11-28 00:00:00+03:00,in,False,899082,False,13,1653,1972,319
166708,2019-11-28 00:00:00+03:00,out,False,899082,True,13,0,262,262
166711,2019-08-19 00:00:00+03:00,in,False,-1,True,1,0,2,2
166711,2019-08-20 00:00:00+03:00,out,False,891250,False,2,110,128,18
166711,2019-08-21 00:00:00+03:00,out,False,891252,True,1,0,3,3
166711,2019-08-22 00:00:00+03:00,out,False,891252,True,4,0,69,69
166711,2019-08-22 00:00:00+03:00,out,False,891252,False,8,570,606,36
166711,2019-08-23 00:00:00+03:00,in,False,-1,True,1,0,0,0
166711,2019-08-23 00:00:00+03:00,out,False,891970,False,6,553,633,80
166711,2019-08-23 00:00:00+03:00,out,False,891970,True,9,0,145,145
166711,2019-08-23 00:00:00+03:00,out,False,891970,False,6,553,633,80
166711,2019-08-24 00:00:00+03:00,in,False,-1,True,4,0,0,0
166711,2019-08-26 00:00:00+03:00,in,False,-1,True,2,0,1,1
166711,2019-08-26 00:00:00+03:00,out,False,891252,True,21,0,321,321
166711,2019-08-26 00:00:00+03:00,out,False,891252,False,7,1088,1137,49
166711,2019-08-27 00:00:00+03:00,out,False,891252,False,3,37,59,22
166711,2019-08-27 00:00:00+03:00,in,False,-1,True,2,0,30,30
166711,2019-08-27 00:00:00+03:00,out,False,891252,True,4,0,61,61
166711,2019-08-29 00:00:00+03:00,out,False,891252,False,5,341,368,27
166711,2019-08-29 00:00:00+03:00,out,False,891252,True,2,0,21,21
166711,2019-08-29 00:00:00+03:00,out,False,891252,False,5,341,368,27
166711,2019-08-30 00:00:00+03:00,out,False,891252,True,7,0,74,74
166711,2019-08-30 00:00:00+03:00,out,False,891252,False,11,933,1009,76
166711,2019-08-30 00:00:00+03:00,out,False,891252,True,7,0,74,74
166711,2019-09-02 00:00:00+03:00,out,False,891252,False,10,878,947,69
166711,2019-09-02 00:00:00+03:00,in,False,-1,True,1,0,0,0
166711,2019-09-02 00:00:00+03:00,out,False,891252,True,3,0,31,31
166711,2019-09-14 00:00:00+03:00,in,False,-1,True,11,0,0,0
166711,2019-09-15 00:00:00+03:00,in,False,-1,True,3,0,0,0
166711,2019-09-16 00:00:00+03:00,in,False,-1,True,4,0,4,4
166711,2019-09-26 00:00:00+03:00,in,False,-1,True,1,0,0,0
166711,2019-09-30 00:00:00+03:00,in,False,-1,True,2,0,0,0
166711,2019-10-01 00:00:00+03:00,in,False,-1,True,1,0,0,0
166711,2019-10-01 00:00:00+03:00,in,False,-1,True,1,0,0,0
166711,2019-10-21 00:00:00+03:00,in,False,-1,True,1,0,0,0
166711,2019-10-22 00:00:00+03:00,in,False,-1,True,3,0,4,4
166711,2019-10-24 00:00:00+03:00,in,False,-1,True,3,0,0,0
166711,2019-10-25 00:00:00+03:00,in,False,-1,True,9,0,2,2
166711,2019-11-22 00:00:00+03:00,in,False,891254,False,1,79,105,26
166711,2019-11-22 00:00:00+03:00,in,False,-1,True,2,0,4,4
166711,2019-11-22 00:00:00+03:00,in,False,891254,False,1,79,105,26
166711,2019-11-25 00:00:00+03:00,in,False,-1,True,2,0,46,46
166713,2019-08-21 00:00:00+03:00,in,False,-1,True,4,0,8,8
166713,2019-08-22 00:00:00+03:00,in,False,891918,False,1,40,62,22
166713,2019-08-22 00:00:00+03:00,in,False,891908,False,4,538,568,30
166713,2019-08-22 00:00:00+03:00,in,False,-1,True,4,0,8,8
166713,2019-08-26 00:00:00+03:00,in,False,891908,False,1,713,727,14
166713,2019-09-03 00:00:00+03:00,in,False,-1,True,1,0,31,31
166713,2019-09-04 00:00:00+03:00,in,False,891908,False,2,29,51,22
166713,2019-09-04 00:00:00+03:00,in,False,891918,False,1,97,125,28
166713,2019-09-04 00:00:00+03:00,in,False,891918,False,1,97,125,28
166713,2019-09-05 00:00:00+03:00,in,False,891908,False,1,303,312,9
166713,2019-09-06 00:00:00+03:00,in,False,-1,True,1,0,3,3
166713,2019-09-10 00:00:00+03:00,in,False,891908,False,1,389,395,6
166713,2019-09-11 00:00:00+03:00,in,True,891908,False,1,34,41,7
166713,2019-09-11 00:00:00+03:00,out,True,891908,False,1,141,159,18
166713,2019-09-16 00:00:00+03:00,in,False,-1,True,1,0,43,43
166713,2019-09-16 00:00:00+03:00,in,False,-1,True,1,0,43,43
166713,2019-09-19 00:00:00+03:00,in,False,891908,False,3,321,362,41
166713,2019-09-23 00:00:00+03:00,in,False,891908,False,1,13,37,24
166713,2019-09-24 00:00:00+03:00,in,False,891908,False,1,19,27,8
166713,2019-09-26 00:00:00+03:00,in,False,-1,True,2,0,4,4
166713,2019-09-26 00:00:00+03:00,in,False,-1,True,2,0,4,4
166713,2019-10-01 00:00:00+03:00,in,False,-1,True,1,0,2,2
166713,2019-10-02 00:00:00+03:00,in,False,891908,False,1,15,30,15
166713,2019-10-02 00:00:00+03:00,in,False,891908,False,1,15,30,15
166713,2019-10-04 00:00:00+03:00,in,False,-1,True,2,0,62,62
166713,2019-10-05 00:00:00+03:00,in,False,-1,True,1,0,34,34
166713,2019-10-09 00:00:00+03:00,in,False,891908,False,2,57,78,21
166713,2019-10-10 00:00:00+03:00,out,False,891908,False,1,70,74,4
166713,2019-10-10 00:00:00+03:00,in,False,891908,False,1,87,109,22
166713,2019-10-10 00:00:00+03:00,in,False,-1,True,1,0,45,45
166713,2019-10-10 00:00:00+03:00,in,False,891918,False,1,84,123,39
166713,2019-10-10 00:00:00+03:00,out,False,891908,True,4,0,9,9
166713,2019-10-10 00:00:00+03:00,in,False,-1,True,1,0,45,45
166713,2019-10-10 00:00:00+03:00,in,False,891918,False,1,84,123,39
166713,2019-10-14 00:00:00+03:00,in,False,-1,True,1,0,35,35
166713,2019-10-17 00:00:00+03:00,in,False,891908,False,1,9,13,4
166713,2019-10-18 00:00:00+03:00,in,False,-1,True,1,0,34,34
166713,2019-10-21 00:00:00+03:00,out,False,891918,True,1,0,15,15
166713,2019-10-25 00:00:00+03:00,in,False,891908,False,1,22,28,6
166713,2019-10-27 00:00:00+03:00,in,False,891918,False,1,13,54,41
166713,2019-10-27 00:00:00+03:00,in,False,-1,True,1,0,84,84
166713,2019-10-29 00:00:00+03:00,in,False,891908,False,1,132,143,11
166713,2019-10-30 00:00:00+03:00,in,False,891908,False,1,117,130,13
166713,2019-11-03 00:00:00+03:00,in,False,-1,True,1,0,96,96
166713,2019-11-05 00:00:00+03:00,in,False,891908,False,1,8,12,4
166713,2019-11-06 00:00:00+03:00,in,False,891918,False,1,81,107,26
166713,2019-11-06 00:00:00+03:00,in,False,891908,False,4,225,254,29
166713,2019-11-07 00:00:00+03:00,in,False,891908,False,1,203,208,5
166713,2019-11-08 00:00:00+03:00,in,False,891908,False,2,679,699,20
166713,2019-11-08 00:00:00+03:00,in,False,-1,True,1,0,2,2
166713,2019-11-09 00:00:00+03:00,in,False,-1,True,1,0,48,48
166713,2019-11-09 00:00:00+03:00,in,False,-1,True,1,0,48,48
166713,2019-11-14 00:00:00+03:00,in,False,891908,False,1,854,858,4
166713,2019-11-15 00:00:00+03:00,in,False,891908,False,2,2124,2146,22
166713,2019-11-15 00:00:00+03:00,in,False,-1,True,1,0,74,74
166713,2019-11-16 00:00:00+03:00,out,False,891908,False,1,152,163,11
166713,2019-11-16 00:00:00+03:00,out,False,891908,True,2,0,2,2
166713,2019-11-16 00:00:00+03:00,out,False,891908,True,2,0,2,2
166713,2019-11-17 00:00:00+03:00,in,False,-1,True,2,0,216,216
166713,2019-11-17 00:00:00+03:00,in,False,891908,False,1,1765,1791,26
166713,2019-11-21 00:00:00+03:00,in,False,891908,False,1,287,291,4
166713,2019-11-23 00:00:00+03:00,in,False,891908,False,1,81,91,10
166713,2019-11-26 00:00:00+03:00,in,False,-1,True,1,0,29,29
166713,2019-11-26 00:00:00+03:00,in,False,891908,False,1,66,73,7
166713,2019-11-27 00:00:00+03:00,in,False,-1,True,2,0,95,95
166713,2019-11-27 00:00:00+03:00,in,False,891908,False,1,15,27,12
166717,2019-08-20 00:00:00+03:00,out,False,891988,True,3,0,98,98
166717,2019-08-26 00:00:00+03:00,out,False,891988,True,3,0,26,26
166717,2019-08-26 00:00:00+03:00,in,False,891988,False,7,422,488,66
166717,2019-08-26 00:00:00+03:00,out,False,891988,False,9,379,525,146
166717,2019-08-27 00:00:00+03:00,out,False,891988,False,3,168,249,81
166717,2019-08-27 00:00:00+03:00,in,False,891988,False,3,277,294,17
166717,2019-08-27 00:00:00+03:00,out,False,891988,True,2,0,50,50
166717,2019-08-27 00:00:00+03:00,in,False,-1,True,6,0,0,0
166717,2019-08-27 00:00:00+03:00,in,False,891988,False,3,277,294,17
166717,2019-08-28 00:00:00+03:00,in,False,891988,False,2,107,123,16
166717,2019-08-28 00:00:00+03:00,out,False,891988,True,1,0,50,50
166717,2019-08-28 00:00:00+03:00,in,False,-1,True,2,0,0,0
166717,2019-08-28 00:00:00+03:00,out,False,891988,False,6,1468,1539,71
166717,2019-08-28 00:00:00+03:00,in,False,-1,True,2,0,0,0
166717,2019-08-29 00:00:00+03:00,in,False,-1,True,2,0,0,0
166717,2019-08-29 00:00:00+03:00,in,False,891988,False,6,306,367,61
166717,2019-08-29 00:00:00+03:00,out,False,891988,True,1,0,6,6
166717,2019-08-29 00:00:00+03:00,out,False,891988,False,5,490,547,57
166717,2019-08-30 00:00:00+03:00,out,False,891988,True,1,0,15,15
166717,2019-08-30 00:00:00+03:00,out,False,891988,False,3,199,275,76
166717,2019-08-30 00:00:00+03:00,in,False,891988,False,4,348,381,33
166717,2019-09-02 00:00:00+03:00,out,False,891988,False,2,145,196,51
166717,2019-09-02 00:00:00+03:00,in,False,-1,True,7,0,53,53
166717,2019-09-02 00:00:00+03:00,in,False,891988,False,6,2623,2669,46
166717,2019-09-02 00:00:00+03:00,out,False,891988,True,3,0,23,23
166717,2019-09-03 00:00:00+03:00,out,False,891988,False,6,371,491,120
166717,2019-09-03 00:00:00+03:00,in,False,891988,False,3,717,747,30
166717,2019-09-04 00:00:00+03:00,in,False,891988,False,3,508,524,16
166717,2019-09-04 00:00:00+03:00,out,False,891988,False,6,1178,1257,79
166717,2019-09-04 00:00:00+03:00,out,False,891988,True,1,0,8,8
166717,2019-09-04 00:00:00+03:00,in,False,891988,False,3,508,524,16
166717,2019-09-05 00:00:00+03:00,out,False,891988,True,1,0,15,15
166717,2019-09-05 00:00:00+03:00,in,False,-1,True,4,0,212,212
166717,2019-09-05 00:00:00+03:00,out,False,891988,False,10,1514,1646,132
166717,2019-09-05 00:00:00+03:00,in,False,891988,False,10,1862,1948,86
166717,2019-09-06 00:00:00+03:00,in,False,-1,True,5,0,649,649
166717,2019-09-06 00:00:00+03:00,out,False,891988,True,9,0,117,117
166717,2019-09-06 00:00:00+03:00,in,False,891988,False,6,352,395,43
166717,2019-09-06 00:00:00+03:00,out,False,891988,False,10,1217,1352,135
166717,2019-09-08 00:00:00+03:00,in,False,-1,True,20,0,4,4
166717,2019-09-09 00:00:00+03:00,out,False,891988,False,1,112,128,16
166717,2019-09-09 00:00:00+03:00,in,False,891988,False,4,538,581,43
166717,2019-09-09 00:00:00+03:00,out,False,891988,True,1,0,9,9
166717,2019-09-10 00:00:00+03:00,in,False,891988,False,5,453,503,50
166717,2019-09-10 00:00:00+03:00,out,False,891988,True,1,0,6,6
166717,2019-09-10 00:00:00+03:00,in,False,-1,True,1,0,46,46
166717,2019-09-10 00:00:00+03:00,out,False,891988,False,7,918,1003,85
166717,2019-09-11 00:00:00+03:00,out,False,891988,False,6,443,522,79
166717,2019-09-11 00:00:00+03:00,in,False,891988,False,4,552,616,64
166717,2019-09-11 00:00:00+03:00,out,False,891988,True,4,0,71,71
166717,2019-09-12 00:00:00+03:00,out,False,891988,True,3,0,97,97
166717,2019-09-12 00:00:00+03:00,in,False,-1,True,2,0,2,2
166717,2019-09-12 00:00:00+03:00,in,False,891988,False,1,11,21,10
166717,2019-09-12 00:00:00+03:00,out,False,891988,False,13,2221,2389,168
166717,2019-09-13 00:00:00+03:00,out,False,891988,False,17,2977,3200,223
166717,2019-09-13 00:00:00+03:00,in,False,891988,False,12,1698,1815,117
166717,2019-09-13 00:00:00+03:00,in,False,-1,True,5,0,83,83
166717,2019-09-13 00:00:00+03:00,out,False,891988,True,3,0,80,80
166717,2019-09-16 00:00:00+03:00,out,False,891988,False,3,300,368,68
166717,2019-09-16 00:00:00+03:00,out,False,891988,True,4,0,70,70
166717,2019-09-16 00:00:00+03:00,in,False,891988,False,10,719,786,67
166717,2019-09-17 00:00:00+03:00,out,False,891988,False,3,471,525,54
166717,2019-09-17 00:00:00+03:00,in,False,891988,False,4,536,576,40
166717,2019-09-17 00:00:00+03:00,in,False,-1,True,7,0,1,1
166717,2019-09-17 00:00:00+03:00,out,False,891988,False,3,471,525,54
166717,2019-09-18 00:00:00+03:00,out,False,891988,True,3,0,85,85
166717,2019-09-18 00:00:00+03:00,in,False,-1,True,1,0,27,27
166717,2019-09-18 00:00:00+03:00,out,False,891988,False,8,1031,1173,142
166717,2019-09-18 00:00:00+03:00,in,False,891988,False,13,1513,1628,115
166717,2019-09-18 00:00:00+03:00,out,False,891988,True,3,0,85,85
166717,2019-09-19 00:00:00+03:00,in,False,891988,False,4,973,1010,37
166717,2019-09-19 00:00:00+03:00,out,False,891988,False,5,373,430,57
166717,2019-09-19 00:00:00+03:00,in,False,-1,True,3,0,0,0
166717,2019-09-19 00:00:00+03:00,out,False,891988,True,2,0,26,26
166717,2019-09-20 00:00:00+03:00,in,False,-1,True,3,0,25,25
166717,2019-09-20 00:00:00+03:00,out,False,891988,False,4,295,347,52
166717,2019-09-20 00:00:00+03:00,out,False,891988,True,1,0,33,33
166717,2019-09-20 00:00:00+03:00,in,False,891988,False,5,639,673,34
166717,2019-09-23 00:00:00+03:00,in,False,891988,False,6,321,384,63
166717,2019-09-23 00:00:00+03:00,out,False,891988,False,4,232,287,55
166717,2019-09-23 00:00:00+03:00,out,False,891988,True,3,0,47,47
166717,2019-09-23 00:00:00+03:00,in,False,891988,False,6,321,384,63
166717,2019-09-24 00:00:00+03:00,in,False,891988,False,14,3137,3295,158
166717,2019-09-24 00:00:00+03:00,in,False,-1,True,1,0,32,32
166717,2019-09-24 00:00:00+03:00,out,False,891988,False,8,1673,1770,97
166717,2019-09-25 00:00:00+03:00,out,False,891988,True,4,0,124,124
166717,2019-09-25 00:00:00+03:00,in,False,-1,True,7,0,38,38
166717,2019-09-25 00:00:00+03:00,out,False,891988,False,4,590,677,87
166717,2019-09-25 00:00:00+03:00,out,False,891988,True,4,0,124,124
166717,2019-09-26 00:00:00+03:00,in,False,-1,True,4,0,373,373
166717,2019-09-26 00:00:00+03:00,out,False,891988,False,15,1546,1775,229
166717,2019-09-26 00:00:00+03:00,out,False,891988,True,6,0,97,97
166717,2019-09-26 00:00:00+03:00,in,False,891988,False,13,2269,2443,174
166717,2019-09-27 00:00:00+03:00,in,False,891988,False,9,1150,1230,80
166717,2019-09-27 00:00:00+03:00,out,False,891988,True,8,0,291,291
166717,2019-09-27 00:00:00+03:00,out,False,891988,False,10,1535,1680,145
166717,2019-09-27 00:00:00+03:00,in,False,-1,True,15,0,4,4
166717,2019-09-27 00:00:00+03:00,in,False,891988,False,9,1150,1230,80
166717,2019-09-30 00:00:00+03:00,out,False,891988,False,5,533,594,61
166717,2019-09-30 00:00:00+03:00,in,False,891988,False,4,568,597,29
166717,2019-10-01 00:00:00+03:00,in,False,891988,False,5,434,482,48
166717,2019-10-01 00:00:00+03:00,in,False,-1,True,2,0,1,1
166717,2019-10-01 00:00:00+03:00,out,False,891988,False,3,164,200,36
166717,2019-10-01 00:00:00+03:00,out,False,891988,False,3,164,200,36
166717,2019-10-02 00:00:00+03:00,out,False,891988,True,2,0,77,77
166717,2019-10-02 00:00:00+03:00,in,False,891988,False,6,406,476,70
166717,2019-10-02 00:00:00+03:00,out,False,891988,False,6,731,804,73
166717,2019-10-02 00:00:00+03:00,out,False,891988,True,2,0,77,77
166717,2019-10-03 00:00:00+03:00,in,False,891988,False,7,812,856,44
166717,2019-10-03 00:00:00+03:00,out,False,891988,False,10,951,1091,140
166717,2019-10-04 00:00:00+03:00,in,False,891988,False,9,1306,1408,102
166717,2019-10-04 00:00:00+03:00,out,False,891988,True,2,0,2,2
166717,2019-10-04 00:00:00+03:00,out,False,891988,False,13,1614,1757,143
166717,2019-10-04 00:00:00+03:00,in,False,-1,True,1,0,39,39
166717,2019-10-06 00:00:00+03:00,in,False,-1,True,3,0,1,1
166717,2019-10-07 00:00:00+03:00,out,False,891988,True,1,0,11,11
166717,2019-10-07 00:00:00+03:00,in,False,-1,True,1,0,1,1
166717,2019-10-07 00:00:00+03:00,out,False,891988,False,10,965,1053,88
166717,2019-10-07 00:00:00+03:00,in,False,891988,False,4,456,541,85
166717,2019-10-07 00:00:00+03:00,in,False,-1,True,1,0,1,1
166717,2019-10-08 00:00:00+03:00,in,False,-1,True,14,0,1,1
166717,2019-10-08 00:00:00+03:00,out,False,891988,False,3,242,306,64
166717,2019-10-08 00:00:00+03:00,in,False,891988,False,3,161,195,34
166717,2019-10-09 00:00:00+03:00,in,False,-1,True,3,0,113,113
166717,2019-10-09 00:00:00+03:00,in,False,891988,False,3,227,246,19
166717,2019-10-10 00:00:00+03:00,out,False,891988,False,10,668,775,107
166717,2019-10-10 00:00:00+03:00,in,False,891988,False,10,664,745,81
166717,2019-10-10 00:00:00+03:00,out,False,891988,True,3,0,53,53
166717,2019-10-10 00:00:00+03:00,in,False,-1,True,3,0,9,9
166717,2019-10-10 00:00:00+03:00,out,False,891988,True,3,0,53,53
166717,2019-10-11 00:00:00+03:00,in,False,891988,False,7,1086,1164,78
166717,2019-10-11 00:00:00+03:00,out,False,891988,True,4,0,55,55
166717,2019-10-11 00:00:00+03:00,out,False,891988,False,7,644,721,77
166717,2019-10-14 00:00:00+03:00,out,False,891988,False,3,252,280,28
166717,2019-10-14 00:00:00+03:00,in,False,-1,True,1,0,0,0
166717,2019-10-14 00:00:00+03:00,in,False,891988,False,5,479,538,59
166717,2019-10-14 00:00:00+03:00,in,False,-1,True,1,0,0,0
166717,2019-10-15 00:00:00+03:00,in,False,891988,False,1,20,26,6
166717,2019-10-15 00:00:00+03:00,out,False,891988,False,1,59,67,8
166717,2019-10-16 00:00:00+03:00,out,False,891988,False,2,65,88,23
166717,2019-10-16 00:00:00+03:00,in,False,891988,False,5,271,325,54
166717,2019-10-16 00:00:00+03:00,in,False,-1,True,2,0,47,47
166717,2019-10-17 00:00:00+03:00,out,False,891988,False,6,493,561,68
166717,2019-10-17 00:00:00+03:00,out,False,891988,True,1,0,22,22
166717,2019-10-17 00:00:00+03:00,in,False,891988,False,9,698,811,113
166717,2019-10-18 00:00:00+03:00,in,False,-1,True,6,0,4,4
166717,2019-10-18 00:00:00+03:00,out,False,891988,False,4,533,577,44
166717,2019-10-18 00:00:00+03:00,in,False,891988,False,4,343,390,47
166717,2019-10-18 00:00:00+03:00,out,False,891988,False,4,533,577,44
166717,2019-10-18 00:00:00+03:00,in,False,-1,True,6,0,4,4
166717,2019-10-21 00:00:00+03:00,out,False,891988,True,2,0,14,14
166717,2019-10-21 00:00:00+03:00,in,False,-1,True,3,0,49,49
166717,2019-10-21 00:00:00+03:00,out,False,891988,False,3,657,692,35
166717,2019-10-21 00:00:00+03:00,in,False,891988,False,12,841,957,116
166717,2019-10-22 00:00:00+03:00,in,False,-1,True,10,0,2,2
166717,2019-10-22 00:00:00+03:00,out,False,891988,False,4,346,396,50
166717,2019-10-22 00:00:00+03:00,in,False,891988,False,7,522,592,70
166717,2019-10-22 00:00:00+03:00,in,False,-1,True,10,0,2,2
166717,2019-10-23 00:00:00+03:00,in,False,-1,True,1,0,0,0
166717,2019-10-23 00:00:00+03:00,in,False,891988,False,7,521,593,72
166717,2019-10-23 00:00:00+03:00,out,False,891988,False,5,622,692,70
166717,2019-10-23 00:00:00+03:00,out,False,891988,True,2,0,59,59
166717,2019-10-24 00:00:00+03:00,in,False,891988,False,1,109,116,7
166717,2019-10-24 00:00:00+03:00,out,False,891988,False,3,348,391,43
166717,2019-10-24 00:00:00+03:00,in,False,-1,True,1,0,43,43
166717,2019-10-25 00:00:00+03:00,out,False,891988,False,6,1225,1294,69
166717,2019-10-25 00:00:00+03:00,in,False,891988,False,7,1205,1274,69
166717,2019-10-25 00:00:00+03:00,out,False,891988,True,1,0,0,0
166717,2019-10-28 00:00:00+03:00,out,False,891988,False,16,2561,2739,178
166717,2019-10-28 00:00:00+03:00,out,False,891988,True,3,0,45,45
166717,2019-10-28 00:00:00+03:00,in,False,-1,True,1,0,84,84
166717,2019-10-28 00:00:00+03:00,in,False,891988,False,14,1496,1652,156
166717,2019-10-29 00:00:00+03:00,in,False,-1,True,10,0,53,53
166717,2019-10-30 00:00:00+03:00,in,False,891988,False,13,1386,1481,95
166717,2019-10-30 00:00:00+03:00,out,False,891988,False,3,437,462,25
166717,2019-10-31 00:00:00+03:00,in,False,891988,False,4,537,574,37
166717,2019-10-31 00:00:00+03:00,out,False,891988,False,6,317,435,118
166717,2019-10-31 00:00:00+03:00,out,False,891988,True,2,0,18,18
166717,2019-11-01 00:00:00+03:00,in,False,891988,False,3,328,350,22
166717,2019-11-05 00:00:00+03:00,out,False,891988,True,3,0,59,59
166717,2019-11-05 00:00:00+03:00,in,False,-1,True,2,0,75,75
166717,2019-11-05 00:00:00+03:00,in,False,891988,False,9,907,981,74
166717,2019-11-05 00:00:00+03:00,out,False,891988,False,10,1772,1927,155
166717,2019-11-06 00:00:00+03:00,out,False,891988,True,2,0,30,30
166717,2019-11-06 00:00:00+03:00,in,False,891988,False,4,619,659,40
166717,2019-11-06 00:00:00+03:00,out,False,891988,False,5,402,488,86
166717,2019-11-07 00:00:00+03:00,out,False,891988,False,2,117,134,17
166717,2019-11-07 00:00:00+03:00,in,False,891988,False,5,350,406,56
166717,2019-11-07 00:00:00+03:00,out,False,891988,True,1,0,5,5
166717,2019-11-08 00:00:00+03:00,in,False,891988,False,9,763,818,55
166717,2019-11-08 00:00:00+03:00,out,False,891988,False,8,929,1025,96
166717,2019-11-08 00:00:00+03:00,out,False,891988,True,3,0,46,46
166717,2019-11-10 00:00:00+03:00,in,False,-1,True,3,0,0,0
166717,2019-11-11 00:00:00+03:00,out,False,891988,False,2,351,379,28
166717,2019-11-11 00:00:00+03:00,in,False,891988,False,4,528,548,20
166717,2019-11-11 00:00:00+03:00,out,False,891988,True,1,0,41,41
166717,2019-11-11 00:00:00+03:00,in,False,-1,True,7,0,0,0
166717,2019-11-11 00:00:00+03:00,out,False,891988,True,1,0,41,41
166717,2019-11-12 00:00:00+03:00,out,False,891988,True,1,0,8,8
166717,2019-11-12 00:00:00+03:00,in,False,-1,True,1,0,46,46
166717,2019-11-12 00:00:00+03:00,in,False,891988,False,9,1329,1438,109
166717,2019-11-12 00:00:00+03:00,out,False,891988,False,2,95,129,34
166717,2019-11-13 00:00:00+03:00,in,False,-1,True,6,0,0,0
166717,2019-11-13 00:00:00+03:00,out,False,891988,False,2,59,91,32
166717,2019-11-13 00:00:00+03:00,in,False,891988,False,6,421,468,47
166717,2019-11-14 00:00:00+03:00,in,False,-1,True,9,0,2,2
166717,2019-11-15 00:00:00+03:00,in,False,-1,True,3,0,1,1
166717,2019-11-18 00:00:00+03:00,in,False,-1,True,3,0,0,0
166717,2019-11-19 00:00:00+03:00,in,False,891988,False,5,1018,1065,47
166717,2019-11-19 00:00:00+03:00,out,False,891988,False,6,940,994,54
166717,2019-11-20 00:00:00+03:00,out,False,891988,True,3,0,49,49
166717,2019-11-20 00:00:00+03:00,in,False,891988,False,6,312,354,42
166717,2019-11-20 00:00:00+03:00,in,False,-1,True,2,0,84,84
166717,2019-11-20 00:00:00+03:00,out,False,891988,False,7,848,923,75
166717,2019-11-21 00:00:00+03:00,out,False,891988,True,2,0,71,71
166717,2019-11-21 00:00:00+03:00,out,False,891988,False,4,402,478,76
166717,2019-11-21 00:00:00+03:00,in,False,891988,False,8,851,916,65
166717,2019-11-21 00:00:00+03:00,out,False,891988,True,2,0,71,71
166717,2019-11-21 00:00:00+03:00,out,False,891988,False,4,402,478,76
166717,2019-11-22 00:00:00+03:00,in,False,891988,False,6,594,634,40
166717,2019-11-22 00:00:00+03:00,out,False,891988,False,2,143,166,23
166717,2019-11-25 00:00:00+03:00,out,False,891988,True,4,0,80,80
166717,2019-11-25 00:00:00+03:00,in,False,891988,False,6,530,568,38
166717,2019-11-25 00:00:00+03:00,out,False,891988,False,2,212,233,21
166717,2019-11-25 00:00:00+03:00,in,False,891988,False,6,530,568,38
166717,2019-11-26 00:00:00+03:00,out,False,891988,False,4,331,382,51
166717,2019-11-26 00:00:00+03:00,in,False,891988,False,11,1258,1344,86
166717,2019-11-26 00:00:00+03:00,in,False,-1,True,2,0,78,78
166717,2019-11-27 00:00:00+03:00,in,False,891988,False,9,1166,1233,67
166717,2019-11-27 00:00:00+03:00,out,False,891988,False,4,508,559,51
166717,2019-11-28 00:00:00+03:00,in,False,891988,False,13,1155,1255,100
166717,2019-11-28 00:00:00+03:00,out,False,891988,False,6,473,534,61
166725,2019-08-16 00:00:00+03:00,in,False,-1,True,1,0,2,2
166725,2019-08-16 00:00:00+03:00,in,False,889754,False,1,2,13,11
166725,2019-08-16 00:00:00+03:00,out,False,889754,True,2,0,0,0
166725,2019-08-20 00:00:00+03:00,in,False,-1,True,1,0,5,5
166725,2019-08-20 00:00:00+03:00,in,False,889754,False,1,60,70,10
166725,2019-08-22 00:00:00+03:00,in,False,889754,False,1,88,96,8
166725,2019-08-25 00:00:00+03:00,in,False,-1,True,2,0,49,49
166725,2019-08-26 00:00:00+03:00,out,False,889754,True,1,0,60,60
166725,2019-08-26 00:00:00+03:00,in,False,889754,False,2,99,109,10
166725,2019-08-27 00:00:00+03:00,in,False,889754,False,1,20,28,8
166725,2019-08-28 00:00:00+03:00,in,False,-1,True,6,0,92,92
166725,2019-08-28 00:00:00+03:00,in,False,889754,False,5,585,635,50
166725,2019-08-29 00:00:00+03:00,in,False,889754,False,4,294,337,43
166725,2019-08-29 00:00:00+03:00,out,False,889754,False,5,496,549,53
166725,2019-08-29 00:00:00+03:00,out,False,889754,True,1,0,41,41
166725,2019-08-30 00:00:00+03:00,out,False,889754,False,16,1051,1335,284
166725,2019-08-30 00:00:00+03:00,out,False,889754,True,9,0,189,189
166725,2019-08-30 00:00:00+03:00,in,False,889754,False,5,298,342,44
166725,2019-09-02 00:00:00+03:00,in,False,-1,True,2,0,45,45
166725,2019-09-02 00:00:00+03:00,in,False,889754,False,3,420,458,38
166725,2019-09-02 00:00:00+03:00,out,False,889754,True,2,0,39,39
166725,2019-09-02 00:00:00+03:00,out,False,889754,False,3,77,94,17
166725,2019-09-02 00:00:00+03:00,out,False,889754,True,2,0,39,39
166725,2019-09-03 00:00:00+03:00,out,False,889754,True,1,0,60,60
166725,2019-09-03 00:00:00+03:00,in,False,889754,False,5,693,737,44
166725,2019-09-03 00:00:00+03:00,out,False,889754,False,14,544,714,170
166725,2019-09-03 00:00:00+03:00,out,False,889754,True,1,0,60,60
166725,2019-09-04 00:00:00+03:00,in,False,889754,False,2,34,46,12
166725,2019-09-04 00:00:00+03:00,out,False,889754,False,1,722,731,9
166725,2019-09-04 00:00:00+03:00,out,False,889754,False,1,722,731,9
166725,2019-09-05 00:00:00+03:00,out,False,889754,False,10,592,723,131
166725,2019-09-05 00:00:00+03:00,out,False,889754,True,3,0,74,74
166725,2019-09-05 00:00:00+03:00,in,False,889754,False,2,204,217,13
166725,2019-09-06 00:00:00+03:00,in,False,889754,False,5,1101,1179,78
166725,2019-09-09 00:00:00+03:00,out,False,889754,False,8,603,708,105
166725,2019-09-09 00:00:00+03:00,in,False,-1,True,2,0,61,61
166725,2019-09-09 00:00:00+03:00,out,False,889754,True,3,0,46,46
166725,2019-09-09 00:00:00+03:00,in,False,889754,False,7,498,561,63
166725,2019-09-10 00:00:00+03:00,out,False,889754,False,3,83,120,37
166725,2019-09-10 00:00:00+03:00,out,False,889754,True,1,0,19,19
166725,2019-09-10 00:00:00+03:00,in,False,-1,True,1,0,28,28
166725,2019-09-10 00:00:00+03:00,in,False,889754,False,3,142,165,23
166725,2019-09-11 00:00:00+03:00,out,False,889754,True,4,0,72,72
166725,2019-09-11 00:00:00+03:00,out,False,889754,False,11,463,627,164
166725,2019-09-12 00:00:00+03:00,out,False,889754,False,7,645,723,78
166725,2019-09-12 00:00:00+03:00,out,False,889754,True,1,0,22,22
166725,2019-09-13 00:00:00+03:00,out,False,889754,False,5,237,326,89
166725,2019-09-13 00:00:00+03:00,out,False,889754,True,9,0,191,191
166725,2019-09-13 00:00:00+03:00,in,False,889754,False,2,190,209,19
166725,2019-09-13 00:00:00+03:00,out,False,889754,True,9,0,191,191
166725,2019-09-16 00:00:00+03:00,in,False,889754,False,2,41,54,13
166725,2019-09-16 00:00:00+03:00,out,False,889754,False,3,78,120,42
166725,2019-09-16 00:00:00+03:00,in,False,-1,True,3,0,65,65
166725,2019-09-16 00:00:00+03:00,out,False,889754,True,1,0,28,28
166725,2019-09-17 00:00:00+03:00,out,False,889754,True,12,0,311,311
166725,2019-09-17 00:00:00+03:00,in,False,889754,False,5,218,265,47
166725,2019-09-17 00:00:00+03:00,in,False,-1,True,7,0,122,122
166725,2019-09-17 00:00:00+03:00,out,False,889754,False,19,931,1215,284
166725,2019-09-18 00:00:00+03:00,in,False,889754,False,11,1670,1775,105
166725,2019-09-18 00:00:00+03:00,in,False,-1,True,2,0,35,35
166725,2019-09-18 00:00:00+03:00,out,False,889754,True,6,0,173,173
166725,2019-09-18 00:00:00+03:00,out,False,889754,False,14,799,1024,225
166725,2019-09-18 00:00:00+03:00,in,False,889754,False,11,1670,1775,105
166725,2019-09-19 00:00:00+03:00,out,False,889754,False,3,169,227,58
166725,2019-09-19 00:00:00+03:00,in,False,889754,False,8,609,676,67
166725,2019-09-20 00:00:00+03:00,out,False,889754,True,1,0,33,33
166725,2019-09-20 00:00:00+03:00,in,False,889754,False,5,1017,1047,30
166725,2019-09-20 00:00:00+03:00,out,False,889754,False,2,135,176,41
166725,2019-09-21 00:00:00+03:00,in,False,-1,True,1,0,30,30
166725,2019-09-21 00:00:00+03:00,in,False,-1,True,1,0,30,30
166725,2019-09-23 00:00:00+03:00,out,False,889754,False,3,314,344,30
166725,2019-09-23 00:00:00+03:00,out,False,889754,True,2,0,108,108
166725,2019-09-23 00:00:00+03:00,in,False,889754,False,6,741,781,40
166725,2019-09-23 00:00:00+03:00,in,False,889754,False,6,741,781,40
166725,2019-09-24 00:00:00+03:00,in,False,-1,True,13,0,67,67
166725,2019-09-24 00:00:00+03:00,in,False,889754,False,8,934,1007,73
166725,2019-09-24 00:00:00+03:00,out,False,889754,False,4,199,260,61
166725,2019-09-24 00:00:00+03:00,out,False,889754,True,2,0,60,60
166725,2019-09-24 00:00:00+03:00,in,False,889754,False,8,934,1007,73
166725,2019-09-25 00:00:00+03:00,in,False,889754,False,2,126,141,15
166725,2019-09-25 00:00:00+03:00,out,False,889754,True,1,0,8,8
166725,2019-09-25 00:00:00+03:00,out,False,889754,False,9,363,532,169
166725,2019-09-25 00:00:00+03:00,out,False,889754,True,1,0,8,8
166725,2019-09-26 00:00:00+03:00,out,False,889754,True,4,0,174,174
166725,2019-09-26 00:00:00+03:00,in,False,-1,True,20,0,14,14
166725,2019-09-26 00:00:00+03:00,out,False,889754,False,5,331,405,74
166725,2019-09-26 00:00:00+03:00,in,False,889754,False,2,470,483,13
166725,2019-09-27 00:00:00+03:00,in,False,-1,True,1,0,0,0
166725,2019-09-27 00:00:00+03:00,out,False,889754,True,2,0,55,55
166725,2019-09-27 00:00:00+03:00,out,False,889754,False,5,451,550,99
166725,2019-09-27 00:00:00+03:00,in,False,889754,False,3,345,366,21
166725,2019-09-28 00:00:00+03:00,in,False,-1,True,9,0,272,272
166725,2019-09-29 00:00:00+03:00,in,False,-1,True,1,0,30,30
166725,2019-09-30 00:00:00+03:00,out,False,889754,True,1,0,33,33
166725,2019-09-30 00:00:00+03:00,out,False,889754,False,3,435,461,26
166725,2019-09-30 00:00:00+03:00,in,False,889754,False,8,684,766,82
166725,2019-10-01 00:00:00+03:00,out,False,889754,True,1,0,24,24
166725,2019-10-01 00:00:00+03:00,out,False,889754,False,7,1034,1110,76
166725,2019-10-01 00:00:00+03:00,in,False,-1,True,1,0,0,0
166725,2019-10-01 00:00:00+03:00,out,True,889754,False,1,128,134,6
166725,2019-10-01 00:00:00+03:00,in,False,889754,False,6,382,428,46
166725,2019-10-02 00:00:00+03:00,out,False,889754,False,10,775,924,149
166725,2019-10-02 00:00:00+03:00,in,False,889754,False,6,1367,1408,41
166725,2019-10-02 00:00:00+03:00,in,False,-1,True,1,0,3,3
166725,2019-10-03 00:00:00+03:00,out,False,889754,False,11,1425,1536,111
166725,2019-10-03 00:00:00+03:00,in,False,-1,True,9,0,3,3
166725,2019-10-03 00:00:00+03:00,out,False,889754,True,1,0,29,29
166725,2019-10-03 00:00:00+03:00,in,False,889754,False,12,2118,2183,65
166725,2019-10-04 00:00:00+03:00,in,False,889754,False,2,98,113,15
166725,2019-10-04 00:00:00+03:00,out,False,889754,True,1,0,0,0
166725,2019-10-04 00:00:00+03:00,out,False,889754,False,2,1272,1313,41
166725,2019-10-05 00:00:00+03:00,in,False,-1,True,11,0,241,241
166725,2019-10-07 00:00:00+03:00,in,False,-1,True,1,0,3,3
166725,2019-10-07 00:00:00+03:00,out,False,889754,False,13,1070,1222,152
166725,2019-10-07 00:00:00+03:00,out,False,889754,True,8,0,172,172
166725,2019-10-07 00:00:00+03:00,in,False,889754,False,13,1491,1589,98
166725,2019-10-08 00:00:00+03:00,out,False,889754,True,19,0,548,548
166725,2019-10-08 00:00:00+03:00,in,False,-1,True,21,0,28,28
166725,2019-10-08 00:00:00+03:00,out,False,889754,False,43,3623,4318,695
166725,2019-10-08 00:00:00+03:00,in,False,889754,False,13,1277,1357,80
166725,2019-10-09 00:00:00+03:00,in,False,889754,False,4,585,615,30
166725,2019-10-09 00:00:00+03:00,out,False,889754,True,1,0,1,1
166725,2019-10-09 00:00:00+03:00,out,False,889754,False,3,313,343,30
166725,2019-10-09 00:00:00+03:00,in,False,-1,True,1,0,31,31
166725,2019-10-09 00:00:00+03:00,out,False,889754,True,1,0,1,1
166725,2019-10-10 00:00:00+03:00,out,False,889754,False,11,1000,1198,198
166725,2019-10-10 00:00:00+03:00,in,False,-1,True,3,0,8,8
166725,2019-10-10 00:00:00+03:00,in,False,889754,False,11,1712,1805,93
166725,2019-10-10 00:00:00+03:00,out,False,889754,True,5,0,142,142
166725,2019-10-11 00:00:00+03:00,out,False,889754,True,2,0,48,48
166725,2019-10-11 00:00:00+03:00,in,False,889754,False,9,509,572,63
166725,2019-10-11 00:00:00+03:00,out,False,889754,False,9,638,773,135
166725,2019-10-12 00:00:00+03:00,in,False,-1,True,3,0,63,63
166725,2019-10-14 00:00:00+03:00,out,False,889754,False,13,834,1055,221
166725,2019-10-14 00:00:00+03:00,out,False,889754,True,8,0,244,244
166725,2019-10-14 00:00:00+03:00,in,False,889754,False,17,1767,1886,119
166725,2019-10-14 00:00:00+03:00,in,False,-1,True,4,0,2,2
166725,2019-10-14 00:00:00+03:00,out,False,889754,False,13,834,1055,221
166725,2019-10-14 00:00:00+03:00,out,False,889754,True,8,0,244,244
166725,2019-10-14 00:00:00+03:00,in,False,-1,True,4,0,2,2
166725,2019-10-15 00:00:00+03:00,in,False,889754,False,7,1083,1143,60
166725,2019-10-15 00:00:00+03:00,in,False,-1,True,2,0,1,1
166725,2019-10-15 00:00:00+03:00,out,False,889754,False,8,387,495,108
166725,2019-10-15 00:00:00+03:00,out,False,889754,True,9,0,209,209
166725,2019-10-16 00:00:00+03:00,in,False,-1,True,4,0,7,7
166725,2019-10-16 00:00:00+03:00,in,False,889754,False,7,1120,1174,54
166725,2019-10-16 00:00:00+03:00,out,False,889754,False,7,860,935,75
166725,2019-10-16 00:00:00+03:00,out,False,889754,True,3,0,126,126
166725,2019-10-17 00:00:00+03:00,in,False,889754,False,4,202,256,54
166725,2019-10-17 00:00:00+03:00,in,False,-1,True,1,0,4,4
166725,2019-10-17 00:00:00+03:00,out,False,889754,False,4,274,337,63
166725,2019-10-18 00:00:00+03:00,in,False,889754,False,2,180,199,19
166725,2019-10-18 00:00:00+03:00,out,False,889754,True,1,0,13,13
166725,2019-10-19 00:00:00+03:00,in,False,-1,True,4,0,120,120
166725,2019-10-20 00:00:00+03:00,in,False,-1,True,1,0,30,30
166725,2019-10-21 00:00:00+03:00,in,False,889754,False,9,547,622,75
166725,2019-10-21 00:00:00+03:00,in,False,-1,True,8,0,63,63
166725,2019-10-21 00:00:00+03:00,out,False,889754,True,4,0,23,23
166725,2019-10-21 00:00:00+03:00,out,False,889754,False,10,719,850,131
166725,2019-10-22 00:00:00+03:00,in,False,889754,False,4,711,749,38
166725,2019-10-22 00:00:00+03:00,out,False,889754,True,14,0,393,393
166725,2019-10-22 00:00:00+03:00,out,False,889754,False,18,873,1190,317
166725,2019-10-22 00:00:00+03:00,out,False,889754,True,14,0,393,393
166725,2019-10-23 00:00:00+03:00,out,False,889754,True,16,0,338,338
166725,2019-10-23 00:00:00+03:00,out,False,889754,False,31,1290,1765,475
166725,2019-10-23 00:00:00+03:00,in,False,-1,True,1,0,7,7
166725,2019-10-23 00:00:00+03:00,in,False,889754,False,9,409,482,73
166725,2019-10-23 00:00:00+03:00,out,False,889754,True,16,0,338,338
166725,2019-10-24 00:00:00+03:00,out,False,889754,True,11,0,257,257
166725,2019-10-24 00:00:00+03:00,out,False,889754,False,14,562,766,204
166725,2019-10-24 00:00:00+03:00,in,False,889754,False,7,784,836,52
166725,2019-10-24 00:00:00+03:00,in,False,-1,True,6,0,72,72
166725,2019-10-25 00:00:00+03:00,in,False,889754,True,1,1,8,7
166725,2019-10-25 00:00:00+03:00,out,False,889754,False,25,2361,2764,403
166725,2019-10-25 00:00:00+03:00,in,False,889754,False,11,1155,1251,96
166725,2019-10-25 00:00:00+03:00,out,False,889754,True,17,0,395,395
166725,2019-10-26 00:00:00+03:00,in,False,-1,True,3,0,90,90
166725,2019-10-28 00:00:00+03:00,out,False,889754,True,1,0,14,14
166725,2019-10-28 00:00:00+03:00,out,False,889754,False,6,842,918,76
166725,2019-10-28 00:00:00+03:00,in,False,889754,False,13,1677,1774,97
166725,2019-10-28 00:00:00+03:00,in,False,-1,True,1,0,1,1
166725,2019-10-29 00:00:00+03:00,out,False,889754,True,2,0,61,61
166725,2019-10-29 00:00:00+03:00,out,False,889754,False,13,502,671,169
166725,2019-10-29 00:00:00+03:00,in,False,-1,True,2,0,8,8
166725,2019-10-29 00:00:00+03:00,in,False,889754,False,6,256,296,40
166725,2019-10-30 00:00:00+03:00,in,False,-1,True,5,0,3,3
166725,2019-10-30 00:00:00+03:00,out,False,889754,True,15,0,285,285
166725,2019-10-30 00:00:00+03:00,out,False,889754,False,44,4307,4992,685
166725,2019-10-30 00:00:00+03:00,in,False,889754,False,12,932,1040,108
166725,2019-10-30 00:00:00+03:00,out,False,-1,True,1,0,0,0
166725,2019-10-31 00:00:00+03:00,out,False,889754,False,25,1976,2339,363
166725,2019-10-31 00:00:00+03:00,in,False,-1,True,5,0,26,26
166725,2019-10-31 00:00:00+03:00,out,False,889754,True,12,0,239,239
166725,2019-10-31 00:00:00+03:00,in,False,889754,False,11,1024,1117,93
166725,2019-11-01 00:00:00+03:00,in,False,-1,True,4,0,19,19
166725,2019-11-01 00:00:00+03:00,out,False,889754,True,35,0,750,750
166725,2019-11-01 00:00:00+03:00,in,False,889754,False,12,897,978,81
166725,2019-11-01 00:00:00+03:00,out,False,889754,False,42,2707,3405,698
166725,2019-11-02 00:00:00+03:00,in,False,-1,True,3,0,91,91
166725,2019-11-02 00:00:00+03:00,in,False,-1,True,3,0,91,91
166725,2019-11-05 00:00:00+03:00,in,False,889754,False,13,798,881,83
166725,2019-11-05 00:00:00+03:00,out,False,889754,False,42,1567,2249,682
166725,2019-11-05 00:00:00+03:00,out,False,889754,True,24,0,576,576
166725,2019-11-05 00:00:00+03:00,out,False,889754,False,42,1567,2249,682
166725,2019-11-06 00:00:00+03:00,out,False,889754,False,10,806,957,151
166725,2019-11-06 00:00:00+03:00,in,False,-1,True,2,0,14,14
166725,2019-11-06 00:00:00+03:00,out,False,889754,True,11,0,292,292
166725,2019-11-06 00:00:00+03:00,in,False,889754,False,7,457,537,80
166725,2019-11-07 00:00:00+03:00,in,False,-1,True,2,0,0,0
166725,2019-11-07 00:00:00+03:00,out,False,889754,False,4,463,496,33
166725,2019-11-07 00:00:00+03:00,out,False,889754,True,5,0,72,72
166725,2019-11-07 00:00:00+03:00,in,False,889754,False,7,632,697,65
166725,2019-11-08 00:00:00+03:00,in,False,-1,True,2,0,0,0
166725,2019-11-08 00:00:00+03:00,out,False,889754,False,57,2869,3848,979
166725,2019-11-08 00:00:00+03:00,in,False,889754,False,6,526,563,37
166725,2019-11-08 00:00:00+03:00,out,False,889754,True,35,0,597,597
166725,2019-11-09 00:00:00+03:00,in,False,-1,True,1,0,31,31
166725,2019-11-10 00:00:00+03:00,in,False,-1,True,1,0,8,8
166725,2019-11-11 00:00:00+03:00,in,False,889754,False,6,580,625,45
166725,2019-11-11 00:00:00+03:00,out,False,889754,False,3,183,228,45
166725,2019-11-11 00:00:00+03:00,out,False,889754,True,2,0,71,71
166725,2019-11-12 00:00:00+03:00,in,False,889754,False,11,1472,1572,100
166725,2019-11-12 00:00:00+03:00,out,False,889754,False,27,1843,2229,386
166725,2019-11-12 00:00:00+03:00,out,False,889754,True,28,0,296,296
166725,2019-11-12 00:00:00+03:00,out,False,889754,False,27,1843,2229,386
166725,2019-11-13 00:00:00+03:00,out,False,889754,True,3,0,49,49
166725,2019-11-13 00:00:00+03:00,in,False,889754,False,11,1287,1376,89
166725,2019-11-13 00:00:00+03:00,out,False,889754,False,14,1259,1376,117
166725,2019-11-13 00:00:00+03:00,in,False,-1,True,6,0,37,37
166725,2019-11-14 00:00:00+03:00,in,False,889754,True,1,0,10,10
166725,2019-11-14 00:00:00+03:00,out,False,889754,False,16,1550,1799,249
166725,2019-11-14 00:00:00+03:00,in,False,889754,False,7,504,545,41
166725,2019-11-14 00:00:00+03:00,out,False,889754,True,19,0,337,337
166725,2019-11-14 00:00:00+03:00,in,False,-1,True,2,0,2,2
166725,2019-11-15 00:00:00+03:00,in,False,889754,False,4,237,266,29
166725,2019-11-15 00:00:00+03:00,out,False,889754,True,2,0,36,36
166725,2019-11-15 00:00:00+03:00,out,False,889754,False,3,308,363,55
166725,2019-11-16 00:00:00+03:00,in,False,-1,True,3,0,52,52
166725,2019-11-18 00:00:00+03:00,in,False,889754,False,12,2576,2665,89
166725,2019-11-18 00:00:00+03:00,out,False,889754,False,3,180,227,47
166725,2019-11-18 00:00:00+03:00,out,False,889754,True,3,0,35,35
166725,2019-11-18 00:00:00+03:00,in,False,-1,True,7,0,81,81
166725,2019-11-19 00:00:00+03:00,in,False,889754,False,11,1752,1831,79
166725,2019-11-19 00:00:00+03:00,out,False,889754,True,8,0,99,99
166725,2019-11-19 00:00:00+03:00,in,False,-1,True,7,0,32,32
166725,2019-11-19 00:00:00+03:00,out,False,889754,False,7,1227,1272,45
166725,2019-11-20 00:00:00+03:00,out,False,889754,True,10,0,218,218
166725,2019-11-20 00:00:00+03:00,out,False,889754,False,7,503,605,102
166725,2019-11-20 00:00:00+03:00,in,False,889754,False,8,611,664,53
166725,2019-11-20 00:00:00+03:00,in,False,-1,True,5,0,5,5
166725,2019-11-21 00:00:00+03:00,out,False,889754,True,8,0,260,260
166725,2019-11-21 00:00:00+03:00,in,False,-1,True,1,0,3,3
166725,2019-11-21 00:00:00+03:00,in,False,889754,False,4,403,430,27
166725,2019-11-21 00:00:00+03:00,out,False,889754,False,11,734,863,129
166725,2019-11-22 00:00:00+03:00,in,False,-1,True,1,0,22,22
166725,2019-11-22 00:00:00+03:00,out,False,889754,False,3,111,129,18
166725,2019-11-22 00:00:00+03:00,in,False,889754,False,4,519,555,36
166725,2019-11-23 00:00:00+03:00,out,False,889754,True,3,0,70,70
166725,2019-11-23 00:00:00+03:00,out,False,889754,False,2,86,114,28
166725,2019-11-23 00:00:00+03:00,in,False,889754,False,3,230,250,20
166725,2019-11-24 00:00:00+03:00,in,False,-1,True,11,0,317,317
166725,2019-11-25 00:00:00+03:00,in,False,889754,False,6,580,629,49
166725,2019-11-25 00:00:00+03:00,out,False,889754,False,3,1047,1103,56
166725,2019-11-25 00:00:00+03:00,in,False,-1,True,3,0,1,1
166725,2019-11-25 00:00:00+03:00,out,False,889754,True,2,0,82,82
166725,2019-11-25 00:00:00+03:00,in,False,889754,False,6,580,629,49
166725,2019-11-26 00:00:00+03:00,out,False,889754,False,16,1561,1792,231
166725,2019-11-26 00:00:00+03:00,in,False,889754,False,7,590,647,57
166725,2019-11-26 00:00:00+03:00,in,False,-1,True,4,0,8,8
166725,2019-11-26 00:00:00+03:00,out,False,889754,True,10,0,195,195
166725,2019-11-27 00:00:00+03:00,out,False,889754,False,15,1090,1309,219
166725,2019-11-27 00:00:00+03:00,in,False,889754,False,20,2622,2765,143
166725,2019-11-27 00:00:00+03:00,in,False,-1,True,19,0,124,124
166725,2019-11-27 00:00:00+03:00,out,False,889754,True,2,0,88,88
166725,2019-11-28 00:00:00+03:00,in,False,-1,True,1,0,0,0
166725,2019-11-28 00:00:00+03:00,in,False,889754,False,15,798,896,98
166725,2019-11-28 00:00:00+03:00,out,False,889754,False,10,1193,1382,189
166725,2019-11-28 00:00:00+03:00,out,False,889754,True,1,0,10,10
166726,2019-09-04 00:00:00+03:00,in,False,-1,True,1,0,2,2
166726,2019-09-05 00:00:00+03:00,in,False,-1,True,3,0,3,3
166726,2019-09-24 00:00:00+03:00,in,False,-1,True,2,0,4,4
166726,2019-09-24 00:00:00+03:00,in,False,903390,False,1,19,25,6
166726,2019-09-28 00:00:00+03:00,in,False,-1,True,1,0,14,14
166726,2019-10-02 00:00:00+03:00,in,False,903390,False,1,34,46,12
166726,2019-10-07 00:00:00+03:00,in,False,903390,False,2,150,203,53
166726,2019-10-10 00:00:00+03:00,in,False,903390,False,1,53,68,15
166726,2019-10-15 00:00:00+03:00,in,False,903390,False,2,110,136,26
166726,2019-10-18 00:00:00+03:00,in,False,903390,False,1,58,74,16
166726,2019-10-21 00:00:00+03:00,in,False,903390,False,1,56,70,14
166726,2019-11-14 00:00:00+03:00,in,False,-1,True,1,0,110,110
166727,2019-08-19 00:00:00+03:00,in,False,-1,True,1,0,2,2
166727,2019-08-19 00:00:00+03:00,in,False,-1,True,1,0,2,2
166727,2019-08-23 00:00:00+03:00,in,False,-1,True,1,0,2,2
166727,2019-08-25 00:00:00+03:00,in,False,-1,True,1,0,30,30
166727,2019-08-26 00:00:00+03:00,in,False,895170,False,1,64,83,19
166727,2019-08-26 00:00:00+03:00,in,False,-1,True,2,0,61,61
166727,2019-08-27 00:00:00+03:00,in,False,895170,False,1,25,39,14
166727,2019-08-28 00:00:00+03:00,in,False,895170,False,1,482,496,14
166727,2019-08-30 00:00:00+03:00,in,False,895170,False,1,31,48,17
166727,2019-08-30 00:00:00+03:00,in,False,-1,True,1,0,31,31
166727,2019-09-03 00:00:00+03:00,in,False,-1,True,1,0,31,31
166727,2019-09-03 00:00:00+03:00,in,False,-1,True,1,0,31,31
166727,2019-09-06 00:00:00+03:00,in,False,895170,False,1,23,38,15
166727,2019-09-07 00:00:00+03:00,in,False,-1,True,1,0,32,32
166727,2019-09-12 00:00:00+03:00,in,False,-1,True,1,0,3,3
166727,2019-09-12 00:00:00+03:00,in,False,895170,False,2,51,79,28
166727,2019-09-13 00:00:00+03:00,in,False,895170,False,1,26,39,13
166727,2019-09-14 00:00:00+03:00,in,False,895170,False,1,20,37,17
166727,2019-09-14 00:00:00+03:00,in,False,-1,True,3,0,51,51
166727,2019-09-15 00:00:00+03:00,in,False,-1,True,2,0,51,51
166727,2019-09-18 00:00:00+03:00,in,False,-1,True,2,0,34,34
166727,2019-09-18 00:00:00+03:00,in,False,895170,False,1,27,38,11
166727,2019-09-18 00:00:00+03:00,in,False,-1,True,2,0,34,34
166727,2019-09-20 00:00:00+03:00,in,False,-1,True,1,0,30,30
166727,2019-09-21 00:00:00+03:00,in,False,-1,True,2,0,50,50
166727,2019-09-21 00:00:00+03:00,in,False,895170,False,1,15,28,13
166727,2019-09-26 00:00:00+03:00,in,False,-1,True,2,0,4,4
166727,2019-10-03 00:00:00+03:00,in,False,-1,True,1,0,2,2
166727,2019-10-04 00:00:00+03:00,in,False,-1,True,3,0,6,6
166727,2019-10-07 00:00:00+03:00,in,False,-1,True,1,0,2,2
166727,2019-10-09 00:00:00+03:00,in,False,-1,True,1,0,2,2
166727,2019-10-11 00:00:00+03:00,in,False,-1,True,1,0,2,2
166727,2019-10-12 00:00:00+03:00,in,False,-1,True,1,0,2,2
166727,2019-10-16 00:00:00+03:00,in,False,-1,True,1,0,2,2
166727,2019-10-17 00:00:00+03:00,in,False,-1,True,4,0,8,8
166727,2019-10-18 00:00:00+03:00,in,False,-1,True,3,0,6,6
166727,2019-10-21 00:00:00+03:00,in,False,-1,True,5,0,10,10
166727,2019-10-26 00:00:00+03:00,in,False,-1,True,1,0,2,2
166732,2019-08-21 00:00:00+03:00,in,False,-1,True,2,0,4,4
166732,2019-08-26 00:00:00+03:00,in,False,-1,True,1,0,2,2
166732,2019-08-29 00:00:00+03:00,in,False,-1,True,1,0,2,2
166732,2019-09-03 00:00:00+03:00,in,False,-1,True,2,0,4,4
166732,2019-09-06 00:00:00+03:00,in,False,-1,True,2,0,4,4
166732,2019-09-06 00:00:00+03:00,in,False,-1,True,2,0,4,4
166732,2019-09-07 00:00:00+03:00,out,False,894226,True,1,0,1,1
166732,2019-09-07 00:00:00+03:00,out,True,894226,True,1,0,23,23
166732,2019-09-07 00:00:00+03:00,out,True,894232,True,1,0,10,10
166732,2019-09-07 00:00:00+03:00,out,True,894226,False,1,18,34,16
166732,2019-09-07 00:00:00+03:00,in,False,-1,True,3,0,6,6
166732,2019-09-07 00:00:00+03:00,out,True,894232,False,1,16,33,17
166732,2019-09-07 00:00:00+03:00,in,False,-1,True,2,0,4,4
166732,2019-09-07 00:00:00+03:00,out,False,894226,True,1,0,1,1
166732,2019-09-11 00:00:00+03:00,out,True,894226,False,2,38,61,23
166732,2019-09-11 00:00:00+03:00,out,True,894232,False,4,120,172,52
166732,2019-09-12 00:00:00+03:00,in,False,-1,True,15,0,301,301
166732,2019-09-12 00:00:00+03:00,in,True,894232,False,2,12,38,26
166732,2019-09-13 00:00:00+03:00,in,False,-1,True,8,0,300,300
166732,2019-09-13 00:00:00+03:00,in,False,909624,False,1,32,59,27
166732,2019-09-13 00:00:00+03:00,in,False,-1,True,3,0,75,75
166732,2019-09-13 00:00:00+03:00,out,True,894232,True,1,0,26,26
166732,2019-09-13 00:00:00+03:00,in,True,909624,False,2,123,197,74
166732,2019-09-16 00:00:00+03:00,in,False,-1,True,5,0,31,31
166732,2019-09-16 00:00:00+03:00,in,False,-1,True,1,0,18,18
166732,2019-09-16 00:00:00+03:00,out,True,894232,True,1,0,18,18
166732,2019-09-18 00:00:00+03:00,in,False,-1,True,2,0,116,116
166732,2019-09-18 00:00:00+03:00,in,False,-1,True,19,0,461,461
166732,2019-09-18 00:00:00+03:00,out,True,894232,True,1,0,4,4
166732,2019-09-18 00:00:00+03:00,out,True,894232,False,2,97,124,27
166732,2019-09-18 00:00:00+03:00,in,True,894232,False,1,67,80,13
166732,2019-09-18 00:00:00+03:00,in,True,894232,False,1,67,80,13
166732,2019-09-19 00:00:00+03:00,in,False,-1,True,20,0,227,227
166732,2019-09-20 00:00:00+03:00,in,False,-1,True,1,0,21,21
166732,2019-09-21 00:00:00+03:00,in,False,-1,True,1,0,37,37
166732,2019-09-23 00:00:00+03:00,in,False,-1,True,16,0,268,268
166732,2019-09-26 00:00:00+03:00,in,False,-1,True,2,0,66,66
166732,2019-09-27 00:00:00+03:00,in,False,-1,True,16,0,358,358
166732,2019-09-27 00:00:00+03:00,out,True,894226,True,2,0,26,26
166732,2019-09-27 00:00:00+03:00,out,True,894232,True,2,0,39,39
166732,2019-09-28 00:00:00+03:00,in,False,-1,True,5,0,36,36
166732,2019-09-30 00:00:00+03:00,out,True,894226,False,4,47,108,61
166732,2019-09-30 00:00:00+03:00,in,False,-1,True,5,0,54,54
166732,2019-09-30 00:00:00+03:00,out,False,894226,True,3,0,35,35
166732,2019-09-30 00:00:00+03:00,in,False,-1,True,2,0,58,58
166732,2019-09-30 00:00:00+03:00,out,True,894226,True,4,0,48,48
166732,2019-09-30 00:00:00+03:00,in,True,894232,True,1,64,68,4
166732,2019-10-01 00:00:00+03:00,in,False,-1,True,7,0,70,70
166732,2019-10-02 00:00:00+03:00,in,False,-1,True,7,0,107,107
166732,2019-10-03 00:00:00+03:00,in,False,-1,True,1,0,50,50
166732,2019-10-05 00:00:00+03:00,in,False,-1,True,1,0,42,42
166732,2019-10-07 00:00:00+03:00,out,True,894226,True,3,0,37,37
166732,2019-10-07 00:00:00+03:00,in,False,-1,True,2,0,42,42
166732,2019-10-07 00:00:00+03:00,out,True,894224,True,10,0,74,74
166732,2019-10-07 00:00:00+03:00,out,True,894226,False,1,10,22,12
166732,2019-10-07 00:00:00+03:00,in,False,-1,True,30,0,9,9
166732,2019-10-08 00:00:00+03:00,in,False,894224,False,1,25,78,53
166732,2019-10-08 00:00:00+03:00,out,True,894224,True,1,0,14,14
166732,2019-10-08 00:00:00+03:00,in,False,-1,True,1,0,17,17
166732,2019-10-08 00:00:00+03:00,in,True,894224,False,2,187,199,12
166732,2019-10-08 00:00:00+03:00,in,False,-1,True,3,0,33,33
166732,2019-10-08 00:00:00+03:00,in,True,894224,False,2,187,199,12
166732,2019-10-09 00:00:00+03:00,in,False,-1,True,2,0,32,32
166732,2019-10-09 00:00:00+03:00,in,False,-1,True,1,0,5,5
166732,2019-10-11 00:00:00+03:00,in,False,-1,True,1,0,5,5
166732,2019-10-13 00:00:00+03:00,in,False,-1,True,1,0,21,21
166732,2019-10-14 00:00:00+03:00,in,False,-1,True,1,0,37,37
166732,2019-10-16 00:00:00+03:00,in,False,-1,True,1,0,50,50
166732,2019-10-17 00:00:00+03:00,in,False,-1,True,2,0,62,62
166732,2019-10-18 00:00:00+03:00,in,False,-1,True,2,0,53,53
166732,2019-10-20 00:00:00+03:00,in,False,-1,True,1,0,71,71
166732,2019-10-21 00:00:00+03:00,in,False,-1,True,2,0,62,62
166732,2019-10-22 00:00:00+03:00,in,False,-1,True,1,0,46,46
166732,2019-10-25 00:00:00+03:00,in,False,-1,True,1,0,3,3
166732,2019-10-26 00:00:00+03:00,in,False,-1,True,6,0,111,111
166732,2019-10-28 00:00:00+03:00,in,False,-1,True,1,0,3,3
166732,2019-10-30 00:00:00+03:00,out,True,894232,True,1,0,30,30
166732,2019-10-30 00:00:00+03:00,in,False,-1,True,2,0,588,588
166732,2019-10-30 00:00:00+03:00,out,True,894226,True,2,0,60,60
166732,2019-10-30 00:00:00+03:00,out,True,894224,True,2,0,27,27
166732,2019-10-31 00:00:00+03:00,out,True,894232,True,2,0,44,44
166732,2019-11-01 00:00:00+03:00,out,True,894230,True,2,0,18,18
166732,2019-11-01 00:00:00+03:00,out,True,894224,True,5,0,61,61
166732,2019-11-01 00:00:00+03:00,in,False,-1,True,13,0,354,354
166732,2019-11-05 00:00:00+03:00,in,True,894230,False,3,116,162,46
166732,2019-11-05 00:00:00+03:00,in,False,894224,False,2,147,157,10
166732,2019-11-05 00:00:00+03:00,out,True,894230,False,2,49,66,17
166732,2019-11-05 00:00:00+03:00,in,False,-1,True,13,0,628,628
166732,2019-11-05 00:00:00+03:00,out,True,894230,True,1,0,16,16
166732,2019-11-05 00:00:00+03:00,out,False,894230,True,1,0,12,12
166732,2019-11-05 00:00:00+03:00,out,True,894224,True,2,0,26,26
166732,2019-11-05 00:00:00+03:00,in,False,894224,False,2,147,157,10
166732,2019-11-14 00:00:00+03:00,in,False,-1,True,2,0,307,307
166732,2019-11-15 00:00:00+03:00,in,False,-1,True,2,0,10,10
166732,2019-11-18 00:00:00+03:00,in,False,-1,True,1,0,61,61
166732,2019-11-19 00:00:00+03:00,in,False,-1,True,2,0,93,93
166732,2019-11-19 00:00:00+03:00,in,False,-1,True,12,0,598,598
166732,2019-11-19 00:00:00+03:00,out,True,894230,True,1,0,14,14
166732,2019-11-20 00:00:00+03:00,in,False,-1,True,1,0,26,26
166732,2019-11-20 00:00:00+03:00,in,False,-1,True,1,0,55,55
166732,2019-11-20 00:00:00+03:00,in,False,-1,True,1,0,55,55
166732,2019-11-21 00:00:00+03:00,out,True,894230,False,1,114,121,7
166732,2019-11-21 00:00:00+03:00,in,True,894224,False,1,37,43,6
166732,2019-11-21 00:00:00+03:00,in,True,894230,False,2,205,250,45
166732,2019-11-21 00:00:00+03:00,in,False,-1,True,5,0,358,358
166732,2019-11-21 00:00:00+03:00,in,False,-1,True,2,0,29,29
166732,2019-11-21 00:00:00+03:00,out,True,894224,True,4,0,4,4
166732,2019-11-21 00:00:00+03:00,in,False,-1,True,2,0,29,29
166732,2019-11-22 00:00:00+03:00,in,False,-1,True,2,0,62,62
166732,2019-11-24 00:00:00+03:00,in,False,-1,True,1,0,66,66
166732,2019-11-24 00:00:00+03:00,in,False,-1,True,1,0,66,66
166732,2019-11-26 00:00:00+03:00,in,False,-1,True,3,0,321,321
166732,2019-11-26 00:00:00+03:00,in,True,894224,False,1,29,33,4
166732,2019-11-26 00:00:00+03:00,in,False,-1,True,2,0,49,49
166732,2019-11-27 00:00:00+03:00,out,True,894230,True,4,0,23,23
166732,2019-11-27 00:00:00+03:00,in,True,894230,True,1,107,111,4
166732,2019-11-27 00:00:00+03:00,out,True,894230,False,2,66,91,25
166732,2019-11-27 00:00:00+03:00,in,False,-1,True,1,0,30,30
166732,2019-11-27 00:00:00+03:00,in,False,-1,True,1,0,5,5
166732,2019-11-27 00:00:00+03:00,in,True,894224,False,1,139,146,7
166732,2019-11-27 00:00:00+03:00,out,True,894224,True,6,0,52,52
166732,2019-11-27 00:00:00+03:00,in,True,894224,True,1,241,246,5
166732,2019-11-27 00:00:00+03:00,in,True,894224,False,1,139,146,7
166732,2019-11-27 00:00:00+03:00,in,False,-1,True,1,0,30,30
166732,2019-11-27 00:00:00+03:00,in,False,-1,True,1,0,5,5
166732,2019-11-28 00:00:00+03:00,in,False,894224,False,1,41,55,14
166732,2019-11-28 00:00:00+03:00,out,True,894224,True,3,0,28,28
166732,2019-11-28 00:00:00+03:00,in,True,894224,False,1,92,96,4
166732,2019-11-28 00:00:00+03:00,out,True,894230,True,1,0,18,18
166732,2019-11-28 00:00:00+03:00,in,False,-1,True,5,0,60,60
166732,2019-11-28 00:00:00+03:00,in,False,894224,False,1,41,55,14
166774,2019-08-20 00:00:00+03:00,in,False,-1,True,2,0,12,12
166774,2019-08-20 00:00:00+03:00,in,False,891824,False,2,21,30,9
166774,2019-08-20 00:00:00+03:00,out,False,891824,True,2,0,18,18
166774,2019-08-20 00:00:00+03:00,out,False,891824,False,1,12,18,6
166774,2019-08-23 00:00:00+03:00,in,False,891824,False,3,33,89,56
166774,2019-08-23 00:00:00+03:00,out,False,891824,True,5,0,21,21
166774,2019-08-23 00:00:00+03:00,out,False,891976,True,2,0,23,23
166774,2019-08-23 00:00:00+03:00,out,False,894934,False,1,30,42,12
166774,2019-08-23 00:00:00+03:00,out,False,894934,True,7,0,78,78
166774,2019-08-23 00:00:00+03:00,in,False,-1,True,24,0,127,127
166774,2019-08-23 00:00:00+03:00,out,False,891824,False,12,867,877,10
166774,2019-08-23 00:00:00+03:00,out,False,894934,False,1,30,42,12
166774,2019-08-24 00:00:00+03:00,in,False,895266,False,1,13,30,17
166774,2019-08-24 00:00:00+03:00,out,False,894934,True,11,0,11,11
166774,2019-08-24 00:00:00+03:00,in,False,-1,True,15,0,81,81
166774,2019-08-24 00:00:00+03:00,in,False,891824,False,3,14,72,58
166774,2019-08-24 00:00:00+03:00,in,False,895266,False,1,13,30,17
166774,2019-08-26 00:00:00+03:00,in,False,-1,True,1,0,42,42
166774,2019-08-26 00:00:00+03:00,in,False,895266,False,1,22,25,3
166774,2019-08-26 00:00:00+03:00,out,False,891824,False,2,27,66,39
166774,2019-08-26 00:00:00+03:00,out,False,895266,True,1,0,6,6
166774,2019-09-09 00:00:00+03:00,out,False,891824,True,1,0,8,8
166774,2019-09-09 00:00:00+03:00,out,False,891824,False,2,81,103,22
166774,2019-09-09 00:00:00+03:00,out,False,891824,False,2,81,103,22
166774,2019-09-30 00:00:00+03:00,out,False,891824,True,1,0,10,10
166774,2019-10-09 00:00:00+03:00,in,False,891824,False,1,20,39,19
166774,2019-10-11 00:00:00+03:00,in,False,891824,False,1,87,102,15
166774,2019-10-11 00:00:00+03:00,in,False,-1,True,1,0,2,2
166774,2019-11-01 00:00:00+03:00,in,False,-1,True,1,0,6,6
166774,2019-11-05 00:00:00+03:00,out,False,891824,False,3,956,996,40
166774,2019-11-05 00:00:00+03:00,out,False,891824,True,1,0,6,6
166774,2019-11-07 00:00:00+03:00,out,False,891824,False,1,683,706,23
166774,2019-11-09 00:00:00+03:00,out,False,891824,True,1,0,60,60
166774,2019-11-19 00:00:00+03:00,in,False,891824,False,1,9,28,19
166774,2019-11-25 00:00:00+03:00,in,False,891824,False,1,11,30,19
166782,2019-08-22 00:00:00+03:00,in,False,-1,True,17,0,205,205
166782,2019-08-22 00:00:00+03:00,in,False,894120,False,4,252,321,69
166782,2019-08-24 00:00:00+03:00,in,False,894120,False,1,88,95,7
166782,2019-08-25 00:00:00+03:00,in,False,894120,False,2,434,450,16
166782,2019-08-26 00:00:00+03:00,in,False,894120,False,4,228,268,40
166782,2019-08-26 00:00:00+03:00,in,False,894120,False,4,228,268,40
166782,2019-08-27 00:00:00+03:00,in,False,894120,False,2,177,202,25
166782,2019-08-27 00:00:00+03:00,in,False,-1,True,1,0,6,6
166782,2019-08-27 00:00:00+03:00,in,False,894120,False,2,177,202,25
166782,2019-08-28 00:00:00+03:00,out,False,893804,False,3,446,476,30
166782,2019-08-28 00:00:00+03:00,out,False,893804,True,1,0,1,1
166782,2019-08-28 00:00:00+03:00,in,False,893804,False,7,487,524,37
166782,2019-08-28 00:00:00+03:00,in,False,-1,True,4,0,81,81
166782,2019-08-28 00:00:00+03:00,in,False,894120,False,1,48,87,39
166782,2019-08-29 00:00:00+03:00,in,False,893804,False,4,166,182,16
166782,2019-08-29 00:00:00+03:00,in,False,-1,True,1,0,8,8
166782,2019-08-30 00:00:00+03:00,in,False,-1,True,5,0,87,87
166782,2019-08-30 00:00:00+03:00,out,False,893804,False,1,35,51,16
166782,2019-08-30 00:00:00+03:00,in,False,899250,False,2,46,81,35
166782,2019-08-30 00:00:00+03:00,in,False,893804,False,11,769,806,37
166782,2019-08-30 00:00:00+03:00,in,False,899250,False,2,46,81,35
166782,2019-08-31 00:00:00+03:00,in,False,893804,False,9,785,820,35
166782,2019-08-31 00:00:00+03:00,in,False,-1,True,1,0,2,2
166782,2019-09-01 00:00:00+03:00,in,False,893804,False,7,389,449,60
166782,2019-09-01 00:00:00+03:00,in,False,899250,False,1,52,108,56
166782,2019-09-02 00:00:00+03:00,in,False,894120,False,1,154,220,66
166782,2019-09-02 00:00:00+03:00,out,False,893804,False,1,13,15,2
166782,2019-09-02 00:00:00+03:00,out,False,899250,False,1,11,13,2
166782,2019-09-02 00:00:00+03:00,in,False,893804,False,19,1503,1582,79
166782,2019-09-02 00:00:00+03:00,in,False,-1,True,2,0,4,4
166782,2019-09-03 00:00:00+03:00,out,False,899250,False,2,15,35,20
166782,2019-09-03 00:00:00+03:00,in,False,894120,False,2,34,164,130
166782,2019-09-03 00:00:00+03:00,out,False,899250,True,4,0,19,19
166782,2019-09-03 00:00:00+03:00,out,False,893804,True,1,0,5,5
166782,2019-09-03 00:00:00+03:00,in,False,-1,False,3,229,277,48
166782,2019-09-03 00:00:00+03:00,in,False,893804,False,33,2684,2811,127
166782,2019-09-03 00:00:00+03:00,in,False,-1,True,6,0,58,58
166782,2019-09-03 00:00:00+03:00,in,False,899250,False,9,529,597,68
166782,2019-09-03 00:00:00+03:00,in,False,900180,False,1,51,56,5
166782,2019-09-03 00:00:00+03:00,in,False,-1,False,3,229,277,48
166782,2019-09-04 00:00:00+03:00,in,False,899250,False,4,331,438,107
166782,2019-09-04 00:00:00+03:00,in,False,-1,True,8,0,128,128
166782,2019-09-04 00:00:00+03:00,in,False,893804,False,27,1953,2073,120
166782,2019-09-05 00:00:00+03:00,in,False,-1,True,2,0,19,19
166782,2019-09-05 00:00:00+03:00,in,False,893804,False,28,1252,1371,119
166782,2019-09-05 00:00:00+03:00,in,False,899250,False,2,251,284,33
166782,2019-09-06 00:00:00+03:00,in,False,899250,False,2,286,306,20
166782,2019-09-06 00:00:00+03:00,in,False,-1,True,1,0,1,1
166782,2019-09-06 00:00:00+03:00,in,False,893804,False,28,1779,1894,115
166782,2019-09-06 00:00:00+03:00,out,False,893804,False,1,70,81,11
166782,2019-09-06 00:00:00+03:00,out,False,893804,False,1,70,81,11
166782,2019-09-07 00:00:00+03:00,in,False,893804,False,4,706,723,17
166782,2019-09-07 00:00:00+03:00,in,False,899250,False,2,113,130,17
166782,2019-09-07 00:00:00+03:00,in,False,-1,False,1,332,345,13
166782,2019-09-07 00:00:00+03:00,in,False,-1,False,1,332,345,13
166782,2019-09-08 00:00:00+03:00,in,False,899250,False,1,20,37,17
166782,2019-09-08 00:00:00+03:00,in,False,893804,False,10,385,426,41
166782,2019-09-09 00:00:00+03:00,in,False,-1,True,5,0,98,98
166782,2019-09-09 00:00:00+03:00,out,False,893804,False,1,3,36,33
166782,2019-09-09 00:00:00+03:00,out,False,899250,True,1,0,26,26
166782,2019-09-09 00:00:00+03:00,in,False,899250,False,5,200,300,100
166782,2019-09-09 00:00:00+03:00,in,False,893804,False,32,1921,2103,182
166782,2019-09-09 00:00:00+03:00,out,False,899250,True,1,0,26,26
166782,2019-09-09 00:00:00+03:00,in,False,-1,True,5,0,98,98
166782,2019-09-10 00:00:00+03:00,in,False,899250,False,1,190,197,7
166782,2019-09-10 00:00:00+03:00,out,False,899250,True,2,0,2,2
166782,2019-09-10 00:00:00+03:00,in,False,-1,True,3,0,44,44
166782,2019-09-10 00:00:00+03:00,in,False,893804,False,26,1700,1822,122
166782,2019-09-10 00:00:00+03:00,out,False,893804,True,1,0,1,1
166782,2019-09-10 00:00:00+03:00,out,False,893804,True,1,0,1,1
166782,2019-09-11 00:00:00+03:00,out,False,893804,False,1,214,231,17
166782,2019-09-11 00:00:00+03:00,in,False,893804,False,23,1488,1577,89
166782,2019-09-11 00:00:00+03:00,out,False,893804,True,1,0,10,10
166782,2019-09-12 00:00:00+03:00,in,False,-1,True,3,0,70,70
166782,2019-09-12 00:00:00+03:00,in,False,893804,False,33,2287,2421,134
166782,2019-09-12 00:00:00+03:00,out,False,899250,False,1,3,37,34
166782,2019-09-12 00:00:00+03:00,in,False,899250,False,6,432,539,107
166782,2019-09-12 00:00:00+03:00,out,False,893804,True,2,0,34,34
166782,2019-09-12 00:00:00+03:00,out,False,893804,False,1,67,76,9
166782,2019-09-12 00:00:00+03:00,in,False,899250,False,6,432,539,107
166782,2019-09-13 00:00:00+03:00,in,False,-1,True,4,0,269,269
166782,2019-09-13 00:00:00+03:00,in,False,893804,False,21,1644,1775,131
166782,2019-09-13 00:00:00+03:00,in,False,-1,False,1,5,16,11
166782,2019-09-13 00:00:00+03:00,in,False,-1,True,4,0,269,269
166782,2019-09-14 00:00:00+03:00,in,False,-1,True,3,0,17,17
166782,2019-09-14 00:00:00+03:00,in,False,893804,False,9,511,555,44
166782,2019-09-15 00:00:00+03:00,in,False,893804,False,12,621,669,48
166782,2019-09-15 00:00:00+03:00,in,False,-1,True,4,0,69,69
166782,2019-09-15 00:00:00+03:00,out,False,899250,False,3,16,44,28
166782,2019-09-15 00:00:00+03:00,out,False,893804,False,1,10,23,13
166782,2019-09-15 00:00:00+03:00,out,False,899250,True,1,0,6,6
166782,2019-09-15 00:00:00+03:00,out,False,893804,True,1,0,2,2
166782,2019-09-16 00:00:00+03:00,out,False,893804,False,1,29,37,8
166782,2019-09-16 00:00:00+03:00,out,False,899250,False,2,97,150,53
166782,2019-09-16 00:00:00+03:00,in,False,893804,False,22,1404,1511,107
166782,2019-09-16 00:00:00+03:00,in,False,-1,True,8,0,80,80
166782,2019-09-16 00:00:00+03:00,in,False,899250,False,7,585,709,124
166782,2019-09-17 00:00:00+03:00,in,False,-1,True,4,0,37,37
166782,2019-09-17 00:00:00+03:00,out,False,893804,True,1,0,4,4
166782,2019-09-17 00:00:00+03:00,in,False,893804,False,11,875,949,74
166782,2019-09-17 00:00:00+03:00,in,False,899250,False,1,77,99,22
166782,2019-09-18 00:00:00+03:00,out,False,893804,False,16,789,1040,251
166782,2019-09-18 00:00:00+03:00,in,False,893804,False,20,1360,1447,87
166782,2019-09-18 00:00:00+03:00,out,False,893804,True,18,0,280,280
166782,2019-09-18 00:00:00+03:00,out,False,900180,False,39,1740,2557,817
166782,2019-09-18 00:00:00+03:00,in,False,900180,False,8,472,539,67
166782,2019-09-18 00:00:00+03:00,out,False,900180,True,26,0,490,490
166782,2019-09-18 00:00:00+03:00,out,True,900180,True,1,0,4,4
166782,2019-09-18 00:00:00+03:00,in,False,-1,True,5,0,101,101
166782,2019-09-18 00:00:00+03:00,in,False,894120,True,1,0,36,36
166782,2019-09-18 00:00:00+03:00,in,False,900180,False,8,472,539,67
166782,2019-09-19 00:00:00+03:00,out,False,899250,True,14,0,429,429
166782,2019-09-19 00:00:00+03:00,in,False,899250,False,2,206,221,15
166782,2019-09-19 00:00:00+03:00,in,False,-1,True,8,0,103,103
166782,2019-09-19 00:00:00+03:00,out,True,893804,True,3,0,10,10
166782,2019-09-19 00:00:00+03:00,out,False,893804,False,47,2178,2905,727
166782,2019-09-19 00:00:00+03:00,out,True,899250,False,1,5,7,2
166782,2019-09-19 00:00:00+03:00,in,False,893804,False,23,1219,1311,92
166782,2019-09-19 00:00:00+03:00,out,False,899250,False,12,447,620,173
166782,2019-09-19 00:00:00+03:00,out,False,893804,True,21,0,602,602
166782,2019-09-20 00:00:00+03:00,out,False,893804,False,88,5709,7218,1509
166782,2019-09-20 00:00:00+03:00,out,False,899250,True,27,0,719,719
166782,2019-09-20 00:00:00+03:00,out,True,893804,True,2,0,3,3
166782,2019-09-20 00:00:00+03:00,in,False,899250,False,5,380,440,60
166782,2019-09-20 00:00:00+03:00,in,False,893804,False,21,1201,1287,86
166782,2019-09-20 00:00:00+03:00,out,False,893804,True,71,0,1180,1180
166782,2019-09-20 00:00:00+03:00,in,False,-1,True,8,0,92,92
166782,2019-09-20 00:00:00+03:00,out,False,899250,False,47,2820,3566,746
166782,2019-09-20 00:00:00+03:00,in,False,899250,False,5,380,440,60
166782,2019-09-20 00:00:00+03:00,out,True,893804,True,2,0,3,3
166782,2019-09-20 00:00:00+03:00,out,False,893804,True,71,0,1180,1180
166782,2019-09-21 00:00:00+03:00,in,False,893804,False,5,212,234,22
166782,2019-09-21 00:00:00+03:00,out,False,899250,True,45,0,1203,1203
166782,2019-09-21 00:00:00+03:00,in,False,-1,True,4,0,43,43
166782,2019-09-21 00:00:00+03:00,out,False,893804,False,4,166,239,73
166782,2019-09-21 00:00:00+03:00,out,False,899250,False,56,2458,3535,1077
166782,2019-09-21 00:00:00+03:00,out,False,893804,True,2,0,122,122
166782,2019-09-21 00:00:00+03:00,in,False,899250,False,1,40,64,24
166782,2019-09-21 00:00:00+03:00,out,False,899250,True,45,0,1203,1203
166782,2019-09-22 00:00:00+03:00,out,False,893804,True,3,0,41,41
166782,2019-09-22 00:00:00+03:00,in,False,-1,True,7,0,155,155
166782,2019-09-22 00:00:00+03:00,out,False,899250,False,37,1652,2398,746
166782,2019-09-22 00:00:00+03:00,out,False,893804,False,1,204,217,13
166782,2019-09-22 00:00:00+03:00,in,False,899250,False,1,16,23,7
166782,2019-09-22 00:00:00+03:00,out,False,899250,True,26,0,726,726
166782,2019-09-22 00:00:00+03:00,in,False,893804,False,9,1290,1336,46
166782,2019-09-22 00:00:00+03:00,out,False,893804,True,3,0,41,41
166782,2019-09-23 00:00:00+03:00,out,False,900180,False,42,2076,2902,826
166782,2019-09-23 00:00:00+03:00,out,False,899250,False,25,1658,2115,457
166782,2019-09-23 00:00:00+03:00,out,False,900180,True,15,0,508,508
166782,2019-09-23 00:00:00+03:00,out,False,893804,True,21,0,478,478
166782,2019-09-23 00:00:00+03:00,in,False,893804,False,29,1994,2128,134
166782,2019-09-23 00:00:00+03:00,out,False,899250,True,11,0,349,349
166782,2019-09-23 00:00:00+03:00,in,False,899250,False,2,117,133,16
166782,2019-09-23 00:00:00+03:00,out,False,893804,False,39,1941,2688,747
166782,2019-09-23 00:00:00+03:00,in,False,-1,True,5,0,48,48
166782,2019-09-23 00:00:00+03:00,out,False,899250,True,11,0,349,349
166782,2019-09-23 00:00:00+03:00,out,False,900180,True,15,0,508,508
166782,2019-09-24 00:00:00+03:00,in,False,-1,True,12,0,188,188
166782,2019-09-24 00:00:00+03:00,out,True,893804,True,3,0,0,0
166782,2019-09-24 00:00:00+03:00,out,False,893804,True,13,0,304,304
166782,2019-09-24 00:00:00+03:00,out,False,900180,True,4,0,61,61
166782,2019-09-24 00:00:00+03:00,in,False,899250,False,3,194,251,57
166782,2019-09-24 00:00:00+03:00,in,False,893804,False,18,1262,1322,60
166782,2019-09-24 00:00:00+03:00,out,False,899250,True,16,0,477,477
166782,2019-09-24 00:00:00+03:00,out,False,893804,False,22,1578,1964,386
166782,2019-09-24 00:00:00+03:00,out,False,899250,False,41,2040,2783,743
166782,2019-09-24 00:00:00+03:00,out,False,900180,False,15,2032,2309,277
166782,2019-09-25 00:00:00+03:00,out,False,-1,True,1,0,0,0
166782,2019-09-25 00:00:00+03:00,in,False,893804,False,38,3140,3345,205
166782,2019-09-25 00:00:00+03:00,out,False,893804,False,25,1576,1978,402
166782,2019-09-25 00:00:00+03:00,out,False,899250,False,40,1799,2492,693
166782,2019-09-25 00:00:00+03:00,out,False,899250,True,30,0,778,778
166782,2019-09-25 00:00:00+03:00,out,False,900180,False,50,2288,3235,947
166782,2019-09-25 00:00:00+03:00,out,True,900180,True,1,0,3,3
166782,2019-09-25 00:00:00+03:00,out,False,900180,True,18,0,419,419
166782,2019-09-25 00:00:00+03:00,out,False,893804,True,10,0,269,269
166782,2019-09-25 00:00:00+03:00,in,False,899250,False,4,251,309,58
166782,2019-09-25 00:00:00+03:00,in,False,-1,True,8,0,130,130
166782,2019-09-25 00:00:00+03:00,out,False,899250,False,40,1799,2492,693
166782,2019-09-26 00:00:00+03:00,out,False,900180,True,12,0,406,406
166782,2019-09-26 00:00:00+03:00,out,False,893804,True,20,0,299,299
166782,2019-09-26 00:00:00+03:00,in,False,899250,False,6,386,450,64
166782,2019-09-26 00:00:00+03:00,out,True,900180,True,5,0,11,11
166782,2019-09-26 00:00:00+03:00,out,False,893804,False,52,2552,3416,864
166782,2019-09-26 00:00:00+03:00,in,False,-1,True,5,0,29,29
166782,2019-09-26 00:00:00+03:00,in,False,893804,False,29,1722,1820,98
166782,2019-09-26 00:00:00+03:00,out,False,900180,False,26,1957,2425,468
166782,2019-09-26 00:00:00+03:00,out,False,899250,False,4,185,234,49
166782,2019-09-27 00:00:00+03:00,out,True,893804,True,3,0,1,1
166782,2019-09-27 00:00:00+03:00,out,False,899250,True,5,0,254,254
166782,2019-09-27 00:00:00+03:00,in,False,899250,False,7,588,714,126
166782,2019-09-27 00:00:00+03:00,out,False,893804,False,18,839,1139,300
166782,2019-09-27 00:00:00+03:00,out,False,899250,False,14,800,994,194
166782,2019-09-27 00:00:00+03:00,out,False,893804,True,7,0,210,210
166782,2019-09-27 00:00:00+03:00,in,False,-1,True,1,0,0,0
166782,2019-09-27 00:00:00+03:00,in,False,893804,False,27,1991,2129,138
166782,2019-09-27 00:00:00+03:00,out,False,893804,True,7,0,210,210
166782,2019-09-27 00:00:00+03:00,in,False,899250,False,7,588,714,126
166782,2019-09-28 00:00:00+03:00,in,False,-1,True,11,0,200,200
166782,2019-09-28 00:00:00+03:00,out,False,893804,False,45,2286,3164,878
166782,2019-09-28 00:00:00+03:00,out,False,893804,True,26,0,720,720
166782,2019-09-28 00:00:00+03:00,out,False,899250,False,1,15,24,9
166782,2019-09-28 00:00:00+03:00,in,False,893804,False,11,812,852,40
166782,2019-09-28 00:00:00+03:00,out,False,899250,True,1,0,41,41
166782,2019-09-28 00:00:00+03:00,in,False,899250,False,4,568,641,73
166782,2019-09-28 00:00:00+03:00,out,True,893804,True,1,0,4,4
166782,2019-09-28 00:00:00+03:00,out,True,893804,True,1,0,4,4
166782,2019-09-28 00:00:00+03:00,out,False,893804,True,26,0,720,720
166782,2019-09-29 00:00:00+03:00,in,False,-1,True,7,0,80,80
166782,2019-09-29 00:00:00+03:00,out,False,899250,False,48,2478,3533,1055
166782,2019-09-29 00:00:00+03:00,in,False,893804,True,1,1,10,9
166782,2019-09-29 00:00:00+03:00,out,False,893804,False,4,108,168,60
166782,2019-09-29 00:00:00+03:00,out,False,899250,True,50,0,1453,1453
166782,2019-09-29 00:00:00+03:00,in,False,899250,False,1,51,68,17
166782,2019-09-29 00:00:00+03:00,in,False,893804,False,15,919,1073,154
166782,2019-09-29 00:00:00+03:00,out,False,893804,True,3,0,44,44
166782,2019-09-29 00:00:00+03:00,out,False,899250,True,50,0,1453,1453
166782,2019-09-30 00:00:00+03:00,out,False,900180,True,14,0,413,413
166782,2019-09-30 00:00:00+03:00,out,False,900180,False,29,1783,2379,596
166782,2019-09-30 00:00:00+03:00,out,False,899250,True,8,0,283,283
166782,2019-09-30 00:00:00+03:00,out,False,893804,False,3,121,170,49
166782,2019-09-30 00:00:00+03:00,in,False,893804,False,38,2891,3120,229
166782,2019-09-30 00:00:00+03:00,in,False,899250,False,2,57,73,16
166782,2019-09-30 00:00:00+03:00,out,False,899250,False,16,487,780,293
166782,2019-09-30 00:00:00+03:00,in,False,893804,False,38,2891,3120,229
166782,2019-10-01 00:00:00+03:00,out,False,893804,False,64,3255,4486,1231
166782,2019-10-01 00:00:00+03:00,out,False,900180,False,1,8,15,7
166782,2019-10-01 00:00:00+03:00,in,False,-1,True,6,0,71,71
166782,2019-10-01 00:00:00+03:00,out,False,899250,True,12,0,331,331
166782,2019-10-01 00:00:00+03:00,out,False,900180,True,1,0,11,11
166782,2019-10-01 00:00:00+03:00,in,False,899250,False,7,304,383,79
166782,2019-10-01 00:00:00+03:00,out,False,899250,False,16,578,870,292
166782,2019-10-01 00:00:00+03:00,out,False,893804,True,34,0,877,877
166782,2019-10-01 00:00:00+03:00,in,False,893804,False,32,1656,1776,120
166782,2019-10-01 00:00:00+03:00,out,False,899250,False,16,578,870,292
166782,2019-10-01 00:00:00+03:00,out,False,893804,True,34,0,877,877
166782,2019-10-01 00:00:00+03:00,out,False,899250,True,12,0,331,331
166782,2019-10-02 00:00:00+03:00,in,False,-1,True,3,0,16,16
166782,2019-10-02 00:00:00+03:00,out,False,900180,True,28,0,644,644
166782,2019-10-02 00:00:00+03:00,in,False,893804,False,41,2368,2582,214
166782,2019-10-02 00:00:00+03:00,out,False,899250,True,15,0,373,373
166782,2019-10-02 00:00:00+03:00,out,True,900180,True,3,0,0,0
166782,2019-10-02 00:00:00+03:00,out,False,900180,False,56,4551,5545,994
166782,2019-10-02 00:00:00+03:00,out,False,-1,True,1,0,0,0
166782,2019-10-02 00:00:00+03:00,out,False,893804,True,7,0,122,122
166782,2019-10-02 00:00:00+03:00,out,False,899250,False,27,1229,1700,471
166782,2019-10-02 00:00:00+03:00,out,False,893804,False,22,1299,1656,357
166782,2019-10-02 00:00:00+03:00,in,False,899250,False,2,101,138,37
166782,2019-10-02 00:00:00+03:00,out,False,899250,False,27,1229,1700,471
166782,2019-10-02 00:00:00+03:00,in,False,893804,False,41,2368,2582,214
166782,2019-10-03 00:00:00+03:00,out,False,899250,False,12,383,598,215
166782,2019-10-03 00:00:00+03:00,out,True,899250,True,1,0,2,2
166782,2019-10-03 00:00:00+03:00,out,False,900180,True,1,0,35,35
166782,2019-10-03 00:00:00+03:00,in,False,893804,False,30,2665,2784,119
166782,2019-10-03 00:00:00+03:00,out,False,893804,False,31,2216,2798,582
166782,2019-10-03 00:00:00+03:00,out,False,899250,True,5,0,204,204
166782,2019-10-03 00:00:00+03:00,in,False,-1,True,3,0,34,34
166782,2019-10-03 00:00:00+03:00,in,False,899250,True,1,0,18,18
166782,2019-10-03 00:00:00+03:00,in,False,899250,False,4,326,421,95
166782,2019-10-03 00:00:00+03:00,out,False,900180,False,5,205,246,41
166782,2019-10-03 00:00:00+03:00,out,False,893804,True,18,0,194,194
166782,2019-10-04 00:00:00+03:00,out,False,900180,False,3,118,166,48
166782,2019-10-04 00:00:00+03:00,out,False,893804,False,65,3213,4457,1244
166782,2019-10-04 00:00:00+03:00,in,False,-1,True,5,0,49,49
166782,2019-10-04 00:00:00+03:00,in,False,899250,False,6,688,810,122
166782,2019-10-04 00:00:00+03:00,out,True,900180,True,3,0,0,0
166782,2019-10-04 00:00:00+03:00,out,False,900180,True,1,0,23,23
166782,2019-10-04 00:00:00+03:00,in,False,893804,False,24,1683,1842,159
166782,2019-10-04 00:00:00+03:00,out,False,893804,True,47,0,1114,1114
166782,2019-10-04 00:00:00+03:00,out,False,900180,True,1,0,23,23
166782,2019-10-04 00:00:00+03:00,out,False,893804,True,47,0,1114,1114
166782,2019-10-05 00:00:00+03:00,out,False,893804,False,18,1078,1318,240
166782,2019-10-05 00:00:00+03:00,out,False,899250,True,3,0,147,147
166782,2019-10-05 00:00:00+03:00,in,False,893804,False,6,283,314,31
166782,2019-10-05 00:00:00+03:00,out,False,893804,True,20,0,527,527
166782,2019-10-05 00:00:00+03:00,in,False,-1,True,8,0,22,22
166782,2019-10-05 00:00:00+03:00,out,False,899250,False,5,88,214,126
166782,2019-10-05 00:00:00+03:00,in,False,899250,False,3,259,293,34
166782,2019-10-05 00:00:00+03:00,out,True,900180,True,1,0,0,0
166782,2019-10-05 00:00:00+03:00,in,False,893804,False,6,283,314,31
166782,2019-10-06 00:00:00+03:00,out,False,893804,False,32,2232,2886,654
166782,2019-10-06 00:00:00+03:00,out,False,899250,True,6,0,140,140
166782,2019-10-06 00:00:00+03:00,in,False,899250,False,2,62,80,18
166782,2019-10-06 00:00:00+03:00,in,False,-1,True,11,0,29,29
166782,2019-10-06 00:00:00+03:00,out,False,899250,False,5,98,229,131
166782,2019-10-06 00:00:00+03:00,in,False,893804,False,11,676,750,74
166782,2019-10-06 00:00:00+03:00,out,False,893804,True,15,0,532,532
166782,2019-10-07 00:00:00+03:00,out,False,899250,False,24,1224,1679,455
166782,2019-10-07 00:00:00+03:00,out,False,893804,True,21,0,618,618
166782,2019-10-07 00:00:00+03:00,out,True,893804,True,2,0,6,6
166782,2019-10-07 00:00:00+03:00,out,False,900180,True,28,0,522,522
166782,2019-10-07 00:00:00+03:00,in,False,919994,False,1,87,175,88
166782,2019-10-07 00:00:00+03:00,in,False,899250,False,9,859,1035,176
166782,2019-10-07 00:00:00+03:00,out,False,899250,True,14,0,363,363
166782,2019-10-07 00:00:00+03:00,in,False,893804,True,1,0,3,3
166782,2019-10-07 00:00:00+03:00,in,False,899250,True,1,1,8,7
166782,2019-10-07 00:00:00+03:00,out,True,900180,True,2,0,0,0
166782,2019-10-07 00:00:00+03:00,out,False,900180,False,32,2005,2568,563
166782,2019-10-07 00:00:00+03:00,in,False,-1,True,6,0,74,74
166782,2019-10-07 00:00:00+03:00,out,False,893804,False,45,3967,4602,635
166782,2019-10-07 00:00:00+03:00,in,False,893804,False,36,3304,3623,319
166782,2019-10-08 00:00:00+03:00,out,False,900180,False,1,511,532,21
166782,2019-10-08 00:00:00+03:00,out,False,893804,False,30,1501,1898,397
166782,2019-10-08 00:00:00+03:00,in,False,-1,False,1,218,234,16
166782,2019-10-08 00:00:00+03:00,out,False,899250,False,22,889,1305,416
166782,2019-10-08 00:00:00+03:00,in,False,899250,True,1,0,10,10
166782,2019-10-08 00:00:00+03:00,out,False,893804,True,24,0,451,451
166782,2019-10-08 00:00:00+03:00,in,False,899250,False,2,78,107,29
166782,2019-10-08 00:00:00+03:00,out,False,899250,True,6,0,143,143
166782,2019-10-08 00:00:00+03:00,in,False,893804,False,38,2045,2219,174
166782,2019-10-08 00:00:00+03:00,in,False,-1,True,4,0,31,31
166782,2019-10-08 00:00:00+03:00,in,False,-1,True,4,0,31,31
166782,2019-10-08 00:00:00+03:00,out,False,899250,False,22,889,1305,416
166782,2019-10-09 00:00:00+03:00,in,False,899250,False,1,99,127,28
166782,2019-10-09 00:00:00+03:00,out,False,899250,True,7,0,232,232
166782,2019-10-09 00:00:00+03:00,out,False,900180,False,4,140,186,46
166782,2019-10-09 00:00:00+03:00,in,False,899250,True,1,0,8,8
166782,2019-10-09 00:00:00+03:00,in,False,893804,False,31,1833,1960,127
166782,2019-10-09 00:00:00+03:00,out,True,893804,True,2,0,0,0
166782,2019-10-09 00:00:00+03:00,in,False,-1,True,2,0,33,33
166782,2019-10-09 00:00:00+03:00,out,False,893804,False,60,3183,4208,1025
166782,2019-10-09 00:00:00+03:00,out,False,900180,True,6,0,55,55
166782,2019-10-09 00:00:00+03:00,out,False,893804,True,32,0,813,813
166782,2019-10-09 00:00:00+03:00,out,False,899250,False,10,310,540,230
166782,2019-10-09 00:00:00+03:00,out,False,900180,True,6,0,55,55
166782,2019-10-09 00:00:00+03:00,out,False,893804,True,32,0,813,813
166782,2019-10-09 00:00:00+03:00,out,False,899250,True,7,0,232,232
166782,2019-10-09 00:00:00+03:00,in,False,899250,False,1,99,127,28
166782,2019-10-09 00:00:00+03:00,out,True,893804,True,2,0,0,0
166782,2019-10-10 00:00:00+03:00,out,False,893804,False,43,2752,3583,831
166782,2019-10-10 00:00:00+03:00,out,True,893804,True,2,0,6,6
166782,2019-10-10 00:00:00+03:00,out,False,899250,True,5,0,135,135
166782,2019-10-10 00:00:00+03:00,in,False,-1,True,3,0,19,19
166782,2019-10-10 00:00:00+03:00,out,False,893804,True,28,0,423,423
166782,2019-10-10 00:00:00+03:00,in,False,899250,False,3,348,370,22
166782,2019-10-10 00:00:00+03:00,in,False,-1,False,1,89,103,14
166782,2019-10-10 00:00:00+03:00,out,False,899250,False,14,362,582,220
166782,2019-10-10 00:00:00+03:00,in,False,893804,False,31,2267,2409,142
166782,2019-10-10 00:00:00+03:00,in,False,893804,True,1,0,10,10
166782,2019-10-10 00:00:00+03:00,out,False,899250,False,14,362,582,220
166782,2019-10-11 00:00:00+03:00,out,False,900180,True,2,0,68,68
166782,2019-10-11 00:00:00+03:00,out,False,899250,False,14,437,643,206
166782,2019-10-11 00:00:00+03:00,out,False,893804,True,22,0,424,424
166782,2019-10-11 00:00:00+03:00,in,False,-1,True,7,0,166,166
166782,2019-10-11 00:00:00+03:00,out,False,900180,False,4,298,325,27
166782,2019-10-11 00:00:00+03:00,in,False,899250,False,2,109,125,16
166782,2019-10-11 00:00:00+03:00,in,False,893804,False,37,1905,2179,274
166782,2019-10-11 00:00:00+03:00,out,False,899250,True,6,0,60,60
166782,2019-10-11 00:00:00+03:00,out,False,893804,False,35,2477,3177,700
166782,2019-10-12 00:00:00+03:00,in,False,893804,False,20,1715,1819,104
166782,2019-10-12 00:00:00+03:00,in,False,-1,True,2,0,4,4
166782,2019-10-12 00:00:00+03:00,out,False,893804,True,2,0,101,101
166782,2019-10-12 00:00:00+03:00,in,False,-1,False,1,66,114,48
166782,2019-10-12 00:00:00+03:00,out,False,893804,False,5,318,430,112
166782,2019-10-12 00:00:00+03:00,in,False,899250,False,1,56,68,12
166782,2019-10-12 00:00:00+03:00,out,False,899250,False,1,26,49,23
166782,2019-10-13 00:00:00+03:00,in,False,893804,False,14,976,1049,73
166782,2019-10-13 00:00:00+03:00,out,False,893804,False,16,747,955,208
166782,2019-10-13 00:00:00+03:00,in,False,-1,False,1,188,223,35
166782,2019-10-13 00:00:00+03:00,out,False,893804,True,6,0,222,222
166782,2019-10-13 00:00:00+03:00,in,False,-1,True,1,0,0,0
166782,2019-10-13 00:00:00+03:00,in,False,899250,False,4,135,188,53
166782,2019-10-14 00:00:00+03:00,out,False,893804,True,32,0,583,583
166782,2019-10-14 00:00:00+03:00,in,False,-1,True,4,0,10,10
166782,2019-10-14 00:00:00+03:00,out,False,899250,False,9,298,436,138
166782,2019-10-14 00:00:00+03:00,in,False,893804,False,30,1999,2163,164
166782,2019-10-14 00:00:00+03:00,out,False,899250,True,11,0,334,334
166782,2019-10-14 00:00:00+03:00,out,False,893804,False,46,2574,3398,824
166782,2019-10-14 00:00:00+03:00,in,False,893804,True,1,0,3,3
166782,2019-10-14 00:00:00+03:00,in,False,899250,False,6,709,831,122
166782,2019-10-14 00:00:00+03:00,in,False,893804,True,1,0,3,3
166782,2019-10-14 00:00:00+03:00,out,False,899250,False,9,298,436,138
166782,2019-10-15 00:00:00+03:00,in,False,-1,True,7,0,63,63
166782,2019-10-15 00:00:00+03:00,in,False,899250,False,15,1272,1455,183
166782,2019-10-15 00:00:00+03:00,in,False,919994,False,4,317,439,122
166782,2019-10-15 00:00:00+03:00,out,True,900180,True,3,0,0,0
166782,2019-10-15 00:00:00+03:00,out,False,899250,True,1,0,2,2
166782,2019-10-15 00:00:00+03:00,out,True,893804,True,1,0,0,0
166782,2019-10-15 00:00:00+03:00,in,False,893804,False,36,2737,2956,219
166782,2019-10-15 00:00:00+03:00,out,False,900180,False,22,1144,1548,404
166782,2019-10-15 00:00:00+03:00,out,False,893804,True,27,0,519,519
166782,2019-10-15 00:00:00+03:00,out,False,900180,True,12,0,266,266
166782,2019-10-15 00:00:00+03:00,out,False,893804,False,50,2569,3424,855
166782,2019-10-15 00:00:00+03:00,out,False,899250,False,8,335,468,133
166782,2019-10-15 00:00:00+03:00,out,True,893804,True,1,0,0,0
166782,2019-10-15 00:00:00+03:00,out,False,899250,True,1,0,2,2
166782,2019-10-15 00:00:00+03:00,out,False,893804,False,50,2569,3424,855
166782,2019-10-16 00:00:00+03:00,in,False,-1,True,4,0,53,53
166782,2019-10-16 00:00:00+03:00,out,False,893804,True,17,0,444,444
166782,2019-10-16 00:00:00+03:00,in,False,893804,False,31,1953,2094,141
166782,2019-10-16 00:00:00+03:00,out,False,899250,False,14,628,798,170
166782,2019-10-16 00:00:00+03:00,out,False,893804,False,29,1335,1777,442
166782,2019-10-16 00:00:00+03:00,out,False,900180,True,2,0,18,18
166782,2019-10-16 00:00:00+03:00,out,False,900180,False,8,1024,1098,74
166782,2019-10-16 00:00:00+03:00,out,False,899250,True,7,0,285,285
166782,2019-10-16 00:00:00+03:00,in,False,899250,False,1,107,149,42
166782,2019-10-16 00:00:00+03:00,out,False,899250,True,7,0,285,285
166782,2019-10-17 00:00:00+03:00,out,False,899250,False,1,28,37,9
166782,2019-10-17 00:00:00+03:00,out,True,900180,True,3,0,0,0
166782,2019-10-17 00:00:00+03:00,out,False,893804,False,35,1465,2014,549
166782,2019-10-17 00:00:00+03:00,out,True,893804,True,1,0,0,0
166782,2019-10-17 00:00:00+03:00,in,False,893804,False,36,2470,2648,178
166782,2019-10-17 00:00:00+03:00,out,False,900180,False,64,2974,4051,1077
166782,2019-10-17 00:00:00+03:00,in,False,899250,False,4,116,148,32
166782,2019-10-17 00:00:00+03:00,in,False,899250,True,1,0,7,7
166782,2019-10-17 00:00:00+03:00,in,False,-1,True,4,0,26,26
166782,2019-10-17 00:00:00+03:00,out,False,893804,True,16,0,338,338
166782,2019-10-17 00:00:00+03:00,out,False,900180,True,55,0,1224,1224
166782,2019-10-17 00:00:00+03:00,out,False,900180,False,64,2974,4051,1077
166782,2019-10-18 00:00:00+03:00,out,True,900180,True,1,0,0,0
166782,2019-10-18 00:00:00+03:00,in,False,-1,True,8,0,153,153
166782,2019-10-18 00:00:00+03:00,out,False,893804,True,18,0,547,547
166782,2019-10-18 00:00:00+03:00,out,False,893804,False,40,2183,2795,612
166782,2019-10-18 00:00:00+03:00,out,False,900180,True,8,0,169,169
166782,2019-10-18 00:00:00+03:00,out,False,900180,False,11,778,930,152
166782,2019-10-18 00:00:00+03:00,out,True,893804,True,2,0,0,0
166782,2019-10-18 00:00:00+03:00,out,False,899250,False,11,338,554,216
166782,2019-10-18 00:00:00+03:00,in,False,-1,False,1,7,19,12
166782,2019-10-18 00:00:00+03:00,in,False,899250,False,8,762,851,89
166782,2019-10-18 00:00:00+03:00,out,False,899250,True,13,0,341,341
166782,2019-10-18 00:00:00+03:00,in,False,893804,False,31,2204,2376,172
166782,2019-10-18 00:00:00+03:00,in,False,919994,False,1,24,60,36
166782,2019-10-18 00:00:00+03:00,out,False,899250,True,13,0,341,341
166782,2019-10-18 00:00:00+03:00,in,False,893804,False,31,2204,2376,172
166782,2019-10-18 00:00:00+03:00,in,False,-1,True,8,0,153,153
166782,2019-10-19 00:00:00+03:00,out,True,893804,True,1,0,0,0
166782,2019-10-19 00:00:00+03:00,out,False,899250,True,3,0,119,119
166782,2019-10-19 00:00:00+03:00,in,False,-1,True,1,0,8,8
166782,2019-10-19 00:00:00+03:00,in,False,893804,False,13,952,1021,69
166782,2019-10-19 00:00:00+03:00,out,False,899250,False,5,96,211,115
166782,2019-10-19 00:00:00+03:00,out,False,893804,False,27,1610,2098,488
166782,2019-10-19 00:00:00+03:00,out,False,893804,True,22,0,512,512
166782,2019-10-19 00:00:00+03:00,out,False,899250,True,3,0,119,119
166782,2019-10-20 00:00:00+03:00,out,False,899250,False,8,211,364,153
166782,2019-10-20 00:00:00+03:00,in,False,-1,True,2,0,8,8
166782,2019-10-20 00:00:00+03:00,in,False,899250,False,3,85,111,26
166782,2019-10-20 00:00:00+03:00,out,False,899250,True,11,0,309,309
166782,2019-10-20 00:00:00+03:00,out,False,900180,True,12,0,311,311
166782,2019-10-20 00:00:00+03:00,in,False,893804,False,13,804,898,94
166782,2019-10-20 00:00:00+03:00,out,False,893804,True,14,0,256,256
166782,2019-10-20 00:00:00+03:00,out,False,900180,False,20,827,1215,388
166782,2019-10-20 00:00:00+03:00,out,False,893804,False,16,766,1060,294
166782,2019-10-20 00:00:00+03:00,out,False,893804,False,16,766,1060,294
166782,2019-10-20 00:00:00+03:00,out,False,900180,False,20,827,1215,388
166782,2019-10-20 00:00:00+03:00,out,False,899250,True,11,0,309,309
166782,2019-10-21 00:00:00+03:00,out,False,893804,False,33,2118,2632,514
166782,2019-10-21 00:00:00+03:00,in,False,-1,True,4,0,141,141
166782,2019-10-21 00:00:00+03:00,out,False,899250,True,7,0,145,145
166782,2019-10-21 00:00:00+03:00,out,False,893804,True,25,0,417,417
166782,2019-10-21 00:00:00+03:00,out,False,899250,False,9,300,455,155
166782,2019-10-21 00:00:00+03:00,in,False,899250,False,2,74,160,86
166782,2019-10-21 00:00:00+03:00,out,False,900180,True,15,0,258,258
166782,2019-10-21 00:00:00+03:00,out,False,900180,False,32,1350,1865,515
166782,2019-10-21 00:00:00+03:00,in,False,893804,False,37,2651,2905,254
166782,2019-10-21 00:00:00+03:00,out,True,893804,True,1,0,0,0
166782,2019-10-21 00:00:00+03:00,in,False,899250,False,2,74,160,86
166782,2019-10-22 00:00:00+03:00,out,False,899250,False,3,226,293,67
166782,2019-10-22 00:00:00+03:00,out,False,900180,True,18,0,385,385
166782,2019-10-22 00:00:00+03:00,in,False,919994,False,2,207,266,59
166782,2019-10-22 00:00:00+03:00,in,False,899250,False,7,855,930,75
166782,2019-10-22 00:00:00+03:00,out,False,900180,False,28,2093,2600,507
166782,2019-10-22 00:00:00+03:00,in,False,893804,False,38,3055,3269,214
166782,2019-10-22 00:00:00+03:00,out,False,893804,False,43,1885,2536,651
166782,2019-10-22 00:00:00+03:00,out,False,899250,True,1,0,60,60
166782,2019-10-22 00:00:00+03:00,in,False,-1,True,2,0,82,82
166782,2019-10-22 00:00:00+03:00,out,False,893804,True,40,0,867,867
166782,2019-10-22 00:00:00+03:00,out,False,893804,False,43,1885,2536,651
166782,2019-10-23 00:00:00+03:00,out,False,900180,True,4,0,134,134
166782,2019-10-23 00:00:00+03:00,out,True,893804,True,1,0,0,0
166782,2019-10-23 00:00:00+03:00,out,False,900180,False,7,594,668,74
166782,2019-10-23 00:00:00+03:00,in,False,899250,False,6,728,886,158
166782,2019-10-23 00:00:00+03:00,out,False,893804,False,43,1599,2198,599
166782,2019-10-23 00:00:00+03:00,in,False,919994,False,2,411,551,140
166782,2019-10-23 00:00:00+03:00,in,False,893804,False,49,3561,3770,209
166782,2019-10-23 00:00:00+03:00,out,False,899250,False,2,170,196,26
166782,2019-10-23 00:00:00+03:00,out,False,893804,True,21,0,460,460
166782,2019-10-23 00:00:00+03:00,in,False,-1,True,6,0,201,201
166782,2019-10-24 00:00:00+03:00,out,False,893804,False,22,1727,2095,368
166782,2019-10-24 00:00:00+03:00,out,False,900180,True,10,0,251,251
166782,2019-10-24 00:00:00+03:00,out,False,899250,False,6,148,233,85
166782,2019-10-24 00:00:00+03:00,out,False,900180,False,38,3002,3506,504
166782,2019-10-24 00:00:00+03:00,out,True,900180,True,1,0,0,0
166782,2019-10-24 00:00:00+03:00,out,False,899250,True,2,0,104,104
166782,2019-10-24 00:00:00+03:00,in,False,-1,False,1,53,80,27
166782,2019-10-24 00:00:00+03:00,in,False,899250,False,5,821,915,94
166782,2019-10-24 00:00:00+03:00,out,False,893804,True,10,0,162,162
166782,2019-10-24 00:00:00+03:00,in,False,893804,False,37,3223,3378,155
166782,2019-10-24 00:00:00+03:00,in,False,893804,True,2,1,9,8
166782,2019-10-24 00:00:00+03:00,in,False,-1,True,8,0,217,217
166782,2019-10-25 00:00:00+03:00,in,False,899250,False,1,38,46,8
166782,2019-10-25 00:00:00+03:00,out,False,899250,False,9,366,582,216
166782,2019-10-25 00:00:00+03:00,in,False,-1,True,7,0,85,85
166782,2019-10-25 00:00:00+03:00,out,True,893804,True,1,0,0,0
166782,2019-10-25 00:00:00+03:00,out,False,899250,True,6,0,118,118
166782,2019-10-25 00:00:00+03:00,out,False,893804,True,31,0,656,656
166782,2019-10-25 00:00:00+03:00,out,True,900180,True,3,0,0,0
166782,2019-10-25 00:00:00+03:00,out,False,900180,False,54,4041,4744,703
166782,2019-10-25 00:00:00+03:00,in,False,893804,True,1,0,3,3
166782,2019-10-25 00:00:00+03:00,in,False,893804,False,36,1931,2125,194
166782,2019-10-25 00:00:00+03:00,out,False,893804,False,46,2553,3266,713
166782,2019-10-25 00:00:00+03:00,out,False,900180,True,39,0,726,726
166782,2019-10-25 00:00:00+03:00,out,False,-1,True,1,0,0,0
166782,2019-10-25 00:00:00+03:00,in,False,893804,True,1,0,3,3
166782,2019-10-25 00:00:00+03:00,in,False,-1,True,7,0,85,85
166782,2019-10-26 00:00:00+03:00,in,False,893804,False,16,864,931,67
166782,2019-10-26 00:00:00+03:00,out,False,899250,True,5,0,146,146
166782,2019-10-26 00:00:00+03:00,out,False,899250,False,3,61,113,52
166782,2019-10-26 00:00:00+03:00,in,False,-1,True,8,0,20,20
166782,2019-10-26 00:00:00+03:00,out,False,893804,False,25,995,1411,416
166782,2019-10-26 00:00:00+03:00,out,False,893804,True,12,0,333,333
166782,2019-10-27 00:00:00+03:00,out,False,899250,True,3,0,97,97
166782,2019-10-27 00:00:00+03:00,out,False,893804,False,25,1507,1955,448
166782,2019-10-27 00:00:00+03:00,out,False,893804,True,13,0,336,336
166782,2019-10-27 00:00:00+03:00,in,False,899250,False,4,416,541,125
166782,2019-10-27 00:00:00+03:00,in,False,893804,False,13,1177,1219,42
166782,2019-10-27 00:00:00+03:00,out,False,899250,False,8,101,272,171
166782,2019-10-27 00:00:00+03:00,out,False,899250,True,3,0,97,97
166782,2019-10-28 00:00:00+03:00,out,False,893804,True,15,0,371,371
166782,2019-10-28 00:00:00+03:00,in,False,893804,False,31,1858,2015,157
166782,2019-10-28 00:00:00+03:00,out,False,900180,False,6,687,756,69
166782,2019-10-28 00:00:00+03:00,out,False,893804,False,29,1230,1613,383
166782,2019-10-28 00:00:00+03:00,out,False,899250,True,1,0,37,37
166782,2019-10-28 00:00:00+03:00,out,False,899250,False,3,212,283,71
166782,2019-10-28 00:00:00+03:00,in,False,899250,False,4,388,475,87
166782,2019-10-28 00:00:00+03:00,in,False,-1,True,1,0,10,10
166782,2019-10-29 00:00:00+03:00,out,False,893804,False,25,1373,1795,422
166782,2019-10-29 00:00:00+03:00,out,False,899250,True,5,0,152,152
166782,2019-10-29 00:00:00+03:00,in,False,-1,True,1,0,2,2
166782,2019-10-29 00:00:00+03:00,in,False,893804,False,37,2761,2917,156
166782,2019-10-29 00:00:00+03:00,out,False,899250,False,21,474,784,310
166782,2019-10-29 00:00:00+03:00,in,False,899250,False,4,277,334,57
166782,2019-10-29 00:00:00+03:00,out,False,900180,False,2,105,123,18
166782,2019-10-29 00:00:00+03:00,out,False,893804,True,9,0,229,229
166782,2019-10-29 00:00:00+03:00,out,True,893804,True,1,0,0,0
166782,2019-10-30 00:00:00+03:00,out,False,899250,True,7,0,301,301
166782,2019-10-30 00:00:00+03:00,out,False,893804,True,16,0,502,502
166782,2019-10-30 00:00:00+03:00,in,False,899250,False,3,198,225,27
166782,2019-10-30 00:00:00+03:00,out,False,893804,False,23,1158,1512,354
166782,2019-10-30 00:00:00+03:00,in,False,-1,True,7,0,155,155
166782,2019-10-30 00:00:00+03:00,in,False,893804,False,42,4280,4501,221
166782,2019-10-30 00:00:00+03:00,out,False,899250,False,11,282,473,191
166782,2019-10-30 00:00:00+03:00,out,False,900180,False,18,1224,1464,240
166782,2019-10-30 00:00:00+03:00,out,False,900180,True,12,0,234,234
166782,2019-10-31 00:00:00+03:00,out,True,900180,True,1,0,0,0
166782,2019-10-31 00:00:00+03:00,in,False,-1,True,4,0,26,26
166782,2019-10-31 00:00:00+03:00,out,False,900180,False,28,1348,1879,531
166782,2019-10-31 00:00:00+03:00,in,False,919994,False,1,165,224,59
166782,2019-10-31 00:00:00+03:00,in,False,899250,False,3,207,253,46
166782,2019-10-31 00:00:00+03:00,out,False,900180,True,20,0,464,464
166782,2019-10-31 00:00:00+03:00,in,False,893804,False,22,1788,1888,100
166782,2019-10-31 00:00:00+03:00,out,False,899250,True,6,0,193,193
166782,2019-10-31 00:00:00+03:00,out,False,893804,False,48,3009,3799,790
166782,2019-10-31 00:00:00+03:00,out,True,893804,True,1,0,0,0
166782,2019-10-31 00:00:00+03:00,out,False,899250,False,9,304,472,168
166782,2019-10-31 00:00:00+03:00,out,False,893804,True,28,0,640,640
166782,2019-10-31 00:00:00+03:00,in,False,919994,False,1,165,224,59
166782,2019-10-31 00:00:00+03:00,out,False,893804,True,28,0,640,640
166782,2019-11-01 00:00:00+03:00,out,False,900180,False,30,1778,2307,529
166782,2019-11-01 00:00:00+03:00,out,False,893804,False,13,473,675,202
166782,2019-11-01 00:00:00+03:00,out,True,900180,True,1,0,0,0
166782,2019-11-01 00:00:00+03:00,out,False,900180,True,30,0,532,532
166782,2019-11-01 00:00:00+03:00,in,False,893804,False,37,1897,2169,272
166782,2019-11-01 00:00:00+03:00,out,False,899250,False,11,316,536,220
166782,2019-11-01 00:00:00+03:00,in,False,893804,True,1,0,12,12
166782,2019-11-01 00:00:00+03:00,out,False,893804,True,17,0,267,267
166782,2019-11-01 00:00:00+03:00,out,False,899250,True,3,0,85,85
166782,2019-11-01 00:00:00+03:00,out,False,900180,False,30,1778,2307,529
166782,2019-11-02 00:00:00+03:00,out,False,900180,False,52,2230,3326,1096
166782,2019-11-02 00:00:00+03:00,out,False,900180,True,45,0,1272,1272
166782,2019-11-02 00:00:00+03:00,out,False,893804,True,1,0,34,34
166782,2019-11-02 00:00:00+03:00,in,False,-1,True,7,0,86,86
166782,2019-11-02 00:00:00+03:00,out,False,899250,False,1,4,40,36
166782,2019-11-02 00:00:00+03:00,out,False,893804,False,3,119,168,49
166782,2019-11-02 00:00:00+03:00,in,False,893804,False,25,1000,1103,103
166782,2019-11-02 00:00:00+03:00,out,False,893804,True,1,0,34,34
166782,2019-11-03 00:00:00+03:00,out,False,899250,False,1,4,40,36
166782,2019-11-03 00:00:00+03:00,in,False,893804,False,14,1192,1288,96
166782,2019-11-03 00:00:00+03:00,out,False,893804,False,46,1728,2735,1007
166782,2019-11-03 00:00:00+03:00,in,False,-1,True,10,0,158,158
166782,2019-11-03 00:00:00+03:00,in,False,899250,False,5,450,560,110
166782,2019-11-03 00:00:00+03:00,out,False,893804,True,38,0,920,920
166782,2019-11-03 00:00:00+03:00,in,False,893804,False,14,1192,1288,96
166782,2019-11-04 00:00:00+03:00,out,False,899250,False,9,252,415,163
166782,2019-11-04 00:00:00+03:00,in,False,-1,False,1,90,121,31
166782,2019-11-04 00:00:00+03:00,out,True,893804,True,1,0,0,0
166782,2019-11-04 00:00:00+03:00,in,False,893804,False,23,1380,1483,103
166782,2019-11-04 00:00:00+03:00,out,False,893804,True,28,0,607,607
166782,2019-11-04 00:00:00+03:00,in,False,-1,True,2,0,16,16
166782,2019-11-04 00:00:00+03:00,in,False,899250,False,3,725,758,33
166782,2019-11-04 00:00:00+03:00,out,False,893804,False,35,2369,2983,614
166782,2019-11-04 00:00:00+03:00,out,False,899250,True,2,0,68,68
166782,2019-11-04 00:00:00+03:00,out,False,899250,True,2,0,68,68
166782,2019-11-05 00:00:00+03:00,in,False,899250,False,8,1077,1188,111
166782,2019-11-05 00:00:00+03:00,in,False,919994,False,2,115,157,42
166782,2019-11-05 00:00:00+03:00,out,False,893804,False,45,1335,2152,817
166782,2019-11-05 00:00:00+03:00,in,False,-1,True,15,0,85,85
166782,2019-11-05 00:00:00+03:00,out,False,893804,True,23,0,412,412
166782,2019-11-05 00:00:00+03:00,in,False,893804,False,42,2098,2379,281
166782,2019-11-06 00:00:00+03:00,out,False,899250,True,4,0,67,67
166782,2019-11-06 00:00:00+03:00,in,False,893804,False,33,2687,2841,154
166782,2019-11-06 00:00:00+03:00,out,False,893804,False,55,2292,3253,961
166782,2019-11-06 00:00:00+03:00,in,False,899250,False,10,1788,1973,185
166782,2019-11-06 00:00:00+03:00,in,False,919994,False,1,79,110,31
166782,2019-11-06 00:00:00+03:00,out,False,893804,True,33,0,747,747
166782,2019-11-06 00:00:00+03:00,out,False,899250,False,8,1042,1164,122
166782,2019-11-06 00:00:00+03:00,in,False,-1,True,7,0,123,123
166782,2019-11-06 00:00:00+03:00,in,False,893804,False,33,2687,2841,154
166782,2019-11-06 00:00:00+03:00,out,False,893804,False,55,2292,3253,961
166782,2019-11-07 00:00:00+03:00,out,False,900180,True,44,0,1115,1115
166782,2019-11-07 00:00:00+03:00,out,False,899250,True,2,0,36,36
166782,2019-11-07 00:00:00+03:00,in,False,-1,True,6,0,43,43
166782,2019-11-07 00:00:00+03:00,out,False,893804,True,30,0,602,602
166782,2019-11-07 00:00:00+03:00,in,False,893804,False,47,2833,3049,216
166782,2019-11-07 00:00:00+03:00,out,False,893804,False,27,1345,1810,465
166782,2019-11-07 00:00:00+03:00,in,False,899250,False,1,96,107,11
166782,2019-11-07 00:00:00+03:00,in,False,919994,False,2,231,355,124
166782,2019-11-07 00:00:00+03:00,out,False,900180,False,50,2948,3735,787
166782,2019-11-07 00:00:00+03:00,out,False,899250,False,5,121,195,74
166782,2019-11-07 00:00:00+03:00,in,False,-1,True,6,0,43,43
166782,2019-11-07 00:00:00+03:00,out,False,900180,False,50,2948,3735,787
166782,2019-11-08 00:00:00+03:00,out,False,893804,True,39,0,864,864
166782,2019-11-08 00:00:00+03:00,in,False,899250,False,3,91,138,47
166782,2019-11-08 00:00:00+03:00,out,False,900180,True,25,0,593,593
166782,2019-11-08 00:00:00+03:00,in,False,919994,False,1,47,110,63
166782,2019-11-08 00:00:00+03:00,in,False,-1,True,4,0,27,27
166782,2019-11-08 00:00:00+03:00,out,True,893804,True,1,0,0,0
166782,2019-11-08 00:00:00+03:00,out,True,900180,True,2,0,0,0
166782,2019-11-08 00:00:00+03:00,in,False,893804,False,34,1620,1762,142
166782,2019-11-08 00:00:00+03:00,out,False,900180,False,51,2922,3908,986
166782,2019-11-08 00:00:00+03:00,in,False,-1,False,1,145,167,22
166782,2019-11-08 00:00:00+03:00,out,False,893804,False,50,2208,2938,730
166782,2019-11-08 00:00:00+03:00,in,False,893804,False,34,1620,1762,142
166782,2019-11-09 00:00:00+03:00,out,False,899250,True,1,0,60,60
166782,2019-11-09 00:00:00+03:00,out,False,893804,True,1,0,31,31
166782,2019-11-09 00:00:00+03:00,in,False,893804,False,10,976,1026,50
166782,2019-11-09 00:00:00+03:00,in,False,-1,True,2,0,62,62
166782,2019-11-09 00:00:00+03:00,in,False,-1,False,1,32,64,32
166782,2019-11-09 00:00:00+03:00,out,False,893804,False,4,261,304,43
166782,2019-11-09 00:00:00+03:00,in,False,919994,False,2,69,120,51
166782,2019-11-09 00:00:00+03:00,out,False,899250,False,6,206,303,97
166782,2019-11-10 00:00:00+03:00,in,False,-1,True,5,0,202,202
166782,2019-11-10 00:00:00+03:00,out,False,899250,False,19,795,1077,282
166782,2019-11-10 00:00:00+03:00,out,False,899250,True,13,0,448,448
166782,2019-11-10 00:00:00+03:00,in,False,-1,False,1,121,148,27
166782,2019-11-10 00:00:00+03:00,out,False,893804,True,9,0,266,266
166782,2019-11-10 00:00:00+03:00,in,False,899250,False,1,66,93,27
166782,2019-11-10 00:00:00+03:00,in,False,893804,False,22,1875,2030,155
166782,2019-11-10 00:00:00+03:00,out,False,893804,False,5,477,568,91
166782,2019-11-10 00:00:00+03:00,out,False,893804,True,9,0,266,266
166782,2019-11-11 00:00:00+03:00,out,False,899250,False,33,2572,3139,567
166782,2019-11-11 00:00:00+03:00,in,False,899250,False,3,100,116,16
166782,2019-11-11 00:00:00+03:00,in,False,893804,False,39,3268,3400,132
166782,2019-11-11 00:00:00+03:00,in,False,-1,True,2,0,21,21
166782,2019-11-11 00:00:00+03:00,out,False,900180,False,1,130,141,11
166782,2019-11-11 00:00:00+03:00,out,False,893804,False,25,1165,1571,406
166782,2019-11-11 00:00:00+03:00,out,False,899250,True,6,0,163,163
166782,2019-11-11 00:00:00+03:00,out,False,893804,True,5,0,130,130
166782,2019-11-12 00:00:00+03:00,out,False,893804,False,14,667,902,235
166782,2019-11-12 00:00:00+03:00,out,False,893804,True,13,0,219,219
166782,2019-11-12 00:00:00+03:00,out,False,899250,True,13,0,310,310
166782,2019-11-12 00:00:00+03:00,out,True,893804,True,1,0,0,0
166782,2019-11-12 00:00:00+03:00,in,False,893804,False,39,3361,3567,206
166782,2019-11-12 00:00:00+03:00,in,False,-1,True,3,0,42,42
166782,2019-11-12 00:00:00+03:00,in,False,899250,False,2,67,84,17
166782,2019-11-12 00:00:00+03:00,out,False,899250,False,30,986,1455,469
166782,2019-11-13 00:00:00+03:00,out,False,899250,True,22,0,424,424
166782,2019-11-13 00:00:00+03:00,out,True,900180,True,2,0,0,0
166782,2019-11-13 00:00:00+03:00,out,False,900180,False,33,1943,2547,604
166782,2019-11-13 00:00:00+03:00,in,False,893804,False,30,2912,3036,124
166782,2019-11-13 00:00:00+03:00,out,False,893804,True,18,0,347,347
166782,2019-11-13 00:00:00+03:00,out,False,893804,False,27,1401,1787,386
166782,2019-11-13 00:00:00+03:00,out,False,899250,False,20,847,1179,332
166782,2019-11-13 00:00:00+03:00,in,False,899250,False,4,313,421,108
166782,2019-11-13 00:00:00+03:00,in,False,-1,True,7,0,58,58
166782,2019-11-13 00:00:00+03:00,out,False,900180,True,19,0,394,394
166782,2019-11-14 00:00:00+03:00,in,False,893804,False,36,2741,2909,168
166782,2019-11-14 00:00:00+03:00,out,False,899250,True,4,0,108,108
166782,2019-11-14 00:00:00+03:00,out,False,893804,False,37,2255,2781,526
166782,2019-11-14 00:00:00+03:00,out,False,893804,True,28,0,620,620
166782,2019-11-14 00:00:00+03:00,out,False,899250,False,3,663,702,39
166782,2019-11-14 00:00:00+03:00,in,False,-1,True,10,0,351,351
166782,2019-11-14 00:00:00+03:00,in,False,-1,False,1,50,104,54
166782,2019-11-14 00:00:00+03:00,in,False,899250,False,7,828,908,80
166782,2019-11-14 00:00:00+03:00,in,False,-1,False,1,50,104,54
166782,2019-11-15 00:00:00+03:00,out,False,900180,True,4,0,90,90
166782,2019-11-15 00:00:00+03:00,out,False,893804,True,16,0,466,466
166782,2019-11-15 00:00:00+03:00,out,False,893804,False,23,977,1355,378
166782,2019-11-15 00:00:00+03:00,out,False,899250,True,1,0,6,6
166782,2019-11-15 00:00:00+03:00,out,False,900180,False,18,1450,1703,253
166782,2019-11-15 00:00:00+03:00,in,False,-1,True,3,0,67,67
166782,2019-11-15 00:00:00+03:00,out,False,899250,False,2,600,612,12
166782,2019-11-15 00:00:00+03:00,in,False,893804,False,35,3341,3510,169
166782,2019-11-15 00:00:00+03:00,in,False,899250,False,1,13,19,6
166782,2019-11-15 00:00:00+03:00,out,False,899250,False,2,600,612,12
166782,2019-11-16 00:00:00+03:00,in,True,893804,False,1,46,49,3
166782,2019-11-16 00:00:00+03:00,out,False,899250,True,1,0,40,40
166782,2019-11-16 00:00:00+03:00,in,False,899250,False,1,202,209,7
166782,2019-11-16 00:00:00+03:00,out,False,899250,False,1,168,187,19
166782,2019-11-16 00:00:00+03:00,in,False,-1,True,2,0,97,97
166782,2019-11-16 00:00:00+03:00,out,False,893804,True,8,0,218,218
166782,2019-11-16 00:00:00+03:00,in,False,893804,False,19,1425,1518,93
166782,2019-11-16 00:00:00+03:00,out,False,893804,False,11,577,754,177
166782,2019-11-16 00:00:00+03:00,in,False,-1,True,2,0,97,97
166782,2019-11-17 00:00:00+03:00,in,False,-1,True,5,0,74,74
166782,2019-11-17 00:00:00+03:00,in,False,899250,False,1,55,67,12
166782,2019-11-17 00:00:00+03:00,in,False,893804,False,16,1069,1141,72
166782,2019-11-17 00:00:00+03:00,out,False,893804,False,23,457,862,405
166782,2019-11-17 00:00:00+03:00,out,False,893804,True,7,0,219,219
166782,2019-11-18 00:00:00+03:00,out,False,893804,False,17,767,1108,341
166782,2019-11-18 00:00:00+03:00,in,True,893804,False,2,202,208,6
166782,2019-11-18 00:00:00+03:00,out,True,900180,True,1,0,0,0
166782,2019-11-18 00:00:00+03:00,in,False,-1,True,1,0,83,83
166782,2019-11-18 00:00:00+03:00,out,False,900180,False,42,2261,2873,612
166782,2019-11-18 00:00:00+03:00,in,False,899250,False,3,131,281,150
166782,2019-11-18 00:00:00+03:00,in,False,893804,True,1,1,9,8
166782,2019-11-18 00:00:00+03:00,out,False,893804,True,7,0,196,196
166782,2019-11-18 00:00:00+03:00,in,False,893804,False,27,1824,1975,151
166782,2019-11-18 00:00:00+03:00,out,False,899250,False,4,126,171,45
166782,2019-11-18 00:00:00+03:00,in,False,-1,True,4,0,91,91
166782,2019-11-18 00:00:00+03:00,out,True,893804,True,1,0,0,0
166782,2019-11-18 00:00:00+03:00,out,False,900180,True,18,0,319,319
166782,2019-11-18 00:00:00+03:00,out,True,893804,True,1,0,0,0
166782,2019-11-19 00:00:00+03:00,out,False,899250,False,18,330,589,259
166782,2019-11-19 00:00:00+03:00,out,False,893804,False,5,199,256,57
166782,2019-11-19 00:00:00+03:00,out,False,893804,True,3,0,96,96
166782,2019-11-19 00:00:00+03:00,out,False,899250,True,5,0,133,133
166782,2019-11-19 00:00:00+03:00,out,False,900180,True,3,0,129,129
166782,2019-11-19 00:00:00+03:00,out,False,900180,False,9,1077,1207,130
166782,2019-11-19 00:00:00+03:00,in,False,-1,True,3,0,21,21
166782,2019-11-19 00:00:00+03:00,in,False,893804,False,39,2763,2945,182
166782,2019-11-19 00:00:00+03:00,in,False,899250,False,1,31,36,5
166782,2019-11-19 00:00:00+03:00,out,False,893804,True,3,0,96,96
166782,2019-11-20 00:00:00+03:00,out,False,893804,False,13,358,555,197
166782,2019-11-20 00:00:00+03:00,in,False,893804,False,32,2630,2834,204
166782,2019-11-20 00:00:00+03:00,in,False,-1,False,1,8,24,16
166782,2019-11-20 00:00:00+03:00,out,False,893804,True,6,0,170,170
166782,2019-11-20 00:00:00+03:00,out,False,900180,False,22,865,1307,442
166782,2019-11-20 00:00:00+03:00,in,False,899250,False,3,242,335,93
166782,2019-11-20 00:00:00+03:00,out,True,900180,True,2,0,0,0
166782,2019-11-20 00:00:00+03:00,out,False,899250,False,17,996,1281,285
166782,2019-11-20 00:00:00+03:00,out,False,900180,True,12,0,371,371
166782,2019-11-20 00:00:00+03:00,out,False,899250,True,7,0,249,249
166782,2019-11-20 00:00:00+03:00,in,False,-1,True,2,0,107,107
166782,2019-11-20 00:00:00+03:00,in,False,-1,True,2,0,107,107
166782,2019-11-21 00:00:00+03:00,out,False,900180,True,2,0,11,11
166782,2019-11-21 00:00:00+03:00,in,False,-1,True,4,0,60,60
166782,2019-11-21 00:00:00+03:00,out,False,893804,True,3,0,124,124
166782,2019-11-21 00:00:00+03:00,in,False,899250,False,2,210,263,53
166782,2019-11-21 00:00:00+03:00,out,False,900180,False,11,835,904,69
166782,2019-11-21 00:00:00+03:00,out,False,893804,False,21,955,1338,383
166782,2019-11-21 00:00:00+03:00,out,False,899250,False,2,285,310,25
166782,2019-11-21 00:00:00+03:00,out,False,899250,True,1,0,2,2
166782,2019-11-21 00:00:00+03:00,in,False,893804,False,35,2481,2744,263
166782,2019-11-21 00:00:00+03:00,in,True,893804,False,1,224,228,4
166782,2019-11-21 00:00:00+03:00,out,False,893804,False,21,955,1338,383
166782,2019-11-22 00:00:00+03:00,in,False,-1,True,5,0,157,157
166782,2019-11-22 00:00:00+03:00,in,False,893804,False,38,3134,3345,211
166782,2019-11-22 00:00:00+03:00,out,True,900180,True,2,0,0,0
166782,2019-11-22 00:00:00+03:00,out,False,899250,True,3,0,142,142
166782,2019-11-22 00:00:00+03:00,out,False,899250,False,8,412,576,164
166782,2019-11-22 00:00:00+03:00,in,False,899250,False,4,326,363,37
166782,2019-11-22 00:00:00+03:00,out,False,893804,False,23,606,937,331
166782,2019-11-22 00:00:00+03:00,in,True,893804,False,1,25,27,2
166782,2019-11-22 00:00:00+03:00,out,False,893804,True,8,0,165,165
166782,2019-11-22 00:00:00+03:00,out,False,900180,False,4,701,721,20
166782,2019-11-23 00:00:00+03:00,out,False,893804,False,10,272,415,143
166782,2019-11-23 00:00:00+03:00,out,False,899250,True,1,0,27,27
166782,2019-11-23 00:00:00+03:00,in,False,-1,True,4,0,321,321
166782,2019-11-23 00:00:00+03:00,out,False,893804,True,6,0,102,102
166782,2019-11-23 00:00:00+03:00,in,False,893804,False,21,1192,1311,119
166782,2019-11-23 00:00:00+03:00,in,False,899250,False,1,14,41,27
166782,2019-11-23 00:00:00+03:00,in,False,893804,True,1,0,8,8
166782,2019-11-23 00:00:00+03:00,out,False,899250,False,2,80,114,34
166782,2019-11-23 00:00:00+03:00,in,True,893804,False,1,72,88,16
166782,2019-11-23 00:00:00+03:00,out,False,893804,False,10,272,415,143
166782,2019-11-24 00:00:00+03:00,in,False,893804,False,11,596,683,87
166782,2019-11-24 00:00:00+03:00,in,False,-1,True,3,0,126,126
166782,2019-11-24 00:00:00+03:00,out,False,893804,True,10,0,243,243
166782,2019-11-24 00:00:00+03:00,in,False,899250,False,2,216,237,21
166782,2019-11-24 00:00:00+03:00,out,False,899250,True,4,0,117,117
166782,2019-11-24 00:00:00+03:00,out,False,893804,False,31,1397,1952,555
166782,2019-11-24 00:00:00+03:00,out,False,899250,False,3,125,155,30
166782,2019-11-24 00:00:00+03:00,out,False,893804,True,10,0,243,243
166782,2019-11-25 00:00:00+03:00,in,False,899250,False,2,177,197,20
166782,2019-11-25 00:00:00+03:00,out,True,900180,True,1,0,0,0
166782,2019-11-25 00:00:00+03:00,out,False,900180,True,19,0,225,225
166782,2019-11-25 00:00:00+03:00,out,False,900180,False,29,1917,2360,443
166782,2019-11-25 00:00:00+03:00,in,False,-1,True,6,0,37,37
166782,2019-11-25 00:00:00+03:00,in,False,893804,False,48,3428,3641,213
166782,2019-11-25 00:00:00+03:00,out,False,893804,True,6,0,131,131
166782,2019-11-25 00:00:00+03:00,out,False,899250,True,10,0,310,310
166782,2019-11-25 00:00:00+03:00,out,False,893804,False,17,798,1062,264
166782,2019-11-25 00:00:00+03:00,out,False,899250,False,14,441,629,188
166782,2019-11-25 00:00:00+03:00,out,False,900180,True,19,0,225,225
166782,2019-11-26 00:00:00+03:00,out,False,893804,False,29,984,1426,442
166782,2019-11-26 00:00:00+03:00,in,False,899250,False,4,527,559,32
166782,2019-11-26 00:00:00+03:00,in,False,893804,False,38,3430,3644,214
166782,2019-11-26 00:00:00+03:00,out,False,900180,False,19,1143,1454,311
166782,2019-11-26 00:00:00+03:00,out,True,900180,True,3,0,0,0
166782,2019-11-26 00:00:00+03:00,out,False,893804,True,12,0,233,233
166782,2019-11-26 00:00:00+03:00,out,False,899250,False,2,356,376,20
166782,2019-11-26 00:00:00+03:00,out,False,900180,True,15,0,291,291
166782,2019-11-26 00:00:00+03:00,out,True,893804,True,2,0,0,0
166782,2019-11-26 00:00:00+03:00,in,False,919994,False,1,104,123,19
166782,2019-11-26 00:00:00+03:00,out,False,893804,False,29,984,1426,442
166782,2019-11-27 00:00:00+03:00,out,False,900180,False,16,1030,1256,226
166782,2019-11-27 00:00:00+03:00,in,False,899250,False,2,139,156,17
166782,2019-11-27 00:00:00+03:00,in,False,893804,False,25,2044,2195,151
166782,2019-11-27 00:00:00+03:00,out,False,893804,True,14,0,239,239
166782,2019-11-27 00:00:00+03:00,out,False,893804,False,21,1610,1892,282
166782,2019-11-27 00:00:00+03:00,out,True,893804,True,1,0,0,0
166782,2019-11-27 00:00:00+03:00,out,False,900180,True,9,0,112,112
166782,2019-11-27 00:00:00+03:00,out,False,899250,False,1,310,317,7
166782,2019-11-27 00:00:00+03:00,out,False,893804,False,21,1610,1892,282
166782,2019-11-28 00:00:00+03:00,in,False,899250,False,4,393,471,78
166782,2019-11-28 00:00:00+03:00,in,False,-1,True,7,0,280,280
166782,2019-11-28 00:00:00+03:00,in,False,893804,False,44,3876,4047,171
166782,2019-11-28 00:00:00+03:00,out,False,893804,True,24,0,604,604
166782,2019-11-28 00:00:00+03:00,in,False,-1,False,1,135,158,23
166782,2019-11-28 00:00:00+03:00,out,False,893804,False,24,943,1310,367
166800,2019-08-20 00:00:00+03:00,out,False,892530,True,1,0,7,7
166800,2019-08-20 00:00:00+03:00,in,False,-1,True,2,0,64,64
166800,2019-08-21 00:00:00+03:00,in,False,892538,False,2,464,506,42
166800,2019-08-21 00:00:00+03:00,in,False,-1,True,1,0,31,31
166800,2019-08-21 00:00:00+03:00,in,False,892536,False,1,67,109,42
166800,2019-08-21 00:00:00+03:00,out,False,892538,False,3,277,311,34
166800,2019-08-22 00:00:00+03:00,out,True,892530,True,1,0,0,0
166800,2019-08-22 00:00:00+03:00,in,False,892532,False,5,306,392,86
166800,2019-08-22 00:00:00+03:00,in,False,-1,True,22,0,404,404
166800,2019-08-22 00:00:00+03:00,in,False,-1,True,22,0,404,404
166800,2019-08-23 00:00:00+03:00,in,False,-1,True,4,0,130,130
166800,2019-08-23 00:00:00+03:00,out,False,892532,False,1,127,157,30
166800,2019-08-23 00:00:00+03:00,out,False,892534,False,1,46,46,0
166800,2019-08-23 00:00:00+03:00,in,False,892534,False,3,770,876,106
166800,2019-08-24 00:00:00+03:00,in,False,-1,True,3,0,52,52
166800,2019-08-25 00:00:00+03:00,in,False,-1,True,2,0,40,40
166800,2019-08-26 00:00:00+03:00,out,False,892538,True,4,0,241,241
166800,2019-08-26 00:00:00+03:00,in,False,-1,True,1,0,17,17
166800,2019-08-26 00:00:00+03:00,out,False,892538,False,12,1097,1266,169
166800,2019-08-26 00:00:00+03:00,in,False,892538,False,2,893,960,67
166800,2019-08-26 00:00:00+03:00,in,False,892538,False,2,893,960,67
166800,2019-08-27 00:00:00+03:00,in,False,892534,False,6,3750,3932,182
166800,2019-08-27 00:00:00+03:00,in,False,-1,True,6,0,149,149
166800,2019-08-27 00:00:00+03:00,out,False,892538,False,1,87,102,15
166800,2019-08-27 00:00:00+03:00,out,False,892534,False,3,3613,3649,36
166800,2019-08-27 00:00:00+03:00,out,False,892532,True,2,0,43,43
166800,2019-08-27 00:00:00+03:00,in,False,892538,False,1,88,119,31
166800,2019-08-27 00:00:00+03:00,out,False,892538,True,4,0,145,145
166800,2019-08-27 00:00:00+03:00,in,False,892532,False,1,93,121,28
166800,2019-08-27 00:00:00+03:00,out,False,892532,False,1,72,82,10
166800,2019-08-27 00:00:00+03:00,in,False,-1,True,6,0,149,149
166800,2019-08-28 00:00:00+03:00,in,False,892534,False,2,44,123,79
166800,2019-08-28 00:00:00+03:00,in,False,892532,False,1,79,106,27
166800,2019-08-28 00:00:00+03:00,in,False,-1,True,17,0,520,520
166800,2019-08-28 00:00:00+03:00,out,False,892534,False,1,9,18,9
166800,2019-08-28 00:00:00+03:00,out,True,892532,True,1,0,2,2
166800,2019-08-28 00:00:00+03:00,in,False,892532,False,1,79,106,27
166800,2019-08-29 00:00:00+03:00,in,False,892538,False,1,87,118,31
166800,2019-08-29 00:00:00+03:00,in,False,-1,True,2,0,41,41
166800,2019-08-29 00:00:00+03:00,out,False,892538,False,2,115,137,22
166800,2019-08-30 00:00:00+03:00,out,False,892538,True,7,0,117,117
166800,2019-08-30 00:00:00+03:00,in,False,-1,True,1,0,65,65
166800,2019-08-30 00:00:00+03:00,out,False,892538,False,11,520,752,232
166800,2019-08-31 00:00:00+03:00,in,False,-1,True,1,0,20,20
166800,2019-09-01 00:00:00+03:00,in,False,-1,True,1,0,20,20
166800,2019-09-02 00:00:00+03:00,out,False,892538,False,4,288,341,53
166800,2019-09-02 00:00:00+03:00,in,False,-1,True,2,0,39,39
166800,2019-09-02 00:00:00+03:00,in,False,892538,False,3,309,399,90
166800,2019-09-03 00:00:00+03:00,in,False,-1,True,1,0,47,47
166800,2019-09-04 00:00:00+03:00,out,False,892532,False,3,130,157,27
166800,2019-09-04 00:00:00+03:00,in,False,-1,True,7,0,160,160
166800,2019-09-04 00:00:00+03:00,in,False,892536,False,1,14,47,33
166800,2019-09-04 00:00:00+03:00,in,False,892532,False,1,1,16,15
166800,2019-09-04 00:00:00+03:00,in,False,892530,False,1,58,82,24
166800,2019-09-04 00:00:00+03:00,in,False,892534,False,5,304,471,167
166800,2019-09-04 00:00:00+03:00,out,False,892534,True,4,0,30,30
166800,2019-09-05 00:00:00+03:00,out,False,892530,True,1,0,60,60
166800,2019-09-05 00:00:00+03:00,in,False,892534,False,1,133,171,38
166800,2019-09-07 00:00:00+03:00,in,False,-1,True,1,0,41,41
166800,2019-09-09 00:00:00+03:00,out,False,892532,False,2,116,126,10
166800,2019-09-09 00:00:00+03:00,in,False,892534,False,3,368,471,103
166800,2019-09-09 00:00:00+03:00,in,False,892532,False,1,61,91,30
166800,2019-09-10 00:00:00+03:00,in,False,892534,False,7,1150,1374,224
166800,2019-09-10 00:00:00+03:00,in,False,-1,True,3,0,186,186
166800,2019-09-10 00:00:00+03:00,in,False,892534,False,7,1150,1374,224
166800,2019-09-10 00:00:00+03:00,in,False,-1,True,3,0,186,186
166800,2019-09-11 00:00:00+03:00,in,False,892532,False,2,207,272,65
166800,2019-09-11 00:00:00+03:00,in,False,-1,True,1,0,25,25
166800,2019-09-12 00:00:00+03:00,in,False,892534,False,1,27,69,42
166800,2019-09-12 00:00:00+03:00,out,False,892530,True,1,0,60,60
166800,2019-09-13 00:00:00+03:00,in,False,-1,True,3,0,59,59
166800,2019-09-14 00:00:00+03:00,in,False,-1,True,1,0,20,20
166800,2019-09-16 00:00:00+03:00,in,False,892532,False,4,373,488,115
166800,2019-09-16 00:00:00+03:00,in,False,-1,True,3,0,116,116
166800,2019-09-16 00:00:00+03:00,out,False,892536,True,1,0,18,18
166800,2019-09-16 00:00:00+03:00,out,False,892532,False,1,25,44,19
166800,2019-09-16 00:00:00+03:00,out,False,892532,True,1,0,14,14
166800,2019-09-17 00:00:00+03:00,in,False,-1,True,3,0,63,63
166800,2019-09-17 00:00:00+03:00,out,False,892536,True,1,0,3,3
166800,2019-09-17 00:00:00+03:00,in,False,892536,False,2,249,324,75
166800,2019-09-18 00:00:00+03:00,in,False,892532,False,2,202,256,54
166800,2019-09-18 00:00:00+03:00,in,False,892536,False,2,221,302,81
166800,2019-09-18 00:00:00+03:00,out,False,892532,False,4,325,384,59
166800,2019-09-19 00:00:00+03:00,out,False,892532,True,1,0,8,8
166800,2019-09-19 00:00:00+03:00,out,False,892532,False,4,816,873,57
166800,2019-09-19 00:00:00+03:00,in,False,892532,False,2,185,238,53
166800,2019-09-19 00:00:00+03:00,in,False,892536,False,2,204,263,59
166800,2019-09-19 00:00:00+03:00,out,False,892532,False,4,816,873,57
166800,2019-09-21 00:00:00+03:00,in,False,-1,True,3,0,64,64
166800,2019-09-21 00:00:00+03:00,in,False,892536,False,1,19,53,34
166800,2019-09-21 00:00:00+03:00,out,False,892536,True,1,0,2,2
166800,2019-09-21 00:00:00+03:00,out,False,892536,False,1,304,316,12
166800,2019-09-21 00:00:00+03:00,in,False,-1,True,3,0,64,64
166800,2019-09-21 00:00:00+03:00,out,False,892536,True,1,0,2,2
166800,2019-09-22 00:00:00+03:00,in,False,-1,True,2,0,40,40
166800,2019-09-23 00:00:00+03:00,in,False,892536,False,2,231,284,53
166800,2019-09-23 00:00:00+03:00,out,False,892532,False,6,642,686,44
166800,2019-09-23 00:00:00+03:00,out,False,892532,True,1,0,33,33
166800,2019-09-23 00:00:00+03:00,in,False,892532,False,4,537,654,117
166800,2019-09-24 00:00:00+03:00,in,False,892536,False,1,374,409,35
166800,2019-09-24 00:00:00+03:00,in,False,892536,False,1,374,409,35
166800,2019-09-25 00:00:00+03:00,in,False,-1,True,8,0,148,148
166800,2019-09-25 00:00:00+03:00,in,False,892532,False,1,135,194,59
166800,2019-09-25 00:00:00+03:00,in,False,892532,False,1,135,194,59
166800,2019-09-26 00:00:00+03:00,in,False,892532,False,5,657,820,163
166800,2019-09-26 00:00:00+03:00,in,False,-1,True,2,0,40,40
166800,2019-09-27 00:00:00+03:00,in,False,892532,False,3,168,252,84
166800,2019-09-27 00:00:00+03:00,in,False,-1,True,2,0,20,20
166800,2019-09-27 00:00:00+03:00,out,False,892532,False,2,15,55,40
166800,2019-09-27 00:00:00+03:00,out,False,892532,True,1,0,60,60
166800,2019-09-27 00:00:00+03:00,out,False,892532,False,2,15,55,40
166800,2019-09-28 00:00:00+03:00,in,False,-1,True,2,0,40,40
166800,2019-09-29 00:00:00+03:00,in,False,-1,True,2,0,41,41
166800,2019-09-30 00:00:00+03:00,in,False,-1,True,3,0,46,46
166800,2019-09-30 00:00:00+03:00,out,False,892538,True,3,0,123,123
166800,2019-09-30 00:00:00+03:00,out,False,892538,False,8,1244,1373,129
166800,2019-10-01 00:00:00+03:00,out,False,892538,False,4,147,234,87
166800,2019-10-03 00:00:00+03:00,out,False,892538,True,11,0,423,423
166800,2019-10-03 00:00:00+03:00,out,False,892534,True,1,0,39,39
166800,2019-10-03 00:00:00+03:00,in,False,-1,True,7,0,175,175
166800,2019-10-03 00:00:00+03:00,out,False,892534,False,1,23,42,19
166800,2019-10-03 00:00:00+03:00,out,False,892538,False,8,729,853,124
166800,2019-10-04 00:00:00+03:00,in,False,-1,True,1,0,8,8
166800,2019-10-04 00:00:00+03:00,out,False,892538,False,16,1155,1337,182
166800,2019-10-04 00:00:00+03:00,out,False,892538,True,4,0,90,90
166800,2019-10-05 00:00:00+03:00,in,False,-1,True,4,0,62,62
166800,2019-10-06 00:00:00+03:00,in,False,-1,True,2,0,40,40
166800,2019-10-07 00:00:00+03:00,out,False,892538,False,7,705,814,109
166800,2019-10-07 00:00:00+03:00,in,False,-1,True,2,0,41,41
166800,2019-10-07 00:00:00+03:00,out,False,892538,True,2,0,66,66
166800,2019-10-07 00:00:00+03:00,out,False,892538,False,7,705,814,109
166800,2019-10-08 00:00:00+03:00,in,False,-1,True,1,0,18,18
166800,2019-10-09 00:00:00+03:00,in,False,-1,True,3,0,57,57
166800,2019-10-10 00:00:00+03:00,in,False,892538,False,1,175,214,39
166800,2019-10-10 00:00:00+03:00,in,False,-1,True,11,0,218,218
166800,2019-10-10 00:00:00+03:00,out,False,892538,False,5,768,812,44
166800,2019-10-11 00:00:00+03:00,in,False,-1,True,11,0,209,209
166800,2019-10-11 00:00:00+03:00,in,False,-1,True,11,0,209,209
166800,2019-10-12 00:00:00+03:00,in,False,-1,True,5,0,100,100
166800,2019-10-14 00:00:00+03:00,in,False,-1,True,2,0,88,88
166800,2019-10-14 00:00:00+03:00,out,False,892532,False,1,39,77,38
166800,2019-10-14 00:00:00+03:00,out,False,892532,False,1,39,77,38
166800,2019-10-15 00:00:00+03:00,in,False,-1,True,6,0,265,265
166800,2019-10-16 00:00:00+03:00,in,False,-1,True,4,0,80,80
166800,2019-10-17 00:00:00+03:00,in,False,-1,True,2,0,40,40
166800,2019-10-18 00:00:00+03:00,in,False,-1,True,2,0,40,40
166800,2019-10-21 00:00:00+03:00,in,False,-1,True,1,0,32,32
166800,2019-10-21 00:00:00+03:00,in,False,892536,False,2,49,150,101
166800,2019-10-22 00:00:00+03:00,out,False,892532,False,2,165,185,20
166800,2019-10-22 00:00:00+03:00,in,False,892532,False,1,45,81,36
166800,2019-10-23 00:00:00+03:00,out,False,892532,True,4,0,138,138
166800,2019-10-23 00:00:00+03:00,in,False,892532,False,1,30,57,27
166800,2019-10-23 00:00:00+03:00,out,False,892532,False,6,520,592,72
166800,2019-10-23 00:00:00+03:00,in,False,892530,False,1,40,76,36
166800,2019-10-23 00:00:00+03:00,in,False,892536,False,1,25,62,37
166800,2019-10-23 00:00:00+03:00,in,False,-1,True,3,0,49,49
166800,2019-10-24 00:00:00+03:00,in,False,-1,True,2,0,95,95
166800,2019-10-24 00:00:00+03:00,in,False,892536,False,1,314,346,32
166800,2019-10-25 00:00:00+03:00,out,False,892532,False,11,621,790,169
166800,2019-10-25 00:00:00+03:00,out,False,892532,True,3,0,140,140
166800,2019-10-25 00:00:00+03:00,in,False,892530,False,1,13,54,41
166800,2019-10-25 00:00:00+03:00,in,False,892532,False,5,849,1005,156
166800,2019-10-25 00:00:00+03:00,out,False,892536,False,1,55,62,7
166800,2019-10-25 00:00:00+03:00,in,False,-1,True,1,0,65,65
166800,2019-10-25 00:00:00+03:00,in,False,892532,False,5,849,1005,156
166800,2019-10-27 00:00:00+03:00,in,False,-1,True,1,0,1,1
166800,2019-10-28 00:00:00+03:00,in,False,-1,True,1,0,20,20
166800,2019-10-28 00:00:00+03:00,out,False,892532,True,1,0,39,39
166800,2019-10-28 00:00:00+03:00,in,False,892532,False,4,132,235,103
166800,2019-10-28 00:00:00+03:00,out,False,892532,True,1,0,39,39
166800,2019-10-29 00:00:00+03:00,in,False,-1,True,3,0,61,61
166800,2019-10-30 00:00:00+03:00,in,False,892532,False,2,458,520,62
166800,2019-10-30 00:00:00+03:00,in,False,-1,True,3,0,82,82
166800,2019-10-31 00:00:00+03:00,in,False,-1,True,1,0,20,20
166800,2019-11-01 00:00:00+03:00,out,False,892532,True,2,0,12,12
166800,2019-11-01 00:00:00+03:00,in,False,892532,False,4,442,554,112
166800,2019-11-01 00:00:00+03:00,out,False,892532,False,3,426,461,35
166800,2019-11-02 00:00:00+03:00,in,False,-1,True,1,0,18,18
166800,2019-11-04 00:00:00+03:00,in,False,-1,True,2,0,40,40
166800,2019-11-05 00:00:00+03:00,out,False,892532,False,1,99,119,20
166800,2019-11-05 00:00:00+03:00,in,False,-1,True,1,0,9,9
166800,2019-11-05 00:00:00+03:00,out,False,892530,True,1,0,62,62
166800,2019-11-05 00:00:00+03:00,out,False,892532,True,2,0,17,17
166800,2019-11-05 00:00:00+03:00,in,False,892532,False,3,93,181,88
166800,2019-11-05 00:00:00+03:00,out,False,892530,False,1,17,31,14
166800,2019-11-05 00:00:00+03:00,in,False,892530,False,2,230,290,60
166800,2019-11-05 00:00:00+03:00,in,False,892530,False,2,230,290,60
166800,2019-11-05 00:00:00+03:00,out,False,892530,False,1,17,31,14
166800,2019-11-05 00:00:00+03:00,out,False,892532,True,2,0,17,17
166800,2019-11-06 00:00:00+03:00,out,False,892530,True,2,0,36,36
166800,2019-11-06 00:00:00+03:00,in,False,-1,True,8,0,165,165
166800,2019-11-06 00:00:00+03:00,in,False,892530,False,2,125,199,74
166800,2019-11-07 00:00:00+03:00,in,False,892530,False,1,25,59,34
166800,2019-11-07 00:00:00+03:00,in,False,-1,True,2,0,70,70
166800,2019-11-09 00:00:00+03:00,in,False,-1,True,2,0,40,40
166800,2019-11-11 00:00:00+03:00,out,False,892536,False,1,78,91,13
166800,2019-11-11 00:00:00+03:00,in,False,-1,True,1,0,20,20
166800,2019-11-11 00:00:00+03:00,in,False,-1,True,1,0,20,20
166800,2019-11-12 00:00:00+03:00,out,False,892532,True,1,0,9,9
166800,2019-11-12 00:00:00+03:00,out,False,892536,True,1,0,31,31
166800,2019-11-12 00:00:00+03:00,in,False,892532,False,1,23,57,34
166800,2019-11-14 00:00:00+03:00,in,False,-1,True,1,0,21,21
166800,2019-11-15 00:00:00+03:00,out,False,892536,False,1,286,305,19
166800,2019-11-15 00:00:00+03:00,in,False,-1,True,2,0,36,36
166800,2019-11-15 00:00:00+03:00,out,False,892532,True,1,0,6,6
166800,2019-11-18 00:00:00+03:00,out,False,892532,False,1,14,39,25
166800,2019-11-18 00:00:00+03:00,in,False,-1,True,1,0,37,37
166800,2019-11-18 00:00:00+03:00,in,False,892532,False,1,262,292,30
166800,2019-11-18 00:00:00+03:00,out,False,892532,True,2,0,38,38
166800,2019-11-19 00:00:00+03:00,in,False,-1,True,5,0,104,104
166800,2019-11-19 00:00:00+03:00,in,False,892532,False,1,37,68,31
166800,2019-11-19 00:00:00+03:00,in,False,892532,False,1,37,68,31
166800,2019-11-20 00:00:00+03:00,out,False,892530,False,1,121,155,34
166800,2019-11-20 00:00:00+03:00,in,False,892532,False,3,416,502,86
166800,2019-11-20 00:00:00+03:00,out,False,892532,False,1,99,113,14
166800,2019-11-20 00:00:00+03:00,in,False,-1,True,1,0,20,20
166800,2019-11-21 00:00:00+03:00,in,False,892532,False,1,22,61,39
166800,2019-11-21 00:00:00+03:00,in,False,892530,False,1,32,65,33
166800,2019-11-21 00:00:00+03:00,out,False,892532,True,1,0,60,60
166800,2019-11-22 00:00:00+03:00,out,False,892532,False,1,34,36,2
166800,2019-11-22 00:00:00+03:00,in,False,-1,True,1,0,23,23
166800,2019-11-23 00:00:00+03:00,in,False,-1,True,2,0,40,40
166800,2019-11-24 00:00:00+03:00,in,False,-1,True,1,0,20,20
166800,2019-11-25 00:00:00+03:00,out,False,892532,True,2,0,102,102
166800,2019-11-25 00:00:00+03:00,out,False,892532,False,2,241,259,18
166800,2019-11-25 00:00:00+03:00,in,False,-1,True,1,0,50,50
166800,2019-11-25 00:00:00+03:00,in,False,892532,False,1,74,104,30
166800,2019-11-25 00:00:00+03:00,in,False,892532,False,1,74,104,30
166800,2019-11-25 00:00:00+03:00,out,False,892532,True,2,0,102,102
166800,2019-11-26 00:00:00+03:00,in,False,-1,True,1,0,50,50
166800,2019-11-27 00:00:00+03:00,out,False,892532,False,3,362,396,34
166800,2019-11-27 00:00:00+03:00,in,False,-1,True,6,0,95,95
166800,2019-11-27 00:00:00+03:00,in,False,892532,False,1,1,35,34
166800,2019-11-27 00:00:00+03:00,out,False,892532,True,1,0,8,8
166800,2019-11-28 00:00:00+03:00,out,False,892536,True,3,0,14,14
166800,2019-11-28 00:00:00+03:00,out,False,892532,False,2,165,180,15
166800,2019-11-28 00:00:00+03:00,in,False,892532,False,4,330,429,99
166800,2019-11-28 00:00:00+03:00,out,False,892536,False,2,333,349,16
166800,2019-11-28 00:00:00+03:00,out,False,892532,True,5,0,58,58
166800,2019-11-28 00:00:00+03:00,out,False,892536,True,3,0,14,14
166803,2019-08-20 00:00:00+03:00,in,False,891948,False,1,33,36,3
166803,2019-08-20 00:00:00+03:00,in,False,-1,True,13,0,299,299
166803,2019-08-20 00:00:00+03:00,out,True,891946,False,1,71,89,18
166803,2019-08-20 00:00:00+03:00,out,True,891946,False,1,71,89,18
166803,2019-08-21 00:00:00+03:00,in,False,-1,True,4,0,103,103
166803,2019-08-21 00:00:00+03:00,out,True,893172,False,1,36,56,20
166803,2019-08-21 00:00:00+03:00,in,False,891946,False,1,58,67,9
166803,2019-08-21 00:00:00+03:00,in,False,893172,False,2,69,158,89
166803,2019-08-21 00:00:00+03:00,out,True,893172,True,2,0,18,18
166803,2019-08-21 00:00:00+03:00,out,False,891946,False,2,163,169,6
166803,2019-08-21 00:00:00+03:00,out,False,891946,False,2,163,169,6
166803,2019-08-22 00:00:00+03:00,out,False,891946,False,2,87,97,10
166803,2019-08-22 00:00:00+03:00,in,False,891946,False,1,8,17,9
166803,2019-08-22 00:00:00+03:00,out,False,891946,True,2,0,120,120
166803,2019-08-23 00:00:00+03:00,in,False,-1,True,3,0,149,149
166803,2019-08-23 00:00:00+03:00,in,False,893172,False,1,54,80,26
166803,2019-08-23 00:00:00+03:00,out,False,891946,False,1,44,62,18
166803,2019-08-24 00:00:00+03:00,in,False,-1,True,1,0,17,17
166803,2019-08-24 00:00:00+03:00,out,False,891946,False,4,161,223,62
166803,2019-08-24 00:00:00+03:00,out,False,891946,True,11,0,234,234
166803,2019-08-25 00:00:00+03:00,in,False,-1,True,1,0,7,7
166803,2019-08-25 00:00:00+03:00,out,False,891946,True,2,0,29,29
166803,2019-08-25 00:00:00+03:00,out,False,891946,False,1,64,79,15
166803,2019-08-26 00:00:00+03:00,in,False,893172,False,3,349,424,75
166803,2019-08-27 00:00:00+03:00,out,False,891946,False,1,20,29,9
166803,2019-08-27 00:00:00+03:00,in,False,-1,True,1,0,1,1
166803,2019-08-27 00:00:00+03:00,in,False,893172,False,2,98,131,33
166803,2019-08-27 00:00:00+03:00,in,False,893172,False,2,98,131,33
166803,2019-08-28 00:00:00+03:00,in,False,893172,False,1,46,66,20
166803,2019-08-28 00:00:00+03:00,in,False,891946,False,2,199,237,38
166803,2019-08-28 00:00:00+03:00,in,False,-1,True,1,0,22,22
166803,2019-08-29 00:00:00+03:00,out,False,891946,False,1,159,172,13
166803,2019-08-29 00:00:00+03:00,in,False,891946,False,1,36,50,14
166803,2019-09-03 00:00:00+03:00,in,False,893172,False,2,123,171,48
166803,2019-09-03 00:00:00+03:00,in,False,-1,True,1,0,23,23
166803,2019-09-04 00:00:00+03:00,in,False,893172,False,2,481,528,47
166803,2019-09-04 00:00:00+03:00,in,False,-1,True,1,0,1,1
166803,2019-09-05 00:00:00+03:00,in,False,893172,False,3,219,282,63
166803,2019-09-05 00:00:00+03:00,in,False,-1,True,1,0,24,24
166803,2019-09-07 00:00:00+03:00,in,False,-1,True,3,0,53,53
166803,2019-09-07 00:00:00+03:00,in,False,893172,False,2,78,118,40
166803,2019-09-08 00:00:00+03:00,in,False,891946,False,1,81,104,23
166803,2019-09-09 00:00:00+03:00,in,False,-1,True,2,0,33,33
166803,2019-09-10 00:00:00+03:00,in,False,891946,False,2,107,158,51
166803,2019-09-10 00:00:00+03:00,in,False,-1,True,1,0,25,25
166803,2019-09-11 00:00:00+03:00,in,False,-1,True,1,0,1,1
166803,2019-09-12 00:00:00+03:00,in,False,893172,False,1,133,152,19
166803,2019-09-14 00:00:00+03:00,in,False,891946,False,1,19,42,23
166803,2019-09-15 00:00:00+03:00,in,False,893172,False,2,83,125,42
166803,2019-09-16 00:00:00+03:00,in,False,891946,False,1,298,312,14
166803,2019-09-17 00:00:00+03:00,in,False,893172,False,1,68,86,18
166803,2019-09-17 00:00:00+03:00,in,False,893172,False,1,68,86,18
166803,2019-09-18 00:00:00+03:00,in,False,893172,False,3,965,1030,65
166803,2019-09-18 00:00:00+03:00,in,False,-1,True,1,0,24,24
166803,2019-09-19 00:00:00+03:00,in,False,893172,False,2,78,120,42
166803,2019-09-20 00:00:00+03:00,in,False,-1,True,3,0,58,58
166803,2019-09-20 00:00:00+03:00,in,False,893172,False,1,97,118,21
166803,2019-09-26 00:00:00+03:00,in,False,-1,True,1,0,1,1
166803,2019-09-28 00:00:00+03:00,in,False,-1,True,1,0,11,11
166803,2019-09-28 00:00:00+03:00,in,False,891946,False,1,59,82,23
166803,2019-09-28 00:00:00+03:00,in,False,-1,True,1,0,11,11
166803,2019-09-30 00:00:00+03:00,out,False,891946,True,2,0,23,23
166803,2019-10-01 00:00:00+03:00,in,False,893172,False,1,129,151,22
166803,2019-10-04 00:00:00+03:00,in,False,-1,True,1,0,24,24
166803,2019-10-04 00:00:00+03:00,in,False,891946,False,1,37,60,23
166803,2019-10-07 00:00:00+03:00,in,False,-1,True,3,0,72,72
166803,2019-10-11 00:00:00+03:00,in,False,-1,True,2,0,39,39
166803,2019-10-11 00:00:00+03:00,in,False,893172,False,1,60,80,20
166803,2019-10-12 00:00:00+03:00,in,False,-1,True,1,0,24,24
166803,2019-10-13 00:00:00+03:00,in,False,893172,False,1,52,83,31
166803,2019-10-13 00:00:00+03:00,in,False,-1,True,1,0,24,24
166803,2019-10-13 00:00:00+03:00,in,False,893172,False,1,52,83,31
166803,2019-10-14 00:00:00+03:00,in,False,-1,True,1,0,24,24
166803,2019-10-14 00:00:00+03:00,in,False,891946,False,1,78,91,13
166803,2019-10-15 00:00:00+03:00,in,False,-1,True,1,0,24,24
166803,2019-10-16 00:00:00+03:00,in,False,891946,False,2,86,134,48
166803,2019-10-19 00:00:00+03:00,in,False,893172,False,1,44,77,33
166803,2019-10-19 00:00:00+03:00,in,False,-1,True,1,0,1,1
166803,2019-10-22 00:00:00+03:00,in,False,893172,False,1,63,81,18
166803,2019-10-22 00:00:00+03:00,in,False,893172,False,1,63,81,18
166803,2019-10-25 00:00:00+03:00,in,False,-1,True,2,0,48,48
166803,2019-10-27 00:00:00+03:00,in,False,891946,False,1,145,173,28
166803,2019-10-27 00:00:00+03:00,in,False,-1,True,1,0,24,24
166803,2019-10-27 00:00:00+03:00,in,False,891946,False,1,145,173,28
166803,2019-10-28 00:00:00+03:00,in,False,893172,False,2,195,246,51
166803,2019-10-29 00:00:00+03:00,in,False,893172,False,2,143,198,55
166803,2019-10-29 00:00:00+03:00,in,False,-1,True,1,0,19,19
166803,2019-10-30 00:00:00+03:00,in,False,-1,True,1,0,1,1
166803,2019-10-30 00:00:00+03:00,in,False,-1,True,1,0,1,1
166803,2019-10-31 00:00:00+03:00,out,True,891946,True,1,0,27,27
166803,2019-10-31 00:00:00+03:00,in,False,-1,True,1,0,9,9
166803,2019-10-31 00:00:00+03:00,in,False,893172,False,1,38,55,17
166803,2019-11-05 00:00:00+03:00,out,True,891946,True,1,0,0,0
166803,2019-11-06 00:00:00+03:00,in,False,-1,True,1,0,1,1
166803,2019-11-07 00:00:00+03:00,in,False,-1,True,1,0,24,24
166803,2019-11-21 00:00:00+03:00,in,False,-1,True,1,0,25,25
166812,2019-08-21 00:00:00+03:00,in,False,-1,True,3,0,7,7
166812,2019-08-30 00:00:00+03:00,out,False,900594,False,1,46,76,30
166812,2019-09-03 00:00:00+03:00,out,False,900594,False,2,443,447,4
166812,2019-09-03 00:00:00+03:00,out,False,900594,True,4,0,0,0
166812,2019-09-04 00:00:00+03:00,out,False,900594,False,4,363,387,24
166812,2019-09-04 00:00:00+03:00,in,False,900594,False,4,204,256,52
166812,2019-09-05 00:00:00+03:00,out,False,900594,False,3,526,542,16
166812,2019-09-06 00:00:00+03:00,out,False,900594,True,1,0,0,0
166812,2019-09-06 00:00:00+03:00,out,False,900594,False,3,236,263,27
166812,2019-09-09 00:00:00+03:00,out,False,900594,False,1,44,58,14
166812,2019-09-10 00:00:00+03:00,in,False,-1,True,1,0,0,0
166812,2019-09-10 00:00:00+03:00,out,False,900594,True,4,0,66,66
166812,2019-09-10 00:00:00+03:00,out,False,900594,False,8,843,927,84
166812,2019-09-10 00:00:00+03:00,in,False,-1,True,1,0,0,0
166812,2019-09-12 00:00:00+03:00,out,False,900594,False,1,289,292,3
166812,2019-09-13 00:00:00+03:00,out,False,900594,True,1,0,8,8
166812,2019-09-13 00:00:00+03:00,out,False,900594,False,5,1013,1061,48
166812,2019-09-16 00:00:00+03:00,out,False,900594,True,1,0,28,28
166812,2019-09-19 00:00:00+03:00,out,False,900594,False,2,470,493,23
166812,2019-09-20 00:00:00+03:00,out,False,900594,False,5,781,806,25
166812,2019-09-20 00:00:00+03:00,out,False,900594,True,1,0,7,7
166812,2019-09-23 00:00:00+03:00,out,False,900594,False,10,2091,2139,48
166812,2019-09-23 00:00:00+03:00,in,False,900594,False,2,315,338,23
166812,2019-09-24 00:00:00+03:00,out,False,900594,False,2,555,570,15
166812,2019-09-24 00:00:00+03:00,out,False,900594,True,1,0,21,21
166812,2019-09-25 00:00:00+03:00,in,False,900594,False,1,132,145,13
166812,2019-09-30 00:00:00+03:00,out,False,900594,False,1,111,121,10
166812,2019-09-30 00:00:00+03:00,in,False,900594,False,1,328,334,6
166812,2019-10-03 00:00:00+03:00,out,False,900594,False,3,404,419,15
166812,2019-10-03 00:00:00+03:00,in,False,900594,False,1,199,204,5
166812,2019-10-04 00:00:00+03:00,in,False,900594,False,2,99,129,30
166812,2019-10-04 00:00:00+03:00,out,False,900594,True,2,0,4,4
166812,2019-10-04 00:00:00+03:00,out,False,900594,False,7,1367,1460,93
166812,2019-10-07 00:00:00+03:00,out,False,900594,False,2,313,331,18
166812,2019-10-08 00:00:00+03:00,out,False,900594,False,1,194,205,11
166812,2019-10-08 00:00:00+03:00,out,False,900594,False,1,194,205,11
166812,2019-10-10 00:00:00+03:00,out,False,900594,True,2,0,91,91
166812,2019-10-10 00:00:00+03:00,out,False,900594,False,3,569,579,10
166812,2019-10-10 00:00:00+03:00,in,False,900594,False,2,91,119,28
166812,2019-10-16 00:00:00+03:00,out,False,900594,False,2,335,360,25
166812,2019-10-16 00:00:00+03:00,in,False,900594,False,1,274,285,11
166812,2019-10-16 00:00:00+03:00,out,False,900594,False,2,335,360,25
166812,2019-10-17 00:00:00+03:00,out,False,900594,False,1,208,210,2
166812,2019-10-17 00:00:00+03:00,in,False,900594,False,1,35,47,12
166812,2019-10-18 00:00:00+03:00,out,False,900594,False,4,594,641,47
166812,2019-10-22 00:00:00+03:00,in,False,900594,False,1,105,122,17
166812,2019-10-22 00:00:00+03:00,out,False,900594,False,3,415,431,16
166812,2019-10-22 00:00:00+03:00,out,False,900594,False,3,415,431,16
166812,2019-10-23 00:00:00+03:00,out,False,900594,False,1,107,114,7
166812,2019-10-23 00:00:00+03:00,in,False,900594,False,1,45,50,5
166812,2019-10-23 00:00:00+03:00,out,False,900594,True,2,0,15,15
166812,2019-10-23 00:00:00+03:00,out,False,900594,False,1,107,114,7
166812,2019-10-24 00:00:00+03:00,in,False,900594,False,1,24,34,10
166812,2019-10-24 00:00:00+03:00,out,False,900594,False,2,568,573,5
166812,2019-10-24 00:00:00+03:00,in,False,900594,False,1,24,34,10
166812,2019-10-25 00:00:00+03:00,out,False,900594,True,4,0,69,69
166812,2019-10-25 00:00:00+03:00,out,False,900594,False,8,984,1062,78
166812,2019-10-25 00:00:00+03:00,in,False,900594,False,1,89,94,5
166812,2019-10-28 00:00:00+03:00,out,False,900594,False,1,101,111,10
166812,2019-10-29 00:00:00+03:00,in,False,900594,False,2,321,335,14
166812,2019-10-29 00:00:00+03:00,out,False,900594,False,3,829,862,33
166812,2019-10-30 00:00:00+03:00,out,False,900594,False,1,56,64,8
166812,2019-10-31 00:00:00+03:00,in,False,900594,False,4,1126,1176,50
166812,2019-10-31 00:00:00+03:00,out,False,900594,False,2,254,258,4
166812,2019-10-31 00:00:00+03:00,out,False,900594,False,2,254,258,4
166812,2019-11-01 00:00:00+03:00,in,False,900594,False,1,89,99,10
166812,2019-11-01 00:00:00+03:00,out,False,900594,False,3,330,402,72
166812,2019-11-04 00:00:00+03:00,out,False,900594,False,1,7,9,2
166812,2019-11-05 00:00:00+03:00,out,False,900594,False,5,375,412,37
166812,2019-11-05 00:00:00+03:00,out,False,900594,True,5,0,16,16
166812,2019-11-11 00:00:00+03:00,out,False,900594,False,2,229,242,13
166812,2019-11-11 00:00:00+03:00,out,False,900594,True,5,0,22,22
166812,2019-11-12 00:00:00+03:00,out,False,900594,True,1,0,31,31
166812,2019-11-13 00:00:00+03:00,out,False,900594,False,3,284,327,43
166812,2019-11-13 00:00:00+03:00,in,False,900594,False,1,335,345,10
166812,2019-11-14 00:00:00+03:00,out,False,900594,False,1,77,94,17
166812,2019-11-19 00:00:00+03:00,out,False,900594,False,6,1802,1814,12
166812,2019-11-19 00:00:00+03:00,out,False,900594,True,2,0,45,45
166812,2019-11-20 00:00:00+03:00,out,False,900594,False,5,601,625,24
166812,2019-11-20 00:00:00+03:00,out,False,900594,False,5,601,625,24
166812,2019-11-21 00:00:00+03:00,out,False,900594,False,1,108,109,1
166812,2019-11-22 00:00:00+03:00,out,False,900594,True,3,0,28,28
166812,2019-11-22 00:00:00+03:00,out,False,900594,False,4,367,430,63
166812,2019-11-25 00:00:00+03:00,out,False,900594,False,5,849,901,52
166812,2019-11-25 00:00:00+03:00,in,False,900594,False,1,29,46,17
166812,2019-11-26 00:00:00+03:00,out,False,900594,False,9,1292,1390,98
166812,2019-11-26 00:00:00+03:00,in,False,900594,False,1,90,109,19
166812,2019-11-26 00:00:00+03:00,out,False,900594,True,1,0,9,9
166812,2019-11-27 00:00:00+03:00,out,False,900594,False,4,717,737,20
166812,2019-11-27 00:00:00+03:00,out,False,900594,True,1,0,55,55
166812,2019-11-28 00:00:00+03:00,out,False,900594,False,17,3239,3411,172
166812,2019-11-28 00:00:00+03:00,in,False,-1,True,2,0,31,31
166812,2019-11-28 00:00:00+03:00,in,False,900594,False,5,417,445,28
166812,2019-11-28 00:00:00+03:00,out,False,900594,True,2,0,34,34
166813,2019-08-30 00:00:00+03:00,out,False,900614,True,1,0,13,13
166813,2019-09-02 00:00:00+03:00,out,False,900614,False,2,113,131,18
166813,2019-09-02 00:00:00+03:00,out,False,900614,False,2,113,131,18
166813,2019-09-03 00:00:00+03:00,in,False,900614,False,1,31,43,12
166813,2019-09-03 00:00:00+03:00,out,False,900614,True,1,0,7,7
166813,2019-09-03 00:00:00+03:00,in,False,-1,True,2,0,62,62
166813,2019-09-04 00:00:00+03:00,in,False,900614,False,2,44,53,9
166813,2019-09-04 00:00:00+03:00,out,False,900614,False,1,34,44,10
166813,2019-09-04 00:00:00+03:00,out,False,900614,True,1,0,2,2
166813,2019-09-04 00:00:00+03:00,out,False,900614,False,1,34,44,10
166813,2019-09-05 00:00:00+03:00,out,False,900614,False,1,98,107,9
166813,2019-09-06 00:00:00+03:00,out,False,900614,False,1,28,45,17
166813,2019-09-06 00:00:00+03:00,out,False,900614,False,1,28,45,17
166813,2019-09-12 00:00:00+03:00,out,False,900614,True,1,0,30,30
166813,2019-09-19 00:00:00+03:00,in,False,-1,True,2,0,61,61
166813,2019-09-20 00:00:00+03:00,in,False,-1,True,5,0,124,124
166813,2019-09-20 00:00:00+03:00,out,False,900614,False,1,185,187,2
166813,2019-09-23 00:00:00+03:00,out,False,900614,False,1,147,148,1
166813,2019-09-24 00:00:00+03:00,in,False,900614,False,6,488,530,42
166813,2019-09-24 00:00:00+03:00,in,False,-1,True,2,0,37,37
166813,2019-09-24 00:00:00+03:00,out,False,900614,False,1,19,26,7
166813,2019-09-27 00:00:00+03:00,out,False,900614,False,2,189,195,6
166813,2019-09-27 00:00:00+03:00,out,False,900614,False,2,189,195,6
166813,2019-10-01 00:00:00+03:00,in,False,-1,True,3,0,92,92
166813,2019-10-01 00:00:00+03:00,out,False,900614,False,2,44,52,8
166813,2019-10-01 00:00:00+03:00,in,False,900614,False,1,21,38,17
166813,2019-10-02 00:00:00+03:00,in,False,-1,True,1,0,2,2
166813,2019-10-02 00:00:00+03:00,in,False,900614,False,2,87,104,17
166813,2019-10-02 00:00:00+03:00,out,False,900614,False,3,94,120,26
166813,2019-10-04 00:00:00+03:00,out,False,900614,False,3,329,350,21
166813,2019-10-07 00:00:00+03:00,out,False,900614,False,3,97,125,28
166813,2019-10-07 00:00:00+03:00,out,False,900614,True,2,0,8,8
166813,2019-10-08 00:00:00+03:00,out,False,900614,False,1,181,189,8
166813,2019-10-09 00:00:00+03:00,in,False,900614,False,1,42,50,8
166813,2019-10-09 00:00:00+03:00,out,False,900614,False,1,129,145,16
166813,2019-10-09 00:00:00+03:00,in,False,900614,False,1,42,50,8
166813,2019-10-10 00:00:00+03:00,in,False,-1,True,1,0,18,18
166813,2019-10-10 00:00:00+03:00,in,False,900614,False,3,150,195,45
166813,2019-10-10 00:00:00+03:00,in,False,900614,False,3,150,195,45
166813,2019-10-11 00:00:00+03:00,in,False,-1,True,4,0,44,44
166813,2019-10-11 00:00:00+03:00,out,False,900614,False,1,75,78,3
166813,2019-10-11 00:00:00+03:00,in,False,900614,False,1,24,34,10
166813,2019-10-12 00:00:00+03:00,in,False,900614,False,1,173,182,9
166813,2019-10-12 00:00:00+03:00,in,False,-1,True,1,0,26,26
166813,2019-10-14 00:00:00+03:00,in,False,-1,True,4,0,57,57
166813,2019-10-15 00:00:00+03:00,out,False,900614,False,1,345,361,16
166813,2019-10-17 00:00:00+03:00,in,False,-1,True,2,0,53,53
166813,2019-10-18 00:00:00+03:00,out,False,900614,False,1,92,94,2
166813,2019-10-21 00:00:00+03:00,in,False,-1,True,2,0,54,54
166813,2019-10-21 00:00:00+03:00,in,False,900614,False,2,118,155,37
166813,2019-10-22 00:00:00+03:00,in,False,-1,True,3,0,1,1
166813,2019-10-24 00:00:00+03:00,in,False,-1,True,2,0,1,1
166813,2019-10-24 00:00:00+03:00,in,False,-1,True,2,0,1,1
166813,2019-10-29 00:00:00+03:00,in,False,-1,True,6,0,4,4
166813,2019-10-29 00:00:00+03:00,in,False,-1,True,6,0,4,4
166813,2019-10-30 00:00:00+03:00,in,False,-1,True,1,0,0,0
166813,2019-11-01 00:00:00+03:00,in,False,-1,True,1,0,1,1
166813,2019-11-05 00:00:00+03:00,in,False,-1,True,1,0,0,0
166813,2019-11-05 00:00:00+03:00,in,False,954318,False,1,12,16,4
166813,2019-11-05 00:00:00+03:00,in,False,900614,False,1,35,38,3
166813,2019-11-05 00:00:00+03:00,in,False,954616,False,1,92,98,6
166813,2019-11-06 00:00:00+03:00,out,False,955820,True,1,0,5,5
166813,2019-11-06 00:00:00+03:00,out,False,900614,False,2,25,49,24
166813,2019-11-06 00:00:00+03:00,in,False,900614,False,1,12,18,6
166813,2019-11-08 00:00:00+03:00,in,False,954616,False,2,83,98,15
166813,2019-11-08 00:00:00+03:00,in,False,-1,True,2,0,27,27
166813,2019-11-12 00:00:00+03:00,in,False,954616,False,1,34,41,7
166813,2019-11-14 00:00:00+03:00,out,False,955820,True,1,0,16,16
166813,2019-11-14 00:00:00+03:00,in,False,-1,True,3,0,52,52
166813,2019-11-14 00:00:00+03:00,in,False,-1,True,3,0,52,52
166813,2019-11-15 00:00:00+03:00,in,False,954616,False,1,47,51,4
166813,2019-11-18 00:00:00+03:00,in,False,954616,False,1,89,95,6
166813,2019-11-18 00:00:00+03:00,in,False,-1,True,2,0,61,61
166813,2019-11-19 00:00:00+03:00,out,False,955820,False,2,109,130,21
166813,2019-11-19 00:00:00+03:00,in,False,-1,True,1,0,2,2
166813,2019-11-19 00:00:00+03:00,out,False,954318,True,1,0,6,6
166813,2019-11-21 00:00:00+03:00,out,False,955820,False,2,45,80,35
166813,2019-11-21 00:00:00+03:00,out,False,955820,True,2,0,56,56
166813,2019-11-28 00:00:00+03:00,in,False,954616,False,1,59,67,8
166813,2019-11-28 00:00:00+03:00,out,False,955820,True,1,0,11,11
166833,2019-08-26 00:00:00+03:00,in,False,-1,True,1,0,2,2
166833,2019-09-04 00:00:00+03:00,out,False,903254,False,11,787,887,100
166833,2019-09-04 00:00:00+03:00,out,False,903254,True,8,0,180,180
166833,2019-09-04 00:00:00+03:00,in,False,-1,True,2,0,30,30
166833,2019-09-04 00:00:00+03:00,in,False,903254,False,3,55,79,24
166833,2019-09-04 00:00:00+03:00,in,False,-1,True,2,0,30,30
166833,2019-09-05 00:00:00+03:00,out,False,903254,True,1,0,33,33
166833,2019-09-05 00:00:00+03:00,out,False,903254,False,3,1847,1884,37
166833,2019-09-05 00:00:00+03:00,in,False,903254,False,1,236,245,9
166833,2019-09-05 00:00:00+03:00,in,False,-1,True,2,0,36,36
166833,2019-09-06 00:00:00+03:00,in,False,903254,False,1,99,113,14
166833,2019-09-06 00:00:00+03:00,out,False,903254,True,1,0,42,42
166833,2019-09-06 00:00:00+03:00,out,False,903254,True,1,0,42,42
166833,2019-09-06 00:00:00+03:00,in,False,903254,False,1,99,113,14
166833,2019-09-08 00:00:00+03:00,out,False,903254,False,3,209,253,44
166833,2019-09-08 00:00:00+03:00,in,False,903254,False,2,163,194,31
166833,2019-09-08 00:00:00+03:00,out,False,903254,False,3,209,253,44
166833,2019-09-09 00:00:00+03:00,out,False,903254,False,15,656,849,193
166833,2019-09-09 00:00:00+03:00,in,False,903254,False,2,53,87,34
166833,2019-09-09 00:00:00+03:00,out,False,903254,True,4,0,104,104
166833,2019-09-10 00:00:00+03:00,out,False,903254,False,10,508,634,126
166833,2019-09-10 00:00:00+03:00,out,False,903254,True,1,0,27,27
166833,2019-09-10 00:00:00+03:00,in,False,903254,False,2,68,112,44
166833,2019-09-11 00:00:00+03:00,out,False,903254,False,6,390,447,57
166833,2019-09-11 00:00:00+03:00,out,False,903254,False,6,390,447,57
166833,2019-09-13 00:00:00+03:00,out,False,903254,False,3,121,161,40
166833,2019-09-15 00:00:00+03:00,out,False,903254,False,4,173,247,74
166833,2019-09-15 00:00:00+03:00,out,False,903254,True,2,0,64,64
166833,2019-09-15 00:00:00+03:00,in,False,-1,True,1,0,6,6
166833,2019-09-15 00:00:00+03:00,in,False,-1,True,1,0,6,6
166833,2019-09-16 00:00:00+03:00,in,False,-1,True,3,0,26,26
166833,2019-09-16 00:00:00+03:00,out,False,903254,False,20,708,974,266
166833,2019-09-16 00:00:00+03:00,in,False,903254,False,4,809,868,59
166833,2019-09-16 00:00:00+03:00,out,False,903254,True,9,0,262,262
166833,2019-09-17 00:00:00+03:00,out,False,903254,True,6,0,173,173
166833,2019-09-17 00:00:00+03:00,out,False,903254,False,14,1952,2124,172
166833,2019-09-17 00:00:00+03:00,in,False,903254,False,2,80,109,29
166833,2019-09-17 00:00:00+03:00,in,False,-1,True,1,0,26,26
166833,2019-09-18 00:00:00+03:00,in,False,-1,True,1,0,35,35
166833,2019-09-18 00:00:00+03:00,out,False,903254,False,17,2234,2456,222
166833,2019-09-18 00:00:00+03:00,out,False,903254,True,4,0,127,127
166833,2019-09-19 00:00:00+03:00,in,False,903254,False,3,725,782,57
166833,2019-09-19 00:00:00+03:00,out,False,903254,True,6,0,188,188
166833,2019-09-19 00:00:00+03:00,out,False,903254,False,13,765,911,146
166833,2019-09-19 00:00:00+03:00,in,False,-1,True,2,0,38,38
166833,2019-09-20 00:00:00+03:00,out,False,903254,False,11,494,716,222
166833,2019-09-20 00:00:00+03:00,out,False,903254,True,1,0,15,15
166833,2019-09-20 00:00:00+03:00,in,False,903254,False,1,78,90,12
166833,2019-09-21 00:00:00+03:00,out,False,903254,False,5,120,208,88
166833,2019-09-21 00:00:00+03:00,out,False,903254,True,1,0,5,5
166833,2019-09-22 00:00:00+03:00,out,False,903254,False,9,235,344,109
166833,2019-09-22 00:00:00+03:00,in,False,903254,False,2,124,172,48
166833,2019-09-22 00:00:00+03:00,in,False,-1,True,1,0,4,4
166833,2019-09-23 00:00:00+03:00,in,False,-1,True,1,0,4,4
166833,2019-09-23 00:00:00+03:00,out,False,903254,False,16,807,961,154
166833,2019-09-23 00:00:00+03:00,in,False,903254,False,6,618,746,128
166833,2019-09-23 00:00:00+03:00,out,False,903254,True,6,0,162,162
166833,2019-09-24 00:00:00+03:00,out,False,903254,False,15,912,1172,260
166833,2019-09-24 00:00:00+03:00,out,False,903254,True,6,0,200,200
166833,2019-09-24 00:00:00+03:00,in,False,903254,False,4,292,389,97
166833,2019-09-25 00:00:00+03:00,out,False,903254,False,18,2062,2268,206
166833,2019-09-25 00:00:00+03:00,in,False,903254,False,3,159,221,62
166833,2019-09-25 00:00:00+03:00,out,False,903254,True,2,0,37,37
166833,2019-09-25 00:00:00+03:00,out,False,903254,True,2,0,37,37
166833,2019-09-26 00:00:00+03:00,out,False,903254,True,2,0,34,34
166833,2019-09-26 00:00:00+03:00,in,False,903254,False,1,22,50,28
166833,2019-09-26 00:00:00+03:00,out,False,903254,False,3,140,165,25
166833,2019-09-27 00:00:00+03:00,out,False,903254,True,3,0,24,24
166833,2019-09-27 00:00:00+03:00,in,False,903254,False,1,278,294,16
166833,2019-09-27 00:00:00+03:00,out,False,903254,False,5,1743,1794,51
166833,2019-09-28 00:00:00+03:00,in,False,903254,False,2,104,135,31
166833,2019-09-28 00:00:00+03:00,out,False,903254,True,3,0,120,120
166833,2019-09-28 00:00:00+03:00,out,False,903254,False,10,396,545,149
166833,2019-09-28 00:00:00+03:00,out,False,903254,True,3,0,120,120
166833,2019-09-28 00:00:00+03:00,out,False,903254,False,10,396,545,149
166833,2019-09-29 00:00:00+03:00,out,False,903254,False,3,68,120,52
166833,2019-09-29 00:00:00+03:00,out,False,903254,True,4,0,117,117
166833,2019-09-30 00:00:00+03:00,in,False,-1,True,5,0,36,36
166833,2019-09-30 00:00:00+03:00,in,False,903254,False,7,566,667,101
166833,2019-09-30 00:00:00+03:00,out,False,903254,False,44,2281,2968,687
166833,2019-09-30 00:00:00+03:00,out,False,903254,True,6,0,117,117
166833,2019-10-01 00:00:00+03:00,out,False,903254,False,26,1555,1963,408
166833,2019-10-01 00:00:00+03:00,in,False,903254,False,3,143,198,55
166833,2019-10-01 00:00:00+03:00,out,False,903254,True,7,0,196,196
166833,2019-10-01 00:00:00+03:00,in,False,903254,False,3,143,198,55
166833,2019-10-02 00:00:00+03:00,in,False,903254,False,4,1314,1369,55
166833,2019-10-02 00:00:00+03:00,out,False,903254,False,16,526,775,249
166833,2019-10-02 00:00:00+03:00,out,False,903254,True,6,0,194,194
166833,2019-10-02 00:00:00+03:00,in,False,-1,True,1,0,38,38
166833,2019-10-02 00:00:00+03:00,in,False,903254,False,4,1314,1369,55
166833,2019-10-03 00:00:00+03:00,in,False,-1,True,1,0,41,41
166833,2019-10-03 00:00:00+03:00,out,False,903254,True,5,0,161,161
166833,2019-10-03 00:00:00+03:00,in,False,903254,False,3,66,113,47
166833,2019-10-03 00:00:00+03:00,out,False,903254,False,10,2661,2773,112
166833,2019-10-03 00:00:00+03:00,in,False,-1,True,1,0,41,41
166833,2019-10-04 00:00:00+03:00,out,False,903254,True,2,0,18,18
166833,2019-10-04 00:00:00+03:00,out,False,903254,False,2,1963,1989,26
166833,2019-10-04 00:00:00+03:00,in,False,-1,True,1,0,0,0
166833,2019-10-05 00:00:00+03:00,out,False,903254,True,2,0,56,56
166833,2019-10-05 00:00:00+03:00,out,False,903254,False,5,181,263,82
166833,2019-10-06 00:00:00+03:00,out,False,903254,False,11,191,460,269
166833,2019-10-06 00:00:00+03:00,in,False,-1,True,1,0,9,9
166833,2019-10-06 00:00:00+03:00,out,False,903254,True,3,0,117,117
166833,2019-10-07 00:00:00+03:00,out,False,903254,True,9,0,261,261
166833,2019-10-07 00:00:00+03:00,out,False,903254,False,32,2315,2786,471
166833,2019-10-07 00:00:00+03:00,in,False,903254,False,7,724,826,102
166833,2019-10-08 00:00:00+03:00,out,False,903254,False,7,258,338,80
166833,2019-10-08 00:00:00+03:00,out,False,903254,True,1,0,43,43
166833,2019-10-08 00:00:00+03:00,in,False,903254,False,4,233,309,76
166833,2019-10-09 00:00:00+03:00,out,False,903254,True,4,0,68,68
166833,2019-10-09 00:00:00+03:00,out,False,903254,False,7,224,331,107
166833,2019-10-09 00:00:00+03:00,in,False,-1,True,1,0,14,14
166833,2019-10-10 00:00:00+03:00,in,False,903254,False,2,152,180,28
166833,2019-10-10 00:00:00+03:00,out,False,903254,True,1,0,33,33
166833,2019-10-10 00:00:00+03:00,out,False,903254,False,13,583,803,220
166833,2019-10-10 00:00:00+03:00,in,False,-1,True,2,0,17,17
166833,2019-10-10 00:00:00+03:00,out,False,903254,True,1,0,33,33
166833,2019-10-11 00:00:00+03:00,in,False,-1,True,2,0,12,12
166833,2019-10-11 00:00:00+03:00,out,False,903254,True,7,0,257,257
166833,2019-10-11 00:00:00+03:00,in,False,903254,False,8,1073,1178,105
166833,2019-10-11 00:00:00+03:00,out,False,903254,False,21,1161,1482,321
166833,2019-10-11 00:00:00+03:00,out,False,903254,True,7,0,257,257
166833,2019-10-12 00:00:00+03:00,in,False,903254,False,1,12,35,23
166833,2019-10-12 00:00:00+03:00,out,False,903254,False,1,164,187,23
166833,2019-10-13 00:00:00+03:00,out,False,903254,True,3,0,65,65
166833,2019-10-13 00:00:00+03:00,in,False,903254,False,1,21,40,19
166833,2019-10-13 00:00:00+03:00,out,False,903254,False,6,78,197,119
166833,2019-10-14 00:00:00+03:00,in,False,903254,False,3,150,223,73
166833,2019-10-14 00:00:00+03:00,out,False,903254,False,42,2809,3412,603
166833,2019-10-14 00:00:00+03:00,out,False,903254,True,5,0,100,100
166833,2019-10-14 00:00:00+03:00,in,False,-1,True,1,0,37,37
166833,2019-10-14 00:00:00+03:00,out,False,903254,False,42,2809,3412,603
166833,2019-10-15 00:00:00+03:00,out,False,903254,True,7,0,204,204
166833,2019-10-15 00:00:00+03:00,in,False,-1,True,2,0,32,32
166833,2019-10-15 00:00:00+03:00,in,False,903254,False,5,569,631,62
166833,2019-10-15 00:00:00+03:00,out,False,903254,False,27,1436,1790,354
166833,2019-10-16 00:00:00+03:00,in,False,903254,False,2,267,301,34
166833,2019-10-16 00:00:00+03:00,out,False,903254,False,4,251,315,64
166833,2019-10-16 00:00:00+03:00,out,False,903254,True,5,0,129,129
166833,2019-10-17 00:00:00+03:00,in,False,903254,False,4,465,526,61
166833,2019-10-17 00:00:00+03:00,in,False,-1,True,1,0,37,37
166833,2019-10-17 00:00:00+03:00,out,False,903254,True,5,0,150,150
166833,2019-10-17 00:00:00+03:00,out,False,903254,False,5,801,889,88
166833,2019-10-17 00:00:00+03:00,in,False,-1,True,1,0,37,37
166833,2019-10-18 00:00:00+03:00,out,False,903254,True,11,0,366,366
166833,2019-10-18 00:00:00+03:00,in,False,-1,True,2,0,122,122
166833,2019-10-18 00:00:00+03:00,out,False,903254,False,15,1364,1619,255
166833,2019-10-18 00:00:00+03:00,in,False,903254,False,8,1007,1118,111
166833,2019-10-19 00:00:00+03:00,in,False,903254,False,1,32,55,23
166833,2019-10-19 00:00:00+03:00,out,False,903254,False,1,24,36,12
166833,2019-10-20 00:00:00+03:00,in,False,-1,True,1,0,49,49
166833,2019-10-20 00:00:00+03:00,out,False,903254,False,3,35,97,62
166833,2019-10-20 00:00:00+03:00,out,False,903254,True,3,0,77,77
166833,2019-10-20 00:00:00+03:00,in,False,903254,False,2,157,197,40
166833,2019-10-21 00:00:00+03:00,out,False,903254,False,12,1954,2059,105
166833,2019-10-21 00:00:00+03:00,in,False,903254,False,2,97,130,33
166833,2019-10-21 00:00:00+03:00,out,False,903254,True,3,0,55,55
166833,2019-10-22 00:00:00+03:00,in,False,903254,False,6,941,1049,108
166833,2019-10-22 00:00:00+03:00,out,False,903254,False,28,1484,1927,443
166833,2019-10-22 00:00:00+03:00,in,False,-1,True,1,0,6,6
166833,2019-10-22 00:00:00+03:00,out,False,903254,True,8,0,239,239
166833,2019-10-22 00:00:00+03:00,out,False,903254,True,8,0,239,239
166833,2019-10-23 00:00:00+03:00,out,False,903254,False,28,1865,2297,432
166833,2019-10-23 00:00:00+03:00,in,False,-1,True,1,0,17,17
166833,2019-10-23 00:00:00+03:00,out,False,903254,True,11,0,320,320
166833,2019-10-23 00:00:00+03:00,in,False,903254,False,3,261,302,41
166833,2019-10-23 00:00:00+03:00,in,False,903254,False,3,261,302,41
166833,2019-10-24 00:00:00+03:00,out,False,903254,True,5,0,146,146
166833,2019-10-24 00:00:00+03:00,in,False,-1,True,1,0,47,47
166833,2019-10-24 00:00:00+03:00,in,False,903254,False,3,126,189,63
166833,2019-10-24 00:00:00+03:00,out,False,903254,False,20,1711,1908,197
166833,2019-10-25 00:00:00+03:00,in,False,-1,True,2,0,21,21
166833,2019-10-25 00:00:00+03:00,in,False,903254,False,1,81,99,18
166833,2019-10-25 00:00:00+03:00,out,False,903254,False,3,99,132,33
166833,2019-10-26 00:00:00+03:00,out,False,903254,True,8,0,158,158
166833,2019-10-26 00:00:00+03:00,in,False,903254,False,5,263,337,74
166833,2019-10-26 00:00:00+03:00,out,False,903254,False,7,159,301,142
166833,2019-10-27 00:00:00+03:00,out,False,903254,True,4,0,159,159
166833,2019-10-27 00:00:00+03:00,out,False,903254,False,25,1964,2304,340
166833,2019-10-27 00:00:00+03:00,in,False,-1,True,1,0,2,2
166833,2019-10-27 00:00:00+03:00,in,False,903254,False,6,321,432,111
166833,2019-10-27 00:00:00+03:00,out,False,903254,True,4,0,159,159
166833,2019-10-28 00:00:00+03:00,out,False,903254,True,1,0,38,38
166833,2019-10-28 00:00:00+03:00,out,False,903254,False,2,149,180,31
166833,2019-10-28 00:00:00+03:00,in,False,903254,False,1,36,56,20
166833,2019-10-28 00:00:00+03:00,out,False,903254,True,1,0,38,38
166833,2019-10-29 00:00:00+03:00,out,False,903254,False,5,1045,1089,44
166833,2019-10-29 00:00:00+03:00,in,False,903254,False,1,111,131,20
166833,2019-10-30 00:00:00+03:00,out,False,903254,True,5,0,110,110
166833,2019-10-30 00:00:00+03:00,in,False,-1,True,1,0,49,49
166833,2019-10-30 00:00:00+03:00,out,False,903254,False,12,737,913,176
166833,2019-10-30 00:00:00+03:00,out,False,903254,False,12,737,913,176
166833,2019-10-31 00:00:00+03:00,in,False,903254,False,5,260,327,67
166833,2019-10-31 00:00:00+03:00,in,False,-1,True,2,0,4,4
166833,2019-10-31 00:00:00+03:00,out,False,903254,True,6,0,133,133
166833,2019-10-31 00:00:00+03:00,out,False,903254,False,15,1983,2170,187
166833,2019-10-31 00:00:00+03:00,out,False,903254,True,6,0,133,133
166833,2019-11-01 00:00:00+03:00,in,False,903254,False,2,104,148,44
166833,2019-11-01 00:00:00+03:00,in,False,-1,True,1,0,5,5
166833,2019-11-01 00:00:00+03:00,out,False,903254,False,1,16,33,17
166833,2019-11-02 00:00:00+03:00,in,False,903254,False,1,132,151,19
166833,2019-11-02 00:00:00+03:00,out,False,903254,False,2,311,336,25
166833,2019-11-03 00:00:00+03:00,out,False,903254,False,11,301,530,229
166833,2019-11-03 00:00:00+03:00,out,False,903254,True,5,0,198,198
166833,2019-11-03 00:00:00+03:00,in,False,903254,False,4,241,296,55
166833,2019-11-04 00:00:00+03:00,out,False,903254,False,13,428,673,245
166833,2019-11-04 00:00:00+03:00,in,False,903254,False,8,623,730,107
166833,2019-11-04 00:00:00+03:00,out,False,903254,True,3,0,91,91
166833,2019-11-05 00:00:00+03:00,in,False,903254,False,3,220,278,58
166833,2019-11-05 00:00:00+03:00,out,False,903254,False,13,951,1127,176
166833,2019-11-05 00:00:00+03:00,out,False,903254,True,5,0,172,172
166833,2019-11-06 00:00:00+03:00,in,False,903254,False,5,240,323,83
166833,2019-11-06 00:00:00+03:00,out,False,903254,True,2,0,43,43
166833,2019-11-06 00:00:00+03:00,in,False,-1,True,1,0,56,56
166833,2019-11-06 00:00:00+03:00,out,False,903254,False,15,1007,1252,245
166833,2019-11-07 00:00:00+03:00,out,False,903254,True,2,0,33,33
166833,2019-11-07 00:00:00+03:00,in,False,903254,False,4,162,253,91
166833,2019-11-07 00:00:00+03:00,out,False,903254,False,8,594,691,97
166833,2019-11-07 00:00:00+03:00,in,False,-1,True,1,0,3,3
166833,2019-11-07 00:00:00+03:00,out,False,903254,False,8,594,691,97
166833,2019-11-08 00:00:00+03:00,in,False,903254,False,2,39,81,42
166833,2019-11-08 00:00:00+03:00,out,False,903254,False,8,548,705,157
166833,2019-11-08 00:00:00+03:00,out,False,903254,True,1,0,3,3
166833,2019-11-09 00:00:00+03:00,out,False,903254,False,1,55,69,14
166833,2019-11-09 00:00:00+03:00,in,False,903254,False,1,43,67,24
166833,2019-11-11 00:00:00+03:00,in,False,-1,True,1,0,7,7
166833,2019-11-11 00:00:00+03:00,out,False,903254,False,20,1362,1628,266
166833,2019-11-11 00:00:00+03:00,out,False,903254,True,6,0,122,122
166833,2019-11-11 00:00:00+03:00,in,False,903254,False,1,55,69,14
166833,2019-11-12 00:00:00+03:00,out,False,903254,False,38,2858,3276,418
166833,2019-11-12 00:00:00+03:00,out,False,903254,True,14,0,158,158
166833,2019-11-12 00:00:00+03:00,in,False,903254,False,4,432,504,72
166833,2019-11-12 00:00:00+03:00,in,False,-1,True,1,0,4,4
166833,2019-11-12 00:00:00+03:00,in,False,903254,False,4,432,504,72
166833,2019-11-13 00:00:00+03:00,in,False,903254,False,1,165,184,19
166833,2019-11-13 00:00:00+03:00,out,False,903254,False,18,419,722,303
166833,2019-11-13 00:00:00+03:00,out,False,903254,True,4,0,125,125
166833,2019-11-13 00:00:00+03:00,in,False,-1,True,1,0,25,25
166833,2019-11-13 00:00:00+03:00,out,False,903254,True,4,0,125,125
166833,2019-11-14 00:00:00+03:00,out,False,903254,False,10,445,583,138
166833,2019-11-14 00:00:00+03:00,in,False,903254,False,1,124,140,16
166833,2019-11-14 00:00:00+03:00,out,False,903254,True,4,0,113,113
166833,2019-11-15 00:00:00+03:00,in,False,-1,True,4,0,66,66
166833,2019-11-15 00:00:00+03:00,out,False,903254,False,7,316,419,103
166833,2019-11-15 00:00:00+03:00,out,False,903254,True,4,0,132,132
166833,2019-11-16 00:00:00+03:00,out,False,903254,True,1,0,39,39
166833,2019-11-16 00:00:00+03:00,out,False,903254,False,3,182,213,31
166833,2019-11-16 00:00:00+03:00,in,False,903254,False,3,431,472,41
166833,2019-11-17 00:00:00+03:00,in,False,903254,False,1,125,137,12
166833,2019-11-17 00:00:00+03:00,out,False,903254,False,9,386,565,179
166833,2019-11-18 00:00:00+03:00,out,False,903254,True,11,0,329,329
166833,2019-11-18 00:00:00+03:00,in,False,-1,True,1,0,4,4
166833,2019-11-18 00:00:00+03:00,out,False,903254,False,26,1148,1491,343
166833,2019-11-18 00:00:00+03:00,in,False,903254,False,4,286,347,61
166833,2019-11-18 00:00:00+03:00,in,False,903254,False,4,286,347,61
166833,2019-11-19 00:00:00+03:00,out,False,903254,True,1,0,43,43
166833,2019-11-19 00:00:00+03:00,in,False,-1,True,1,0,65,65
166833,2019-11-19 00:00:00+03:00,in,False,903254,False,3,151,216,65
166833,2019-11-19 00:00:00+03:00,out,False,903254,False,16,930,1142,212
166833,2019-11-20 00:00:00+03:00,out,False,903254,True,15,0,215,215
166833,2019-11-20 00:00:00+03:00,out,False,903254,False,32,4603,5022,419
166833,2019-11-20 00:00:00+03:00,in,False,-1,True,4,0,80,80
166833,2019-11-20 00:00:00+03:00,in,False,903254,False,4,212,268,56
166833,2019-11-21 00:00:00+03:00,in,False,-1,True,3,0,61,61
166833,2019-11-21 00:00:00+03:00,out,False,903254,True,6,0,181,181
166833,2019-11-21 00:00:00+03:00,in,False,903254,False,8,1198,1374,176
166833,2019-11-21 00:00:00+03:00,out,False,903254,False,21,1524,1783,259
166833,2019-11-21 00:00:00+03:00,out,True,903254,True,1,0,0,0
166833,2019-11-22 00:00:00+03:00,out,False,903254,True,12,0,343,343
166833,2019-11-22 00:00:00+03:00,out,False,903254,False,26,2659,3025,366
166833,2019-11-22 00:00:00+03:00,in,False,903254,False,11,504,729,225
166833,2019-11-22 00:00:00+03:00,in,False,-1,True,1,0,6,6
166833,2019-11-23 00:00:00+03:00,out,False,903254,True,1,0,29,29
166833,2019-11-23 00:00:00+03:00,out,False,903254,False,5,208,297,89
166833,2019-11-23 00:00:00+03:00,in,False,903254,False,3,192,232,40
166833,2019-11-24 00:00:00+03:00,out,False,903254,True,1,0,0,0
166833,2019-11-24 00:00:00+03:00,out,False,903254,False,7,581,728,147
166833,2019-11-25 00:00:00+03:00,out,False,903254,True,10,0,138,138
166833,2019-11-25 00:00:00+03:00,in,False,903254,False,2,105,143,38
166833,2019-11-25 00:00:00+03:00,in,False,-1,True,2,0,9,9
166833,2019-11-25 00:00:00+03:00,out,False,903254,False,36,1485,2055,570
166833,2019-11-25 00:00:00+03:00,in,False,-1,True,2,0,9,9
166833,2019-11-26 00:00:00+03:00,in,False,-1,True,1,0,90,90
166833,2019-11-26 00:00:00+03:00,in,False,903254,False,7,445,610,165
166833,2019-11-26 00:00:00+03:00,out,False,903254,True,5,0,113,113
166833,2019-11-26 00:00:00+03:00,out,False,903254,False,20,1864,2169,305
166833,2019-11-27 00:00:00+03:00,out,False,903254,False,36,2881,3403,522
166833,2019-11-27 00:00:00+03:00,in,False,903254,False,15,1236,1456,220
166833,2019-11-27 00:00:00+03:00,in,False,-1,True,3,0,71,71
166833,2019-11-27 00:00:00+03:00,out,False,903254,True,8,0,245,245
166833,2019-11-28 00:00:00+03:00,out,False,903254,True,25,0,514,514
166833,2019-11-28 00:00:00+03:00,in,False,903254,False,7,520,618,98
166833,2019-11-28 00:00:00+03:00,out,False,903254,False,34,3157,3691,534
166833,2019-11-28 00:00:00+03:00,in,False,-1,True,2,0,11,11
166836,2019-08-27 00:00:00+03:00,in,False,-1,True,1,0,3,3
166836,2019-09-02 00:00:00+03:00,in,False,-1,True,2,0,34,34
166836,2019-09-04 00:00:00+03:00,in,False,-1,True,4,0,78,78
166836,2019-09-05 00:00:00+03:00,in,False,-1,True,2,0,30,30
166836,2019-09-09 00:00:00+03:00,in,False,-1,True,1,0,47,47
166836,2019-09-10 00:00:00+03:00,in,False,-1,True,1,0,47,47
166836,2019-09-11 00:00:00+03:00,in,False,-1,True,1,0,1,1
166836,2019-09-12 00:00:00+03:00,in,False,-1,True,2,0,55,55
166836,2019-09-13 00:00:00+03:00,in,False,901350,False,1,13,54,41
166836,2019-09-17 00:00:00+03:00,in,False,-1,True,1,0,47,47
166836,2019-09-18 00:00:00+03:00,in,False,-1,True,2,0,48,48
166836,2019-09-18 00:00:00+03:00,in,False,901350,False,1,27,55,28
166836,2019-09-21 00:00:00+03:00,in,False,-1,True,1,0,21,21
166836,2019-09-22 00:00:00+03:00,in,False,-1,True,1,0,8,8
166836,2019-09-23 00:00:00+03:00,in,False,-1,True,3,0,134,134
166836,2019-09-23 00:00:00+03:00,in,False,901350,False,5,256,414,158
166836,2019-09-24 00:00:00+03:00,in,False,901350,False,1,30,58,28
166836,2019-09-24 00:00:00+03:00,in,False,-1,True,1,0,45,45
166836,2019-09-25 00:00:00+03:00,in,False,901350,False,1,13,38,25
166836,2019-09-25 00:00:00+03:00,in,False,-1,True,1,0,29,29
166836,2019-09-28 00:00:00+03:00,in,False,-1,True,1,0,14,14
166836,2019-09-28 00:00:00+03:00,in,False,901350,False,4,363,487,124
166836,2019-09-29 00:00:00+03:00,in,False,-1,True,2,0,22,22
166836,2019-09-30 00:00:00+03:00,in,False,901350,False,5,899,1079,180
166836,2019-09-30 00:00:00+03:00,in,False,-1,True,1,0,7,7
166836,2019-10-01 00:00:00+03:00,in,False,-1,True,4,0,177,177
166836,2019-10-01 00:00:00+03:00,in,False,901350,False,7,185,412,227
166836,2019-10-02 00:00:00+03:00,in,False,-1,True,3,0,105,105
166836,2019-10-02 00:00:00+03:00,in,False,901350,False,2,66,119,53
166836,2019-10-03 00:00:00+03:00,in,False,-1,True,3,0,61,61
166836,2019-10-04 00:00:00+03:00,in,False,-1,True,6,0,161,161
166836,2019-10-07 00:00:00+03:00,in,False,-1,True,3,0,102,102
166836,2019-10-08 00:00:00+03:00,in,False,901350,False,1,22,49,27
166836,2019-10-08 00:00:00+03:00,in,False,-1,True,6,0,198,198
166836,2019-10-09 00:00:00+03:00,in,False,-1,True,3,0,97,97
166836,2019-10-10 00:00:00+03:00,in,False,901350,False,1,34,60,26
166836,2019-10-10 00:00:00+03:00,in,False,-1,True,2,0,91,91
166836,2019-10-11 00:00:00+03:00,in,False,-1,True,10,0,318,318
166836,2019-10-12 00:00:00+03:00,in,False,-1,True,2,0,73,73
166836,2019-10-14 00:00:00+03:00,in,False,-1,True,15,0,534,534
166836,2019-10-15 00:00:00+03:00,in,False,-1,True,5,0,117,117
166836,2019-10-15 00:00:00+03:00,in,False,901350,False,1,24,53,29
166836,2019-10-16 00:00:00+03:00,in,False,-1,True,11,0,340,340
166836,2019-10-17 00:00:00+03:00,in,False,-1,True,8,0,257,257
166836,2019-10-18 00:00:00+03:00,in,False,-1,True,1,0,47,47
166836,2019-10-21 00:00:00+03:00,in,False,-1,True,12,0,310,310
166836,2019-10-22 00:00:00+03:00,in,False,901350,False,1,10,37,27
166836,2019-10-22 00:00:00+03:00,in,False,-1,True,6,0,141,141
166836,2019-10-23 00:00:00+03:00,in,False,-1,True,7,0,230,230
166836,2019-10-24 00:00:00+03:00,in,False,-1,True,8,0,197,197
166836,2019-10-25 00:00:00+03:00,in,False,-1,True,3,0,99,99
166836,2019-10-27 00:00:00+03:00,in,False,-1,True,3,0,65,65
166836,2019-10-28 00:00:00+03:00,in,False,-1,True,5,0,130,130
166836,2019-10-29 00:00:00+03:00,in,False,-1,True,6,0,172,172
166836,2019-10-30 00:00:00+03:00,in,False,-1,True,4,0,140,140
166836,2019-10-31 00:00:00+03:00,in,False,-1,True,6,0,169,169
166836,2019-11-01 00:00:00+03:00,in,False,-1,True,1,0,47,47
166836,2019-11-02 00:00:00+03:00,in,False,-1,True,1,0,27,27
166836,2019-11-05 00:00:00+03:00,in,False,901350,False,1,25,57,32
166836,2019-11-05 00:00:00+03:00,in,False,-1,True,2,0,70,70
166836,2019-11-06 00:00:00+03:00,in,False,901350,False,3,114,190,76
166836,2019-11-06 00:00:00+03:00,in,False,-1,True,2,0,57,57
166836,2019-11-07 00:00:00+03:00,in,False,-1,True,3,0,72,72
166836,2019-11-07 00:00:00+03:00,in,False,901350,False,2,32,75,43
166836,2019-11-08 00:00:00+03:00,in,False,901350,False,6,181,315,134
166836,2019-11-08 00:00:00+03:00,in,False,901350,False,6,181,315,134
166836,2019-11-11 00:00:00+03:00,in,False,901350,False,2,32,74,42
166836,2019-11-11 00:00:00+03:00,in,False,-1,True,2,0,48,48
166836,2019-11-12 00:00:00+03:00,in,False,901350,False,3,48,113,65
166836,2019-11-13 00:00:00+03:00,in,False,901350,False,7,117,283,166
166836,2019-11-13 00:00:00+03:00,in,False,-1,True,2,0,98,98
166836,2019-11-14 00:00:00+03:00,in,False,901350,False,2,40,83,43
166836,2019-11-15 00:00:00+03:00,in,False,901350,False,2,72,116,44
166836,2019-11-17 00:00:00+03:00,in,False,-1,True,2,0,146,146
166836,2019-11-18 00:00:00+03:00,in,False,-1,True,1,0,1,1
166836,2019-11-18 00:00:00+03:00,in,False,901350,False,2,65,111,46
166836,2019-11-19 00:00:00+03:00,in,False,901350,False,3,178,249,71
166836,2019-11-19 00:00:00+03:00,in,False,-1,True,2,0,16,16
166836,2019-11-19 00:00:00+03:00,in,False,901350,False,3,178,249,71
166836,2019-11-20 00:00:00+03:00,in,False,901350,False,5,150,259,109
166836,2019-11-20 00:00:00+03:00,in,False,901350,False,5,150,259,109
166836,2019-11-21 00:00:00+03:00,in,False,901350,False,5,84,189,105
166836,2019-11-21 00:00:00+03:00,in,False,901350,False,5,84,189,105
166836,2019-11-22 00:00:00+03:00,in,False,901350,False,2,32,76,44
166836,2019-11-23 00:00:00+03:00,in,False,901350,False,1,23,45,22
166836,2019-11-25 00:00:00+03:00,in,False,901350,False,2,56,102,46
166836,2019-11-25 00:00:00+03:00,in,False,-1,True,1,0,1,1
166836,2019-11-26 00:00:00+03:00,in,False,-1,True,2,0,146,146
166836,2019-11-26 00:00:00+03:00,in,False,901350,False,4,74,163,89
166836,2019-11-27 00:00:00+03:00,in,False,901350,False,7,141,291,150
166836,2019-11-28 00:00:00+03:00,in,False,901350,False,2,79,122,43
166836,2019-11-28 00:00:00+03:00,in,False,-1,True,2,0,94,94
166837,2019-08-22 00:00:00+03:00,in,False,-1,True,1,0,2,2
166837,2019-08-27 00:00:00+03:00,in,False,-1,True,2,0,4,4
166837,2019-08-28 00:00:00+03:00,in,False,-1,True,2,0,4,4
166837,2019-09-03 00:00:00+03:00,in,False,-1,True,2,0,4,4
166837,2019-09-04 00:00:00+03:00,in,False,-1,True,3,0,6,6
166837,2019-09-07 00:00:00+03:00,in,False,-1,True,1,0,2,2
166837,2019-09-09 00:00:00+03:00,in,False,-1,True,1,0,2,2
166837,2019-09-09 00:00:00+03:00,in,False,-1,True,1,0,2,2
166837,2019-09-11 00:00:00+03:00,in,False,-1,True,3,0,7,7
166837,2019-09-12 00:00:00+03:00,in,False,910226,True,1,20,34,14
166837,2019-09-12 00:00:00+03:00,in,False,-1,True,4,0,4,4
166837,2019-09-12 00:00:00+03:00,in,False,910044,False,2,69,92,23
166837,2019-09-12 00:00:00+03:00,in,False,-1,True,4,0,4,4
166837,2019-09-13 00:00:00+03:00,in,False,-1,True,1,0,2,2
166837,2019-09-16 00:00:00+03:00,in,False,-1,True,2,0,4,4
166837,2019-09-17 00:00:00+03:00,in,False,-1,True,2,0,40,40
166837,2019-09-18 00:00:00+03:00,in,False,910044,False,3,486,542,56
166837,2019-09-18 00:00:00+03:00,in,False,-1,True,9,0,62,62
166837,2019-09-18 00:00:00+03:00,in,False,910226,False,1,9,29,20
166837,2019-09-18 00:00:00+03:00,in,False,913886,True,1,24,35,11
166837,2019-09-19 00:00:00+03:00,in,False,-1,True,3,0,23,23
166837,2019-09-20 00:00:00+03:00,in,False,910044,False,2,268,298,30
166837,2019-09-20 00:00:00+03:00,in,False,-1,True,2,0,5,5
166837,2019-09-20 00:00:00+03:00,in,False,-1,True,2,0,5,5
166837,2019-09-22 00:00:00+03:00,in,False,-1,True,2,0,2,2
166837,2019-09-23 00:00:00+03:00,in,False,913886,False,1,14,30,16
166837,2019-09-23 00:00:00+03:00,in,False,-1,True,3,0,15,15
166837,2019-09-24 00:00:00+03:00,in,False,910044,False,3,487,531,44
166837,2019-09-24 00:00:00+03:00,in,False,910226,False,1,34,53,19
166837,2019-09-24 00:00:00+03:00,in,False,-1,True,3,0,28,28
166837,2019-09-26 00:00:00+03:00,in,False,910226,False,1,213,228,15
166837,2019-09-26 00:00:00+03:00,in,False,-1,True,5,0,37,37
166837,2019-09-26 00:00:00+03:00,in,False,-1,True,5,0,37,37
166837,2019-09-28 00:00:00+03:00,in,False,-1,True,1,0,52,52
166837,2019-09-29 00:00:00+03:00,in,False,-1,True,1,0,2,2
166837,2019-09-30 00:00:00+03:00,in,False,910038,False,1,12,29,17
166837,2019-09-30 00:00:00+03:00,in,False,-1,True,5,0,50,50
166837,2019-10-01 00:00:00+03:00,in,False,-1,True,4,0,14,14
166837,2019-10-02 00:00:00+03:00,in,False,910226,False,1,16,33,17
166837,2019-10-02 00:00:00+03:00,in,False,919896,True,1,21,37,16
166837,2019-10-02 00:00:00+03:00,in,False,919896,False,1,120,130,10
166837,2019-10-02 00:00:00+03:00,in,False,919896,False,1,120,130,10
166837,2019-10-02 00:00:00+03:00,in,False,919896,True,1,21,37,16
166837,2019-10-03 00:00:00+03:00,in,False,-1,True,1,0,11,11
166837,2019-10-03 00:00:00+03:00,in,False,910226,False,1,25,40,15
166837,2019-10-04 00:00:00+03:00,in,False,-1,True,1,0,7,7
166837,2019-10-07 00:00:00+03:00,in,False,-1,True,1,0,7,7
166837,2019-10-08 00:00:00+03:00,in,False,-1,True,2,0,13,13
166837,2019-10-09 00:00:00+03:00,in,False,910226,True,1,24,36,12
166837,2019-10-09 00:00:00+03:00,in,False,-1,True,6,0,108,108
166837,2019-10-09 00:00:00+03:00,in,False,910044,False,1,87,102,15
166837,2019-10-10 00:00:00+03:00,in,False,910038,False,1,192,205,13
166837,2019-10-10 00:00:00+03:00,in,False,910226,False,1,6,26,20
166837,2019-10-11 00:00:00+03:00,in,False,-1,True,30,0,343,343
166837,2019-10-11 00:00:00+03:00,in,False,924662,False,1,28,48,20
166837,2019-10-11 00:00:00+03:00,in,False,910044,False,2,484,526,42
166837,2019-10-14 00:00:00+03:00,in,False,-1,True,2,0,30,30
166837,2019-10-15 00:00:00+03:00,in,False,-1,True,5,0,46,46
166837,2019-10-15 00:00:00+03:00,in,False,-1,True,5,0,46,46
166837,2019-10-16 00:00:00+03:00,in,False,-1,True,5,0,65,65
166837,2019-10-17 00:00:00+03:00,in,False,-1,True,5,0,50,50
166837,2019-10-18 00:00:00+03:00,in,False,-1,True,7,0,41,41
166837,2019-10-21 00:00:00+03:00,in,False,-1,True,3,0,28,28
166837,2019-10-22 00:00:00+03:00,in,False,919896,False,2,227,258,31
166837,2019-10-22 00:00:00+03:00,in,False,910044,False,2,212,239,27
166837,2019-10-22 00:00:00+03:00,in,False,-1,True,8,0,70,70
166837,2019-10-23 00:00:00+03:00,in,False,-1,True,7,0,22,22
166837,2019-10-23 00:00:00+03:00,in,False,910044,False,2,241,262,21
166837,2019-10-23 00:00:00+03:00,in,False,930242,True,1,0,24,24
166837,2019-10-24 00:00:00+03:00,in,False,-1,True,4,0,25,25
166837,2019-10-24 00:00:00+03:00,in,False,910044,False,1,28,37,9
166837,2019-10-24 00:00:00+03:00,in,False,945710,False,1,50,67,17
166837,2019-10-25 00:00:00+03:00,in,False,-1,True,4,0,39,39
166837,2019-10-28 00:00:00+03:00,in,False,-1,True,4,0,53,53
166837,2019-10-29 00:00:00+03:00,in,False,930242,False,1,35,50,15
166837,2019-10-29 00:00:00+03:00,in,False,-1,True,9,0,78,78
166837,2019-10-30 00:00:00+03:00,in,False,-1,True,6,0,52,52
166837,2019-10-31 00:00:00+03:00,in,False,930242,False,1,121,136,15
166837,2019-10-31 00:00:00+03:00,in,False,-1,True,10,0,59,59
166837,2019-10-31 00:00:00+03:00,in,False,919896,False,1,115,128,13
166837,2019-10-31 00:00:00+03:00,in,False,919896,False,1,115,128,13
166837,2019-11-01 00:00:00+03:00,in,False,-1,True,3,0,40,40
166837,2019-11-01 00:00:00+03:00,in,False,930242,False,1,141,156,15
166837,2019-11-02 00:00:00+03:00,in,False,-1,True,1,0,12,12
166837,2019-11-02 00:00:00+03:00,in,False,-1,True,1,0,12,12
166837,2019-11-05 00:00:00+03:00,in,False,-1,True,1,0,2,2
166837,2019-11-05 00:00:00+03:00,in,False,910044,False,1,145,160,15
166837,2019-11-06 00:00:00+03:00,in,False,-1,True,1,0,2,2
166837,2019-11-07 00:00:00+03:00,in,False,-1,True,26,0,323,323
166837,2019-11-08 00:00:00+03:00,in,False,-1,True,27,0,334,334
166837,2019-11-09 00:00:00+03:00,in,False,-1,True,26,0,326,326
166837,2019-11-10 00:00:00+03:00,in,False,-1,True,13,0,27,27
166837,2019-11-11 00:00:00+03:00,in,False,-1,True,21,0,44,44
166837,2019-11-12 00:00:00+03:00,in,False,-1,True,21,0,44,44
166837,2019-11-13 00:00:00+03:00,in,False,-1,True,32,0,71,71
166837,2019-11-14 00:00:00+03:00,in,False,-1,True,33,0,69,69
166837,2019-11-15 00:00:00+03:00,in,False,-1,True,26,0,55,55
166837,2019-11-16 00:00:00+03:00,in,False,-1,True,28,0,56,56
166837,2019-11-17 00:00:00+03:00,in,False,-1,True,16,0,33,33
166837,2019-11-18 00:00:00+03:00,in,False,-1,True,30,0,62,62
166837,2019-11-19 00:00:00+03:00,in,False,-1,True,29,0,63,63
166837,2019-11-20 00:00:00+03:00,in,False,-1,True,51,0,103,103
166837,2019-11-21 00:00:00+03:00,in,False,-1,True,41,0,85,85
166837,2019-11-22 00:00:00+03:00,in,False,-1,True,46,0,95,95
166837,2019-11-23 00:00:00+03:00,in,False,-1,True,41,0,84,84
166837,2019-11-24 00:00:00+03:00,in,False,-1,True,44,0,89,89
166837,2019-11-25 00:00:00+03:00,in,False,-1,True,47,0,102,102
166837,2019-11-26 00:00:00+03:00,in,False,-1,True,47,0,100,100
166837,2019-11-27 00:00:00+03:00,in,False,-1,True,45,0,96,96
166837,2019-11-28 00:00:00+03:00,in,False,-1,True,46,0,96,96
166839,2019-08-23 00:00:00+03:00,in,False,894614,False,2,91,118,27
166839,2019-08-27 00:00:00+03:00,in,False,894614,False,2,55,68,13
166839,2019-09-01 00:00:00+03:00,in,False,-1,True,1,0,70,70
166839,2019-09-03 00:00:00+03:00,in,False,894614,False,1,73,92,19
166839,2019-09-03 00:00:00+03:00,in,False,894614,True,1,0,30,30
166839,2019-09-04 00:00:00+03:00,in,False,894614,False,1,108,116,8
166839,2019-09-07 00:00:00+03:00,in,False,894614,False,1,1140,1158,18
166839,2019-09-09 00:00:00+03:00,in,False,902720,False,4,167,229,62
166839,2019-09-09 00:00:00+03:00,in,False,-1,True,46,0,27,27
166839,2019-09-09 00:00:00+03:00,out,False,902720,False,5,1811,1868,57
166839,2019-09-09 00:00:00+03:00,out,False,902720,True,1,0,33,33
166839,2019-09-10 00:00:00+03:00,out,False,902720,True,17,0,475,475
166839,2019-09-10 00:00:00+03:00,out,False,902720,False,27,4207,4664,457
166839,2019-09-10 00:00:00+03:00,out,True,902720,True,5,0,0,0
166839,2019-09-10 00:00:00+03:00,in,False,902720,False,3,388,413,25
166839,2019-09-11 00:00:00+03:00,out,False,902720,True,19,0,445,445
166839,2019-09-11 00:00:00+03:00,out,False,902720,False,24,3061,3475,414
166839,2019-09-11 00:00:00+03:00,in,False,902720,False,2,45,67,22
166839,2019-09-12 00:00:00+03:00,in,False,902720,False,2,511,603,92
166839,2019-09-12 00:00:00+03:00,out,False,902720,False,5,523,591,68
166839,2019-09-12 00:00:00+03:00,out,False,902720,True,5,0,121,121
166839,2019-09-12 00:00:00+03:00,out,False,902720,False,5,523,591,68
166839,2019-09-13 00:00:00+03:00,in,False,902720,False,2,260,285,25
166839,2019-09-13 00:00:00+03:00,out,False,902720,True,2,0,52,52
166839,2019-09-13 00:00:00+03:00,out,False,902720,False,11,2125,2303,178
166839,2019-09-16 00:00:00+03:00,out,True,902720,True,4,0,10,10
166839,2019-09-16 00:00:00+03:00,in,True,902720,False,1,8,14,6
166839,2019-09-16 00:00:00+03:00,out,False,902720,False,38,2870,3463,593
166839,2019-09-16 00:00:00+03:00,in,False,902720,False,6,757,863,106
166839,2019-09-16 00:00:00+03:00,out,False,902720,True,41,0,934,934
166839,2019-09-16 00:00:00+03:00,in,False,-1,True,1,0,3,3
166839,2019-09-16 00:00:00+03:00,in,False,-1,True,8,0,201,201
166839,2019-09-17 00:00:00+03:00,in,False,-1,True,4,0,77,77
166839,2019-09-17 00:00:00+03:00,in,False,902720,False,8,2075,2188,113
166839,2019-09-17 00:00:00+03:00,out,False,902720,True,25,0,501,501
166839,2019-09-17 00:00:00+03:00,out,False,902720,False,19,1860,2103,243
166839,2019-09-18 00:00:00+03:00,out,False,902720,False,25,3653,4047,394
166839,2019-09-18 00:00:00+03:00,in,False,902720,False,3,342,398,56
166839,2019-09-18 00:00:00+03:00,out,False,902720,True,30,0,641,641
166839,2019-09-18 00:00:00+03:00,in,False,-1,True,2,0,77,77
166839,2019-09-19 00:00:00+03:00,out,False,902720,True,20,0,337,337
166839,2019-09-19 00:00:00+03:00,in,False,902720,False,5,645,767,122
166839,2019-09-19 00:00:00+03:00,in,False,-1,True,2,0,88,88
166839,2019-09-19 00:00:00+03:00,out,False,902720,False,11,1311,1471,160
166839,2019-09-20 00:00:00+03:00,out,False,902720,True,31,0,726,726
166839,2019-09-20 00:00:00+03:00,out,False,902720,False,22,1986,2354,368
166839,2019-09-20 00:00:00+03:00,in,False,902720,False,3,318,377,59
166839,2019-09-22 00:00:00+03:00,in,False,902720,False,1,14,29,15
166839,2019-09-23 00:00:00+03:00,out,False,902720,True,58,0,1305,1305
166839,2019-09-23 00:00:00+03:00,out,True,902720,True,1,0,0,0
166839,2019-09-23 00:00:00+03:00,out,False,902720,False,36,3245,3891,646
166839,2019-09-23 00:00:00+03:00,in,False,-1,True,4,0,76,76
166839,2019-09-24 00:00:00+03:00,out,False,902720,True,41,0,937,937
166839,2019-09-24 00:00:00+03:00,out,False,902720,False,13,732,934,202
166839,2019-09-24 00:00:00+03:00,in,False,902720,False,2,93,120,27
166839,2019-09-25 00:00:00+03:00,out,False,902720,True,57,0,1317,1317
166839,2019-09-25 00:00:00+03:00,out,False,902720,False,32,1920,2525,605
166839,2019-09-25 00:00:00+03:00,in,False,-1,True,3,0,140,140
166839,2019-09-25 00:00:00+03:00,in,False,902720,False,2,480,499,19
166839,2019-09-26 00:00:00+03:00,in,False,-1,True,3,0,168,168
166839,2019-09-26 00:00:00+03:00,out,False,902720,False,31,1688,2280,592
166839,2019-09-26 00:00:00+03:00,in,False,902720,False,1,21,60,39
166839,2019-09-26 00:00:00+03:00,out,True,902720,True,1,0,0,0
166839,2019-09-26 00:00:00+03:00,out,False,902720,True,70,0,1415,1415
166839,2019-09-26 00:00:00+03:00,in,False,902720,False,1,21,60,39
166839,2019-09-27 00:00:00+03:00,out,False,902720,True,78,0,1578,1578
166839,2019-09-27 00:00:00+03:00,out,False,902720,False,33,1345,1888,543
166839,2019-09-27 00:00:00+03:00,in,False,-1,True,1,0,61,61
166839,2019-09-27 00:00:00+03:00,out,True,902720,True,1,0,0,0
166839,2019-09-27 00:00:00+03:00,in,False,902720,False,3,109,198,89
166839,2019-09-27 00:00:00+03:00,out,False,902720,True,78,0,1578,1578
166839,2019-09-28 00:00:00+03:00,in,False,-1,True,3,0,92,92
166839,2019-09-30 00:00:00+03:00,in,False,902720,False,8,1214,1280,66
166839,2019-09-30 00:00:00+03:00,out,False,902720,True,28,0,601,601
166839,2019-09-30 00:00:00+03:00,out,False,902720,False,45,5703,6444,741
166839,2019-09-30 00:00:00+03:00,in,False,-1,True,6,0,195,195
166839,2019-10-01 00:00:00+03:00,out,False,902720,False,37,4051,4718,667
166839,2019-10-01 00:00:00+03:00,out,False,902720,True,57,0,1229,1229
166839,2019-10-01 00:00:00+03:00,in,False,902720,False,8,836,977,141
166839,2019-10-01 00:00:00+03:00,out,False,902720,False,37,4051,4718,667
166839,2019-10-02 00:00:00+03:00,out,False,902720,False,27,1554,2097,543
166839,2019-10-02 00:00:00+03:00,out,False,902720,True,54,0,1199,1199
166839,2019-10-02 00:00:00+03:00,in,False,902720,False,6,2181,2274,93
166839,2019-10-02 00:00:00+03:00,in,False,-1,True,4,0,130,130
166839,2019-10-02 00:00:00+03:00,out,False,902720,True,54,0,1199,1199
166839,2019-10-03 00:00:00+03:00,out,False,902720,False,46,4057,4949,892
166839,2019-10-03 00:00:00+03:00,in,False,-1,True,6,0,179,179
166839,2019-10-03 00:00:00+03:00,out,False,902720,True,49,0,1300,1300
166839,2019-10-03 00:00:00+03:00,in,False,902720,False,7,1222,1289,67
166839,2019-10-04 00:00:00+03:00,in,False,902720,False,2,264,304,40
166839,2019-10-04 00:00:00+03:00,out,False,902720,True,25,0,508,508
166839,2019-10-04 00:00:00+03:00,out,False,902720,False,16,1143,1414,271
166839,2019-10-04 00:00:00+03:00,in,False,902720,False,2,264,304,40
166839,2019-10-07 00:00:00+03:00,out,False,902720,False,29,1778,2295,517
166839,2019-10-07 00:00:00+03:00,out,False,902720,True,40,0,781,781
166839,2019-10-08 00:00:00+03:00,out,False,902720,True,50,0,897,897
166839,2019-10-08 00:00:00+03:00,out,False,902720,False,27,2110,2710,600
166839,2019-10-08 00:00:00+03:00,in,False,902720,False,2,383,403,20
166839,2019-10-08 00:00:00+03:00,out,False,902720,False,27,2110,2710,600
166839,2019-10-09 00:00:00+03:00,out,False,902720,False,41,1538,2278,740
166839,2019-10-09 00:00:00+03:00,in,False,902720,False,3,262,323,61
166839,2019-10-09 00:00:00+03:00,out,False,902720,True,68,0,1311,1311
166839,2019-10-09 00:00:00+03:00,in,False,902720,False,3,262,323,61
166839,2019-10-10 00:00:00+03:00,out,False,902720,False,36,2209,2781,572
166839,2019-10-10 00:00:00+03:00,in,False,902720,False,2,156,174,18
166839,2019-10-10 00:00:00+03:00,out,False,902720,True,71,0,1236,1236
166839,2019-10-10 00:00:00+03:00,in,False,-1,True,2,0,26,26
166839,2019-10-10 00:00:00+03:00,out,False,902720,True,71,0,1236,1236
166839,2019-10-11 00:00:00+03:00,in,False,902720,False,3,455,501,46
166839,2019-10-11 00:00:00+03:00,out,False,902720,False,16,731,981,250
166839,2019-10-11 00:00:00+03:00,out,False,902720,True,69,0,1155,1155
166839,2019-10-11 00:00:00+03:00,in,False,-1,True,2,0,79,79
166839,2019-10-14 00:00:00+03:00,out,False,902720,False,15,776,1012,236
166839,2019-10-14 00:00:00+03:00,out,False,902720,True,65,0,1062,1062
166839,2019-10-14 00:00:00+03:00,in,False,902720,False,1,376,383,7
166839,2019-10-15 00:00:00+03:00,out,False,902720,False,5,40,112,72
166839,2019-10-15 00:00:00+03:00,out,False,902720,True,52,0,961,961
166839,2019-10-15 00:00:00+03:00,in,False,902720,False,1,207,214,7
166839,2019-10-16 00:00:00+03:00,out,False,902720,True,59,0,1003,1003
166839,2019-10-16 00:00:00+03:00,in,False,-1,True,3,0,63,63
166839,2019-10-16 00:00:00+03:00,in,False,902720,False,2,99,114,15
166839,2019-10-16 00:00:00+03:00,out,False,902720,False,9,833,930,97
166839,2019-10-17 00:00:00+03:00,out,False,902720,True,55,0,844,844
166839,2019-10-17 00:00:00+03:00,in,False,902720,False,1,501,528,27
166839,2019-10-17 00:00:00+03:00,out,False,902720,False,9,605,736,131
166839,2019-10-17 00:00:00+03:00,in,False,-1,True,3,0,129,129
166839,2019-10-18 00:00:00+03:00,out,False,902720,True,50,0,767,767
166839,2019-10-18 00:00:00+03:00,out,False,902720,False,21,1418,1754,336
166839,2019-10-18 00:00:00+03:00,in,False,902720,False,1,7,14,7
166839,2019-10-20 00:00:00+03:00,in,False,-1,True,1,0,10,10
166839,2019-10-20 00:00:00+03:00,in,False,-1,True,1,0,10,10
166839,2019-10-21 00:00:00+03:00,out,False,902720,False,16,708,907,199
166839,2019-10-21 00:00:00+03:00,out,False,902720,True,37,0,617,617
166839,2019-10-22 00:00:00+03:00,out,False,902720,False,9,166,275,109
166839,2019-10-22 00:00:00+03:00,out,False,902720,True,25,0,309,309
166839,2019-10-23 00:00:00+03:00,out,False,902720,True,31,0,110,110
166839,2019-10-23 00:00:00+03:00,out,False,902720,False,2,125,144,19
166839,2019-10-23 00:00:00+03:00,in,False,902720,False,1,64,72,8
166839,2019-10-24 00:00:00+03:00,out,True,902720,True,1,0,0,0
166839,2019-10-24 00:00:00+03:00,out,False,902720,False,19,607,843,236
166839,2019-10-24 00:00:00+03:00,out,False,902720,True,43,0,522,522
166839,2019-10-24 00:00:00+03:00,out,False,-1,True,1,0,1,1
166839,2019-10-24 00:00:00+03:00,out,True,902720,True,1,0,0,0
166839,2019-10-25 00:00:00+03:00,out,False,902720,False,16,1237,1509,272
166839,2019-10-25 00:00:00+03:00,in,False,-1,True,2,0,61,61
166839,2019-10-25 00:00:00+03:00,out,False,902720,True,17,0,248,248
166839,2019-10-25 00:00:00+03:00,out,False,902720,False,16,1237,1509,272
166839,2019-10-28 00:00:00+03:00,in,False,902720,False,1,53,70,17
166839,2019-10-28 00:00:00+03:00,out,False,902720,True,1,0,32,32
166839,2019-10-28 00:00:00+03:00,out,False,902720,False,1,4,35,31
166839,2019-10-28 00:00:00+03:00,in,False,-1,True,4,0,154,154
166839,2019-10-29 00:00:00+03:00,in,False,902720,False,2,167,213,46
166839,2019-10-29 00:00:00+03:00,in,False,-1,True,1,0,15,15
166839,2019-10-30 00:00:00+03:00,out,False,902720,True,14,0,220,220
166839,2019-10-30 00:00:00+03:00,out,False,902720,False,3,297,337,40
166839,2019-10-31 00:00:00+03:00,out,False,902720,False,13,429,601,172
166839,2019-10-31 00:00:00+03:00,out,False,902720,True,28,0,442,442
166839,2019-11-01 00:00:00+03:00,out,False,902720,True,8,0,134,134
166839,2019-11-01 00:00:00+03:00,out,False,902720,False,2,16,51,35
166839,2019-11-01 00:00:00+03:00,out,False,902720,True,8,0,134,134
166839,2019-11-05 00:00:00+03:00,out,False,902720,False,1,22,38,16
166839,2019-11-06 00:00:00+03:00,out,False,902720,True,9,0,21,21
166839,2019-11-06 00:00:00+03:00,out,False,902720,False,2,90,122,32
166839,2019-11-07 00:00:00+03:00,out,False,902720,True,1,0,2,2
166839,2019-11-11 00:00:00+03:00,out,True,902720,True,1,0,0,0
166839,2019-11-11 00:00:00+03:00,out,False,902720,False,1,289,301,12
166839,2019-11-11 00:00:00+03:00,out,False,902720,True,7,0,10,10
166839,2019-11-15 00:00:00+03:00,out,False,902720,True,1,0,2,2
166839,2019-11-18 00:00:00+03:00,in,False,-1,True,2,0,60,60
166839,2019-11-18 00:00:00+03:00,out,False,902720,True,1,0,3,3
166839,2019-11-19 00:00:00+03:00,in,False,-1,True,12,0,305,305
166839,2019-11-20 00:00:00+03:00,in,False,-1,True,14,0,420,420
166839,2019-11-21 00:00:00+03:00,in,False,-1,True,8,0,183,183
166839,2019-11-22 00:00:00+03:00,in,False,-1,True,11,0,301,301
166839,2019-11-25 00:00:00+03:00,in,False,-1,True,1,0,2,2
166843,2019-08-23 00:00:00+03:00,in,False,895140,False,1,42,51,9
166843,2019-08-23 00:00:00+03:00,in,False,-1,True,1,0,2,2
166843,2019-08-26 00:00:00+03:00,in,False,895140,False,3,49,192,143
166843,2019-08-26 00:00:00+03:00,in,False,895172,False,1,36,42,6
166843,2019-08-26 00:00:00+03:00,out,False,895172,True,1,0,18,18
166843,2019-08-26 00:00:00+03:00,out,False,895172,False,2,22,46,24
166843,2019-08-26 00:00:00+03:00,out,True,895172,True,1,0,12,12
166843,2019-08-26 00:00:00+03:00,in,False,-1,True,15,0,718,718
166843,2019-08-26 00:00:00+03:00,out,True,895172,True,1,0,12,12
166843,2019-08-28 00:00:00+03:00,in,False,-1,True,12,0,346,346
166843,2019-08-28 00:00:00+03:00,out,False,895172,False,1,72,84,12
166843,2019-08-29 00:00:00+03:00,out,False,895172,False,4,430,525,95
166843,2019-08-29 00:00:00+03:00,in,False,-1,True,7,0,359,359
166843,2019-08-29 00:00:00+03:00,in,False,895172,False,1,9,18,9
166843,2019-08-30 00:00:00+03:00,out,False,895172,False,1,94,105,11
166843,2019-08-30 00:00:00+03:00,out,False,895172,True,1,0,2,2
166843,2019-09-03 00:00:00+03:00,out,False,895172,False,1,115,140,25
166843,2019-09-09 00:00:00+03:00,out,False,895172,True,2,0,22,22
166843,2019-09-10 00:00:00+03:00,out,False,895172,True,6,0,33,33
166843,2019-09-10 00:00:00+03:00,out,False,895172,False,2,105,126,21
166843,2019-09-11 00:00:00+03:00,out,False,895172,False,1,191,215,24
166843,2019-09-11 00:00:00+03:00,in,False,-1,True,1,0,4,4
166843,2019-09-11 00:00:00+03:00,out,False,895172,True,1,0,58,58
166843,2019-09-11 00:00:00+03:00,out,False,895172,False,1,191,215,24
166843,2019-09-11 00:00:00+03:00,out,False,895172,True,1,0,58,58
166843,2019-09-11 00:00:00+03:00,in,False,-1,True,1,0,4,4
166843,2019-09-12 00:00:00+03:00,out,False,895172,False,1,362,376,14
166843,2019-09-13 00:00:00+03:00,out,False,895172,True,4,0,152,152
166843,2019-09-13 00:00:00+03:00,out,False,895172,False,3,177,228,51
166843,2019-09-16 00:00:00+03:00,in,False,-1,True,2,0,15,15
166843,2019-09-16 00:00:00+03:00,in,False,895172,False,1,593,621,28
166843,2019-09-16 00:00:00+03:00,out,False,895172,True,3,0,172,172
166843,2019-09-16 00:00:00+03:00,out,False,895172,False,6,718,827,109
166843,2019-09-17 00:00:00+03:00,in,False,913474,False,2,31,105,74
166843,2019-09-17 00:00:00+03:00,in,False,-1,True,7,0,262,262
166843,2019-09-17 00:00:00+03:00,out,False,913474,True,3,0,35,35
166843,2019-09-17 00:00:00+03:00,in,False,895172,False,2,749,765,16
166843,2019-09-17 00:00:00+03:00,out,False,913474,False,3,54,127,73
166843,2019-09-17 00:00:00+03:00,out,False,913474,True,3,0,35,35
166843,2019-09-18 00:00:00+03:00,out,False,913474,False,2,84,109,25
166843,2019-09-18 00:00:00+03:00,out,False,913868,True,10,0,181,181
166843,2019-09-18 00:00:00+03:00,out,True,913868,True,7,0,1,1
166843,2019-09-18 00:00:00+03:00,in,False,913868,False,19,651,699,48
166843,2019-09-18 00:00:00+03:00,in,False,-1,True,3,0,108,108
166843,2019-09-18 00:00:00+03:00,out,False,895172,True,1,0,17,17
166843,2019-09-18 00:00:00+03:00,out,False,895172,True,1,0,17,17
166843,2019-09-18 00:00:00+03:00,in,False,-1,True,3,0,108,108
166843,2019-09-18 00:00:00+03:00,out,True,913868,True,7,0,1,1
166843,2019-09-19 00:00:00+03:00,out,False,895172,False,5,1519,1597,78
166843,2019-09-19 00:00:00+03:00,out,True,895172,True,1,0,10,10
166843,2019-09-23 00:00:00+03:00,out,False,895172,True,4,0,78,78
166843,2019-09-24 00:00:00+03:00,in,False,-1,True,1,0,20,20
166843,2019-09-24 00:00:00+03:00,out,False,895172,True,1,0,19,19
166843,2019-09-24 00:00:00+03:00,out,False,895172,False,1,264,267,3
166843,2019-09-25 00:00:00+03:00,out,False,895172,False,2,267,330,63
166843,2019-09-25 00:00:00+03:00,out,False,895172,True,2,0,32,32
166843,2019-09-26 00:00:00+03:00,out,False,895172,True,1,0,19,19
166843,2019-09-26 00:00:00+03:00,out,False,895172,False,3,210,270,60
166843,2019-09-27 00:00:00+03:00,in,False,895172,False,1,44,57,13
166843,2019-09-27 00:00:00+03:00,out,False,895172,True,3,0,82,82
166843,2019-09-27 00:00:00+03:00,out,False,895172,False,7,379,542,163
166843,2019-09-27 00:00:00+03:00,in,False,895172,False,1,44,57,13
166843,2019-09-30 00:00:00+03:00,out,False,895172,False,1,123,136,13
166843,2019-10-02 00:00:00+03:00,in,False,-1,True,6,0,333,333
166843,2019-10-02 00:00:00+03:00,in,False,926312,False,1,11,42,31
166843,2019-10-02 00:00:00+03:00,out,False,895172,False,1,14,27,13
166843,2019-10-02 00:00:00+03:00,out,False,913868,True,1,0,6,6
166843,2019-10-02 00:00:00+03:00,out,False,926312,False,1,3550,3609,59
166843,2019-10-02 00:00:00+03:00,out,False,895172,True,8,0,45,45
166843,2019-10-02 00:00:00+03:00,out,False,926312,True,1,0,34,34
166843,2019-10-02 00:00:00+03:00,in,False,895172,False,2,78,98,20
166843,2019-10-03 00:00:00+03:00,out,False,926312,True,7,0,272,272
166843,2019-10-03 00:00:00+03:00,out,False,926312,False,7,875,992,117
166843,2019-10-07 00:00:00+03:00,out,False,926312,False,1,29,51,22
166843,2019-10-07 00:00:00+03:00,out,False,926312,True,2,0,112,112
166843,2019-10-08 00:00:00+03:00,out,False,926312,False,1,260,283,23
166843,2019-10-08 00:00:00+03:00,out,False,926312,True,10,0,482,482
166843,2019-10-08 00:00:00+03:00,out,True,926312,True,1,0,9,9
166843,2019-10-11 00:00:00+03:00,out,False,926312,False,2,145,179,34
166843,2019-10-11 00:00:00+03:00,out,False,926312,True,7,0,364,364
166843,2019-10-14 00:00:00+03:00,out,False,926312,True,6,0,226,226
166843,2019-10-14 00:00:00+03:00,in,False,-1,True,1,0,3,3
166843,2019-10-14 00:00:00+03:00,out,False,926312,False,3,583,651,68
166843,2019-10-15 00:00:00+03:00,out,False,926312,True,5,0,43,43
166843,2019-10-15 00:00:00+03:00,in,False,926312,False,1,2,12,10
166843,2019-10-16 00:00:00+03:00,out,False,926312,False,1,98,127,29
166843,2019-10-16 00:00:00+03:00,out,False,926312,True,5,0,163,163
166843,2019-10-17 00:00:00+03:00,out,False,926312,False,8,2541,2702,161
166843,2019-10-17 00:00:00+03:00,in,False,-1,True,1,0,2,2
166843,2019-10-17 00:00:00+03:00,out,False,926312,True,11,0,412,412
166843,2019-10-18 00:00:00+03:00,in,False,926312,False,1,277,287,10
166843,2019-10-18 00:00:00+03:00,out,False,926312,True,1,0,17,17
166843,2019-10-18 00:00:00+03:00,out,False,926312,False,3,709,764,55
166843,2019-10-21 00:00:00+03:00,out,False,926312,True,2,0,78,78
166843,2019-10-21 00:00:00+03:00,out,False,926312,False,1,37,52,15
166843,2019-10-22 00:00:00+03:00,out,False,926312,False,2,78,104,26
166843,2019-10-22 00:00:00+03:00,out,False,926312,True,4,0,161,161
166843,2019-10-23 00:00:00+03:00,out,False,926312,True,4,0,104,104
166843,2019-10-23 00:00:00+03:00,out,False,926312,False,6,567,683,116
166843,2019-10-23 00:00:00+03:00,in,False,926312,False,1,460,466,6
166843,2019-10-23 00:00:00+03:00,in,False,-1,True,1,0,9,9
166843,2019-10-24 00:00:00+03:00,in,False,926312,False,2,517,539,22
166843,2019-10-28 00:00:00+03:00,out,False,926312,True,1,0,45,45
166843,2019-10-28 00:00:00+03:00,in,False,926312,False,1,84,94,10
166843,2019-10-28 00:00:00+03:00,out,False,926312,False,2,1709,1737,28
166843,2019-10-29 00:00:00+03:00,out,False,926312,False,1,22,61,39
166843,2019-10-29 00:00:00+03:00,out,False,926312,True,1,0,63,63
166843,2019-10-30 00:00:00+03:00,out,False,926312,False,2,359,397,38
166843,2019-10-30 00:00:00+03:00,out,False,926312,True,4,0,141,141
166843,2019-11-01 00:00:00+03:00,out,False,926312,False,1,26,39,13
166843,2019-11-01 00:00:00+03:00,in,False,-1,True,1,0,16,16
166843,2019-11-05 00:00:00+03:00,out,False,926312,True,1,0,64,64
166843,2019-11-05 00:00:00+03:00,out,False,926312,False,3,72,146,74
166843,2019-11-07 00:00:00+03:00,out,False,926312,False,1,33,51,18
166843,2019-11-11 00:00:00+03:00,in,False,-1,True,1,0,61,61
166843,2019-11-11 00:00:00+03:00,out,False,926312,True,1,0,7,7
166843,2019-11-11 00:00:00+03:00,out,False,926312,False,2,954,991,37
166843,2019-11-14 00:00:00+03:00,out,False,926312,True,2,0,25,25
166843,2019-11-14 00:00:00+03:00,out,False,926312,False,2,205,225,20
166843,2019-11-15 00:00:00+03:00,out,False,926312,False,2,704,722,18
166843,2019-11-22 00:00:00+03:00,in,False,926312,False,1,125,154,29
166843,2019-11-27 00:00:00+03:00,in,False,926312,False,1,631,640,9
166843,2019-11-27 00:00:00+03:00,out,False,926312,True,1,0,31,31
166843,2019-11-27 00:00:00+03:00,out,False,926312,False,1,1285,1287,2
166843,2019-11-28 00:00:00+03:00,in,False,926312,False,1,361,369,8
166874,2019-08-27 00:00:00+03:00,out,False,895598,True,1,0,12,12
166874,2019-08-27 00:00:00+03:00,in,False,895598,False,1,30,34,4
166874,2019-08-27 00:00:00+03:00,in,False,-1,True,5,0,0,0
166874,2019-09-15 00:00:00+03:00,in,False,895598,False,2,34,48,14
166874,2019-09-15 00:00:00+03:00,in,False,-1,True,1,0,16,16
166874,2019-09-25 00:00:00+03:00,in,False,-1,True,1,0,0,0
166874,2019-09-29 00:00:00+03:00,out,False,893700,False,1,68,75,7
166874,2019-10-02 00:00:00+03:00,out,False,895598,False,1,8,20,12
166874,2019-10-05 00:00:00+03:00,out,False,893700,True,3,0,120,120
166874,2019-10-05 00:00:00+03:00,out,False,893700,False,2,0,83,83
166874,2019-10-05 00:00:00+03:00,out,False,893700,False,2,0,83,83
166874,2019-10-08 00:00:00+03:00,in,False,-1,True,1,0,0,0
166874,2019-10-25 00:00:00+03:00,in,False,-1,True,6,0,1,1
166874,2019-10-29 00:00:00+03:00,in,False,-1,True,1,0,0,0
166879,2019-08-26 00:00:00+03:00,in,False,-1,True,2,0,5,5
166879,2019-08-27 00:00:00+03:00,in,False,896538,False,1,15,49,34
166879,2019-08-27 00:00:00+03:00,in,False,896536,False,1,31,45,14
166879,2019-08-27 00:00:00+03:00,in,False,-1,True,7,0,0,0
166879,2019-08-27 00:00:00+03:00,in,False,-1,True,19,0,10,10
166879,2019-08-27 00:00:00+03:00,in,False,-1,True,7,0,0,0
166879,2019-08-27 00:00:00+03:00,in,False,-1,True,19,0,10,10
166879,2019-09-02 00:00:00+03:00,in,False,896538,False,1,29,65,36
166879,2019-09-03 00:00:00+03:00,in,False,-1,True,1,0,35,35
166879,2019-09-03 00:00:00+03:00,in,False,896538,False,2,211,264,53
166879,2019-09-04 00:00:00+03:00,in,False,896538,True,1,0,42,42
166879,2019-09-04 00:00:00+03:00,in,False,-1,True,1,0,37,37
166879,2019-09-04 00:00:00+03:00,in,True,903512,False,1,26,52,26
166879,2019-09-05 00:00:00+03:00,in,False,-1,True,4,0,93,93
166879,2019-09-05 00:00:00+03:00,in,False,903512,False,3,175,276,101
166879,2019-09-06 00:00:00+03:00,in,False,-1,True,4,0,100,100
166879,2019-09-06 00:00:00+03:00,in,False,896536,False,2,84,112,28
166879,2019-09-09 00:00:00+03:00,in,False,-1,True,1,0,21,21
166879,2019-09-09 00:00:00+03:00,in,False,896536,False,1,198,213,15
166879,2019-09-09 00:00:00+03:00,in,False,903512,False,2,185,268,83
166879,2019-09-10 00:00:00+03:00,in,False,903512,False,1,43,87,44
166879,2019-09-12 00:00:00+03:00,in,False,896538,False,1,35,83,48
166879,2019-09-13 00:00:00+03:00,in,False,903512,False,1,8,59,51
166879,2019-09-13 00:00:00+03:00,in,False,-1,True,2,0,7,7
166879,2019-09-15 00:00:00+03:00,in,False,-1,True,1,0,18,18
166879,2019-09-16 00:00:00+03:00,in,False,896536,False,1,112,139,27
166879,2019-09-18 00:00:00+03:00,in,False,903512,False,1,36,80,44
166879,2019-09-18 00:00:00+03:00,in,False,-1,True,2,0,57,57
166879,2019-09-19 00:00:00+03:00,in,False,896536,False,2,176,213,37
166879,2019-09-19 00:00:00+03:00,in,False,-1,True,1,0,52,52
166879,2019-09-20 00:00:00+03:00,in,False,903512,False,1,43,80,37
166879,2019-09-21 00:00:00+03:00,in,False,896536,False,1,149,164,15
166879,2019-09-23 00:00:00+03:00,in,False,896536,False,1,23,46,23
166879,2019-09-23 00:00:00+03:00,in,False,903512,False,2,134,208,74
166879,2019-09-23 00:00:00+03:00,in,False,896536,False,1,23,46,23
166879,2019-09-24 00:00:00+03:00,in,False,896536,False,6,246,356,110
166879,2019-09-24 00:00:00+03:00,in,False,-1,True,2,0,57,57
166879,2019-09-24 00:00:00+03:00,in,False,896536,True,1,0,30,30
166879,2019-09-24 00:00:00+03:00,in,True,903512,False,1,8,30,22
166879,2019-09-24 00:00:00+03:00,in,False,903512,False,3,752,884,132
166879,2019-09-25 00:00:00+03:00,in,True,903512,False,1,93,130,37
166879,2019-09-25 00:00:00+03:00,in,False,-1,True,3,0,59,59
166879,2019-09-26 00:00:00+03:00,in,False,-1,True,1,0,30,30
166879,2019-09-26 00:00:00+03:00,in,True,896536,False,2,15,50,35
166879,2019-09-26 00:00:00+03:00,in,False,896536,False,1,11,23,12
166879,2019-09-26 00:00:00+03:00,in,False,903512,False,1,71,111,40
166879,2019-09-27 00:00:00+03:00,in,False,-1,True,1,0,29,29
166879,2019-09-28 00:00:00+03:00,in,False,-1,True,1,0,29,29
166879,2019-09-29 00:00:00+03:00,in,False,-1,True,1,0,65,65
166879,2019-09-29 00:00:00+03:00,in,False,896536,False,2,25,62,37
166879,2019-09-29 00:00:00+03:00,in,False,903512,False,1,109,157,48
166879,2019-09-29 00:00:00+03:00,in,False,896536,False,2,25,62,37
166879,2019-09-30 00:00:00+03:00,in,False,-1,True,2,0,12,12
166879,2019-10-01 00:00:00+03:00,in,False,903512,False,4,158,278,120
166879,2019-10-02 00:00:00+03:00,in,False,896536,False,1,36,46,10
166879,2019-10-02 00:00:00+03:00,in,False,903512,False,1,48,99,51
166879,2019-10-03 00:00:00+03:00,in,False,896536,False,1,3,13,10
166879,2019-10-04 00:00:00+03:00,in,False,903512,False,3,403,624,221
166879,2019-10-04 00:00:00+03:00,in,False,896536,False,1,8,28,20
166879,2019-10-04 00:00:00+03:00,in,True,896536,False,1,12,25,13
166879,2019-10-04 00:00:00+03:00,in,False,-1,True,1,0,7,7
166879,2019-10-07 00:00:00+03:00,in,False,903512,False,1,149,208,59
166879,2019-10-07 00:00:00+03:00,in,False,896536,False,3,1152,1223,71
166879,2019-10-07 00:00:00+03:00,in,False,-1,True,2,0,50,50
166879,2019-10-08 00:00:00+03:00,in,False,896536,False,1,11,25,14
166879,2019-10-09 00:00:00+03:00,in,False,896536,False,1,336,354,18
166879,2019-10-10 00:00:00+03:00,in,False,927070,False,1,59,115,56
166879,2019-10-10 00:00:00+03:00,in,False,896536,False,5,554,678,124
166879,2019-10-10 00:00:00+03:00,in,False,-1,True,2,0,10,10
166879,2019-10-10 00:00:00+03:00,in,False,896536,False,5,554,678,124
166879,2019-10-12 00:00:00+03:00,in,False,896536,False,2,423,462,39
166879,2019-10-13 00:00:00+03:00,in,False,-1,True,1,0,2,2
166879,2019-10-13 00:00:00+03:00,in,False,896536,False,2,914,938,24
166879,2019-10-14 00:00:00+03:00,in,False,896536,True,1,0,10,10
166879,2019-10-14 00:00:00+03:00,in,False,-1,True,1,0,29,29
166879,2019-10-14 00:00:00+03:00,in,False,896536,False,1,27,37,10
166879,2019-10-15 00:00:00+03:00,in,False,896538,False,1,273,361,88
166879,2019-10-15 00:00:00+03:00,in,False,927070,False,1,37,53,16
166879,2019-10-15 00:00:00+03:00,in,False,896536,False,1,31,55,24
166879,2019-10-16 00:00:00+03:00,in,False,927070,False,2,117,270,153
166879,2019-10-16 00:00:00+03:00,in,True,896536,False,1,13,29,16
166879,2019-10-16 00:00:00+03:00,in,False,896536,False,3,859,948,89
166879,2019-10-16 00:00:00+03:00,in,True,896536,False,1,13,29,16
166879,2019-10-17 00:00:00+03:00,in,False,-1,True,1,0,6,6
166879,2019-10-17 00:00:00+03:00,in,False,896536,False,1,89,104,15
166879,2019-10-18 00:00:00+03:00,in,False,896536,False,5,636,692,56
166879,2019-10-18 00:00:00+03:00,in,False,-1,True,2,0,81,81
166879,2019-10-18 00:00:00+03:00,in,False,-1,True,4,0,52,52
166879,2019-10-19 00:00:00+03:00,in,False,896536,False,5,558,658,100
166879,2019-10-19 00:00:00+03:00,in,False,927070,False,4,322,479,157
166879,2019-10-19 00:00:00+03:00,in,False,896538,False,1,145,174,29
166879,2019-10-19 00:00:00+03:00,in,False,896536,False,5,558,658,100
166879,2019-10-20 00:00:00+03:00,in,False,896536,False,3,891,937,46
166879,2019-10-21 00:00:00+03:00,in,False,896536,False,1,60,74,14
166879,2019-10-21 00:00:00+03:00,in,False,927070,False,1,253,282,29
166879,2019-10-21 00:00:00+03:00,in,False,927070,False,1,253,282,29
166879,2019-10-22 00:00:00+03:00,in,False,-1,True,4,0,222,222
166879,2019-10-22 00:00:00+03:00,in,False,896536,False,8,959,1197,238
166879,2019-10-23 00:00:00+03:00,in,False,927070,False,3,645,732,87
166879,2019-10-23 00:00:00+03:00,in,False,896536,False,2,1421,1450,29
166879,2019-10-23 00:00:00+03:00,in,False,-1,True,3,0,14,14
166879,2019-10-23 00:00:00+03:00,in,False,896536,False,2,1421,1450,29
166879,2019-10-24 00:00:00+03:00,in,False,-1,True,2,0,20,20
166879,2019-10-24 00:00:00+03:00,in,False,896536,False,3,366,396,30
166879,2019-10-24 00:00:00+03:00,in,False,927070,False,1,356,412,56
166879,2019-10-24 00:00:00+03:00,in,False,927070,False,1,356,412,56
166879,2019-10-25 00:00:00+03:00,in,False,896536,False,4,364,551,187
166879,2019-10-25 00:00:00+03:00,in,False,896536,False,4,364,551,187
166879,2019-10-26 00:00:00+03:00,in,False,-1,True,1,0,48,48
166879,2019-10-26 00:00:00+03:00,in,False,896536,False,3,82,113,31
166879,2019-10-27 00:00:00+03:00,in,False,896536,False,2,182,202,20
166879,2019-10-28 00:00:00+03:00,in,False,896536,False,4,212,346,134
166879,2019-10-28 00:00:00+03:00,in,False,927070,False,1,1,45,44
166879,2019-10-28 00:00:00+03:00,in,False,-1,True,5,0,195,195
166879,2019-10-30 00:00:00+03:00,in,False,896536,False,4,649,680,31
166879,2019-10-30 00:00:00+03:00,in,False,927070,False,1,1,60,59
166879,2019-10-30 00:00:00+03:00,in,False,-1,True,3,0,102,102
166879,2019-10-30 00:00:00+03:00,in,False,896536,False,4,649,680,31
166879,2019-10-30 00:00:00+03:00,in,False,-1,True,3,0,102,102
166879,2019-10-31 00:00:00+03:00,in,False,-1,True,1,0,7,7
166879,2019-10-31 00:00:00+03:00,in,False,896538,False,1,15,64,49
166879,2019-10-31 00:00:00+03:00,in,False,927070,False,3,529,654,125
166879,2019-10-31 00:00:00+03:00,in,False,896536,False,2,346,364,18
166879,2019-10-31 00:00:00+03:00,in,False,927070,False,3,529,654,125
166879,2019-11-01 00:00:00+03:00,in,False,896536,False,4,640,685,45
166879,2019-11-01 00:00:00+03:00,in,False,-1,True,2,0,160,160
166879,2019-11-01 00:00:00+03:00,in,False,-1,True,2,0,160,160
166879,2019-11-02 00:00:00+03:00,in,False,896536,False,1,31,181,150
166879,2019-11-03 00:00:00+03:00,in,False,896536,False,4,136,259,123
166879,2019-11-04 00:00:00+03:00,in,False,896536,False,5,467,541,74
166879,2019-11-04 00:00:00+03:00,in,False,927070,False,1,195,237,42
166879,2019-11-05 00:00:00+03:00,in,False,896536,False,2,428,448,20
166879,2019-11-05 00:00:00+03:00,in,False,927070,False,1,393,406,13
166879,2019-11-06 00:00:00+03:00,in,False,896536,False,1,57,66,9
166879,2019-11-07 00:00:00+03:00,in,False,927070,False,2,685,786,101
166879,2019-11-07 00:00:00+03:00,in,False,896536,False,4,216,266,50
166879,2019-11-07 00:00:00+03:00,in,False,927070,False,2,685,786,101
166879,2019-11-08 00:00:00+03:00,in,False,896536,False,3,869,1094,225
166879,2019-11-09 00:00:00+03:00,in,False,896536,False,1,24,45,21
166879,2019-11-10 00:00:00+03:00,in,False,896536,False,3,603,641,38
166879,2019-11-10 00:00:00+03:00,in,False,-1,True,3,0,38,38
166879,2019-11-10 00:00:00+03:00,in,False,927070,False,1,49,92,43
166879,2019-11-11 00:00:00+03:00,in,False,927070,False,2,804,888,84
166879,2019-11-11 00:00:00+03:00,in,False,896536,False,4,219,379,160
166879,2019-11-12 00:00:00+03:00,in,False,-1,True,2,0,4,4
166879,2019-11-12 00:00:00+03:00,in,False,896536,False,4,584,658,74
166879,2019-11-13 00:00:00+03:00,in,False,927070,False,1,171,201,30
166879,2019-11-13 00:00:00+03:00,in,False,896536,False,4,1315,1457,142
166879,2019-11-13 00:00:00+03:00,in,False,-1,True,6,0,36,36
166879,2019-11-14 00:00:00+03:00,in,False,896536,False,2,390,422,32
166879,2019-11-15 00:00:00+03:00,in,False,896536,False,5,814,894,80
166879,2019-11-15 00:00:00+03:00,in,False,-1,True,1,0,2,2
166879,2019-11-15 00:00:00+03:00,in,False,896538,False,2,202,360,158
166879,2019-11-15 00:00:00+03:00,in,False,927070,False,2,116,218,102
166879,2019-11-16 00:00:00+03:00,in,False,896536,False,6,814,1083,269
166879,2019-11-16 00:00:00+03:00,in,False,-1,True,1,0,24,24
166879,2019-11-17 00:00:00+03:00,in,False,-1,True,1,0,2,2
166879,2019-11-17 00:00:00+03:00,in,False,896536,False,2,153,189,36
166879,2019-11-17 00:00:00+03:00,in,False,896536,False,2,153,189,36
166879,2019-11-18 00:00:00+03:00,in,False,927070,False,2,190,288,98
166879,2019-11-18 00:00:00+03:00,in,False,-1,True,1,0,2,2
166879,2019-11-18 00:00:00+03:00,in,False,927070,False,2,190,288,98
166879,2019-11-19 00:00:00+03:00,in,False,896538,False,1,1077,1144,67
166879,2019-11-19 00:00:00+03:00,in,False,-1,True,3,0,6,6
166879,2019-11-19 00:00:00+03:00,in,False,896536,False,4,886,922,36
166879,2019-11-20 00:00:00+03:00,in,False,896536,False,3,64,99,35
166879,2019-11-21 00:00:00+03:00,in,False,896536,False,4,751,805,54
166879,2019-11-21 00:00:00+03:00,in,False,-1,True,1,0,1,1
166879,2019-11-22 00:00:00+03:00,in,False,896538,False,2,85,146,61
166879,2019-11-22 00:00:00+03:00,in,False,927070,False,1,79,175,96
166879,2019-11-22 00:00:00+03:00,in,False,896536,False,5,487,530,43
166879,2019-11-24 00:00:00+03:00,in,False,896536,False,4,297,341,44
166879,2019-11-24 00:00:00+03:00,in,False,927070,False,1,17,41,24
166879,2019-11-24 00:00:00+03:00,in,False,927070,False,1,17,41,24
166879,2019-11-25 00:00:00+03:00,in,False,896536,False,4,386,460,74
166879,2019-11-25 00:00:00+03:00,in,False,-1,True,1,0,4,4
166879,2019-11-26 00:00:00+03:00,in,False,896536,False,3,654,687,33
166879,2019-11-26 00:00:00+03:00,in,False,-1,True,1,0,10,10
166879,2019-11-27 00:00:00+03:00,in,False,896536,False,4,179,234,55
166879,2019-11-28 00:00:00+03:00,in,False,896536,False,3,166,203,37
166884,2019-08-26 00:00:00+03:00,in,False,895774,False,2,53,67,14
166884,2019-08-26 00:00:00+03:00,out,False,895776,True,3,0,5,5
166884,2019-08-26 00:00:00+03:00,in,False,895776,False,1,102,112,10
166884,2019-08-26 00:00:00+03:00,out,False,895776,False,8,413,591,178
166884,2019-08-27 00:00:00+03:00,in,False,895774,False,1,221,228,7
166884,2019-08-27 00:00:00+03:00,out,False,895776,True,1,0,33,33
166884,2019-08-27 00:00:00+03:00,out,False,895776,False,1,93,104,11
166884,2019-08-30 00:00:00+03:00,in,False,-1,True,36,0,4,4
166884,2019-08-30 00:00:00+03:00,out,False,895774,False,6,493,540,47
166884,2019-08-30 00:00:00+03:00,out,True,895776,True,1,0,0,0
166884,2019-08-30 00:00:00+03:00,in,False,-1,True,14,0,1,1
166884,2019-08-30 00:00:00+03:00,in,False,895774,False,4,1309,1332,23
166884,2019-08-30 00:00:00+03:00,out,False,895774,True,5,0,119,119
166884,2019-08-31 00:00:00+03:00,out,False,895774,True,1,0,8,8
166884,2019-08-31 00:00:00+03:00,out,False,895774,False,1,148,155,7
166884,2019-09-02 00:00:00+03:00,out,False,895774,False,4,193,255,62
166884,2019-09-02 00:00:00+03:00,in,False,-1,True,7,0,2,2
166884,2019-09-02 00:00:00+03:00,out,False,895774,True,7,0,78,78
166884,2019-09-02 00:00:00+03:00,in,False,-1,True,1,0,0,0
166884,2019-09-03 00:00:00+03:00,out,False,895776,False,9,288,427,139
166884,2019-09-03 00:00:00+03:00,out,False,895776,True,4,0,47,47
166884,2019-09-03 00:00:00+03:00,in,False,895776,False,2,51,78,27
166884,2019-09-03 00:00:00+03:00,in,False,-1,True,1,0,19,19
166884,2019-09-03 00:00:00+03:00,out,False,895774,True,1,0,12,12
166884,2019-09-04 00:00:00+03:00,in,False,895774,False,4,472,516,44
166884,2019-09-04 00:00:00+03:00,out,False,895774,False,11,642,737,95
166884,2019-09-04 00:00:00+03:00,out,False,895774,True,17,0,301,301
166884,2019-09-05 00:00:00+03:00,out,False,895776,True,3,0,68,68
166884,2019-09-05 00:00:00+03:00,in,False,895776,True,1,0,14,14
166884,2019-09-05 00:00:00+03:00,out,False,895776,False,4,164,216,52
166884,2019-09-06 00:00:00+03:00,in,False,-1,True,4,0,2,2
166884,2019-09-06 00:00:00+03:00,out,False,895776,True,1,0,30,30
166884,2019-09-06 00:00:00+03:00,out,False,895776,False,1,21,41,20
166884,2019-09-10 00:00:00+03:00,out,False,895776,False,1,33,53,20
166884,2019-09-10 00:00:00+03:00,in,False,-1,True,5,0,1,1
166884,2019-09-11 00:00:00+03:00,out,False,895774,False,4,566,591,25
166884,2019-09-11 00:00:00+03:00,out,False,895774,True,2,0,120,120
166884,2019-09-11 00:00:00+03:00,out,False,895776,False,20,1262,1511,249
166884,2019-09-11 00:00:00+03:00,out,False,895776,True,16,0,256,256
166884,2019-09-12 00:00:00+03:00,in,False,-1,True,1,0,43,43
166884,2019-09-12 00:00:00+03:00,out,False,895776,False,5,288,342,54
166884,2019-09-12 00:00:00+03:00,in,False,895776,False,1,131,147,16
166884,2019-09-12 00:00:00+03:00,out,False,895776,True,1,0,45,45
166884,2019-09-12 00:00:00+03:00,out,False,895774,False,1,79,82,3
166884,2019-09-12 00:00:00+03:00,out,False,895774,True,1,0,3,3
166884,2019-09-13 00:00:00+03:00,out,False,895776,False,8,344,459,115
166884,2019-09-13 00:00:00+03:00,out,False,895776,True,9,0,128,128
166884,2019-09-16 00:00:00+03:00,in,False,-1,True,2,0,7,7
166884,2019-09-16 00:00:00+03:00,out,False,895776,False,1,110,128,18
166884,2019-09-16 00:00:00+03:00,out,False,895776,True,6,0,124,124
166884,2019-09-17 00:00:00+03:00,in,False,895776,False,1,90,104,14
166884,2019-09-17 00:00:00+03:00,out,False,895776,True,3,0,51,51
166884,2019-09-17 00:00:00+03:00,out,False,895776,False,7,344,457,113
166884,2019-09-17 00:00:00+03:00,in,False,-1,True,8,0,0,0
166884,2019-09-17 00:00:00+03:00,in,False,-1,True,21,0,9,9
166884,2019-09-18 00:00:00+03:00,out,False,895776,False,5,315,401,86
166884,2019-09-18 00:00:00+03:00,out,False,895776,True,3,0,63,63
166884,2019-09-23 00:00:00+03:00,in,False,-1,True,2,0,17,17
166884,2019-09-23 00:00:00+03:00,out,False,895774,False,2,665,691,26
166884,2019-09-24 00:00:00+03:00,out,False,895774,False,1,11,31,20
166884,2019-09-24 00:00:00+03:00,out,False,917890,False,1,647,660,13
166884,2019-09-24 00:00:00+03:00,out,False,917890,False,1,647,660,13
166884,2019-09-25 00:00:00+03:00,out,False,895774,True,1,0,0,0
166884,2019-09-27 00:00:00+03:00,out,False,895774,True,1,0,60,60
166884,2019-09-27 00:00:00+03:00,out,False,895774,False,1,304,316,12
166884,2019-09-30 00:00:00+03:00,out,False,895774,False,3,62,78,16
166884,2019-10-01 00:00:00+03:00,out,False,895774,False,2,350,375,25
166884,2019-10-01 00:00:00+03:00,in,False,-1,True,3,0,48,48
166884,2019-10-02 00:00:00+03:00,in,False,895774,False,1,35,78,43
166884,2019-10-02 00:00:00+03:00,out,False,895774,False,2,379,389,10
166884,2019-10-03 00:00:00+03:00,out,False,895774,True,9,0,145,145
166884,2019-10-03 00:00:00+03:00,in,False,895774,False,1,40,51,11
166884,2019-10-03 00:00:00+03:00,out,False,895774,False,5,208,254,46
166884,2019-10-03 00:00:00+03:00,out,False,895774,True,9,0,145,145
166884,2019-10-04 00:00:00+03:00,in,False,-1,True,1,0,0,0
166884,2019-10-07 00:00:00+03:00,out,False,895774,False,4,292,348,56
166884,2019-10-07 00:00:00+03:00,out,False,895774,False,4,292,348,56
166884,2019-10-08 00:00:00+03:00,out,False,895774,False,1,49,64,15
166884,2019-10-08 00:00:00+03:00,out,False,895774,True,2,0,12,12
166884,2019-10-09 00:00:00+03:00,out,False,895776,False,4,289,363,74
166884,2019-10-09 00:00:00+03:00,out,False,895776,True,1,0,2,2
166884,2019-10-10 00:00:00+03:00,out,False,895776,False,6,548,610,62
166884,2019-10-10 00:00:00+03:00,out,False,895776,True,3,0,81,81
166884,2019-10-10 00:00:00+03:00,in,False,895776,False,2,53,89,36
166884,2019-10-11 00:00:00+03:00,out,False,895774,False,1,4,14,10
166884,2019-10-11 00:00:00+03:00,out,False,895776,False,1,40,55,15
166884,2019-10-11 00:00:00+03:00,out,False,895774,True,1,0,22,22
166884,2019-10-12 00:00:00+03:00,out,False,895776,False,1,53,68,15
166884,2019-10-12 00:00:00+03:00,in,False,-1,True,1,0,0,0
166884,2019-10-13 00:00:00+03:00,out,False,895774,False,1,306,309,3
166884,2019-10-14 00:00:00+03:00,out,False,895776,False,13,1714,1828,114
166884,2019-10-14 00:00:00+03:00,out,False,895774,True,1,0,3,3
166884,2019-10-14 00:00:00+03:00,out,False,895774,False,2,73,87,14
166884,2019-10-14 00:00:00+03:00,out,False,895776,True,13,0,219,219
166884,2019-10-14 00:00:00+03:00,out,False,895776,False,13,1714,1828,114
166884,2019-10-15 00:00:00+03:00,out,False,895776,True,1,0,24,24
166884,2019-10-15 00:00:00+03:00,out,False,895776,False,2,61,82,21
166884,2019-10-16 00:00:00+03:00,in,False,-1,True,15,0,10,10
166884,2019-10-16 00:00:00+03:00,out,False,895774,False,3,250,267,17
166884,2019-10-16 00:00:00+03:00,out,False,895776,True,16,0,253,253
166884,2019-10-16 00:00:00+03:00,out,False,895776,False,18,1254,1445,191
166884,2019-10-16 00:00:00+03:00,in,False,-1,True,6,0,5,5
166884,2019-10-16 00:00:00+03:00,in,False,895776,False,1,82,100,18
166884,2019-10-16 00:00:00+03:00,out,False,895774,True,1,0,39,39
166884,2019-10-17 00:00:00+03:00,out,False,895776,False,6,1749,1812,63
166884,2019-10-17 00:00:00+03:00,out,False,895776,True,3,0,34,34
166884,2019-10-17 00:00:00+03:00,in,False,895776,False,1,37,49,12
166884,2019-10-18 00:00:00+03:00,in,False,-1,True,1,0,70,70
166884,2019-10-19 00:00:00+03:00,in,False,-1,True,2,0,0,0
166884,2019-10-19 00:00:00+03:00,in,False,-1,True,2,0,0,0
166884,2019-10-20 00:00:00+03:00,in,False,-1,True,5,0,0,0
166884,2019-10-21 00:00:00+03:00,in,False,895776,False,1,39,52,13
166884,2019-10-21 00:00:00+03:00,in,False,-1,True,3,0,30,30
166884,2019-10-21 00:00:00+03:00,out,False,895776,False,9,830,919,89
166884,2019-10-21 00:00:00+03:00,out,False,895776,True,5,0,169,169
166884,2019-10-21 00:00:00+03:00,in,False,-1,True,3,0,30,30
166884,2019-10-22 00:00:00+03:00,in,False,-1,True,1,0,0,0
166884,2019-10-22 00:00:00+03:00,in,False,895776,False,1,17,32,15
166884,2019-10-22 00:00:00+03:00,out,False,895776,False,6,247,312,65
166884,2019-10-22 00:00:00+03:00,out,False,895776,True,1,0,39,39
166884,2019-10-23 00:00:00+03:00,out,False,895776,True,9,0,2,2
166884,2019-10-24 00:00:00+03:00,in,False,-1,True,1,0,2,2
166884,2019-10-24 00:00:00+03:00,in,False,-1,True,1,0,2,2
166884,2019-10-28 00:00:00+03:00,in,False,-1,True,1,0,2,2
166884,2019-11-12 00:00:00+03:00,in,False,-1,True,1,0,2,2
166884,2019-11-15 00:00:00+03:00,in,False,-1,True,1,0,2,2
166884,2019-11-20 00:00:00+03:00,in,False,-1,True,2,0,4,4
166884,2019-11-23 00:00:00+03:00,in,False,-1,True,1,0,2,2
166884,2019-11-24 00:00:00+03:00,in,False,-1,True,1,0,2,2
166884,2019-11-25 00:00:00+03:00,in,False,-1,True,1,0,2,2
166896,2019-08-26 00:00:00+03:00,in,False,-1,True,34,0,2,2
166896,2019-08-26 00:00:00+03:00,in,False,-1,True,34,0,2,2
166896,2019-08-27 00:00:00+03:00,in,False,-1,True,48,0,1,1
166896,2019-08-28 00:00:00+03:00,in,False,-1,True,56,0,4,4
166896,2019-08-30 00:00:00+03:00,in,False,895578,False,5,37,213,176
166896,2019-08-30 00:00:00+03:00,in,False,895576,False,1,26,36,10
166896,2019-08-30 00:00:00+03:00,in,False,895574,False,5,18,129,111
166896,2019-08-30 00:00:00+03:00,in,False,-1,True,21,0,321,321
166896,2019-08-31 00:00:00+03:00,in,False,-1,True,1,0,5,5
166896,2019-09-02 00:00:00+03:00,in,False,-1,True,1,0,18,18
166896,2019-09-02 00:00:00+03:00,in,False,895578,False,1,25,40,15
166896,2019-09-03 00:00:00+03:00,in,False,-1,True,1,0,16,16
166896,2019-09-03 00:00:00+03:00,in,False,895574,False,2,274,317,43
166896,2019-09-04 00:00:00+03:00,in,False,-1,True,1,0,32,32
166896,2019-09-04 00:00:00+03:00,in,False,895576,False,1,5,14,9
166896,2019-09-05 00:00:00+03:00,in,False,895574,False,2,31,64,33
166896,2019-09-05 00:00:00+03:00,in,False,-1,True,3,0,50,50
166896,2019-09-05 00:00:00+03:00,in,False,895574,True,3,2,25,23
166896,2019-09-06 00:00:00+03:00,in,False,-1,True,2,0,15,15
166896,2019-09-06 00:00:00+03:00,in,False,895576,False,1,7,27,20
166896,2019-09-07 00:00:00+03:00,in,False,-1,True,2,0,59,59
166896,2019-09-08 00:00:00+03:00,in,False,-1,True,2,0,91,91
166896,2019-09-08 00:00:00+03:00,in,False,-1,True,2,0,91,91
166896,2019-09-09 00:00:00+03:00,in,False,895574,False,1,41,52,11
166896,2019-09-09 00:00:00+03:00,in,False,-1,True,1,0,7,7
166896,2019-09-10 00:00:00+03:00,in,False,895574,False,3,501,550,49
166896,2019-09-10 00:00:00+03:00,in,False,895578,False,1,394,414,20
166896,2019-09-10 00:00:00+03:00,in,False,-1,True,3,0,26,26
166896,2019-09-11 00:00:00+03:00,in,False,895574,False,2,229,295,66
166896,2019-09-11 00:00:00+03:00,in,False,895576,False,1,7,24,17
166896,2019-09-11 00:00:00+03:00,in,False,-1,True,1,0,32,32
166896,2019-09-12 00:00:00+03:00,in,False,895574,False,1,36,46,10
166896,2019-09-12 00:00:00+03:00,in,False,-1,True,2,0,21,21
166896,2019-09-13 00:00:00+03:00,in,False,895576,False,1,8,24,16
166896,2019-09-13 00:00:00+03:00,in,False,-1,True,7,0,294,294
166896,2019-09-14 00:00:00+03:00,in,False,-1,True,1,0,3,3
166896,2019-09-16 00:00:00+03:00,in,False,-1,True,7,0,166,166
166896,2019-09-16 00:00:00+03:00,in,False,895574,False,2,452,476,24
166896,2019-09-16 00:00:00+03:00,in,False,895578,False,2,27,45,18
166896,2019-09-17 00:00:00+03:00,in,False,895578,False,1,63,69,6
166896,2019-09-17 00:00:00+03:00,in,False,-1,True,3,0,48,48
166896,2019-09-18 00:00:00+03:00,in,False,895576,False,1,16,42,26
166896,2019-09-18 00:00:00+03:00,in,False,895574,False,3,611,654,43
166896,2019-09-19 00:00:00+03:00,in,False,-1,True,6,0,42,42
166896,2019-09-19 00:00:00+03:00,in,False,895574,False,1,208,217,9
166896,2019-09-19 00:00:00+03:00,in,False,895576,False,2,38,77,39
166896,2019-09-20 00:00:00+03:00,in,False,895578,False,1,27,38,11
166896,2019-09-20 00:00:00+03:00,in,False,895574,False,1,119,129,10
166896,2019-09-20 00:00:00+03:00,in,False,-1,True,10,0,105,105
166896,2019-09-20 00:00:00+03:00,in,False,895576,False,1,39,57,18
166896,2019-09-22 00:00:00+03:00,in,False,-1,True,3,0,65,65
166896,2019-09-25 00:00:00+03:00,in,False,895576,False,2,297,331,34
166896,2019-09-25 00:00:00+03:00,in,False,-1,True,1,0,21,21
166896,2019-09-26 00:00:00+03:00,in,False,895576,False,2,123,152,29
166896,2019-09-26 00:00:00+03:00,in,False,895578,False,2,38,66,28
166896,2019-09-26 00:00:00+03:00,in,False,-1,True,2,0,26,26
166896,2019-09-27 00:00:00+03:00,in,False,895574,False,1,11,29,18
166896,2019-09-27 00:00:00+03:00,in,False,895578,False,1,3,18,15
166896,2019-09-27 00:00:00+03:00,in,False,895576,False,1,8,23,15
166896,2019-09-28 00:00:00+03:00,in,False,895574,False,2,15,37,22
166896,2019-09-28 00:00:00+03:00,in,False,-1,True,4,0,62,62
166896,2019-09-29 00:00:00+03:00,in,False,-1,True,1,0,4,4
166896,2019-09-30 00:00:00+03:00,in,False,895576,False,1,11,23,12
166896,2019-09-30 00:00:00+03:00,in,False,895574,False,1,6,20,14
166896,2019-09-30 00:00:00+03:00,in,False,-1,True,3,0,38,38
166896,2019-09-30 00:00:00+03:00,in,False,895578,False,3,416,447,31
166896,2019-09-30 00:00:00+03:00,in,False,-1,True,3,0,38,38
166896,2019-10-01 00:00:00+03:00,in,False,895574,False,2,598,631,33
166896,2019-10-01 00:00:00+03:00,in,False,895578,False,1,128,138,10
166896,2019-10-01 00:00:00+03:00,in,False,-1,True,1,0,4,4
166896,2019-10-02 00:00:00+03:00,in,False,-1,True,4,0,102,102
166896,2019-10-02 00:00:00+03:00,in,False,895574,False,1,148,164,16
166896,2019-10-02 00:00:00+03:00,in,False,895578,False,2,70,92,22
166896,2019-10-03 00:00:00+03:00,in,False,895578,False,1,4,11,7
166896,2019-10-03 00:00:00+03:00,in,False,895576,False,2,159,194,35
166896,2019-10-03 00:00:00+03:00,in,False,-1,True,4,0,44,44
166896,2019-10-03 00:00:00+03:00,in,False,895574,False,2,552,586,34
166896,2019-10-04 00:00:00+03:00,in,False,895574,False,1,4,21,17
166896,2019-10-04 00:00:00+03:00,in,False,-1,True,3,0,69,69
166896,2019-10-04 00:00:00+03:00,in,False,895576,False,3,324,380,56
166896,2019-10-04 00:00:00+03:00,in,False,895574,False,1,4,21,17
166896,2019-10-05 00:00:00+03:00,in,False,-1,True,1,0,17,17
166896,2019-10-07 00:00:00+03:00,in,False,895578,False,1,42,51,9
166896,2019-10-07 00:00:00+03:00,in,False,895576,False,1,88,109,21
166896,2019-10-07 00:00:00+03:00,in,False,-1,True,5,0,48,48
166896,2019-10-07 00:00:00+03:00,in,False,895574,False,4,610,678,68
166896,2019-10-07 00:00:00+03:00,in,False,895576,False,1,88,109,21
166896,2019-10-08 00:00:00+03:00,in,False,-1,True,2,0,26,26
166896,2019-10-08 00:00:00+03:00,in,False,895574,False,4,516,564,48
166896,2019-10-08 00:00:00+03:00,in,False,895578,False,1,209,220,11
166896,2019-10-09 00:00:00+03:00,in,False,895576,False,3,616,655,39
166896,2019-10-09 00:00:00+03:00,in,False,-1,True,2,0,6,6
166896,2019-10-09 00:00:00+03:00,in,False,895576,False,3,616,655,39
166896,2019-10-10 00:00:00+03:00,in,False,-1,True,4,0,32,32
166896,2019-10-10 00:00:00+03:00,in,False,895576,False,4,40,116,76
166896,2019-10-10 00:00:00+03:00,in,False,895574,False,1,8,20,12
166896,2019-10-10 00:00:00+03:00,in,False,895578,False,1,16,48,32
166896,2019-10-11 00:00:00+03:00,in,False,895574,False,1,137,157,20
166896,2019-10-11 00:00:00+03:00,in,False,-1,True,3,0,59,59
166896,2019-10-11 00:00:00+03:00,in,False,895578,False,1,118,136,18
166896,2019-10-12 00:00:00+03:00,in,False,-1,True,2,0,7,7
166896,2019-10-14 00:00:00+03:00,in,False,-1,True,12,0,109,109
166896,2019-10-14 00:00:00+03:00,in,False,895578,False,1,11,26,15
166896,2019-10-14 00:00:00+03:00,in,False,895574,False,1,13,26,13
166896,2019-10-14 00:00:00+03:00,in,False,895576,False,2,17,40,23
166896,2019-10-15 00:00:00+03:00,in,False,895576,False,2,15,44,29
166896,2019-10-15 00:00:00+03:00,in,False,-1,True,2,0,6,6
166896,2019-10-15 00:00:00+03:00,in,False,895574,False,3,337,398,61
166896,2019-10-15 00:00:00+03:00,in,False,895578,False,1,23,32,9
166896,2019-10-16 00:00:00+03:00,in,False,895576,False,3,53,88,35
166896,2019-10-16 00:00:00+03:00,in,False,-1,True,1,0,28,28
166896,2019-10-16 00:00:00+03:00,in,False,895574,False,2,224,261,37
166896,2019-10-17 00:00:00+03:00,in,False,-1,True,1,0,3,3
166896,2019-10-17 00:00:00+03:00,in,False,895576,False,2,941,982,41
166896,2019-10-17 00:00:00+03:00,in,False,895578,False,1,32,45,13
166896,2019-10-17 00:00:00+03:00,in,False,895576,False,2,941,982,41
166896,2019-10-18 00:00:00+03:00,in,False,895578,False,1,60,74,14
166896,2019-10-18 00:00:00+03:00,in,False,-1,True,2,0,12,12
166896,2019-10-19 00:00:00+03:00,in,False,895578,False,1,15,27,12
166896,2019-10-19 00:00:00+03:00,in,False,-1,True,3,0,94,94
166896,2019-10-21 00:00:00+03:00,in,False,-1,True,1,0,3,3
166896,2019-10-21 00:00:00+03:00,in,False,895578,False,2,413,443,30
166896,2019-10-21 00:00:00+03:00,in,False,895574,False,2,135,163,28
166896,2019-10-22 00:00:00+03:00,in,False,895574,False,5,702,771,69
166896,2019-10-22 00:00:00+03:00,in,False,895578,False,1,28,43,15
166896,2019-10-22 00:00:00+03:00,in,False,-1,True,1,0,3,3
166896,2019-10-22 00:00:00+03:00,in,False,895576,False,1,103,120,17
166896,2019-10-23 00:00:00+03:00,in,False,-1,True,4,0,41,41
166896,2019-10-24 00:00:00+03:00,in,False,895578,False,2,25,54,29
166896,2019-10-24 00:00:00+03:00,in,False,895576,False,1,1,22,21
166896,2019-10-24 00:00:00+03:00,in,False,-1,True,3,0,56,56
166896,2019-10-24 00:00:00+03:00,in,False,895574,False,1,70,87,17
166896,2019-10-25 00:00:00+03:00,in,False,-1,True,7,0,234,234
166896,2019-10-25 00:00:00+03:00,in,False,895574,False,3,356,395,39
166896,2019-10-25 00:00:00+03:00,in,False,895576,False,1,7,20,13
166896,2019-10-25 00:00:00+03:00,in,False,895576,False,1,7,20,13
166896,2019-10-26 00:00:00+03:00,in,False,895578,False,2,650,672,22
166896,2019-10-26 00:00:00+03:00,in,False,-1,True,1,0,20,20
166896,2019-10-27 00:00:00+03:00,in,False,-1,True,2,0,14,14
166896,2019-10-28 00:00:00+03:00,in,False,895578,False,5,369,433,64
166896,2019-10-28 00:00:00+03:00,in,False,895576,False,1,4,23,19
166896,2019-10-28 00:00:00+03:00,in,False,-1,True,5,0,40,40
166896,2019-10-28 00:00:00+03:00,in,False,-1,True,5,0,40,40
166896,2019-10-28 00:00:00+03:00,in,False,895578,False,5,369,433,64
166896,2019-10-29 00:00:00+03:00,in,False,-1,True,1,0,1,1
166896,2019-10-29 00:00:00+03:00,in,False,895576,False,3,21,60,39
166896,2019-10-29 00:00:00+03:00,in,False,895578,False,1,15,30,15
166896,2019-10-30 00:00:00+03:00,in,False,-1,True,8,0,245,245
166896,2019-10-30 00:00:00+03:00,in,False,895574,False,1,251,263,12
166896,2019-10-31 00:00:00+03:00,in,False,-1,True,5,0,119,119
166896,2019-10-31 00:00:00+03:00,in,False,895578,False,3,27,63,36
166896,2019-11-01 00:00:00+03:00,in,False,895578,False,2,16,55,39
166896,2019-11-01 00:00:00+03:00,in,False,895576,False,2,89,114,25
166896,2019-11-01 00:00:00+03:00,in,False,-1,True,3,0,49,49
166896,2019-11-02 00:00:00+03:00,in,False,895578,False,1,9,18,9
166896,2019-11-05 00:00:00+03:00,in,False,895574,False,2,133,165,32
166896,2019-11-05 00:00:00+03:00,in,False,-1,True,5,0,154,154
166896,2019-11-05 00:00:00+03:00,in,False,895576,False,5,461,537,76
166896,2019-11-05 00:00:00+03:00,in,False,895574,False,2,133,165,32
166896,2019-11-06 00:00:00+03:00,in,False,895574,False,1,14,27,13
166896,2019-11-06 00:00:00+03:00,in,False,895576,True,1,0,23,23
166896,2019-11-06 00:00:00+03:00,in,False,895576,False,3,16,66,50
166896,2019-11-06 00:00:00+03:00,in,False,-1,True,6,0,83,83
166896,2019-11-06 00:00:00+03:00,in,False,895578,False,1,14,27,13
166896,2019-11-07 00:00:00+03:00,in,False,-1,True,7,0,97,97
166896,2019-11-07 00:00:00+03:00,in,False,895576,False,3,219,277,58
166896,2019-11-07 00:00:00+03:00,in,False,895574,False,1,5,15,10
166896,2019-11-08 00:00:00+03:00,in,False,895574,False,1,484,495,11
166896,2019-11-08 00:00:00+03:00,in,False,-1,True,5,0,76,76
166896,2019-11-08 00:00:00+03:00,in,False,895576,False,1,5,22,17
166896,2019-11-09 00:00:00+03:00,in,False,-1,True,1,0,3,3
166896,2019-11-09 00:00:00+03:00,in,False,-1,True,1,0,3,3
166896,2019-11-11 00:00:00+03:00,in,False,895576,False,1,155,172,17
166896,2019-11-11 00:00:00+03:00,in,False,-1,True,9,0,233,233
166896,2019-11-11 00:00:00+03:00,in,False,895574,False,1,192,207,15
166896,2019-11-12 00:00:00+03:00,in,False,895576,False,1,2,23,21
166896,2019-11-12 00:00:00+03:00,in,False,-1,True,3,0,12,12
166896,2019-11-12 00:00:00+03:00,in,False,895574,False,1,214,227,13
166896,2019-11-12 00:00:00+03:00,in,False,895576,False,1,2,23,21
166896,2019-11-13 00:00:00+03:00,in,False,895578,False,2,437,458,21
166896,2019-11-13 00:00:00+03:00,in,False,895576,False,1,345,371,26
166896,2019-11-13 00:00:00+03:00,in,False,-1,True,9,0,303,303
166896,2019-11-13 00:00:00+03:00,in,False,895574,False,2,83,111,28
166896,2019-11-14 00:00:00+03:00,in,False,895574,False,2,89,107,18
166896,2019-11-14 00:00:00+03:00,in,False,895576,False,1,269,295,26
166896,2019-11-14 00:00:00+03:00,in,False,-1,True,3,0,33,33
166896,2019-11-14 00:00:00+03:00,in,False,895578,False,1,20,30,10
166896,2019-11-15 00:00:00+03:00,in,False,895574,False,1,15,29,14
166896,2019-11-15 00:00:00+03:00,in,False,-1,True,2,0,70,70
166896,2019-11-18 00:00:00+03:00,in,False,895578,False,1,619,632,13
166896,2019-11-18 00:00:00+03:00,in,False,895574,False,7,633,729,96
166896,2019-11-18 00:00:00+03:00,in,False,-1,True,7,0,150,150
166896,2019-11-18 00:00:00+03:00,in,False,895576,False,3,531,583,52
166896,2019-11-19 00:00:00+03:00,in,False,895574,False,3,89,132,43
166896,2019-11-19 00:00:00+03:00,in,False,895578,False,1,31,45,14
166896,2019-11-19 00:00:00+03:00,in,False,-1,True,6,0,38,38
166896,2019-11-19 00:00:00+03:00,in,False,895578,False,1,31,45,14
166896,2019-11-20 00:00:00+03:00,in,False,895576,False,1,49,69,20
166896,2019-11-20 00:00:00+03:00,in,False,895574,False,1,248,255,7
166896,2019-11-20 00:00:00+03:00,in,False,-1,True,3,0,20,20
166896,2019-11-20 00:00:00+03:00,in,False,-1,True,3,0,20,20
166896,2019-11-21 00:00:00+03:00,in,False,-1,True,1,0,60,60
166896,2019-11-21 00:00:00+03:00,in,False,895574,False,4,1423,1481,58
166896,2019-11-21 00:00:00+03:00,in,False,895576,False,2,394,465,71
166896,2019-11-21 00:00:00+03:00,in,False,895578,False,1,55,68,13
166896,2019-11-21 00:00:00+03:00,in,False,895576,False,2,394,465,71
166896,2019-11-21 00:00:00+03:00,in,False,895578,False,1,55,68,13
166896,2019-11-22 00:00:00+03:00,in,False,895574,False,1,24,54,30
166896,2019-11-24 00:00:00+03:00,in,False,-1,True,1,0,27,27
166896,2019-11-24 00:00:00+03:00,in,False,-1,True,1,0,27,27
166896,2019-11-25 00:00:00+03:00,in,False,895574,False,1,15,29,14
166896,2019-11-25 00:00:00+03:00,in,False,-1,True,4,0,59,59
166896,2019-11-25 00:00:00+03:00,in,False,895578,False,1,12,21,9
166896,2019-11-26 00:00:00+03:00,in,False,895576,False,1,10,26,16
166896,2019-11-27 00:00:00+03:00,in,False,895574,False,3,354,398,44
166899,2019-08-23 00:00:00+03:00,in,False,894656,False,1,21,26,5
166899,2019-08-23 00:00:00+03:00,out,False,894656,False,17,1496,1634,138
166899,2019-08-23 00:00:00+03:00,out,False,894656,True,16,0,164,164
166899,2019-08-26 00:00:00+03:00,out,False,894656,True,12,0,129,129
166899,2019-08-26 00:00:00+03:00,out,False,894656,False,15,1085,1171,86
166899,2019-08-27 00:00:00+03:00,out,False,894656,True,25,0,278,278
166899,2019-08-27 00:00:00+03:00,in,False,-1,True,1,0,13,13
166899,2019-08-27 00:00:00+03:00,out,False,894656,False,20,1447,1586,139
166899,2019-08-28 00:00:00+03:00,in,False,-1,True,2,0,25,25
166899,2019-08-28 00:00:00+03:00,out,False,894656,True,47,0,570,570
166899,2019-08-28 00:00:00+03:00,out,False,894656,False,35,4105,4391,286
166899,2019-08-29 00:00:00+03:00,in,False,894656,False,1,47,67,20
166899,2019-08-29 00:00:00+03:00,out,False,894656,False,36,2242,2550,308
166899,2019-08-29 00:00:00+03:00,out,False,894656,True,71,0,723,723
166899,2019-08-30 00:00:00+03:00,out,False,894656,True,36,0,307,307
166899,2019-08-30 00:00:00+03:00,in,False,894656,False,3,16,189,173
166899,2019-08-30 00:00:00+03:00,out,False,894656,False,31,2160,2458,298
166899,2019-09-02 00:00:00+03:00,out,False,894656,True,13,0,171,171
166899,2019-09-02 00:00:00+03:00,in,False,-1,True,1,0,2,2
166899,2019-09-02 00:00:00+03:00,out,False,894656,False,35,3265,3514,249
166899,2019-09-03 00:00:00+03:00,in,False,894656,False,2,54,74,20
166899,2019-09-03 00:00:00+03:00,out,False,894656,True,9,0,244,244
166899,2019-09-03 00:00:00+03:00,out,False,894656,False,24,1356,1604,248
166899,2019-09-04 00:00:00+03:00,out,False,894656,False,38,2707,3007,300
166899,2019-09-04 00:00:00+03:00,in,False,894656,False,1,56,69,13
166899,2019-09-04 00:00:00+03:00,out,False,894656,True,11,0,180,180
166899,2019-09-04 00:00:00+03:00,out,False,894656,False,38,2707,3007,300
166899,2019-09-05 00:00:00+03:00,out,False,894656,False,28,1865,2063,198
166899,2019-09-05 00:00:00+03:00,out,False,894656,True,26,0,257,257
166899,2019-09-05 00:00:00+03:00,out,False,894656,False,28,1865,2063,198
166899,2019-09-06 00:00:00+03:00,out,False,894656,True,14,0,175,175
166899,2019-09-06 00:00:00+03:00,out,False,894656,False,13,759,836,77
166899,2019-09-07 00:00:00+03:00,in,False,-1,True,1,0,1,1
166899,2019-09-09 00:00:00+03:00,out,False,894656,False,20,2139,2336,197
166899,2019-09-09 00:00:00+03:00,out,False,894656,True,16,0,172,172
166899,2019-09-10 00:00:00+03:00,out,False,894656,False,13,1155,1277,122
166899,2019-09-10 00:00:00+03:00,out,False,894656,True,11,0,150,150
166899,2019-09-11 00:00:00+03:00,in,False,-1,True,1,0,19,19
166899,2019-09-11 00:00:00+03:00,out,False,894656,False,21,2366,2523,157
166899,2019-09-11 00:00:00+03:00,out,False,894656,True,15,0,276,276
166899,2019-09-12 00:00:00+03:00,out,False,894656,False,19,2097,2232,135
166899,2019-09-12 00:00:00+03:00,out,False,894656,True,31,0,401,401
166899,2019-09-12 00:00:00+03:00,in,False,894656,False,1,101,110,9
166899,2019-09-13 00:00:00+03:00,out,False,894656,True,32,0,472,472
166899,2019-09-13 00:00:00+03:00,in,False,-1,True,1,0,17,17
166899,2019-09-13 00:00:00+03:00,out,False,894656,False,23,2977,3158,181
166899,2019-09-13 00:00:00+03:00,in,False,-1,True,1,0,17,17
166899,2019-09-16 00:00:00+03:00,out,False,894656,True,34,0,414,414
166899,2019-09-16 00:00:00+03:00,in,False,-1,True,1,0,23,23
166899,2019-09-16 00:00:00+03:00,out,False,894656,False,31,2014,2209,195
166899,2019-09-17 00:00:00+03:00,out,False,894656,False,27,2152,2357,205
166899,2019-09-17 00:00:00+03:00,out,False,894656,True,19,0,279,279
166899,2019-09-18 00:00:00+03:00,out,False,894656,True,18,0,262,262
166899,2019-09-18 00:00:00+03:00,out,False,894656,False,32,1676,1898,222
166899,2019-09-19 00:00:00+03:00,out,False,894656,True,39,0,551,551
166899,2019-09-19 00:00:00+03:00,out,False,894656,False,31,1977,2188,211
166899,2019-09-20 00:00:00+03:00,out,False,894656,False,32,2802,3026,224
166899,2019-09-20 00:00:00+03:00,out,False,894656,True,19,0,303,303
166899,2019-09-20 00:00:00+03:00,in,False,894656,False,1,104,123,19
166899,2019-09-23 00:00:00+03:00,out,False,894656,False,25,1571,1740,169
166899,2019-09-23 00:00:00+03:00,out,False,894656,True,28,0,422,422
166899,2019-09-23 00:00:00+03:00,in,False,-1,True,1,0,15,15
166899,2019-09-23 00:00:00+03:00,in,False,894656,False,2,73,105,32
166899,2019-09-24 00:00:00+03:00,out,False,894656,True,29,0,426,426
166899,2019-09-24 00:00:00+03:00,out,False,894656,False,16,1602,1690,88
166899,2019-09-24 00:00:00+03:00,in,False,894656,False,1,16,83,67
166899,2019-09-24 00:00:00+03:00,in,False,-1,True,1,0,23,23
166899,2019-09-25 00:00:00+03:00,out,False,894656,True,26,0,419,419
166899,2019-09-25 00:00:00+03:00,out,False,894656,False,33,1714,1933,219
166899,2019-09-25 00:00:00+03:00,out,False,894656,True,26,0,419,419
166899,2019-09-26 00:00:00+03:00,out,False,894656,False,20,1739,1874,135
166899,2019-09-26 00:00:00+03:00,out,False,894656,True,12,0,229,229
166899,2019-09-26 00:00:00+03:00,in,False,-1,True,1,0,13,13
166899,2019-09-27 00:00:00+03:00,out,False,894656,True,15,0,237,237
166899,2019-09-27 00:00:00+03:00,out,False,894656,False,31,1830,2069,239
166899,2019-09-30 00:00:00+03:00,out,False,894656,True,21,0,224,224
166899,2019-09-30 00:00:00+03:00,out,False,894656,False,29,1421,1622,201
166899,2019-10-01 00:00:00+03:00,out,False,894656,True,22,0,258,258
166899,2019-10-01 00:00:00+03:00,out,False,894656,False,25,1153,1316,163
166899,2019-10-02 00:00:00+03:00,out,True,894662,True,1,0,2,2
166899,2019-10-02 00:00:00+03:00,out,False,894662,False,1,7,17,10
166899,2019-10-02 00:00:00+03:00,out,False,894656,False,27,1743,1872,129
166899,2019-10-02 00:00:00+03:00,out,False,894656,True,18,0,210,210
166899,2019-10-02 00:00:00+03:00,in,False,-1,True,1,0,17,17
166899,2019-10-02 00:00:00+03:00,out,False,894662,True,1,0,13,13
166899,2019-10-03 00:00:00+03:00,out,False,894656,True,14,0,261,261
166899,2019-10-03 00:00:00+03:00,out,False,894656,False,25,1924,2064,140
166899,2019-10-04 00:00:00+03:00,out,False,894656,True,17,0,194,194
166899,2019-10-04 00:00:00+03:00,in,False,894656,False,1,22,42,20
166899,2019-10-04 00:00:00+03:00,out,False,894656,False,32,2668,2847,179
166899,2019-10-04 00:00:00+03:00,out,False,894656,False,32,2668,2847,179
166899,2019-10-05 00:00:00+03:00,in,False,-1,True,1,0,7,7
166899,2019-10-07 00:00:00+03:00,out,False,894656,True,13,0,203,203
166899,2019-10-07 00:00:00+03:00,out,False,894656,False,25,1825,1970,145
166899,2019-10-07 00:00:00+03:00,in,False,-1,True,1,0,7,7
166899,2019-10-07 00:00:00+03:00,out,False,894656,True,13,0,203,203
166899,2019-10-08 00:00:00+03:00,out,False,894656,False,15,1099,1199,100
166899,2019-10-08 00:00:00+03:00,out,False,894656,True,16,0,269,269
166899,2019-10-09 00:00:00+03:00,out,False,894656,False,24,2430,2607,177
166899,2019-10-09 00:00:00+03:00,out,False,894656,True,11,0,163,163
166899,2019-10-10 00:00:00+03:00,out,False,894662,False,1,337,341,4
166899,2019-10-10 00:00:00+03:00,out,False,894656,True,18,0,274,274
166899,2019-10-10 00:00:00+03:00,out,False,894662,True,1,0,14,14
166899,2019-10-10 00:00:00+03:00,out,False,894656,False,24,1546,1721,175
166899,2019-10-10 00:00:00+03:00,out,False,894662,False,1,337,341,4
166899,2019-10-11 00:00:00+03:00,out,False,894656,True,18,0,304,304
166899,2019-10-11 00:00:00+03:00,out,False,894656,False,27,1767,1967,200
166899,2019-10-12 00:00:00+03:00,in,False,-1,True,1,0,6,6
166899,2019-10-14 00:00:00+03:00,out,False,894656,True,25,0,371,371
166899,2019-10-14 00:00:00+03:00,out,False,894656,False,26,1808,1985,177
166899,2019-10-14 00:00:00+03:00,in,False,-1,True,1,0,16,16
166899,2019-10-14 00:00:00+03:00,out,False,894656,False,26,1808,1985,177
166899,2019-10-15 00:00:00+03:00,in,False,-1,True,1,0,17,17
166899,2019-10-15 00:00:00+03:00,out,False,894656,False,32,2514,2735,221
166899,2019-10-15 00:00:00+03:00,out,False,894656,True,26,0,286,286
166899,2019-10-16 00:00:00+03:00,out,False,894656,False,32,1454,1699,245
166899,2019-10-16 00:00:00+03:00,out,False,894656,True,14,0,198,198
166899,2019-10-16 00:00:00+03:00,out,False,894662,False,1,32,52,20
166899,2019-10-16 00:00:00+03:00,in,False,-1,True,1,0,11,11
166899,2019-10-17 00:00:00+03:00,out,False,894656,True,14,0,210,210
166899,2019-10-17 00:00:00+03:00,out,False,894656,False,32,2442,2666,224
166899,2019-10-18 00:00:00+03:00,out,False,894656,False,31,1779,1979,200
166899,2019-10-18 00:00:00+03:00,out,False,894656,True,30,0,343,343
166899,2019-10-21 00:00:00+03:00,out,False,894656,False,28,1551,1733,182
166899,2019-10-21 00:00:00+03:00,out,False,894662,True,1,0,21,21
166899,2019-10-21 00:00:00+03:00,out,False,894656,True,14,0,241,241
166899,2019-10-21 00:00:00+03:00,out,False,894662,True,1,0,21,21
166899,2019-10-22 00:00:00+03:00,out,False,894656,True,25,0,379,379
166899,2019-10-22 00:00:00+03:00,out,False,894656,False,27,2097,2250,153
166899,2019-10-23 00:00:00+03:00,out,False,894656,False,28,1434,1603,169
166899,2019-10-23 00:00:00+03:00,out,False,894656,True,22,0,333,333
166899,2019-10-23 00:00:00+03:00,out,False,894656,False,28,1434,1603,169
166899,2019-10-24 00:00:00+03:00,out,False,894656,False,19,1119,1296,177
166899,2019-10-24 00:00:00+03:00,in,False,-1,True,1,0,16,16
166899,2019-10-24 00:00:00+03:00,out,False,894656,True,9,0,114,114
166899,2019-10-25 00:00:00+03:00,out,False,894656,False,31,1665,1868,203
166899,2019-10-25 00:00:00+03:00,out,False,894656,True,29,0,319,319
166899,2019-10-28 00:00:00+03:00,out,False,894656,True,22,0,364,364
166899,2019-10-28 00:00:00+03:00,out,False,894656,False,31,2150,2314,164
166899,2019-10-29 00:00:00+03:00,out,False,894656,True,7,0,103,103
166899,2019-10-29 00:00:00+03:00,out,False,894656,False,28,1828,1978,150
166899,2019-10-30 00:00:00+03:00,out,False,894656,True,12,0,219,219
166899,2019-10-30 00:00:00+03:00,out,False,894656,False,28,1422,1625,203
166899,2019-10-31 00:00:00+03:00,in,False,-1,True,1,0,0,0
166899,2019-10-31 00:00:00+03:00,out,False,894656,False,27,1472,1681,209
166899,2019-10-31 00:00:00+03:00,out,False,894656,True,19,0,196,196
166899,2019-11-01 00:00:00+03:00,out,False,894656,False,31,1746,1937,191
166899,2019-11-01 00:00:00+03:00,in,False,894656,False,1,64,77,13
166899,2019-11-01 00:00:00+03:00,out,False,894656,True,15,0,257,257
166899,2019-11-05 00:00:00+03:00,in,False,894656,False,1,39,72,33
166899,2019-11-05 00:00:00+03:00,out,False,894656,False,24,1580,1729,149
166899,2019-11-05 00:00:00+03:00,out,False,894656,True,21,0,212,212
166899,2019-11-06 00:00:00+03:00,out,False,894656,True,12,0,234,234
166899,2019-11-06 00:00:00+03:00,out,False,894656,False,31,2921,3131,210
166899,2019-11-06 00:00:00+03:00,in,False,-1,True,1,0,1,1
166899,2019-11-07 00:00:00+03:00,out,False,894656,False,30,1279,1488,209
166899,2019-11-07 00:00:00+03:00,out,False,894656,True,8,0,160,160
166899,2019-11-08 00:00:00+03:00,out,False,894656,True,13,0,190,190
166899,2019-11-08 00:00:00+03:00,out,False,894656,False,30,1384,1562,178
166899,2019-11-11 00:00:00+03:00,out,False,894656,False,29,1424,1629,205
166899,2019-11-11 00:00:00+03:00,out,False,894656,True,13,0,165,165
166899,2019-11-12 00:00:00+03:00,in,False,-1,True,1,0,42,42
166899,2019-11-12 00:00:00+03:00,out,False,894656,True,13,0,218,218
166899,2019-11-12 00:00:00+03:00,out,False,894656,False,26,1084,1273,189
166899,2019-11-12 00:00:00+03:00,out,False,894656,False,26,1084,1273,189
166899,2019-11-13 00:00:00+03:00,in,False,-1,True,1,0,12,12
166899,2019-11-13 00:00:00+03:00,out,False,894656,False,27,1634,1870,236
166899,2019-11-13 00:00:00+03:00,out,False,894656,True,15,0,246,246
166899,2019-11-13 00:00:00+03:00,in,False,-1,True,1,0,12,12
166899,2019-11-14 00:00:00+03:00,out,False,894656,False,33,1822,2006,184
166899,2019-11-14 00:00:00+03:00,out,False,894656,True,12,0,111,111
166899,2019-11-14 00:00:00+03:00,out,False,894656,True,12,0,111,111
166899,2019-11-15 00:00:00+03:00,out,False,894656,True,12,0,168,168
166899,2019-11-15 00:00:00+03:00,out,False,894662,True,3,0,27,27
166899,2019-11-15 00:00:00+03:00,in,False,894662,False,1,668,677,9
166899,2019-11-15 00:00:00+03:00,out,False,894656,False,28,1096,1227,131
166899,2019-11-15 00:00:00+03:00,out,False,894662,False,8,713,787,74
166899,2019-11-15 00:00:00+03:00,out,False,894662,False,8,713,787,74
166899,2019-11-18 00:00:00+03:00,out,False,894662,False,1,1305,1319,14
166899,2019-11-18 00:00:00+03:00,in,False,-1,True,6,0,8,8
166899,2019-11-18 00:00:00+03:00,out,False,894656,False,32,2025,2249,224
166899,2019-11-18 00:00:00+03:00,out,False,894656,True,8,0,142,142
166899,2019-11-18 00:00:00+03:00,out,False,894662,False,1,1305,1319,14
166899,2019-11-19 00:00:00+03:00,out,False,894662,False,4,2346,2395,49
166899,2019-11-19 00:00:00+03:00,out,False,894656,False,28,2377,2560,183
166899,2019-11-19 00:00:00+03:00,out,False,894656,True,11,0,129,129
166899,2019-11-20 00:00:00+03:00,out,False,894662,True,2,0,107,107
166899,2019-11-20 00:00:00+03:00,out,False,894656,True,14,0,190,190
166899,2019-11-20 00:00:00+03:00,out,False,894656,False,26,1858,2014,156
166899,2019-11-21 00:00:00+03:00,out,False,894656,True,19,0,221,221
166899,2019-11-21 00:00:00+03:00,out,False,894662,False,3,2860,2908,48
166899,2019-11-21 00:00:00+03:00,in,False,894656,False,1,66,78,12
166899,2019-11-21 00:00:00+03:00,out,False,894656,False,28,1296,1459,163
166899,2019-11-22 00:00:00+03:00,out,False,894656,True,17,0,311,311
166899,2019-11-22 00:00:00+03:00,out,False,894656,False,25,1191,1351,160
166899,2019-11-22 00:00:00+03:00,in,False,-1,True,2,0,6,6
166899,2019-11-25 00:00:00+03:00,out,False,894656,False,25,1086,1213,127
166899,2019-11-25 00:00:00+03:00,out,False,894656,True,12,0,202,202
166899,2019-11-25 00:00:00+03:00,in,False,894656,False,1,85,94,9
166899,2019-11-26 00:00:00+03:00,in,False,-1,True,1,0,0,0
166899,2019-11-26 00:00:00+03:00,out,False,894656,False,26,1272,1482,210
166899,2019-11-26 00:00:00+03:00,out,False,894656,True,3,0,54,54
166899,2019-11-26 00:00:00+03:00,out,False,894662,False,1,323,336,13
166899,2019-11-27 00:00:00+03:00,out,False,894656,False,24,1180,1306,126
166899,2019-11-27 00:00:00+03:00,out,False,894656,True,21,0,294,294
166899,2019-11-28 00:00:00+03:00,out,False,894662,False,4,1127,1168,41
166899,2019-11-28 00:00:00+03:00,out,False,894662,True,2,0,32,32
166899,2019-11-28 00:00:00+03:00,in,False,894656,False,2,79,117,38
166899,2019-11-28 00:00:00+03:00,out,False,894656,True,18,0,211,211
166899,2019-11-28 00:00:00+03:00,in,False,-1,True,1,0,5,5
166899,2019-11-28 00:00:00+03:00,out,False,894656,False,28,1474,1710,236
166899,2019-11-28 00:00:00+03:00,out,True,894662,True,2,0,0,0
166901,2019-08-24 00:00:00+03:00,in,False,-1,True,1,0,2,2
166901,2019-08-25 00:00:00+03:00,in,False,-1,True,1,0,2,2
166901,2019-08-26 00:00:00+03:00,out,True,896010,True,2,0,0,0
166901,2019-08-26 00:00:00+03:00,out,True,896008,False,2,195,208,13
166901,2019-08-26 00:00:00+03:00,out,False,896010,True,1,0,2,2
166901,2019-08-26 00:00:00+03:00,out,False,896010,True,1,0,2,2
166901,2019-08-27 00:00:00+03:00,out,True,896008,False,3,294,320,26
166901,2019-08-27 00:00:00+03:00,out,False,896016,True,1,0,1,1
166901,2019-08-27 00:00:00+03:00,out,True,896008,True,1,0,0,0
166901,2019-08-27 00:00:00+03:00,in,False,-1,True,5,0,9,9
166901,2019-08-27 00:00:00+03:00,out,False,896016,True,1,0,1,1
166901,2019-08-28 00:00:00+03:00,in,False,-1,True,7,0,83,83
166901,2019-08-28 00:00:00+03:00,in,False,896016,False,1,9,13,4
166901,2019-08-28 00:00:00+03:00,in,False,896012,False,1,12,15,3
166901,2019-08-28 00:00:00+03:00,out,True,896008,False,6,255,332,77
166901,2019-08-28 00:00:00+03:00,in,False,896014,False,1,9,24,15
166901,2019-08-29 00:00:00+03:00,out,False,896016,True,5,0,36,36
166901,2019-08-29 00:00:00+03:00,out,True,896008,False,5,333,379,46
166901,2019-08-29 00:00:00+03:00,in,False,896018,False,1,13,21,8
166901,2019-08-29 00:00:00+03:00,out,True,896008,True,2,0,120,120
166901,2019-08-29 00:00:00+03:00,in,False,896020,False,7,214,221,7
166901,2019-08-29 00:00:00+03:00,in,False,896016,False,5,94,117,23
166901,2019-08-29 00:00:00+03:00,in,False,896012,False,1,92,97,5
166901,2019-08-29 00:00:00+03:00,out,False,896016,False,7,201,219,18
166901,2019-08-29 00:00:00+03:00,in,False,-1,True,26,0,26,26
166901,2019-08-29 00:00:00+03:00,out,True,896016,True,2,0,1,1
166901,2019-08-30 00:00:00+03:00,in,False,896012,False,1,13,25,12
166901,2019-08-30 00:00:00+03:00,in,False,896020,False,8,253,260,7
166901,2019-08-30 00:00:00+03:00,out,False,896016,False,6,186,199,13
166901,2019-08-30 00:00:00+03:00,out,False,896016,True,5,0,36,36
166901,2019-08-30 00:00:00+03:00,out,False,896014,True,2,0,5,5
166901,2019-08-30 00:00:00+03:00,out,True,896008,False,5,124,206,82
166901,2019-08-30 00:00:00+03:00,in,False,-1,True,19,0,70,70
166901,2019-09-01 00:00:00+03:00,in,False,-1,True,2,0,67,67
166901,2019-09-02 00:00:00+03:00,in,False,896014,False,1,70,85,15
166901,2019-09-02 00:00:00+03:00,out,True,896008,False,1,19,25,6
166901,2019-09-02 00:00:00+03:00,in,False,896012,False,6,746,786,40
166901,2019-09-03 00:00:00+03:00,in,False,896012,False,3,461,481,20
166901,2019-09-03 00:00:00+03:00,out,True,896008,False,4,664,704,40
166901,2019-09-03 00:00:00+03:00,out,True,896018,False,1,54,59,5
166901,2019-09-03 00:00:00+03:00,in,False,896014,False,1,17,32,15
166901,2019-09-03 00:00:00+03:00,out,True,896018,False,1,54,59,5
166901,2019-09-04 00:00:00+03:00,in,False,896020,False,1,5,6,1
166901,2019-09-04 00:00:00+03:00,out,True,896008,False,3,92,120,28
166901,2019-09-04 00:00:00+03:00,in,False,896012,False,4,362,374,12
166901,2019-09-04 00:00:00+03:00,in,False,-1,True,1,0,21,21
166901,2019-09-05 00:00:00+03:00,out,True,896018,True,1,0,39,39
166901,2019-09-05 00:00:00+03:00,out,True,896008,False,4,273,306,33
166901,2019-09-05 00:00:00+03:00,out,True,896008,True,1,0,60,60
166901,2019-09-05 00:00:00+03:00,in,False,896014,False,2,313,353,40
166901,2019-09-05 00:00:00+03:00,in,False,-1,True,1,0,20,20
166901,2019-09-05 00:00:00+03:00,in,False,896012,False,2,196,208,12
166901,2019-09-05 00:00:00+03:00,out,True,896008,True,1,0,60,60
166901,2019-09-05 00:00:00+03:00,in,False,896014,False,2,313,353,40
166901,2019-09-06 00:00:00+03:00,out,True,896008,False,4,158,210,52
166901,2019-09-09 00:00:00+03:00,in,False,896018,False,1,38,45,7
166901,2019-09-09 00:00:00+03:00,out,True,896008,True,6,0,18,18
166901,2019-09-09 00:00:00+03:00,in,False,-1,True,1,0,34,34
166901,2019-09-09 00:00:00+03:00,in,False,896014,False,2,95,120,25
166901,2019-09-09 00:00:00+03:00,out,True,896008,False,4,53,73,20
166901,2019-09-09 00:00:00+03:00,in,False,896012,False,5,619,646,27
166901,2019-09-09 00:00:00+03:00,out,True,896018,True,2,0,5,5
166901,2019-09-09 00:00:00+03:00,out,False,896018,False,2,27,29,2
166901,2019-09-09 00:00:00+03:00,in,False,896014,False,2,95,120,25
166901,2019-09-09 00:00:00+03:00,out,True,896008,False,4,53,73,20
166901,2019-09-10 00:00:00+03:00,in,False,-1,True,3,0,90,90
166901,2019-09-10 00:00:00+03:00,out,True,896008,False,7,741,831,90
166901,2019-09-10 00:00:00+03:00,in,False,896010,False,3,148,200,52
166901,2019-09-10 00:00:00+03:00,in,False,896012,False,5,481,519,38
166901,2019-09-11 00:00:00+03:00,out,True,896008,False,8,353,440,87
166901,2019-09-11 00:00:00+03:00,in,False,-1,True,1,0,39,39
166901,2019-09-11 00:00:00+03:00,in,False,896012,False,4,317,360,43
166901,2019-09-12 00:00:00+03:00,out,True,896008,False,2,98,119,21
166901,2019-09-12 00:00:00+03:00,in,False,896012,False,4,757,783,26
166901,2019-09-12 00:00:00+03:00,in,False,896014,False,1,17,34,17
166901,2019-09-13 00:00:00+03:00,in,False,896012,False,4,312,341,29
166901,2019-09-13 00:00:00+03:00,in,False,-1,True,3,0,19,19
166901,2019-09-13 00:00:00+03:00,out,True,896008,False,4,849,886,37
166901,2019-09-14 00:00:00+03:00,in,False,-1,True,3,0,97,97
166901,2019-09-16 00:00:00+03:00,out,False,896016,True,1,0,0,0
166901,2019-09-16 00:00:00+03:00,out,True,896014,True,1,0,3,3
166901,2019-09-16 00:00:00+03:00,in,False,896012,False,5,451,477,26
166901,2019-09-16 00:00:00+03:00,in,False,896018,False,1,20,45,25
166901,2019-09-16 00:00:00+03:00,out,True,896016,True,4,0,4,4
166901,2019-09-16 00:00:00+03:00,in,False,-1,True,1,0,60,60
166901,2019-09-16 00:00:00+03:00,out,True,896008,False,2,57,78,21
166901,2019-09-16 00:00:00+03:00,in,False,-1,True,1,0,60,60
166901,2019-09-17 00:00:00+03:00,out,True,896016,False,1,28,32,4
166901,2019-09-17 00:00:00+03:00,in,False,896012,False,2,87,100,13
166901,2019-09-17 00:00:00+03:00,in,False,-1,True,19,0,7,7
166901,2019-09-17 00:00:00+03:00,out,True,896016,True,3,0,51,51
166901,2019-09-17 00:00:00+03:00,out,True,896008,False,2,58,67,9
166901,2019-09-17 00:00:00+03:00,out,False,896016,True,1,0,50,50
166901,2019-09-18 00:00:00+03:00,out,True,896008,False,4,80,121,41
166901,2019-09-18 00:00:00+03:00,in,False,896012,False,4,939,954,15
166901,2019-09-18 00:00:00+03:00,out,False,896016,False,7,330,338,8
166901,2019-09-19 00:00:00+03:00,out,True,896008,False,2,77,93,16
166901,2019-09-19 00:00:00+03:00,in,False,896012,False,2,208,225,17
166901,2019-09-19 00:00:00+03:00,out,True,896016,True,1,0,0,0
166901,2019-09-19 00:00:00+03:00,out,False,896016,False,6,419,440,21
166901,2019-09-19 00:00:00+03:00,out,True,896018,False,1,40,41,1
166901,2019-09-19 00:00:00+03:00,in,False,896016,False,1,5,19,14
166901,2019-09-19 00:00:00+03:00,in,False,-1,True,26,0,0,0
166901,2019-09-19 00:00:00+03:00,out,True,896018,False,1,40,41,1
166901,2019-09-20 00:00:00+03:00,in,False,-1,True,14,0,0,0
166901,2019-09-20 00:00:00+03:00,out,True,896008,False,2,113,122,9
166901,2019-09-20 00:00:00+03:00,out,True,896016,False,1,1,5,4
166901,2019-09-20 00:00:00+03:00,in,False,896012,False,2,255,262,7
166901,2019-09-20 00:00:00+03:00,out,True,896008,False,2,113,122,9
166901,2019-09-21 00:00:00+03:00,in,False,-1,True,1,0,28,28
166901,2019-09-23 00:00:00+03:00,in,False,896012,False,4,653,674,21
166901,2019-09-23 00:00:00+03:00,out,True,896016,True,1,0,1,1
166901,2019-09-23 00:00:00+03:00,in,False,-1,True,19,0,13,13
166901,2019-09-23 00:00:00+03:00,out,False,896016,True,2,0,24,24
166901,2019-09-23 00:00:00+03:00,out,True,896008,False,5,603,650,47
166901,2019-09-23 00:00:00+03:00,in,False,896016,False,3,174,207,33
166901,2019-09-24 00:00:00+03:00,in,False,896012,False,4,756,777,21
166901,2019-09-24 00:00:00+03:00,out,True,896016,True,1,0,23,23
166901,2019-09-24 00:00:00+03:00,out,True,896016,False,1,22,26,4
166901,2019-09-24 00:00:00+03:00,out,True,896008,False,1,22,25,3
166901,2019-09-24 00:00:00+03:00,in,False,896016,False,1,80,87,7
166901,2019-09-24 00:00:00+03:00,out,False,896016,False,1,60,66,6
166901,2019-09-24 00:00:00+03:00,out,True,896008,True,1,0,5,5
166901,2019-09-24 00:00:00+03:00,out,True,896008,True,1,0,5,5
166901,2019-09-24 00:00:00+03:00,in,False,896012,False,4,756,777,21
166901,2019-09-24 00:00:00+03:00,in,False,896016,False,1,80,87,7
166901,2019-09-25 00:00:00+03:00,out,True,896016,False,1,128,131,3
166901,2019-09-25 00:00:00+03:00,out,False,896016,True,1,0,39,39
166901,2019-09-25 00:00:00+03:00,in,False,-1,True,12,0,3,3
166901,2019-09-25 00:00:00+03:00,in,False,896016,False,1,187,191,4
166901,2019-09-25 00:00:00+03:00,out,True,896008,False,3,104,153,49
166901,2019-09-25 00:00:00+03:00,in,False,896016,False,1,187,191,4
166901,2019-09-26 00:00:00+03:00,out,False,896016,True,3,0,106,106
166901,2019-09-26 00:00:00+03:00,in,False,896012,False,10,814,870,56
166901,2019-09-26 00:00:00+03:00,in,False,-1,True,29,0,27,27
166901,2019-09-26 00:00:00+03:00,in,False,896016,False,1,133,136,3
166901,2019-09-26 00:00:00+03:00,out,True,896008,False,6,267,350,83
166901,2019-09-26 00:00:00+03:00,out,True,896016,False,1,33,36,3
166901,2019-09-26 00:00:00+03:00,out,True,896016,True,2,0,4,4
166901,2019-09-26 00:00:00+03:00,out,False,896016,False,5,43,115,72
166901,2019-09-26 00:00:00+03:00,out,True,896016,True,2,0,4,4
166901,2019-09-27 00:00:00+03:00,in,False,896012,False,5,712,736,24
166901,2019-09-27 00:00:00+03:00,out,True,896008,True,2,0,0,0
166901,2019-09-27 00:00:00+03:00,in,False,-1,True,27,0,41,41
166901,2019-09-27 00:00:00+03:00,out,False,896016,False,6,623,716,93
166901,2019-09-27 00:00:00+03:00,out,True,896008,False,1,7,16,9
166901,2019-09-27 00:00:00+03:00,out,True,896016,False,1,37,42,5
166901,2019-09-27 00:00:00+03:00,in,False,896018,False,1,2,32,30
166901,2019-09-30 00:00:00+03:00,in,False,-1,True,1,0,40,40
166901,2019-09-30 00:00:00+03:00,in,False,896012,False,4,788,828,40
166901,2019-09-30 00:00:00+03:00,in,False,896018,False,1,30,60,30
166901,2019-09-30 00:00:00+03:00,in,False,896016,False,5,581,617,36
166901,2019-09-30 00:00:00+03:00,in,False,896018,False,1,30,60,30
166901,2019-09-30 00:00:00+03:00,in,False,896016,False,5,581,617,36
166901,2019-10-01 00:00:00+03:00,out,False,896016,False,2,169,190,21
166901,2019-10-01 00:00:00+03:00,in,False,896016,False,1,21,24,3
166901,2019-10-01 00:00:00+03:00,in,False,-1,True,1,0,13,13
166901,2019-10-01 00:00:00+03:00,out,True,896008,True,3,0,0,0
166901,2019-10-01 00:00:00+03:00,in,False,896012,False,4,628,654,26
166901,2019-10-01 00:00:00+03:00,in,False,-1,True,1,0,13,13
166901,2019-10-02 00:00:00+03:00,out,True,896016,False,1,21,25,4
166901,2019-10-02 00:00:00+03:00,in,False,-1,True,2,0,48,48
166901,2019-10-02 00:00:00+03:00,out,False,896016,False,1,19,28,9
166901,2019-10-02 00:00:00+03:00,out,True,896008,True,3,0,0,0
166901,2019-10-02 00:00:00+03:00,out,True,896008,False,8,1632,1704,72
166901,2019-10-02 00:00:00+03:00,in,False,896010,False,1,126,156,30
166901,2019-10-02 00:00:00+03:00,out,False,896016,False,1,19,28,9
166901,2019-10-03 00:00:00+03:00,out,False,896016,True,5,0,146,146
166901,2019-10-03 00:00:00+03:00,out,False,896016,False,4,176,215,39
166901,2019-10-03 00:00:00+03:00,in,False,896018,False,1,27,53,26
166901,2019-10-03 00:00:00+03:00,in,False,896010,False,1,23,27,4
166901,2019-10-03 00:00:00+03:00,out,True,896008,False,2,64,74,10
166901,2019-10-03 00:00:00+03:00,in,False,896012,False,3,1344,1362,18
166901,2019-10-04 00:00:00+03:00,in,False,896016,False,2,107,153,46
166901,2019-10-04 00:00:00+03:00,in,False,896012,False,2,664,674,10
166901,2019-10-04 00:00:00+03:00,out,True,896008,False,1,17,30,13
166901,2019-10-04 00:00:00+03:00,out,True,896016,True,3,0,55,55
166901,2019-10-04 00:00:00+03:00,in,False,-1,True,6,0,0,0
166901,2019-10-04 00:00:00+03:00,in,False,896010,False,1,28,34,6
166901,2019-10-04 00:00:00+03:00,out,True,896016,True,3,0,55,55
166901,2019-10-05 00:00:00+03:00,in,False,-1,True,1,0,24,24
166901,2019-10-05 00:00:00+03:00,in,False,-1,True,1,0,24,24
166901,2019-10-07 00:00:00+03:00,out,True,896016,False,1,52,59,7
166901,2019-10-07 00:00:00+03:00,in,False,-1,True,17,0,41,41
166901,2019-10-07 00:00:00+03:00,out,True,896008,True,1,0,8,8
166901,2019-10-07 00:00:00+03:00,in,False,896016,False,5,288,333,45
166901,2019-10-07 00:00:00+03:00,in,False,896012,False,3,316,331,15
166901,2019-10-07 00:00:00+03:00,out,False,896016,False,1,295,308,13
166901,2019-10-08 00:00:00+03:00,out,True,896016,True,1,0,23,23
166901,2019-10-08 00:00:00+03:00,out,True,896008,False,1,18,21,3
166901,2019-10-08 00:00:00+03:00,in,False,-1,True,14,0,0,0
166901,2019-10-08 00:00:00+03:00,in,False,896012,False,1,181,186,5
166901,2019-10-09 00:00:00+03:00,in,False,896016,False,2,59,81,22
166901,2019-10-09 00:00:00+03:00,in,False,-1,True,14,0,0,0
166901,2019-10-09 00:00:00+03:00,in,False,896016,False,2,59,81,22
166901,2019-10-10 00:00:00+03:00,in,False,896012,False,6,1328,1354,26
166901,2019-10-10 00:00:00+03:00,in,False,-1,True,27,0,8,8
166901,2019-10-10 00:00:00+03:00,out,False,896016,True,1,0,37,37
166901,2019-10-10 00:00:00+03:00,out,True,896008,False,1,8,11,3
166901,2019-10-10 00:00:00+03:00,out,True,896016,True,1,0,17,17
166901,2019-10-10 00:00:00+03:00,in,False,896012,False,6,1328,1354,26
166901,2019-10-11 00:00:00+03:00,in,False,896016,False,1,1,5,4
166901,2019-10-11 00:00:00+03:00,out,True,896008,False,3,368,399,31
166901,2019-10-11 00:00:00+03:00,in,False,-1,True,35,0,30,30
166901,2019-10-11 00:00:00+03:00,out,True,896016,True,1,0,16,16
166901,2019-10-11 00:00:00+03:00,out,False,896016,True,2,0,30,30
166901,2019-10-11 00:00:00+03:00,in,False,-1,True,35,0,30,30
166901,2019-10-12 00:00:00+03:00,in,False,-1,True,1,0,46,46
166901,2019-10-13 00:00:00+03:00,in,False,896012,False,1,66,78,12
166901,2019-10-14 00:00:00+03:00,out,False,896016,False,2,175,194,19
166901,2019-10-14 00:00:00+03:00,out,True,896008,False,1,54,59,5
166901,2019-10-14 00:00:00+03:00,out,True,896016,True,1,0,18,18
166901,2019-10-14 00:00:00+03:00,in,False,-1,True,34,0,1,1
166901,2019-10-14 00:00:00+03:00,in,False,896012,False,6,1152,1187,35
166901,2019-10-15 00:00:00+03:00,out,False,896014,True,1,0,15,15
166901,2019-10-15 00:00:00+03:00,in,False,896012,False,9,711,746,35
166901,2019-10-15 00:00:00+03:00,out,True,896008,False,2,83,96,13
166901,2019-10-15 00:00:00+03:00,in,False,-1,True,8,0,72,72
166901,2019-10-15 00:00:00+03:00,out,False,896016,False,1,18,44,26
166901,2019-10-15 00:00:00+03:00,out,True,896016,True,1,0,14,14
166901,2019-10-15 00:00:00+03:00,in,False,-1,True,8,0,72,72
166901,2019-10-16 00:00:00+03:00,out,True,896016,True,1,0,29,29
166901,2019-10-16 00:00:00+03:00,out,True,896008,False,2,102,112,10
166901,2019-10-16 00:00:00+03:00,in,False,896012,False,6,631,667,36
166901,2019-10-16 00:00:00+03:00,in,False,-1,True,11,0,6,6
166901,2019-10-17 00:00:00+03:00,in,False,-1,True,6,0,60,60
166901,2019-10-17 00:00:00+03:00,out,False,896016,False,1,41,43,2
166901,2019-10-17 00:00:00+03:00,out,True,896008,False,1,13,25,12
166901,2019-10-17 00:00:00+03:00,out,False,896016,True,2,0,47,47
166901,2019-10-17 00:00:00+03:00,in,False,896012,False,3,474,484,10
166901,2019-10-18 00:00:00+03:00,in,False,-1,True,1,0,3,3
166901,2019-10-18 00:00:00+03:00,in,False,896012,False,2,90,97,7
166901,2019-10-18 00:00:00+03:00,out,True,896008,False,4,685,716,31
166901,2019-10-18 00:00:00+03:00,out,False,896016,True,1,0,2,2
166901,2019-10-21 00:00:00+03:00,out,True,896008,False,1,14,29,15
166901,2019-10-21 00:00:00+03:00,out,False,896016,False,1,143,163,20
166901,2019-10-21 00:00:00+03:00,in,False,896012,False,2,182,202,20
166901,2019-10-22 00:00:00+03:00,out,True,896016,False,2,112,125,13
166901,2019-10-22 00:00:00+03:00,out,False,896016,False,2,244,259,15
166901,2019-10-22 00:00:00+03:00,in,False,-1,True,1,0,8,8
166901,2019-10-22 00:00:00+03:00,out,False,896016,True,1,0,41,41
166901,2019-10-22 00:00:00+03:00,out,True,896008,False,2,144,164,20
166901,2019-10-22 00:00:00+03:00,out,True,896008,True,1,0,19,19
166901,2019-10-22 00:00:00+03:00,in,False,896012,False,3,533,547,14
166901,2019-10-22 00:00:00+03:00,in,False,896012,False,3,533,547,14
166901,2019-10-23 00:00:00+03:00,out,False,896016,False,3,283,310,27
166901,2019-10-23 00:00:00+03:00,in,False,896012,False,2,103,107,4
166901,2019-10-23 00:00:00+03:00,out,True,896016,False,1,83,89,6
166901,2019-10-23 00:00:00+03:00,out,True,896016,False,1,83,89,6
166901,2019-10-23 00:00:00+03:00,out,False,896016,False,3,283,310,27
166901,2019-10-24 00:00:00+03:00,in,False,896016,False,1,4,9,5
166901,2019-10-24 00:00:00+03:00,out,False,896016,True,3,0,69,69
166901,2019-10-24 00:00:00+03:00,out,False,896016,False,1,16,29,13
166901,2019-10-24 00:00:00+03:00,in,False,896014,False,1,31,51,20
166901,2019-10-24 00:00:00+03:00,in,False,-1,True,3,0,17,17
166901,2019-10-24 00:00:00+03:00,in,False,896012,False,12,1854,1900,46
166901,2019-10-24 00:00:00+03:00,in,False,896014,False,1,31,51,20
166901,2019-10-25 00:00:00+03:00,out,False,896016,True,1,0,15,15
166901,2019-10-25 00:00:00+03:00,in,False,896016,False,1,41,45,4
166901,2019-10-25 00:00:00+03:00,out,False,896014,True,2,0,31,31
166901,2019-10-25 00:00:00+03:00,out,True,896008,False,1,77,80,3
166901,2019-10-25 00:00:00+03:00,in,False,896012,False,6,437,468,31
166901,2019-10-25 00:00:00+03:00,in,False,-1,True,1,0,26,26
166901,2019-10-27 00:00:00+03:00,in,False,-1,True,2,0,60,60
166901,2019-10-28 00:00:00+03:00,out,True,896016,False,1,9,12,3
166901,2019-10-28 00:00:00+03:00,in,False,896012,False,9,680,738,58
166901,2019-10-28 00:00:00+03:00,in,False,896016,False,1,54,57,3
166901,2019-10-28 00:00:00+03:00,out,True,896008,False,1,27,29,2
166901,2019-10-28 00:00:00+03:00,out,False,896016,False,2,129,161,32
166901,2019-10-28 00:00:00+03:00,in,False,-1,True,8,0,0,0
166901,2019-10-28 00:00:00+03:00,out,True,896016,True,1,0,0,0
166901,2019-10-28 00:00:00+03:00,out,False,896016,True,2,0,37,37
166901,2019-10-28 00:00:00+03:00,out,True,896018,False,1,37,40,3
166901,2019-10-28 00:00:00+03:00,in,False,896012,False,9,680,738,58
166901,2019-10-29 00:00:00+03:00,in,False,896012,False,4,245,266,21
166901,2019-10-29 00:00:00+03:00,out,False,896018,True,1,0,44,44
166901,2019-10-29 00:00:00+03:00,out,False,896016,False,1,90,105,15
166901,2019-10-29 00:00:00+03:00,out,True,896016,False,1,18,20,2
166901,2019-10-29 00:00:00+03:00,in,False,-1,True,5,0,23,23
166901,2019-10-29 00:00:00+03:00,in,False,896012,False,4,245,266,21
166901,2019-10-29 00:00:00+03:00,out,True,896016,False,1,18,20,2
166901,2019-10-30 00:00:00+03:00,out,False,896016,False,2,110,124,14
166901,2019-10-30 00:00:00+03:00,out,True,896008,True,2,0,120,120
166901,2019-10-30 00:00:00+03:00,out,False,896016,True,1,0,0,0
166901,2019-10-30 00:00:00+03:00,in,False,896012,False,5,748,776,28
166901,2019-10-30 00:00:00+03:00,in,False,896014,False,1,116,122,6
166901,2019-10-30 00:00:00+03:00,in,False,-1,True,4,0,60,60
166901,2019-10-30 00:00:00+03:00,out,False,896016,True,1,0,0,0
166901,2019-10-31 00:00:00+03:00,out,True,896016,False,1,17,25,8
166901,2019-10-31 00:00:00+03:00,in,False,896014,False,1,76,80,4
166901,2019-10-31 00:00:00+03:00,in,False,896012,False,2,514,519,5
166901,2019-10-31 00:00:00+03:00,out,False,896016,False,1,235,258,23
166901,2019-10-31 00:00:00+03:00,out,False,896016,False,1,235,258,23
166901,2019-11-01 00:00:00+03:00,out,False,896016,False,1,203,212,9
166901,2019-11-01 00:00:00+03:00,in,False,896012,False,3,337,349,12
166901,2019-11-01 00:00:00+03:00,in,False,-1,True,2,0,68,68
166901,2019-11-01 00:00:00+03:00,out,True,896016,False,2,62,72,10
166901,2019-11-01 00:00:00+03:00,out,True,896008,False,4,617,652,35
166901,2019-11-01 00:00:00+03:00,out,True,896016,False,2,62,72,10
166901,2019-11-04 00:00:00+03:00,in,False,-1,True,3,0,109,109
166901,2019-11-05 00:00:00+03:00,in,False,896016,False,1,54,59,5
166901,2019-11-05 00:00:00+03:00,out,True,896016,False,2,49,73,24
166901,2019-11-05 00:00:00+03:00,out,True,896008,False,2,55,71,16
166901,2019-11-05 00:00:00+03:00,out,False,896016,False,1,43,53,10
166901,2019-11-05 00:00:00+03:00,in,False,896014,False,1,99,106,7
166901,2019-11-05 00:00:00+03:00,in,False,896018,False,1,26,73,47
166901,2019-11-05 00:00:00+03:00,out,True,896016,True,1,0,28,28
166901,2019-11-05 00:00:00+03:00,in,False,896012,False,8,902,935,33
166901,2019-11-06 00:00:00+03:00,out,True,896016,False,1,32,36,4
166901,2019-11-06 00:00:00+03:00,out,True,896008,False,1,12,20,8
166901,2019-11-06 00:00:00+03:00,in,False,896012,False,7,582,629,47
166901,2019-11-06 00:00:00+03:00,in,False,-1,True,2,0,43,43
166901,2019-11-06 00:00:00+03:00,out,True,896008,True,2,0,75,75
166901,2019-11-06 00:00:00+03:00,in,False,-1,True,2,0,43,43
166901,2019-11-07 00:00:00+03:00,out,True,896016,True,2,0,44,44
166901,2019-11-07 00:00:00+03:00,in,False,896012,False,5,470,493,23
166901,2019-11-07 00:00:00+03:00,out,True,896008,True,1,0,18,18
166901,2019-11-07 00:00:00+03:00,in,False,896016,False,1,95,99,4
166901,2019-11-07 00:00:00+03:00,out,True,896008,False,1,89,100,11
166901,2019-11-07 00:00:00+03:00,out,True,896008,False,1,89,100,11
166901,2019-11-08 00:00:00+03:00,in,False,896012,False,2,286,292,6
166901,2019-11-08 00:00:00+03:00,out,True,896008,False,1,22,45,23
166901,2019-11-08 00:00:00+03:00,out,False,896016,True,1,0,39,39
166901,2019-11-08 00:00:00+03:00,in,False,-1,True,4,0,0,0
166901,2019-11-10 00:00:00+03:00,in,False,-1,True,2,0,33,33
166901,2019-11-11 00:00:00+03:00,out,True,896008,False,2,22,35,13
166901,2019-11-11 00:00:00+03:00,out,True,896016,True,2,0,50,50
166901,2019-11-11 00:00:00+03:00,in,False,896012,False,5,469,505,36
166901,2019-11-11 00:00:00+03:00,in,False,896016,False,2,282,289,7
166901,2019-11-11 00:00:00+03:00,in,False,-1,True,2,0,62,62
166901,2019-11-12 00:00:00+03:00,in,False,896016,False,2,91,100,9
166901,2019-11-12 00:00:00+03:00,in,False,896010,False,1,57,94,37
166901,2019-11-12 00:00:00+03:00,out,True,896008,False,4,216,243,27
166901,2019-11-12 00:00:00+03:00,in,False,-1,True,1,0,61,61
166901,2019-11-12 00:00:00+03:00,in,False,896012,False,3,96,129,33
166901,2019-11-13 00:00:00+03:00,out,True,896016,True,2,0,28,28
166901,2019-11-13 00:00:00+03:00,in,False,896012,False,3,142,189,47
166901,2019-11-13 00:00:00+03:00,out,True,896008,False,2,304,315,11
166901,2019-11-13 00:00:00+03:00,out,False,896016,False,4,60,137,77
166901,2019-11-13 00:00:00+03:00,in,False,896016,False,1,81,85,4
166901,2019-11-14 00:00:00+03:00,out,True,896008,True,1,0,38,38
166901,2019-11-14 00:00:00+03:00,out,True,896016,True,1,0,30,30
166901,2019-11-14 00:00:00+03:00,out,False,896016,True,1,0,19,19
166901,2019-11-14 00:00:00+03:00,in,False,896012,False,1,259,266,7
166901,2019-11-14 00:00:00+03:00,in,False,896018,False,1,104,148,44
166901,2019-11-14 00:00:00+03:00,in,False,-1,True,3,0,4,4
166901,2019-11-15 00:00:00+03:00,in,False,-1,True,9,0,60,60
166901,2019-11-15 00:00:00+03:00,in,False,896012,False,6,622,671,49
166901,2019-11-15 00:00:00+03:00,in,False,896016,False,3,258,274,16
166901,2019-11-15 00:00:00+03:00,out,True,896008,False,3,270,307,37
166901,2019-11-15 00:00:00+03:00,out,True,896016,True,2,0,23,23
166901,2019-11-15 00:00:00+03:00,out,False,896016,False,1,131,138,7
166901,2019-11-15 00:00:00+03:00,out,False,896016,True,5,0,123,123
166901,2019-11-15 00:00:00+03:00,out,False,896016,True,5,0,123,123
166901,2019-11-15 00:00:00+03:00,in,False,896016,False,3,258,274,16
166901,2019-11-16 00:00:00+03:00,in,False,-1,True,5,0,141,141
166901,2019-11-16 00:00:00+03:00,in,False,-1,True,5,0,141,141
166901,2019-11-18 00:00:00+03:00,out,True,896008,False,1,23,29,6
166901,2019-11-18 00:00:00+03:00,out,True,896016,False,1,10,18,8
166901,2019-11-18 00:00:00+03:00,out,False,896016,False,2,593,615,22
166901,2019-11-18 00:00:00+03:00,in,False,-1,True,3,0,29,29
166901,2019-11-18 00:00:00+03:00,out,True,896008,True,3,0,0,0
166901,2019-11-18 00:00:00+03:00,in,False,896012,False,2,124,144,20
166901,2019-11-19 00:00:00+03:00,out,True,896008,False,3,114,137,23
166901,2019-11-19 00:00:00+03:00,in,False,896016,False,1,98,101,3
166901,2019-11-19 00:00:00+03:00,out,True,896008,True,1,0,0,0
166901,2019-11-19 00:00:00+03:00,out,True,896016,False,1,12,15,3
166901,2019-11-19 00:00:00+03:00,out,True,896016,True,3,0,86,86
166901,2019-11-19 00:00:00+03:00,in,False,-1,True,1,0,18,18
166901,2019-11-19 00:00:00+03:00,out,True,896016,False,1,12,15,3
166901,2019-11-20 00:00:00+03:00,in,False,-1,True,4,0,83,83
166901,2019-11-20 00:00:00+03:00,out,True,896008,False,5,351,385,34
166901,2019-11-20 00:00:00+03:00,in,False,896016,False,5,355,403,48
166901,2019-11-20 00:00:00+03:00,out,True,896016,False,3,64,75,11
166901,2019-11-20 00:00:00+03:00,out,True,896008,True,1,0,52,52
166901,2019-11-20 00:00:00+03:00,out,False,896016,False,1,8,11,3
166901,2019-11-20 00:00:00+03:00,in,False,896012,False,1,404,422,18
166901,2019-11-20 00:00:00+03:00,out,True,896016,True,1,0,26,26
166901,2019-11-21 00:00:00+03:00,out,True,896016,False,1,24,28,4
166901,2019-11-21 00:00:00+03:00,in,False,896012,True,1,0,6,6
166901,2019-11-21 00:00:00+03:00,in,False,896012,False,2,276,297,21
166901,2019-11-21 00:00:00+03:00,in,False,-1,True,6,0,1,1
166901,2019-11-21 00:00:00+03:00,out,True,896008,False,3,364,388,24
166901,2019-11-21 00:00:00+03:00,in,False,896016,False,1,22,50,28
166901,2019-11-21 00:00:00+03:00,out,False,896016,True,2,0,47,47
166901,2019-11-21 00:00:00+03:00,out,False,896016,False,3,441,476,35
166901,2019-11-22 00:00:00+03:00,in,False,896010,False,1,38,69,31
166901,2019-11-22 00:00:00+03:00,in,False,-1,True,2,0,38,38
166901,2019-11-22 00:00:00+03:00,out,True,896016,True,1,0,29,29
166901,2019-11-22 00:00:00+03:00,out,False,896016,False,2,81,93,12
166901,2019-11-22 00:00:00+03:00,in,False,896016,False,2,265,275,10
166901,2019-11-22 00:00:00+03:00,out,False,896016,True,1,0,34,34
166901,2019-11-22 00:00:00+03:00,in,False,896012,False,1,150,156,6
166901,2019-11-22 00:00:00+03:00,out,True,896016,True,1,0,29,29
166901,2019-11-25 00:00:00+03:00,in,False,896016,False,1,56,66,10
166901,2019-11-25 00:00:00+03:00,out,False,896016,False,7,512,579,67
166901,2019-11-25 00:00:00+03:00,out,True,896008,False,2,39,61,22
166901,2019-11-25 00:00:00+03:00,in,False,-1,True,2,0,4,4
166901,2019-11-25 00:00:00+03:00,out,True,896016,False,1,52,55,3
166901,2019-11-25 00:00:00+03:00,out,True,896008,True,1,0,51,51
166901,2019-11-25 00:00:00+03:00,out,True,896016,True,2,0,54,54
166901,2019-11-25 00:00:00+03:00,out,False,896016,True,4,0,7,7
166901,2019-11-25 00:00:00+03:00,in,False,896012,False,3,773,794,21
166901,2019-11-26 00:00:00+03:00,in,False,-1,True,2,0,0,0
166901,2019-11-26 00:00:00+03:00,out,False,896016,False,1,191,202,11
166901,2019-11-26 00:00:00+03:00,in,False,896014,False,1,9,25,16
166901,2019-11-26 00:00:00+03:00,in,False,896012,False,2,145,157,12
166901,2019-11-26 00:00:00+03:00,in,False,896016,False,1,53,57,4
166901,2019-11-26 00:00:00+03:00,out,True,896008,False,2,28,38,10
166901,2019-11-26 00:00:00+03:00,out,True,896016,True,1,0,28,28
166901,2019-11-27 00:00:00+03:00,out,True,896016,False,1,52,62,10
166901,2019-11-27 00:00:00+03:00,in,False,896014,False,1,103,112,9
166901,2019-11-27 00:00:00+03:00,out,False,896016,True,3,0,80,80
166901,2019-11-27 00:00:00+03:00,out,True,896008,True,1,0,29,29
166901,2019-11-27 00:00:00+03:00,in,False,896012,False,7,539,577,38
166901,2019-11-27 00:00:00+03:00,out,True,896016,True,2,0,29,29
166901,2019-11-27 00:00:00+03:00,in,False,896016,False,18,1295,1442,147
166901,2019-11-27 00:00:00+03:00,in,False,896010,False,2,72,98,26
166901,2019-11-27 00:00:00+03:00,out,True,896014,True,1,0,0,0
166901,2019-11-27 00:00:00+03:00,in,False,-1,True,1,0,5,5
166901,2019-11-27 00:00:00+03:00,out,False,896016,False,15,2709,2877,168
166901,2019-11-27 00:00:00+03:00,out,False,896010,True,1,0,11,11
166901,2019-11-27 00:00:00+03:00,out,False,896016,False,15,2709,2877,168
166901,2019-11-27 00:00:00+03:00,out,True,896016,True,2,0,29,29
166901,2019-11-28 00:00:00+03:00,out,False,896016,True,8,0,287,287
166901,2019-11-28 00:00:00+03:00,out,True,896016,True,3,0,25,25
166901,2019-11-28 00:00:00+03:00,out,False,896016,False,16,1727,1844,117
166901,2019-11-28 00:00:00+03:00,in,False,896012,False,9,713,780,67
166901,2019-11-28 00:00:00+03:00,out,True,896008,False,2,711,723,12
166901,2019-11-28 00:00:00+03:00,in,False,-1,True,3,0,28,28
166901,2019-11-28 00:00:00+03:00,out,False,896014,False,1,32,39,7
166901,2019-11-28 00:00:00+03:00,out,False,896014,False,1,32,39,7
166908,2019-08-27 00:00:00+03:00,in,False,-1,True,2,0,30,30
166908,2019-08-27 00:00:00+03:00,in,False,895786,False,1,59,87,28
166908,2019-08-27 00:00:00+03:00,in,False,-1,True,3,0,104,104
166908,2019-08-27 00:00:00+03:00,in,False,-1,True,3,0,104,104
166908,2019-08-29 00:00:00+03:00,in,False,895782,False,2,81,119,38
166908,2019-08-29 00:00:00+03:00,in,False,895786,False,2,182,230,48
166908,2019-08-30 00:00:00+03:00,in,False,895786,False,2,45,79,34
166908,2019-08-30 00:00:00+03:00,in,False,895782,False,3,108,150,42
166908,2019-08-31 00:00:00+03:00,in,False,895786,False,3,86,145,59
166908,2019-08-31 00:00:00+03:00,in,False,895782,False,2,82,106,24
166908,2019-09-01 00:00:00+03:00,in,False,-1,True,1,0,5,5
166908,2019-09-02 00:00:00+03:00,in,False,895782,False,2,115,150,35
166908,2019-09-02 00:00:00+03:00,in,False,895786,False,2,55,83,28
166908,2019-09-03 00:00:00+03:00,in,False,895786,False,3,108,183,75
166908,2019-09-03 00:00:00+03:00,in,False,895782,False,1,15,37,22
166908,2019-09-04 00:00:00+03:00,in,False,895786,False,4,254,342,88
166908,2019-09-04 00:00:00+03:00,in,False,895786,False,4,254,342,88
166908,2019-09-05 00:00:00+03:00,in,False,895782,False,1,13,50,37
166908,2019-09-05 00:00:00+03:00,in,False,895782,False,1,13,50,37
166908,2019-09-09 00:00:00+03:00,in,False,-1,True,1,0,6,6
166908,2019-09-16 00:00:00+03:00,in,False,895786,False,4,162,220,58
166908,2019-09-16 00:00:00+03:00,in,False,895786,False,4,162,220,58
166908,2019-09-17 00:00:00+03:00,in,False,895786,False,5,408,585,177
166908,2019-09-17 00:00:00+03:00,in,False,-1,True,1,0,10,10
166908,2019-09-18 00:00:00+03:00,in,False,895786,False,5,313,440,127
166908,2019-09-20 00:00:00+03:00,in,False,895786,False,1,58,83,25
166908,2019-09-25 00:00:00+03:00,in,False,-1,True,2,0,6,6
166908,2019-09-25 00:00:00+03:00,in,False,895786,False,1,8,34,26
166908,2019-09-26 00:00:00+03:00,in,False,-1,True,1,0,3,3
166908,2019-09-27 00:00:00+03:00,in,False,-1,True,1,0,8,8
166908,2019-10-07 00:00:00+03:00,in,False,-1,True,1,0,8,8
166908,2019-10-07 00:00:00+03:00,in,False,895786,False,1,29,51,22
166908,2019-10-07 00:00:00+03:00,in,False,895782,False,1,36,61,25
166908,2019-10-08 00:00:00+03:00,in,False,895786,False,2,326,364,38
166908,2019-10-08 00:00:00+03:00,in,False,895782,False,1,37,63,26
166908,2019-10-08 00:00:00+03:00,in,False,895786,False,2,326,364,38
166908,2019-10-09 00:00:00+03:00,in,False,-1,True,1,0,7,7
166916,2019-08-24 00:00:00+03:00,in,False,-1,True,2,0,4,4
166916,2019-08-25 00:00:00+03:00,in,False,-1,True,1,0,2,2
166916,2019-08-26 00:00:00+03:00,in,False,-1,True,1,0,2,2
166916,2019-08-27 00:00:00+03:00,in,False,-1,True,3,0,6,6
166916,2019-08-28 00:00:00+03:00,in,False,-1,True,2,0,4,4
166916,2019-08-29 00:00:00+03:00,in,False,-1,True,2,0,4,4
166916,2019-08-30 00:00:00+03:00,in,False,-1,True,3,0,6,6
166916,2019-08-30 00:00:00+03:00,in,False,-1,True,3,0,6,6
166916,2019-08-31 00:00:00+03:00,in,False,-1,True,2,0,4,4
166916,2019-09-01 00:00:00+03:00,in,False,-1,True,1,0,2,2
166916,2019-09-01 00:00:00+03:00,in,False,-1,True,1,0,2,2
166916,2019-09-02 00:00:00+03:00,in,False,-1,True,3,0,6,6
166916,2019-09-03 00:00:00+03:00,in,False,-1,True,1,0,2,2
166916,2019-09-04 00:00:00+03:00,in,False,-1,True,3,0,7,7
166916,2019-09-06 00:00:00+03:00,in,False,-1,True,3,0,6,6
166916,2019-09-06 00:00:00+03:00,in,False,-1,True,3,0,6,6
166916,2019-09-07 00:00:00+03:00,in,False,-1,True,1,0,2,2
166916,2019-09-08 00:00:00+03:00,out,False,906396,True,2,0,0,0
166916,2019-09-08 00:00:00+03:00,out,False,906398,True,1,0,0,0
166916,2019-09-08 00:00:00+03:00,in,False,906396,False,1,9,18,9
166916,2019-09-09 00:00:00+03:00,in,False,-1,True,3,0,22,22
166916,2019-09-09 00:00:00+03:00,out,False,906392,True,1,0,0,0
166916,2019-09-10 00:00:00+03:00,in,False,-1,True,1,0,4,4
166916,2019-09-12 00:00:00+03:00,in,False,-1,True,9,0,12,12
166916,2019-09-13 00:00:00+03:00,in,False,-1,True,4,0,9,9
166916,2019-09-16 00:00:00+03:00,in,False,-1,True,15,0,25,25
166916,2019-09-17 00:00:00+03:00,in,False,-1,True,6,0,57,57
166916,2019-09-17 00:00:00+03:00,in,False,906392,False,1,9,15,6
166916,2019-09-17 00:00:00+03:00,in,False,906392,False,1,9,15,6
166916,2019-09-18 00:00:00+03:00,in,False,-1,True,1,0,53,53
166916,2019-09-18 00:00:00+03:00,in,False,906392,False,1,41,63,22
166916,2019-09-20 00:00:00+03:00,in,False,906392,False,2,100,126,26
166916,2019-09-20 00:00:00+03:00,out,True,906392,True,1,0,9,9
166916,2019-09-20 00:00:00+03:00,out,True,906396,True,1,0,11,11
166916,2019-09-20 00:00:00+03:00,out,True,906398,True,1,0,6,6
166916,2019-09-20 00:00:00+03:00,in,False,-1,True,18,0,176,176
166916,2019-09-22 00:00:00+03:00,in,False,-1,True,1,0,31,31
166916,2019-09-23 00:00:00+03:00,in,False,-1,True,2,0,4,4
166916,2019-09-24 00:00:00+03:00,in,False,-1,True,1,0,2,2
166916,2019-09-26 00:00:00+03:00,out,False,906394,False,1,6,9,3
166916,2019-09-26 00:00:00+03:00,out,True,906394,True,3,0,21,21
166916,2019-09-26 00:00:00+03:00,out,False,906396,True,1,0,8,8
166916,2019-09-26 00:00:00+03:00,out,False,906396,False,1,4,7,3
166916,2019-09-26 00:00:00+03:00,out,True,906402,True,2,0,18,18
166916,2019-09-26 00:00:00+03:00,in,False,-1,True,19,0,306,306
166916,2019-09-26 00:00:00+03:00,out,False,906402,True,1,0,7,7
166916,2019-09-26 00:00:00+03:00,out,False,906396,True,1,0,8,8
166916,2019-09-27 00:00:00+03:00,in,False,906396,False,9,1278,1612,334
166916,2019-09-27 00:00:00+03:00,out,True,906404,True,3,0,5,5
166916,2019-09-27 00:00:00+03:00,out,False,906400,True,2,0,5,5
166916,2019-09-27 00:00:00+03:00,out,True,906396,False,14,1190,1295,105
166916,2019-09-27 00:00:00+03:00,out,True,906402,False,1,85,88,3
166916,2019-09-27 00:00:00+03:00,out,True,906400,False,3,109,118,9
166916,2019-09-27 00:00:00+03:00,in,False,-1,True,30,0,538,538
166916,2019-09-27 00:00:00+03:00,out,False,906394,True,1,0,9,9
166916,2019-09-27 00:00:00+03:00,out,False,906400,False,5,366,409,43
166916,2019-09-27 00:00:00+03:00,out,False,906396,False,2,183,206,23
166916,2019-09-27 00:00:00+03:00,out,False,906394,False,6,1458,1509,51
166916,2019-09-27 00:00:00+03:00,in,False,906404,False,26,2976,3986,1010
166916,2019-09-27 00:00:00+03:00,out,False,906404,False,11,1667,1784,117
166916,2019-09-27 00:00:00+03:00,in,False,906402,False,2,316,406,90
166916,2019-09-27 00:00:00+03:00,out,True,906400,True,2,0,11,11
166916,2019-09-27 00:00:00+03:00,out,False,906396,True,2,0,28,28
166916,2019-09-27 00:00:00+03:00,out,True,906394,False,2,48,54,6
166916,2019-09-27 00:00:00+03:00,out,True,906394,True,1,25,50,25
166916,2019-09-27 00:00:00+03:00,out,True,906396,True,11,0,49,49
166916,2019-09-27 00:00:00+03:00,out,True,906404,False,2,161,173,12
166916,2019-09-27 00:00:00+03:00,out,False,906404,True,2,0,86,86
166916,2019-09-27 00:00:00+03:00,in,False,906404,False,26,2976,3986,1010
166916,2019-09-28 00:00:00+03:00,in,False,-1,True,9,0,174,174
166916,2019-09-28 00:00:00+03:00,out,False,906392,False,1,3,3,0
166916,2019-09-28 00:00:00+03:00,out,False,906392,False,1,3,3,0
166916,2019-09-29 00:00:00+03:00,in,False,-1,True,1,0,6,6
166916,2019-09-30 00:00:00+03:00,out,False,906408,False,2,71,81,10
166916,2019-09-30 00:00:00+03:00,out,False,906396,False,3,604,628,24
166916,2019-09-30 00:00:00+03:00,out,False,906394,True,1,0,5,5
166916,2019-09-30 00:00:00+03:00,out,True,906400,True,1,0,1,1
166916,2019-09-30 00:00:00+03:00,out,False,906410,True,2,0,4,4
166916,2019-09-30 00:00:00+03:00,out,True,906406,True,3,0,4,4
166916,2019-09-30 00:00:00+03:00,out,False,906394,False,2,909,920,11
166916,2019-09-30 00:00:00+03:00,out,True,906406,False,18,777,866,89
166916,2019-09-30 00:00:00+03:00,in,False,906400,False,7,780,1056,276
166916,2019-09-30 00:00:00+03:00,out,True,906394,True,2,0,0,0
166916,2019-09-30 00:00:00+03:00,out,False,906406,False,14,965,1125,160
166916,2019-09-30 00:00:00+03:00,in,False,906396,False,10,2309,2583,274
166916,2019-09-30 00:00:00+03:00,out,True,906394,False,2,12,19,7
166916,2019-09-30 00:00:00+03:00,in,False,906408,True,1,0,63,63
166916,2019-09-30 00:00:00+03:00,in,False,-1,True,15,0,311,311
166916,2019-09-30 00:00:00+03:00,out,False,906406,True,8,0,127,127
166916,2019-09-30 00:00:00+03:00,in,False,906394,False,2,287,342,55
166916,2019-09-30 00:00:00+03:00,out,True,906408,True,4,0,15,15
166916,2019-09-30 00:00:00+03:00,in,False,906408,False,18,1288,1839,551
166916,2019-09-30 00:00:00+03:00,in,False,906410,False,8,346,565,219
166916,2019-09-30 00:00:00+03:00,out,True,906400,False,3,141,151,10
166916,2019-09-30 00:00:00+03:00,out,False,906410,False,1,207,210,3
166916,2019-09-30 00:00:00+03:00,in,False,906398,False,4,365,452,87
166916,2019-09-30 00:00:00+03:00,out,True,906408,False,2,73,88,15
166916,2019-09-30 00:00:00+03:00,out,True,906398,False,1,12,18,6
166916,2019-09-30 00:00:00+03:00,in,False,906406,False,37,4359,5310,951
166916,2019-09-30 00:00:00+03:00,out,True,906396,False,1,42,50,8
166916,2019-10-01 00:00:00+03:00,out,True,906408,False,1,23,31,8
166916,2019-10-01 00:00:00+03:00,in,False,906394,False,1,230,271,41
166916,2019-10-01 00:00:00+03:00,out,True,906400,False,4,160,176,16
166916,2019-10-01 00:00:00+03:00,in,False,906406,False,23,2476,3065,589
166916,2019-10-01 00:00:00+03:00,out,True,906406,False,6,115,158,43
166916,2019-10-01 00:00:00+03:00,out,True,906394,False,10,372,420,48
166916,2019-10-01 00:00:00+03:00,out,False,906400,True,2,0,60,60
166916,2019-10-01 00:00:00+03:00,out,False,906396,False,5,489,507,18
166916,2019-10-01 00:00:00+03:00,out,False,906394,True,2,0,54,54
166916,2019-10-01 00:00:00+03:00,in,False,906408,False,20,3048,3633,585
166916,2019-10-01 00:00:00+03:00,out,False,906392,False,1,24,26,2
166916,2019-10-01 00:00:00+03:00,out,False,906406,True,8,0,141,141
166916,2019-10-01 00:00:00+03:00,in,False,906400,False,7,770,1008,238
166916,2019-10-01 00:00:00+03:00,in,False,-1,True,23,0,230,230
166916,2019-10-01 00:00:00+03:00,in,False,906410,False,2,101,151,50
166916,2019-10-01 00:00:00+03:00,in,False,906408,True,1,71,106,35
166916,2019-10-01 00:00:00+03:00,out,False,906406,False,21,1413,1637,224
166916,2019-10-01 00:00:00+03:00,out,False,906400,False,13,1512,1657,145
166916,2019-10-01 00:00:00+03:00,in,False,906402,False,1,46,113,67
166916,2019-10-01 00:00:00+03:00,out,True,906406,True,3,0,1,1
166916,2019-10-01 00:00:00+03:00,out,True,906408,True,6,0,11,11
166916,2019-10-01 00:00:00+03:00,in,False,906398,False,6,949,1076,127
166916,2019-10-01 00:00:00+03:00,out,False,906408,False,1,83,101,18
166916,2019-10-01 00:00:00+03:00,out,False,906394,False,10,2679,2809,130
166916,2019-10-01 00:00:00+03:00,out,False,-1,True,1,0,0,0
166916,2019-10-01 00:00:00+03:00,out,True,906396,True,2,0,2,2
166916,2019-10-01 00:00:00+03:00,out,True,906394,True,5,0,52,52
166916,2019-10-01 00:00:00+03:00,in,False,906396,True,1,81,127,46
166916,2019-10-01 00:00:00+03:00,out,True,906392,True,2,0,50,50
166916,2019-10-01 00:00:00+03:00,out,True,906396,False,4,428,462,34
166916,2019-10-01 00:00:00+03:00,in,False,906396,False,7,606,827,221
166916,2019-10-01 00:00:00+03:00,out,True,906408,True,6,0,11,11
166916,2019-10-01 00:00:00+03:00,out,True,906396,False,4,428,462,34
166916,2019-10-01 00:00:00+03:00,out,True,906408,False,1,23,31,8
166916,2019-10-01 00:00:00+03:00,out,True,906394,False,10,372,420,48
166916,2019-10-01 00:00:00+03:00,out,True,906406,False,6,115,158,43
166916,2019-10-02 00:00:00+03:00,in,False,906410,False,6,230,365,135
166916,2019-10-02 00:00:00+03:00,out,True,906406,True,1,0,1,1
166916,2019-10-02 00:00:00+03:00,out,True,906400,False,2,87,99,12
166916,2019-10-02 00:00:00+03:00,out,True,906392,False,1,13,20,7
166916,2019-10-02 00:00:00+03:00,out,True,906400,True,3,0,4,4
166916,2019-10-02 00:00:00+03:00,in,False,906396,False,4,155,270,115
166916,2019-10-02 00:00:00+03:00,out,False,906406,True,10,0,228,228
166916,2019-10-02 00:00:00+03:00,in,False,906394,False,1,503,529,26
166916,2019-10-02 00:00:00+03:00,out,True,906406,False,5,128,152,24
166916,2019-10-02 00:00:00+03:00,out,True,906394,True,1,0,1,1
166916,2019-10-02 00:00:00+03:00,in,False,-1,True,17,0,232,232
166916,2019-10-02 00:00:00+03:00,in,False,906406,False,20,2809,3325,516
166916,2019-10-02 00:00:00+03:00,out,False,906396,False,3,334,348,14
166916,2019-10-02 00:00:00+03:00,out,True,906396,True,2,0,16,16
166916,2019-10-02 00:00:00+03:00,in,False,906400,False,2,119,173,54
166916,2019-10-02 00:00:00+03:00,out,True,906408,True,1,0,28,28
166916,2019-10-02 00:00:00+03:00,out,True,906402,False,1,24,28,4
166916,2019-10-02 00:00:00+03:00,out,True,906394,False,15,523,573,50
166916,2019-10-02 00:00:00+03:00,out,True,906392,True,1,0,18,18
166916,2019-10-02 00:00:00+03:00,in,False,906396,True,1,93,143,50
166916,2019-10-02 00:00:00+03:00,out,True,906398,False,1,42,45,3
166916,2019-10-02 00:00:00+03:00,out,True,906396,False,2,209,228,19
166916,2019-10-02 00:00:00+03:00,in,False,906408,False,17,3139,3683,544
166916,2019-10-02 00:00:00+03:00,out,False,906400,False,8,711,805,94
166916,2019-10-02 00:00:00+03:00,out,False,906406,False,13,1190,1327,137
166916,2019-10-02 00:00:00+03:00,out,True,906408,False,4,125,148,23
166916,2019-10-02 00:00:00+03:00,in,False,906398,False,2,295,333,38
166916,2019-10-02 00:00:00+03:00,out,True,906392,False,1,13,20,7
166916,2019-10-02 00:00:00+03:00,in,False,906408,False,17,3139,3683,544
166916,2019-10-02 00:00:00+03:00,out,True,906408,False,4,125,148,23
166916,2019-10-03 00:00:00+03:00,in,False,906400,False,6,548,735,187
166916,2019-10-03 00:00:00+03:00,out,False,906410,False,2,299,307,8
166916,2019-10-03 00:00:00+03:00,in,False,906408,False,8,1626,1845,219
166916,2019-10-03 00:00:00+03:00,out,True,906406,False,8,282,346,64
166916,2019-10-03 00:00:00+03:00,in,False,906394,False,1,269,296,27
166916,2019-10-03 00:00:00+03:00,in,False,906396,False,4,329,441,112
166916,2019-10-03 00:00:00+03:00,out,False,906410,True,1,0,2,2
166916,2019-10-03 00:00:00+03:00,in,False,906406,False,22,3116,3715,599
166916,2019-10-03 00:00:00+03:00,out,True,906396,False,5,436,467,31
166916,2019-10-03 00:00:00+03:00,out,False,906400,True,1,0,9,9
166916,2019-10-03 00:00:00+03:00,out,False,906400,False,5,282,339,57
166916,2019-10-03 00:00:00+03:00,out,False,906398,False,1,272,274,2
166916,2019-10-03 00:00:00+03:00,out,False,906406,True,9,0,133,133
166916,2019-10-03 00:00:00+03:00,out,True,906406,True,4,0,3,3
166916,2019-10-03 00:00:00+03:00,out,True,906408,True,4,0,39,39
166916,2019-10-03 00:00:00+03:00,out,False,906406,False,31,2045,2414,369
166916,2019-10-03 00:00:00+03:00,in,False,-1,True,8,0,78,78
166916,2019-10-03 00:00:00+03:00,out,True,906400,False,10,439,476,37
166916,2019-10-03 00:00:00+03:00,out,False,906396,False,2,104,107,3
166916,2019-10-03 00:00:00+03:00,out,True,906394,False,1,7,10,3
166916,2019-10-03 00:00:00+03:00,out,True,906396,True,2,0,17,17
166916,2019-10-03 00:00:00+03:00,out,True,906408,False,3,243,282,39
166916,2019-10-03 00:00:00+03:00,in,False,906410,False,25,1132,1783,651
166916,2019-10-03 00:00:00+03:00,out,True,906394,True,2,0,19,19
166916,2019-10-03 00:00:00+03:00,out,True,906392,True,10,0,30,30
166916,2019-10-03 00:00:00+03:00,out,True,906406,True,4,0,3,3
166916,2019-10-03 00:00:00+03:00,in,False,906406,False,22,3116,3715,599
166916,2019-10-03 00:00:00+03:00,out,False,906400,True,1,0,9,9
166916,2019-10-03 00:00:00+03:00,out,False,906410,False,2,299,307,8
166916,2019-10-04 00:00:00+03:00,out,True,906406,True,3,3,39,36
166916,2019-10-04 00:00:00+03:00,in,False,906396,False,1,87,113,26
166916,2019-10-04 00:00:00+03:00,in,False,906410,False,6,381,550,169
166916,2019-10-04 00:00:00+03:00,out,True,906392,True,3,0,30,30
166916,2019-10-04 00:00:00+03:00,in,False,906398,False,3,265,353,88
166916,2019-10-04 00:00:00+03:00,out,True,906406,False,5,187,208,21
166916,2019-10-04 00:00:00+03:00,out,True,906400,True,2,0,14,14
166916,2019-10-04 00:00:00+03:00,out,False,906406,False,16,926,1121,195
166916,2019-10-04 00:00:00+03:00,in,False,906400,False,2,366,424,58
166916,2019-10-04 00:00:00+03:00,in,False,906408,False,8,1429,1647,218
166916,2019-10-04 00:00:00+03:00,out,True,906396,False,4,234,257,23
166916,2019-10-04 00:00:00+03:00,out,False,906410,False,1,69,75,6
166916,2019-10-04 00:00:00+03:00,in,False,906406,False,15,1603,2080,477
166916,2019-10-04 00:00:00+03:00,out,True,906394,False,13,285,365,80
166916,2019-10-04 00:00:00+03:00,out,False,906394,True,2,0,35,35
166916,2019-10-04 00:00:00+03:00,in,False,906394,False,1,43,59,16
166916,2019-10-04 00:00:00+03:00,out,False,906406,True,7,0,86,86
166916,2019-10-04 00:00:00+03:00,out,True,906394,True,7,0,58,58
166916,2019-10-04 00:00:00+03:00,in,False,-1,True,8,0,111,111
166916,2019-10-04 00:00:00+03:00,out,True,906408,False,2,104,126,22
166916,2019-10-04 00:00:00+03:00,out,False,906396,False,2,85,111,26
166916,2019-10-04 00:00:00+03:00,out,True,906400,False,4,143,210,67
166916,2019-10-04 00:00:00+03:00,out,False,906394,False,5,2310,2384,74
166916,2019-10-04 00:00:00+03:00,out,True,906408,True,5,0,9,9
166916,2019-10-04 00:00:00+03:00,out,True,906392,True,3,0,30,30
166916,2019-10-04 00:00:00+03:00,out,True,906406,False,5,187,208,21
166916,2019-10-05 00:00:00+03:00,in,False,-1,True,2,0,41,41
166916,2019-10-05 00:00:00+03:00,in,False,-1,False,1,39,54,15
166916,2019-10-06 00:00:00+03:00,in,False,-1,True,1,0,28,28
166916,2019-10-07 00:00:00+03:00,in,False,-1,True,3,0,47,47
166916,2019-10-07 00:00:00+03:00,out,True,906400,False,2,35,48,13
166916,2019-10-07 00:00:00+03:00,in,False,906400,False,5,277,391,114
166916,2019-10-07 00:00:00+03:00,in,False,906404,False,16,3765,4140,375
166916,2019-10-07 00:00:00+03:00,out,False,906400,False,2,161,179,18
166916,2019-10-07 00:00:00+03:00,in,False,906406,False,20,2665,3262,597
166916,2019-10-07 00:00:00+03:00,out,False,906406,True,3,0,21,21
166916,2019-10-07 00:00:00+03:00,out,False,906406,False,8,498,577,79
166916,2019-10-07 00:00:00+03:00,out,False,906410,False,2,11,23,12
166916,2019-10-07 00:00:00+03:00,out,False,906404,False,17,2095,2264,169
166916,2019-10-07 00:00:00+03:00,out,True,906400,True,2,19,34,15
166916,2019-10-07 00:00:00+03:00,out,True,906406,True,2,0,2,2
166916,2019-10-07 00:00:00+03:00,out,False,906400,True,1,0,11,11
166916,2019-10-07 00:00:00+03:00,out,False,906404,True,9,0,135,135
166916,2019-10-07 00:00:00+03:00,out,True,906406,False,12,658,724,66
166916,2019-10-07 00:00:00+03:00,in,False,906398,False,1,117,153,36
166916,2019-10-07 00:00:00+03:00,in,False,906410,False,7,371,585,214
166916,2019-10-07 00:00:00+03:00,in,False,906410,True,2,0,51,51
166916,2019-10-07 00:00:00+03:00,in,False,906400,False,5,277,391,114
166916,2019-10-07 00:00:00+03:00,in,False,906410,True,2,0,51,51
166916,2019-10-07 00:00:00+03:00,out,False,906406,False,8,498,577,79
166916,2019-10-07 00:00:00+03:00,in,False,906406,False,20,2665,3262,597
166916,2019-10-07 00:00:00+03:00,out,True,906400,False,2,35,48,13
166916,2019-10-08 00:00:00+03:00,out,True,906400,True,1,0,7,7
166916,2019-10-08 00:00:00+03:00,out,False,906400,False,9,616,685,69
166916,2019-10-08 00:00:00+03:00,in,False,906408,False,6,536,681,145
166916,2019-10-08 00:00:00+03:00,in,False,906400,False,2,177,226,49
166916,2019-10-08 00:00:00+03:00,in,False,906400,True,1,39,66,27
166916,2019-10-08 00:00:00+03:00,out,True,906404,False,3,209,231,22
166916,2019-10-08 00:00:00+03:00,in,False,-1,True,4,0,35,35
166916,2019-10-08 00:00:00+03:00,out,False,906406,False,8,352,457,105
166916,2019-10-08 00:00:00+03:00,out,False,906404,True,2,0,120,120
166916,2019-10-08 00:00:00+03:00,out,False,906406,True,5,0,91,91
166916,2019-10-08 00:00:00+03:00,out,False,906410,False,1,517,521,4
166916,2019-10-08 00:00:00+03:00,in,False,906410,False,10,570,784,214
166916,2019-10-08 00:00:00+03:00,in,False,906404,False,14,2007,2354,347
166916,2019-10-08 00:00:00+03:00,out,False,906400,True,1,0,13,13
166916,2019-10-08 00:00:00+03:00,in,False,906406,False,16,2020,2416,396
166916,2019-10-08 00:00:00+03:00,out,True,906406,False,9,467,518,51
166916,2019-10-08 00:00:00+03:00,out,True,906404,True,2,0,23,23
166916,2019-10-08 00:00:00+03:00,out,True,906408,False,7,245,293,48
166916,2019-10-08 00:00:00+03:00,out,False,906404,False,12,1308,1417,109
166916,2019-10-08 00:00:00+03:00,out,False,-1,True,1,0,0,0
166916,2019-10-08 00:00:00+03:00,out,True,906400,False,4,113,124,11
166916,2019-10-08 00:00:00+03:00,in,False,906398,False,6,747,888,141
166916,2019-10-08 00:00:00+03:00,out,True,906408,True,4,0,1,1
166916,2019-10-08 00:00:00+03:00,in,False,906400,True,1,39,66,27
166916,2019-10-08 00:00:00+03:00,in,False,906410,False,10,570,784,214
166916,2019-10-09 00:00:00+03:00,out,True,906392,True,2,0,13,13
166916,2019-10-09 00:00:00+03:00,in,False,-1,True,8,0,86,86
166916,2019-10-09 00:00:00+03:00,out,False,906404,False,15,2231,2360,129
166916,2019-10-09 00:00:00+03:00,out,True,906400,True,4,0,5,5
166916,2019-10-09 00:00:00+03:00,out,False,906406,True,8,0,188,188
166916,2019-10-09 00:00:00+03:00,out,True,906404,False,1,31,41,10
166916,2019-10-09 00:00:00+03:00,out,True,906408,True,2,0,10,10
166916,2019-10-09 00:00:00+03:00,out,False,906400,False,4,635,643,8
166916,2019-10-09 00:00:00+03:00,in,False,906406,False,28,2412,3232,820
166916,2019-10-09 00:00:00+03:00,out,True,906412,True,1,0,9,9
166916,2019-10-09 00:00:00+03:00,out,True,906406,False,5,387,415,28
166916,2019-10-09 00:00:00+03:00,out,False,906412,False,1,24,27,3
166916,2019-10-09 00:00:00+03:00,out,True,906400,False,4,139,152,13
166916,2019-10-09 00:00:00+03:00,out,False,906406,False,18,1289,1496,207
166916,2019-10-09 00:00:00+03:00,out,True,906404,True,1,0,12,12
166916,2019-10-09 00:00:00+03:00,in,False,906408,False,28,3498,4322,824
166916,2019-10-09 00:00:00+03:00,out,True,906408,False,1,30,33,3
166916,2019-10-09 00:00:00+03:00,out,False,906404,True,2,0,72,72
166916,2019-10-09 00:00:00+03:00,out,True,906406,True,1,0,18,18
166916,2019-10-09 00:00:00+03:00,in,False,906400,False,2,230,283,53
166916,2019-10-09 00:00:00+03:00,in,False,906404,False,22,3610,4311,701
166916,2019-10-09 00:00:00+03:00,out,False,906406,False,18,1289,1496,207
166916,2019-10-09 00:00:00+03:00,in,False,906404,False,22,3610,4311,701
166916,2019-10-10 00:00:00+03:00,out,False,906404,True,4,0,130,130
166916,2019-10-10 00:00:00+03:00,out,True,906408,True,7,1,32,31
166916,2019-10-10 00:00:00+03:00,out,True,906404,False,2,82,101,19
166916,2019-10-10 00:00:00+03:00,out,False,906400,False,5,707,761,54
166916,2019-10-10 00:00:00+03:00,in,False,906404,False,19,2077,2638,561
166916,2019-10-10 00:00:00+03:00,out,True,906404,True,4,0,12,12
166916,2019-10-10 00:00:00+03:00,out,False,906408,False,2,224,248,24
166916,2019-10-10 00:00:00+03:00,out,True,906406,False,6,203,251,48
166916,2019-10-10 00:00:00+03:00,out,True,906406,True,2,0,15,15
166916,2019-10-10 00:00:00+03:00,in,False,-1,True,13,0,295,295
166916,2019-10-10 00:00:00+03:00,out,True,906408,False,3,70,93,23
166916,2019-10-10 00:00:00+03:00,out,False,906404,False,9,1335,1447,112
166916,2019-10-10 00:00:00+03:00,in,False,906406,False,20,1601,2109,508
166916,2019-10-10 00:00:00+03:00,out,False,906406,True,6,0,157,157
166916,2019-10-10 00:00:00+03:00,out,False,906412,True,1,0,8,8
166916,2019-10-10 00:00:00+03:00,out,True,906400,False,3,141,153,12
166916,2019-10-10 00:00:00+03:00,out,False,906406,False,21,1759,1975,216
166916,2019-10-10 00:00:00+03:00,out,True,906392,True,1,0,7,7
166916,2019-10-10 00:00:00+03:00,in,False,906400,False,3,329,417,88
166916,2019-10-10 00:00:00+03:00,in,False,906408,False,17,2066,2605,539
166916,2019-10-10 00:00:00+03:00,out,False,906404,True,4,0,130,130
166916,2019-10-10 00:00:00+03:00,out,True,906408,True,7,1,32,31
166916,2019-10-10 00:00:00+03:00,out,False,906404,False,9,1335,1447,112
166916,2019-10-11 00:00:00+03:00,in,False,906398,False,2,236,268,32
166916,2019-10-11 00:00:00+03:00,out,True,906392,True,1,0,10,10
166916,2019-10-11 00:00:00+03:00,out,False,906406,False,23,2151,2336,185
166916,2019-10-11 00:00:00+03:00,out,False,906400,False,5,511,536,25
166916,2019-10-11 00:00:00+03:00,in,False,-1,True,10,0,119,119
166916,2019-10-11 00:00:00+03:00,out,False,906404,False,6,584,651,67
166916,2019-10-11 00:00:00+03:00,out,True,906406,False,4,117,144,27
166916,2019-10-11 00:00:00+03:00,out,True,906400,True,3,0,12,12
166916,2019-10-11 00:00:00+03:00,in,False,906400,False,2,362,426,64
166916,2019-10-11 00:00:00+03:00,in,False,906404,False,9,1309,1552,243
166916,2019-10-11 00:00:00+03:00,out,True,906400,False,5,127,147,20
166916,2019-10-11 00:00:00+03:00,out,False,906406,True,12,0,330,330
166916,2019-10-11 00:00:00+03:00,in,False,906408,False,12,919,1289,370
166916,2019-10-11 00:00:00+03:00,in,False,906406,False,20,2307,2902,595
166916,2019-10-11 00:00:00+03:00,in,False,906408,True,1,0,66,66
166916,2019-10-11 00:00:00+03:00,out,True,906406,True,4,0,40,40
166916,2019-10-11 00:00:00+03:00,in,False,-1,True,10,0,119,119
166916,2019-10-11 00:00:00+03:00,out,True,906392,True,1,0,10,10
166916,2019-10-12 00:00:00+03:00,in,False,-1,True,1,0,9,9
166916,2019-10-13 00:00:00+03:00,in,False,-1,True,2,0,16,16
166916,2019-10-14 00:00:00+03:00,in,False,906408,False,14,2182,2582,400
166916,2019-10-14 00:00:00+03:00,out,True,906404,False,2,104,123,19
166916,2019-10-14 00:00:00+03:00,in,False,906406,False,15,1680,2049,369
166916,2019-10-14 00:00:00+03:00,in,False,906410,False,5,272,359,87
166916,2019-10-14 00:00:00+03:00,out,True,906400,True,6,27,43,16
166916,2019-10-14 00:00:00+03:00,out,False,906406,False,11,661,755,94
166916,2019-10-14 00:00:00+03:00,out,True,906408,True,2,0,16,16
166916,2019-10-14 00:00:00+03:00,out,False,906400,False,2,93,104,11
166916,2019-10-14 00:00:00+03:00,out,True,906406,True,1,0,17,17
166916,2019-10-14 00:00:00+03:00,in,False,-1,True,7,0,120,120
166916,2019-10-14 00:00:00+03:00,in,False,906398,False,3,419,494,75
166916,2019-10-14 00:00:00+03:00,out,False,906404,False,6,724,830,106
166916,2019-10-14 00:00:00+03:00,out,True,906406,False,4,97,123,26
166916,2019-10-14 00:00:00+03:00,out,True,906400,False,6,181,209,28
166916,2019-10-14 00:00:00+03:00,out,False,906406,True,1,0,8,8
166916,2019-10-14 00:00:00+03:00,out,True,906408,False,4,193,220,27
166916,2019-10-14 00:00:00+03:00,in,False,906400,False,2,574,641,67
166916,2019-10-14 00:00:00+03:00,in,False,906404,False,12,1939,2211,272
166916,2019-10-14 00:00:00+03:00,out,True,906400,False,6,181,209,28
166916,2019-10-15 00:00:00+03:00,out,False,906406,True,5,0,100,100
166916,2019-10-15 00:00:00+03:00,out,True,906392,True,1,0,7,7
166916,2019-10-15 00:00:00+03:00,in,False,906392,False,1,16,33,17
166916,2019-10-15 00:00:00+03:00,out,False,906402,False,2,66,81,15
166916,2019-10-15 00:00:00+03:00,in,False,906410,False,12,752,1030,278
166916,2019-10-15 00:00:00+03:00,in,False,906408,False,6,858,988,130
166916,2019-10-15 00:00:00+03:00,in,False,906404,False,12,2191,2495,304
166916,2019-10-15 00:00:00+03:00,out,True,906404,True,1,0,0,0
166916,2019-10-15 00:00:00+03:00,in,False,906392,True,2,58,94,36
166916,2019-10-15 00:00:00+03:00,out,False,906406,False,18,1506,1687,181
166916,2019-10-15 00:00:00+03:00,out,False,906402,True,1,0,14,14
166916,2019-10-15 00:00:00+03:00,in,False,-1,True,4,0,32,32
166916,2019-10-15 00:00:00+03:00,out,True,906408,False,2,82,99,17
166916,2019-10-15 00:00:00+03:00,out,True,906406,False,4,147,156,9
166916,2019-10-15 00:00:00+03:00,in,False,906398,False,1,87,113,26
166916,2019-10-15 00:00:00+03:00,in,False,906406,False,19,2180,2709,529
166916,2019-10-15 00:00:00+03:00,out,True,906404,False,1,66,68,2
166916,2019-10-15 00:00:00+03:00,out,False,906404,False,9,927,1073,146
166916,2019-10-15 00:00:00+03:00,in,False,906400,False,7,607,797,190
166916,2019-10-15 00:00:00+03:00,in,False,906402,False,1,117,152,35
166916,2019-10-15 00:00:00+03:00,out,False,906400,False,11,837,868,31
166916,2019-10-15 00:00:00+03:00,out,True,906400,False,2,40,49,9
166916,2019-10-15 00:00:00+03:00,out,True,906400,True,2,0,0,0
166916,2019-10-15 00:00:00+03:00,in,False,906408,False,6,858,988,130
166916,2019-10-16 00:00:00+03:00,in,False,906404,False,15,3122,3504,382
166916,2019-10-16 00:00:00+03:00,out,True,906404,False,2,145,165,20
166916,2019-10-16 00:00:00+03:00,out,False,906400,True,1,0,9,9
166916,2019-10-16 00:00:00+03:00,out,True,906406,True,2,0,12,12
166916,2019-10-16 00:00:00+03:00,in,False,906392,False,6,155,227,72
166916,2019-10-16 00:00:00+03:00,in,False,906412,False,1,48,65,17
166916,2019-10-16 00:00:00+03:00,out,False,906404,True,7,0,120,120
166916,2019-10-16 00:00:00+03:00,in,False,906398,False,3,545,616,71
166916,2019-10-16 00:00:00+03:00,in,False,906408,False,12,1185,1472,287
166916,2019-10-16 00:00:00+03:00,in,False,-1,True,8,0,102,102
166916,2019-10-16 00:00:00+03:00,out,False,906406,False,20,1651,1839,188
166916,2019-10-16 00:00:00+03:00,in,False,906392,True,5,327,397,70
166916,2019-10-16 00:00:00+03:00,in,False,906410,True,1,35,61,26
166916,2019-10-16 00:00:00+03:00,out,True,906392,True,9,0,114,114
166916,2019-10-16 00:00:00+03:00,out,False,906408,False,2,53,66,13
166916,2019-10-16 00:00:00+03:00,out,False,906400,False,4,333,396,63
166916,2019-10-16 00:00:00+03:00,in,False,906406,False,16,2023,2413,390
166916,2019-10-16 00:00:00+03:00,out,True,906408,True,1,0,0,0
166916,2019-10-16 00:00:00+03:00,in,False,906410,False,11,523,816,293
166916,2019-10-16 00:00:00+03:00,out,False,906404,False,7,859,955,96
166916,2019-10-16 00:00:00+03:00,out,False,906406,True,1,0,10,10
166916,2019-10-16 00:00:00+03:00,in,False,906400,False,4,575,677,102
166916,2019-10-16 00:00:00+03:00,out,True,906412,True,2,0,9,9
166916,2019-10-16 00:00:00+03:00,in,False,906412,True,5,252,350,98
166916,2019-10-16 00:00:00+03:00,out,True,906406,False,2,47,52,5
166916,2019-10-16 00:00:00+03:00,out,False,906408,True,1,0,13,13
166916,2019-10-16 00:00:00+03:00,in,False,906404,False,15,3122,3504,382
166916,2019-10-16 00:00:00+03:00,out,False,906406,False,20,1651,1839,188
166916,2019-10-16 00:00:00+03:00,out,False,906404,True,7,0,120,120
166916,2019-10-17 00:00:00+03:00,in,False,906404,False,12,1210,1546,336
166916,2019-10-17 00:00:00+03:00,out,False,906400,False,2,75,96,21
166916,2019-10-17 00:00:00+03:00,out,False,906404,True,9,0,142,142
166916,2019-10-17 00:00:00+03:00,in,False,906406,False,16,1744,2200,456
166916,2019-10-17 00:00:00+03:00,out,True,906404,True,1,0,0,0
166916,2019-10-17 00:00:00+03:00,out,False,906406,False,16,1368,1538,170
166916,2019-10-17 00:00:00+03:00,out,False,906406,True,1,0,60,60
166916,2019-10-17 00:00:00+03:00,in,False,906408,False,9,912,1134,222
166916,2019-10-17 00:00:00+03:00,out,True,906400,False,2,101,109,8
166916,2019-10-17 00:00:00+03:00,out,True,906412,True,1,0,24,24
166916,2019-10-17 00:00:00+03:00,in,False,906410,True,1,28,55,27
166916,2019-10-17 00:00:00+03:00,out,True,906408,False,2,133,142,9
166916,2019-10-17 00:00:00+03:00,out,True,906406,True,1,0,0,0
166916,2019-10-17 00:00:00+03:00,out,False,906404,False,13,1244,1400,156
166916,2019-10-17 00:00:00+03:00,out,True,906400,True,2,0,0,0
166916,2019-10-17 00:00:00+03:00,out,True,906406,False,2,41,46,5
166916,2019-10-17 00:00:00+03:00,in,False,906398,False,3,248,307,59
166916,2019-10-17 00:00:00+03:00,in,False,906400,False,6,387,556,169
166916,2019-10-17 00:00:00+03:00,in,False,906410,False,4,184,258,74
166916,2019-10-17 00:00:00+03:00,in,False,-1,True,6,0,143,143
166916,2019-10-17 00:00:00+03:00,out,True,906400,True,2,0,0,0
166916,2019-10-18 00:00:00+03:00,in,False,906410,False,6,240,378,138
166916,2019-10-18 00:00:00+03:00,out,True,906412,True,2,0,13,13
166916,2019-10-18 00:00:00+03:00,out,True,906392,True,8,0,130,130
166916,2019-10-18 00:00:00+03:00,in,False,-1,True,8,0,171,171
166916,2019-10-18 00:00:00+03:00,in,False,906412,False,1,108,121,13
166916,2019-10-18 00:00:00+03:00,out,False,906404,True,1,0,46,46
166916,2019-10-18 00:00:00+03:00,in,False,906404,False,16,2682,3110,428
166916,2019-10-18 00:00:00+03:00,out,True,906406,False,6,103,162,59
166916,2019-10-18 00:00:00+03:00,out,False,906406,True,6,0,205,205
166916,2019-10-18 00:00:00+03:00,out,False,906412,False,1,7,10,3
166916,2019-10-18 00:00:00+03:00,out,False,906400,False,1,51,68,17
166916,2019-10-18 00:00:00+03:00,out,True,906400,False,3,79,91,12
166916,2019-10-18 00:00:00+03:00,out,True,906404,False,2,102,113,11
166916,2019-10-18 00:00:00+03:00,in,False,906406,False,8,938,1111,173
166916,2019-10-18 00:00:00+03:00,in,False,906400,False,4,232,350,118
166916,2019-10-18 00:00:00+03:00,in,False,906412,True,2,35,77,42
166916,2019-10-18 00:00:00+03:00,in,False,906398,False,3,388,457,69
166916,2019-10-18 00:00:00+03:00,out,False,906404,False,10,901,1075,174
166916,2019-10-18 00:00:00+03:00,out,False,906406,False,12,996,1108,112
166916,2019-10-19 00:00:00+03:00,in,False,906412,False,1,13,28,15
166916,2019-10-21 00:00:00+03:00,out,False,906406,False,10,780,869,89
166916,2019-10-21 00:00:00+03:00,out,True,906412,False,1,31,43,12
166916,2019-10-21 00:00:00+03:00,out,True,906408,False,2,39,54,15
166916,2019-10-21 00:00:00+03:00,in,False,906396,False,2,125,198,73
166916,2019-10-21 00:00:00+03:00,out,False,906404,False,10,1188,1314,126
166916,2019-10-21 00:00:00+03:00,in,False,906400,False,2,113,165,52
166916,2019-10-21 00:00:00+03:00,out,False,906394,True,1,0,8,8
166916,2019-10-21 00:00:00+03:00,in,False,-1,True,3,0,22,22
166916,2019-10-21 00:00:00+03:00,out,True,906400,False,3,61,70,9
166916,2019-10-21 00:00:00+03:00,out,False,906400,False,3,352,368,16
166916,2019-10-21 00:00:00+03:00,out,True,906412,True,2,0,2,2
166916,2019-10-21 00:00:00+03:00,out,True,906392,True,1,0,0,0
166916,2019-10-21 00:00:00+03:00,in,False,906404,False,11,1956,2250,294
166916,2019-10-21 00:00:00+03:00,in,False,906406,False,10,984,1251,267
166916,2019-10-21 00:00:00+03:00,out,True,906396,False,3,141,158,17
166916,2019-10-21 00:00:00+03:00,out,True,906394,False,3,71,79,8
166916,2019-10-21 00:00:00+03:00,out,True,906400,True,2,0,0,0
166916,2019-10-21 00:00:00+03:00,in,False,906410,False,6,471,585,114
166916,2019-10-21 00:00:00+03:00,out,False,906406,True,2,0,6,6
166916,2019-10-21 00:00:00+03:00,out,True,906406,False,2,42,63,21
166916,2019-10-21 00:00:00+03:00,out,False,906404,True,4,0,169,169
166916,2019-10-21 00:00:00+03:00,out,False,906396,False,1,52,55,3
166916,2019-10-21 00:00:00+03:00,in,False,906408,False,1,88,106,18
166916,2019-10-21 00:00:00+03:00,out,True,906406,True,1,0,0,0
166916,2019-10-21 00:00:00+03:00,out,True,906396,True,3,0,31,31
166916,2019-10-22 00:00:00+03:00,out,False,906406,True,4,0,35,35
166916,2019-10-22 00:00:00+03:00,out,True,906396,False,1,153,155,2
166916,2019-10-22 00:00:00+03:00,out,True,906400,False,2,100,105,5
166916,2019-10-22 00:00:00+03:00,in,False,906404,False,10,2335,2567,232
166916,2019-10-22 00:00:00+03:00,out,False,906406,False,19,1553,1698,145
166916,2019-10-22 00:00:00+03:00,out,True,906406,True,6,0,74,74
166916,2019-10-22 00:00:00+03:00,out,True,906400,True,1,0,0,0
166916,2019-10-22 00:00:00+03:00,out,False,906400,False,8,491,558,67
166916,2019-10-22 00:00:00+03:00,in,False,906400,False,5,777,936,159
166916,2019-10-22 00:00:00+03:00,out,False,906394,True,1,0,18,18
166916,2019-10-22 00:00:00+03:00,out,False,906400,True,2,0,32,32
166916,2019-10-22 00:00:00+03:00,in,False,906404,True,1,18,52,34
166916,2019-10-22 00:00:00+03:00,out,False,906404,False,4,420,468,48
166916,2019-10-22 00:00:00+03:00,in,False,906396,False,1,44,74,30
166916,2019-10-22 00:00:00+03:00,in,False,906394,False,2,311,368,57
166916,2019-10-22 00:00:00+03:00,out,True,906404,False,1,17,19,2
166916,2019-10-22 00:00:00+03:00,out,False,906394,False,3,239,269,30
166916,2019-10-22 00:00:00+03:00,in,False,-1,True,7,0,80,80
166916,2019-10-22 00:00:00+03:00,in,False,906408,False,4,681,760,79
166916,2019-10-22 00:00:00+03:00,in,False,906410,False,8,386,615,229
166916,2019-10-22 00:00:00+03:00,out,True,906406,False,3,86,101,15
166916,2019-10-22 00:00:00+03:00,in,False,906406,False,12,1236,1493,257
166916,2019-10-22 00:00:00+03:00,out,True,906408,False,1,34,37,3
166916,2019-10-22 00:00:00+03:00,in,False,906398,False,2,178,227,49
166916,2019-10-22 00:00:00+03:00,out,True,906394,False,9,237,268,31
166916,2019-10-22 00:00:00+03:00,out,True,906396,False,1,153,155,2
166916,2019-10-23 00:00:00+03:00,out,False,906406,True,5,0,40,40
166916,2019-10-23 00:00:00+03:00,out,False,906396,True,3,0,11,11
166916,2019-10-23 00:00:00+03:00,in,False,906404,False,10,2030,2256,226
166916,2019-10-23 00:00:00+03:00,out,True,906394,False,12,411,475,64
166916,2019-10-23 00:00:00+03:00,in,False,906394,False,3,715,801,86
166916,2019-10-23 00:00:00+03:00,out,True,906394,True,7,0,28,28
166916,2019-10-23 00:00:00+03:00,out,True,906396,False,3,309,334,25
166916,2019-10-23 00:00:00+03:00,out,False,906396,False,1,58,60,2
166916,2019-10-23 00:00:00+03:00,out,True,906400,False,2,54,62,8
166916,2019-10-23 00:00:00+03:00,in,False,906396,False,5,486,618,132
166916,2019-10-23 00:00:00+03:00,out,True,906396,True,1,0,15,15
166916,2019-10-23 00:00:00+03:00,in,False,906406,False,12,2053,2380,327
166916,2019-10-23 00:00:00+03:00,in,False,-1,True,10,0,185,185
166916,2019-10-23 00:00:00+03:00,in,False,906410,False,5,376,481,105
166916,2019-10-23 00:00:00+03:00,in,False,906408,False,9,1861,2083,222
166916,2019-10-23 00:00:00+03:00,out,True,906408,False,1,92,94,2
166916,2019-10-23 00:00:00+03:00,out,True,906406,False,3,86,93,7
166916,2019-10-23 00:00:00+03:00,out,False,906404,False,8,1298,1369,71
166916,2019-10-23 00:00:00+03:00,out,True,906406,True,3,0,16,16
166916,2019-10-23 00:00:00+03:00,out,False,906394,False,5,1184,1221,37
166916,2019-10-23 00:00:00+03:00,out,False,906400,False,3,371,384,13
166916,2019-10-23 00:00:00+03:00,out,True,906404,False,1,110,120,10
166916,2019-10-23 00:00:00+03:00,in,False,906398,False,5,667,786,119
166916,2019-10-23 00:00:00+03:00,out,False,906406,False,16,2703,2783,80
166916,2019-10-23 00:00:00+03:00,out,False,906404,True,2,0,95,95
166916,2019-10-23 00:00:00+03:00,in,False,906400,False,3,382,464,82
166916,2019-10-23 00:00:00+03:00,in,False,906394,False,3,715,801,86
166916,2019-10-23 00:00:00+03:00,in,False,906396,False,5,486,618,132
166916,2019-10-23 00:00:00+03:00,out,True,906400,False,2,54,62,8
166916,2019-10-24 00:00:00+03:00,in,False,906402,False,1,171,196,25
166916,2019-10-24 00:00:00+03:00,out,False,906400,False,6,542,565,23
166916,2019-10-24 00:00:00+03:00,out,True,906398,False,1,6,10,4
166916,2019-10-24 00:00:00+03:00,in,False,-1,True,12,0,365,365
166916,2019-10-24 00:00:00+03:00,out,True,906406,True,2,0,0,0
166916,2019-10-24 00:00:00+03:00,out,False,906406,True,11,0,169,169
166916,2019-10-24 00:00:00+03:00,out,True,906394,True,5,0,29,29
166916,2019-10-24 00:00:00+03:00,out,True,906394,False,5,299,320,21
166916,2019-10-24 00:00:00+03:00,out,False,906398,False,1,43,44,1
166916,2019-10-24 00:00:00+03:00,out,True,906396,False,6,155,190,35
166916,2019-10-24 00:00:00+03:00,in,False,906394,False,1,98,123,25
166916,2019-10-24 00:00:00+03:00,out,False,906406,False,27,2005,2153,148
166916,2019-10-24 00:00:00+03:00,out,False,906394,False,4,5930,5973,43
166916,2019-10-24 00:00:00+03:00,in,False,906410,False,9,587,808,221
166916,2019-10-24 00:00:00+03:00,out,True,906400,True,4,0,17,17
166916,2019-10-24 00:00:00+03:00,in,False,906398,False,1,111,128,17
166916,2019-10-24 00:00:00+03:00,out,False,906400,True,1,0,6,6
166916,2019-10-24 00:00:00+03:00,out,True,906400,False,5,252,266,14
166916,2019-10-24 00:00:00+03:00,in,False,906408,False,2,236,282,46
166916,2019-10-24 00:00:00+03:00,out,False,906404,False,10,716,808,92
166916,2019-10-24 00:00:00+03:00,in,False,906400,False,5,558,676,118
166916,2019-10-24 00:00:00+03:00,in,False,906404,False,7,700,842,142
166916,2019-10-24 00:00:00+03:00,out,True,906408,False,1,22,31,9
166916,2019-10-24 00:00:00+03:00,in,False,906406,False,4,336,437,101
166916,2019-10-24 00:00:00+03:00,out,True,906396,True,4,0,0,0
166916,2019-10-24 00:00:00+03:00,in,False,906396,False,3,363,461,98
166916,2019-10-24 00:00:00+03:00,out,True,906406,False,5,211,229,18
166916,2019-10-24 00:00:00+03:00,out,False,906404,False,10,716,808,92
166916,2019-10-25 00:00:00+03:00,in,False,906404,False,13,2626,2970,344
166916,2019-10-25 00:00:00+03:00,out,False,906394,False,2,209,232,23
166916,2019-10-25 00:00:00+03:00,out,True,906394,True,5,0,19,19
166916,2019-10-25 00:00:00+03:00,in,False,906408,False,8,1269,1500,231
166916,2019-10-25 00:00:00+03:00,out,True,906392,True,1,0,13,13
166916,2019-10-25 00:00:00+03:00,in,False,906408,True,1,61,122,61
166916,2019-10-25 00:00:00+03:00,out,True,928282,True,1,0,6,6
166916,2019-10-25 00:00:00+03:00,in,False,906400,False,4,297,385,88
166916,2019-10-25 00:00:00+03:00,out,False,906412,True,1,0,8,8
166916,2019-10-25 00:00:00+03:00,in,False,906404,True,1,0,35,35
166916,2019-10-25 00:00:00+03:00,out,True,906404,False,2,116,122,6
166916,2019-10-25 00:00:00+03:00,out,True,906394,False,5,39,67,28
166916,2019-10-25 00:00:00+03:00,out,True,906396,False,3,317,333,16
166916,2019-10-25 00:00:00+03:00,out,True,906400,False,2,62,70,8
166916,2019-10-25 00:00:00+03:00,out,False,906406,True,8,0,81,81
166916,2019-10-25 00:00:00+03:00,in,False,-1,True,13,0,309,309
166916,2019-10-25 00:00:00+03:00,out,True,906408,False,1,81,89,8
166916,2019-10-25 00:00:00+03:00,out,True,928284,True,2,0,11,11
166916,2019-10-25 00:00:00+03:00,out,False,906406,False,6,340,382,42
166916,2019-10-25 00:00:00+03:00,out,False,906404,False,4,476,549,73
166916,2019-10-25 00:00:00+03:00,out,False,906400,False,7,405,488,83
166916,2019-10-25 00:00:00+03:00,out,True,906406,False,2,51,67,16
166916,2019-10-25 00:00:00+03:00,out,True,906396,True,2,0,36,36
166916,2019-10-25 00:00:00+03:00,out,False,906400,True,2,0,32,32
166916,2019-10-25 00:00:00+03:00,out,True,906406,True,1,0,19,19
166916,2019-10-25 00:00:00+03:00,out,False,906394,True,3,0,11,11
166916,2019-10-25 00:00:00+03:00,in,False,906400,True,1,21,49,28
166916,2019-10-25 00:00:00+03:00,out,True,906400,True,3,0,11,11
166916,2019-10-25 00:00:00+03:00,out,True,906410,True,2,0,34,34
166916,2019-10-25 00:00:00+03:00,in,False,906406,False,13,1056,1427,371
166916,2019-10-25 00:00:00+03:00,out,True,906408,False,1,81,89,8
166916,2019-10-25 00:00:00+03:00,in,False,906400,True,1,21,49,28
166916,2019-10-25 00:00:00+03:00,in,False,906404,True,1,0,35,35
166916,2019-10-25 00:00:00+03:00,out,False,906412,True,1,0,8,8
166916,2019-10-25 00:00:00+03:00,out,True,906396,True,2,0,36,36
166916,2019-10-25 00:00:00+03:00,out,True,906392,True,1,0,13,13
166916,2019-10-25 00:00:00+03:00,in,False,906400,False,4,297,385,88
166916,2019-10-25 00:00:00+03:00,in,False,906404,False,13,2626,2970,344
166916,2019-10-28 00:00:00+03:00,out,True,906396,False,3,216,224,8
166916,2019-10-28 00:00:00+03:00,in,False,906394,False,3,700,756,56
166916,2019-10-28 00:00:00+03:00,out,True,906398,False,1,57,61,4
166916,2019-10-28 00:00:00+03:00,out,True,906408,True,1,0,0,0
166916,2019-10-28 00:00:00+03:00,out,False,906394,True,1,0,32,32
166916,2019-10-28 00:00:00+03:00,in,False,-1,True,13,0,179,179
166916,2019-10-28 00:00:00+03:00,out,True,906394,True,1,0,13,13
166916,2019-10-28 00:00:00+03:00,in,False,906404,False,10,1296,1564,268
166916,2019-10-28 00:00:00+03:00,in,False,906408,False,13,1094,1560,466
166916,2019-10-28 00:00:00+03:00,out,True,906394,False,10,163,188,25
166916,2019-10-28 00:00:00+03:00,out,False,906394,False,1,102,115,13
166916,2019-10-28 00:00:00+03:00,in,False,906406,False,10,720,1040,320
166916,2019-10-28 00:00:00+03:00,out,False,906406,False,15,1194,1357,163
166916,2019-10-28 00:00:00+03:00,out,True,906404,True,3,0,0,0
166916,2019-10-28 00:00:00+03:00,out,False,906404,True,7,0,163,163
166916,2019-10-28 00:00:00+03:00,out,False,906396,False,2,107,116,9
166916,2019-10-28 00:00:00+03:00,out,False,906404,False,15,1565,1759,194
166916,2019-10-28 00:00:00+03:00,out,False,906406,True,5,0,53,53
166916,2019-10-28 00:00:00+03:00,out,False,906396,False,2,107,116,9
166916,2019-10-28 00:00:00+03:00,out,True,906394,False,10,163,188,25
166916,2019-10-29 00:00:00+03:00,in,False,906406,False,15,1725,2104,379
166916,2019-10-29 00:00:00+03:00,out,True,906406,False,2,102,106,4
166916,2019-10-29 00:00:00+03:00,out,False,906406,False,9,547,641,94
166916,2019-10-29 00:00:00+03:00,out,False,906404,False,10,856,963,107
166916,2019-10-29 00:00:00+03:00,out,True,906398,True,1,0,0,0
166916,2019-10-29 00:00:00+03:00,in,False,906404,True,1,0,45,45
166916,2019-10-29 00:00:00+03:00,out,True,906406,True,2,0,27,27
166916,2019-10-29 00:00:00+03:00,in,False,-1,True,13,0,509,509
166916,2019-10-29 00:00:00+03:00,out,True,906394,False,8,220,241,21
166916,2019-10-29 00:00:00+03:00,out,False,906406,True,1,0,5,5
166916,2019-10-29 00:00:00+03:00,in,False,906404,False,11,1327,1635,308
166916,2019-10-29 00:00:00+03:00,out,False,906394,True,2,0,53,53
166916,2019-10-29 00:00:00+03:00,in,False,906396,False,5,202,394,192
166916,2019-10-29 00:00:00+03:00,out,False,906396,False,1,65,68,3
166916,2019-10-29 00:00:00+03:00,out,True,906396,False,1,78,80,2
166916,2019-10-29 00:00:00+03:00,in,False,906398,False,1,31,64,33
166916,2019-10-29 00:00:00+03:00,in,False,906408,False,4,985,1069,84
166916,2019-10-29 00:00:00+03:00,out,True,906404,False,2,50,54,4
166916,2019-10-29 00:00:00+03:00,out,False,906394,False,1,49,57,8
166916,2019-10-29 00:00:00+03:00,out,True,906394,True,4,0,25,25
166916,2019-10-30 00:00:00+03:00,in,False,906396,False,4,269,438,169
166916,2019-10-30 00:00:00+03:00,out,False,906396,True,1,0,3,3
166916,2019-10-30 00:00:00+03:00,out,True,906406,True,3,0,11,11
166916,2019-10-30 00:00:00+03:00,in,False,906398,False,2,551,606,55
166916,2019-10-30 00:00:00+03:00,out,True,906412,True,4,87,164,77
166916,2019-10-30 00:00:00+03:00,out,True,906394,True,6,0,23,23
166916,2019-10-30 00:00:00+03:00,out,False,906406,False,11,1523,1642,119
166916,2019-10-30 00:00:00+03:00,in,False,906408,False,8,837,1033,196
166916,2019-10-30 00:00:00+03:00,out,True,906396,False,4,420,467,47
166916,2019-10-30 00:00:00+03:00,out,True,906404,False,2,116,127,11
166916,2019-10-30 00:00:00+03:00,out,True,906404,True,4,0,0,0
166916,2019-10-30 00:00:00+03:00,in,False,906404,False,6,364,528,164
166916,2019-10-30 00:00:00+03:00,in,False,906406,False,12,2169,2505,336
166916,2019-10-30 00:00:00+03:00,out,False,906406,True,2,0,67,67
166916,2019-10-30 00:00:00+03:00,in,False,-1,True,15,0,639,639
166916,2019-10-30 00:00:00+03:00,out,True,928282,True,1,0,10,10
166916,2019-10-30 00:00:00+03:00,out,False,906404,False,14,1314,1490,176
166916,2019-10-30 00:00:00+03:00,out,False,906404,True,3,0,96,96
166916,2019-10-30 00:00:00+03:00,out,False,906408,True,5,0,52,52
166916,2019-10-30 00:00:00+03:00,out,True,906412,False,8,496,578,82
166916,2019-10-30 00:00:00+03:00,out,True,906406,False,3,524,558,34
166916,2019-10-30 00:00:00+03:00,out,True,906394,False,4,137,156,19
166916,2019-10-30 00:00:00+03:00,out,True,906392,True,2,0,11,11
166916,2019-10-30 00:00:00+03:00,out,False,906396,False,3,347,351,4
166916,2019-10-30 00:00:00+03:00,out,False,906394,False,2,1847,1889,42
166916,2019-10-30 00:00:00+03:00,out,True,906412,True,4,87,164,77
166916,2019-10-30 00:00:00+03:00,out,False,906406,True,2,0,67,67
166916,2019-10-31 00:00:00+03:00,out,True,906396,True,1,0,26,26
166916,2019-10-31 00:00:00+03:00,out,True,906412,True,3,0,3,3
166916,2019-10-31 00:00:00+03:00,in,False,906406,True,1,18,55,37
166916,2019-10-31 00:00:00+03:00,out,False,906404,True,1,0,56,56
166916,2019-10-31 00:00:00+03:00,out,False,906404,False,15,1534,1674,140
166916,2019-10-31 00:00:00+03:00,in,False,-1,True,7,0,72,72
166916,2019-10-31 00:00:00+03:00,out,True,906412,False,12,1034,1094,60
166916,2019-10-31 00:00:00+03:00,out,False,906406,False,6,505,558,53
166916,2019-10-31 00:00:00+03:00,out,False,906396,True,1,0,13,13
166916,2019-10-31 00:00:00+03:00,out,True,906404,True,1,0,0,0
166916,2019-10-31 00:00:00+03:00,in,False,906408,False,6,524,669,145
166916,2019-10-31 00:00:00+03:00,out,True,906404,False,7,683,751,68
166916,2019-10-31 00:00:00+03:00,out,True,906396,False,1,61,85,24
166916,2019-10-31 00:00:00+03:00,out,True,906406,False,7,329,397,68
166916,2019-10-31 00:00:00+03:00,in,False,906404,False,12,1064,1466,402
166916,2019-10-31 00:00:00+03:00,in,False,906406,False,13,930,1306,376
166916,2019-10-31 00:00:00+03:00,in,False,906398,False,1,150,179,29
166916,2019-10-31 00:00:00+03:00,out,True,906398,False,1,42,49,7
166916,2019-10-31 00:00:00+03:00,out,False,906396,False,3,408,412,4
166916,2019-10-31 00:00:00+03:00,out,True,906412,True,3,0,3,3
166916,2019-10-31 00:00:00+03:00,out,True,906404,False,7,683,751,68
166916,2019-10-31 00:00:00+03:00,in,False,906406,False,13,930,1306,376
166916,2019-11-01 00:00:00+03:00,out,False,906396,False,3,194,205,11
166916,2019-11-01 00:00:00+03:00,out,False,906394,False,2,1063,1080,17
166916,2019-11-01 00:00:00+03:00,out,True,906394,True,2,0,1,1
166916,2019-11-01 00:00:00+03:00,out,True,906412,False,4,403,423,20
166916,2019-11-01 00:00:00+03:00,in,False,906412,False,1,36,51,15
166916,2019-11-01 00:00:00+03:00,out,False,906412,False,1,47,60,13
166916,2019-11-01 00:00:00+03:00,in,False,906396,False,2,449,490,41
166916,2019-11-01 00:00:00+03:00,out,True,906404,True,2,0,16,16
166916,2019-11-01 00:00:00+03:00,out,False,906406,True,8,0,122,122
166916,2019-11-01 00:00:00+03:00,out,False,906404,True,1,0,44,44
166916,2019-11-01 00:00:00+03:00,in,False,906404,False,11,1256,1534,278
166916,2019-11-01 00:00:00+03:00,in,False,906406,False,9,1214,1443,229
166916,2019-11-01 00:00:00+03:00,out,True,906394,False,4,124,136,12
166916,2019-11-01 00:00:00+03:00,in,False,906408,False,6,416,544,128
166916,2019-11-01 00:00:00+03:00,out,False,906406,False,18,1190,1342,152
166916,2019-11-01 00:00:00+03:00,out,False,906402,False,4,810,818,8
166916,2019-11-01 00:00:00+03:00,out,True,906404,False,1,40,42,2
166916,2019-11-01 00:00:00+03:00,out,True,906402,False,1,9,25,16
166916,2019-11-01 00:00:00+03:00,out,False,906404,False,10,613,741,128
166916,2019-11-01 00:00:00+03:00,out,True,906412,True,1,0,21,21
166916,2019-11-01 00:00:00+03:00,in,False,-1,True,9,0,209,209
166916,2019-11-02 00:00:00+03:00,in,False,-1,True,2,0,75,75
166916,2019-11-03 00:00:00+03:00,in,False,-1,True,2,0,46,46
166916,2019-11-03 00:00:00+03:00,in,False,-1,True,2,0,46,46
166916,2019-11-04 00:00:00+03:00,in,False,-1,True,2,0,39,39
166916,2019-11-05 00:00:00+03:00,out,False,906406,True,4,0,69,69
166916,2019-11-05 00:00:00+03:00,out,False,906396,False,5,356,385,29
166916,2019-11-05 00:00:00+03:00,out,True,906416,False,2,164,198,34
166916,2019-11-05 00:00:00+03:00,in,False,906406,False,19,1770,2294,524
166916,2019-11-05 00:00:00+03:00,in,False,906406,True,1,75,103,28
166916,2019-11-05 00:00:00+03:00,out,True,906396,False,5,171,226,55
166916,2019-11-05 00:00:00+03:00,in,False,-1,True,5,0,119,119
166916,2019-11-05 00:00:00+03:00,out,True,906394,False,10,334,392,58
166916,2019-11-05 00:00:00+03:00,out,True,906394,True,5,0,68,68
166916,2019-11-05 00:00:00+03:00,out,True,906406,False,9,369,442,73
166916,2019-11-05 00:00:00+03:00,out,False,906400,False,6,523,562,39
166916,2019-11-05 00:00:00+03:00,out,False,906412,True,1,0,45,45
166916,2019-11-05 00:00:00+03:00,out,False,906396,True,1,0,2,2
166916,2019-11-05 00:00:00+03:00,in,False,906420,False,1,8,22,14
166916,2019-11-05 00:00:00+03:00,out,False,906412,False,4,253,290,37
166916,2019-11-05 00:00:00+03:00,out,True,906398,False,1,7,9,2
166916,2019-11-05 00:00:00+03:00,in,False,906400,False,6,676,819,143
166916,2019-11-05 00:00:00+03:00,out,True,906412,True,3,71,82,11
166916,2019-11-05 00:00:00+03:00,in,False,906396,False,11,976,1334,358
166916,2019-11-05 00:00:00+03:00,out,True,906412,False,10,539,617,78
166916,2019-11-05 00:00:00+03:00,out,False,906406,False,21,1555,1776,221
166916,2019-11-05 00:00:00+03:00,in,False,906394,False,5,1948,2119,171
166916,2019-11-05 00:00:00+03:00,out,True,906400,False,8,383,444,61
166916,2019-11-05 00:00:00+03:00,out,True,906400,True,1,0,0,0
166916,2019-11-05 00:00:00+03:00,in,False,906404,False,1,15,78,63
166916,2019-11-05 00:00:00+03:00,out,True,906406,True,3,0,2,2
166916,2019-11-05 00:00:00+03:00,out,False,906394,False,3,251,297,46
166916,2019-11-05 00:00:00+03:00,out,True,906398,False,1,7,9,2
166916,2019-11-05 00:00:00+03:00,in,False,906394,False,5,1948,2119,171
166916,2019-11-06 00:00:00+03:00,out,False,906394,False,2,1639,1653,14
166916,2019-11-06 00:00:00+03:00,in,False,-1,True,10,0,312,312
166916,2019-11-06 00:00:00+03:00,in,False,906396,False,11,943,1256,313
166916,2019-11-06 00:00:00+03:00,out,False,906412,False,1,48,61,13
166916,2019-11-06 00:00:00+03:00,out,True,906406,True,5,0,29,29
166916,2019-11-06 00:00:00+03:00,out,True,906402,True,2,0,0,0
166916,2019-11-06 00:00:00+03:00,out,True,906398,True,1,0,0,0
166916,2019-11-06 00:00:00+03:00,in,False,906406,False,26,2746,3357,611
166916,2019-11-06 00:00:00+03:00,out,True,906420,True,1,0,7,7
166916,2019-11-06 00:00:00+03:00,out,True,906416,False,1,40,64,24
166916,2019-11-06 00:00:00+03:00,in,False,906396,True,1,23,97,74
166916,2019-11-06 00:00:00+03:00,out,True,906396,False,6,341,396,55
166916,2019-11-06 00:00:00+03:00,out,True,906396,True,83,0,64,64
166916,2019-11-06 00:00:00+03:00,in,False,906400,False,3,349,441,92
166916,2019-11-06 00:00:00+03:00,out,False,906400,False,8,568,601,33
166916,2019-11-06 00:00:00+03:00,out,True,906398,False,5,109,121,12
166916,2019-11-06 00:00:00+03:00,out,True,906392,True,2,0,37,37
166916,2019-11-06 00:00:00+03:00,out,True,906412,False,10,500,562,62
166916,2019-11-06 00:00:00+03:00,out,False,906406,False,22,1689,1941,252
166916,2019-11-06 00:00:00+03:00,out,False,-1,True,6,0,0,0
166916,2019-11-06 00:00:00+03:00,in,False,906408,False,1,169,207,38
166916,2019-11-06 00:00:00+03:00,in,False,906402,False,1,35,93,58
166916,2019-11-06 00:00:00+03:00,in,False,906400,True,1,62,93,31
166916,2019-11-06 00:00:00+03:00,out,False,906406,True,9,0,190,190
166916,2019-11-06 00:00:00+03:00,out,True,906406,False,12,587,735,148
166916,2019-11-06 00:00:00+03:00,out,True,906400,False,2,258,262,4
166916,2019-11-06 00:00:00+03:00,in,False,906394,False,2,688,743,55
166916,2019-11-06 00:00:00+03:00,out,True,906420,False,1,72,90,18
166916,2019-11-06 00:00:00+03:00,out,False,906396,False,4,255,279,24
166916,2019-11-06 00:00:00+03:00,out,True,906394,False,10,1297,1389,92
166916,2019-11-06 00:00:00+03:00,in,False,906394,False,2,688,743,55
166916,2019-11-06 00:00:00+03:00,out,True,906416,False,1,40,64,24
166916,2019-11-06 00:00:00+03:00,out,False,906406,True,9,0,190,190
166916,2019-11-06 00:00:00+03:00,out,False,906396,False,4,255,279,24
166916,2019-11-07 00:00:00+03:00,out,True,906416,True,4,148,239,91
166916,2019-11-07 00:00:00+03:00,out,True,906396,False,5,210,279,69
166916,2019-11-07 00:00:00+03:00,out,False,906400,False,3,206,227,21
166916,2019-11-07 00:00:00+03:00,out,False,906396,False,2,87,91,4
166916,2019-11-07 00:00:00+03:00,out,False,906416,False,1,70,81,11
166916,2019-11-07 00:00:00+03:00,in,False,906398,False,1,36,91,55
166916,2019-11-07 00:00:00+03:00,out,True,906406,False,6,142,227,85
166916,2019-11-07 00:00:00+03:00,out,True,906394,True,2,0,36,36
166916,2019-11-07 00:00:00+03:00,out,True,906416,False,2,1572,1608,36
166916,2019-11-07 00:00:00+03:00,in,False,-1,True,2,0,72,72
166916,2019-11-07 00:00:00+03:00,out,True,906400,True,5,0,10,10
166916,2019-11-07 00:00:00+03:00,out,False,906412,True,1,0,6,6
166916,2019-11-07 00:00:00+03:00,out,True,906398,True,2,0,0,0
166916,2019-11-07 00:00:00+03:00,out,True,906392,True,1,0,18,18
166916,2019-11-07 00:00:00+03:00,in,False,906400,False,2,210,275,65
166916,2019-11-07 00:00:00+03:00,out,True,906412,False,9,471,529,58
166916,2019-11-07 00:00:00+03:00,out,True,906402,False,1,86,96,10
166916,2019-11-07 00:00:00+03:00,in,False,906412,False,2,35,60,25
166916,2019-11-07 00:00:00+03:00,out,False,906394,False,5,1395,1451,56
166916,2019-11-07 00:00:00+03:00,in,False,906406,False,18,1714,2157,443
166916,2019-11-07 00:00:00+03:00,out,True,906406,True,3,0,10,10
166916,2019-11-07 00:00:00+03:00,out,False,906412,False,3,137,176,39
166916,2019-11-07 00:00:00+03:00,in,False,906396,False,11,1473,1744,271
166916,2019-11-07 00:00:00+03:00,out,True,906400,False,9,307,376,69
166916,2019-11-07 00:00:00+03:00,out,False,906406,False,23,1987,2194,207
166916,2019-11-07 00:00:00+03:00,in,False,906394,False,1,67,101,34
166916,2019-11-07 00:00:00+03:00,in,False,906402,False,1,26,75,49
166916,2019-11-07 00:00:00+03:00,out,False,906406,True,4,0,55,55
166916,2019-11-07 00:00:00+03:00,out,True,906398,False,2,87,93,6
166916,2019-11-07 00:00:00+03:00,out,True,906392,False,1,203,215,12
166916,2019-11-07 00:00:00+03:00,out,True,906394,False,11,469,538,69
166916,2019-11-07 00:00:00+03:00,in,False,906406,False,18,1714,2157,443
166916,2019-11-07 00:00:00+03:00,out,False,906394,False,5,1395,1451,56
166916,2019-11-07 00:00:00+03:00,out,True,906394,True,2,0,36,36
166916,2019-11-08 00:00:00+03:00,out,True,906412,False,4,168,198,30
166916,2019-11-08 00:00:00+03:00,out,True,906400,True,3,0,49,49
166916,2019-11-08 00:00:00+03:00,out,False,906404,False,6,674,709,35
166916,2019-11-08 00:00:00+03:00,out,False,906412,True,1,0,27,27
166916,2019-11-08 00:00:00+03:00,out,True,906398,True,1,0,0,0
166916,2019-11-08 00:00:00+03:00,out,False,906394,False,1,448,451,3
166916,2019-11-08 00:00:00+03:00,in,False,906404,False,12,1500,1843,343
166916,2019-11-08 00:00:00+03:00,out,False,906412,False,4,419,469,50
166916,2019-11-08 00:00:00+03:00,out,False,906404,True,5,0,258,258
166916,2019-11-08 00:00:00+03:00,out,False,906396,False,5,221,307,86
166916,2019-11-08 00:00:00+03:00,out,True,906394,False,6,824,879,55
166916,2019-11-08 00:00:00+03:00,out,False,906396,True,2,0,39,39
166916,2019-11-08 00:00:00+03:00,out,False,906406,False,15,833,968,135
166916,2019-11-08 00:00:00+03:00,out,True,906416,False,7,929,1043,114
166916,2019-11-08 00:00:00+03:00,out,False,906400,True,2,0,4,4
166916,2019-11-08 00:00:00+03:00,out,True,906406,True,3,0,18,18
166916,2019-11-08 00:00:00+03:00,out,True,906400,False,11,683,740,57
166916,2019-11-08 00:00:00+03:00,out,False,906406,True,9,0,140,140
166916,2019-11-08 00:00:00+03:00,out,True,906412,True,2,0,48,48
166916,2019-11-08 00:00:00+03:00,out,True,906396,False,10,1048,1135,87
166916,2019-11-08 00:00:00+03:00,out,False,906400,False,6,663,709,46
166916,2019-11-08 00:00:00+03:00,out,True,906406,False,6,237,295,58
166916,2019-11-08 00:00:00+03:00,in,False,906406,False,22,1543,2057,514
166916,2019-11-08 00:00:00+03:00,in,False,906400,False,1,109,136,27
166916,2019-11-08 00:00:00+03:00,in,False,-1,True,16,0,193,193
166916,2019-11-08 00:00:00+03:00,out,True,906416,True,3,0,137,137
166916,2019-11-08 00:00:00+03:00,in,False,906412,False,1,42,58,16
166916,2019-11-08 00:00:00+03:00,out,True,906396,True,4,0,21,21
166916,2019-11-08 00:00:00+03:00,in,False,906396,False,4,708,825,117
166916,2019-11-08 00:00:00+03:00,out,True,906394,True,4,0,78,78
166916,2019-11-08 00:00:00+03:00,out,False,906400,False,6,663,709,46
166916,2019-11-08 00:00:00+03:00,out,True,906398,True,1,0,0,0
166916,2019-11-09 00:00:00+03:00,in,False,-1,True,3,0,32,32
166916,2019-11-09 00:00:00+03:00,out,False,906412,False,2,63,87,24
166916,2019-11-10 00:00:00+03:00,out,True,906394,True,3,0,12,12
166916,2019-11-11 00:00:00+03:00,in,False,906396,False,2,146,203,57
166916,2019-11-11 00:00:00+03:00,out,True,906416,False,6,1070,1176,106
166916,2019-11-11 00:00:00+03:00,out,False,906404,False,8,859,939,80
166916,2019-11-11 00:00:00+03:00,in,False,906410,False,7,824,1029,205
166916,2019-11-11 00:00:00+03:00,out,True,906394,False,11,403,465,62
166916,2019-11-11 00:00:00+03:00,out,True,906404,False,2,127,151,24
166916,2019-11-11 00:00:00+03:00,out,False,906406,False,9,423,523,100
166916,2019-11-11 00:00:00+03:00,in,False,906400,False,5,900,1036,136
166916,2019-11-11 00:00:00+03:00,out,False,906398,True,4,0,38,38
166916,2019-11-11 00:00:00+03:00,out,True,906406,True,1,0,1,1
166916,2019-11-11 00:00:00+03:00,out,False,906396,False,3,1906,1933,27
166916,2019-11-11 00:00:00+03:00,out,True,906400,False,11,589,672,83
166916,2019-11-11 00:00:00+03:00,out,False,906416,False,3,278,298,20
166916,2019-11-11 00:00:00+03:00,out,False,906406,True,1,0,12,12
166916,2019-11-11 00:00:00+03:00,in,False,906404,False,12,1969,2283,314
166916,2019-11-11 00:00:00+03:00,out,False,906404,True,2,0,84,84
166916,2019-11-11 00:00:00+03:00,out,True,906412,True,3,0,62,62
166916,2019-11-11 00:00:00+03:00,out,True,906406,False,5,132,169,37
166916,2019-11-11 00:00:00+03:00,out,True,906400,True,1,0,1,1
166916,2019-11-11 00:00:00+03:00,in,False,906416,False,1,24,39,15
166916,2019-11-11 00:00:00+03:00,out,False,906416,True,3,0,71,71
166916,2019-11-11 00:00:00+03:00,out,False,906400,False,1,54,75,21
166916,2019-11-11 00:00:00+03:00,out,False,906394,False,2,374,389,15
166916,2019-11-11 00:00:00+03:00,out,False,906412,False,3,91,138,47
166916,2019-11-11 00:00:00+03:00,out,True,906396,True,2,0,33,33
166916,2019-11-11 00:00:00+03:00,in,False,-1,True,7,0,102,102
166916,2019-11-11 00:00:00+03:00,out,True,906412,False,13,1193,1258,65
166916,2019-11-11 00:00:00+03:00,out,True,906416,True,1,0,29,29
166916,2019-11-11 00:00:00+03:00,in,False,906406,False,25,3240,3889,649
166916,2019-11-11 00:00:00+03:00,out,True,906398,True,1,0,0,0
166916,2019-11-11 00:00:00+03:00,out,True,906396,False,7,440,506,66
166916,2019-11-11 00:00:00+03:00,out,True,906394,True,4,0,33,33
166916,2019-11-11 00:00:00+03:00,out,True,906400,False,11,589,672,83
166916,2019-11-11 00:00:00+03:00,in,False,906404,False,12,1969,2283,314
166916,2019-11-12 00:00:00+03:00,out,True,906396,True,7,0,45,45
166916,2019-11-12 00:00:00+03:00,out,True,906412,False,9,632,702,70
166916,2019-11-12 00:00:00+03:00,out,True,906404,True,3,0,0,0
166916,2019-11-12 00:00:00+03:00,out,False,906406,True,5,0,124,124
166916,2019-11-12 00:00:00+03:00,out,False,906394,False,2,816,818,2
166916,2019-11-12 00:00:00+03:00,out,False,906404,False,10,1328,1423,95
166916,2019-11-12 00:00:00+03:00,in,False,906404,False,14,3355,3741,386
166916,2019-11-12 00:00:00+03:00,in,False,-1,True,8,0,138,138
166916,2019-11-12 00:00:00+03:00,out,False,906412,False,4,170,221,51
166916,2019-11-12 00:00:00+03:00,out,False,906404,True,3,0,65,65
166916,2019-11-12 00:00:00+03:00,in,False,906396,False,5,722,889,167
166916,2019-11-12 00:00:00+03:00,in,False,906398,False,4,244,344,100
166916,2019-11-12 00:00:00+03:00,in,False,906400,False,4,480,592,112
166916,2019-11-12 00:00:00+03:00,in,False,906394,False,1,195,227,32
166916,2019-11-12 00:00:00+03:00,out,True,906394,True,7,0,127,127
166916,2019-11-12 00:00:00+03:00,out,False,906396,False,1,52,55,3
166916,2019-11-12 00:00:00+03:00,out,False,906412,True,1,0,15,15
166916,2019-11-12 00:00:00+03:00,out,True,906416,True,1,0,43,43
166916,2019-11-12 00:00:00+03:00,out,False,906394,True,1,0,7,7
166916,2019-11-12 00:00:00+03:00,in,False,906410,False,3,252,321,69
166916,2019-11-12 00:00:00+03:00,out,True,906406,False,7,136,215,79
166916,2019-11-12 00:00:00+03:00,out,True,906416,False,6,1620,1703,83
166916,2019-11-12 00:00:00+03:00,out,False,906406,False,16,1393,1528,135
166916,2019-11-12 00:00:00+03:00,out,True,906398,True,1,0,1,1
166916,2019-11-12 00:00:00+03:00,out,False,906416,False,4,418,450,32
166916,2019-11-12 00:00:00+03:00,out,True,906400,False,4,109,168,59
166916,2019-11-12 00:00:00+03:00,in,False,906406,False,22,2077,2681,604
166916,2019-11-12 00:00:00+03:00,out,True,906396,False,7,519,598,79
166916,2019-11-12 00:00:00+03:00,out,True,906412,True,8,35,64,29
166916,2019-11-12 00:00:00+03:00,out,False,906400,False,9,816,883,67
166916,2019-11-12 00:00:00+03:00,out,True,906406,True,7,0,62,62
166916,2019-11-12 00:00:00+03:00,out,True,906394,False,15,906,977,71
166916,2019-11-12 00:00:00+03:00,in,False,906412,False,1,39,47,8
166916,2019-11-12 00:00:00+03:00,out,False,906396,False,1,52,55,3
166916,2019-11-13 00:00:00+03:00,out,True,906400,True,5,0,29,29
166916,2019-11-13 00:00:00+03:00,out,False,906396,False,8,1078,1104,26
166916,2019-11-13 00:00:00+03:00,in,False,906410,True,2,93,145,52
166916,2019-11-13 00:00:00+03:00,out,True,906406,False,6,142,191,49
166916,2019-11-13 00:00:00+03:00,out,True,906416,True,1,0,37,37
166916,2019-11-13 00:00:00+03:00,in,False,906416,False,1,11,26,15
166916,2019-11-13 00:00:00+03:00,out,False,906406,False,15,1041,1172,131
166916,2019-11-13 00:00:00+03:00,out,True,906412,True,4,17,29,12
166916,2019-11-13 00:00:00+03:00,in,False,-1,True,9,0,237,237
166916,2019-11-13 00:00:00+03:00,in,False,906404,False,22,3791,4405,614
166916,2019-11-13 00:00:00+03:00,out,False,906400,True,2,0,55,55
166916,2019-11-13 00:00:00+03:00,out,False,906394,True,1,0,30,30
166916,2019-11-13 00:00:00+03:00,out,True,906406,True,3,0,0,0
166916,2019-11-13 00:00:00+03:00,out,False,906404,False,14,1894,2007,113
166916,2019-11-13 00:00:00+03:00,out,True,906398,False,1,84,95,11
166916,2019-11-13 00:00:00+03:00,in,False,906394,False,1,454,488,34
166916,2019-11-13 00:00:00+03:00,out,True,906404,True,1,0,21,21
166916,2019-11-13 00:00:00+03:00,out,False,906416,False,1,171,175,4
166916,2019-11-13 00:00:00+03:00,in,False,906396,False,2,290,332,42
166916,2019-11-13 00:00:00+03:00,out,True,906394,True,4,0,25,25
166916,2019-11-13 00:00:00+03:00,out,True,906396,False,5,382,435,53
166916,2019-11-13 00:00:00+03:00,out,True,906394,False,10,1000,1051,51
166916,2019-11-13 00:00:00+03:00,out,True,906400,False,4,227,270,43
166916,2019-11-13 00:00:00+03:00,in,False,906398,False,1,125,152,27
166916,2019-11-13 00:00:00+03:00,out,True,906416,False,4,619,659,40
166916,2019-11-13 00:00:00+03:00,out,False,906400,False,6,515,567,52
166916,2019-11-13 00:00:00+03:00,out,False,906406,True,3,0,27,27
166916,2019-11-13 00:00:00+03:00,in,False,906406,False,25,3754,4501,747
166916,2019-11-13 00:00:00+03:00,out,True,906404,False,4,142,180,38
166916,2019-11-13 00:00:00+03:00,in,False,906400,False,3,398,489,91
166916,2019-11-13 00:00:00+03:00,out,False,906404,True,1,0,0,0
166916,2019-11-13 00:00:00+03:00,out,True,906412,False,4,498,515,17
166916,2019-11-13 00:00:00+03:00,in,False,906410,False,13,1109,1437,328
166916,2019-11-13 00:00:00+03:00,out,False,906394,False,2,981,992,11
166916,2019-11-13 00:00:00+03:00,out,True,906400,True,5,0,29,29
166916,2019-11-13 00:00:00+03:00,in,False,906394,False,1,454,488,34
166916,2019-11-13 00:00:00+03:00,in,False,906406,False,25,3754,4501,747
166916,2019-11-13 00:00:00+03:00,out,True,906416,False,4,619,659,40
166916,2019-11-14 00:00:00+03:00,in,False,906396,False,1,85,113,28
166916,2019-11-14 00:00:00+03:00,out,True,906396,True,4,0,65,65
166916,2019-11-14 00:00:00+03:00,out,False,906406,False,12,820,926,106
166916,2019-11-14 00:00:00+03:00,out,True,906400,True,1,0,0,0
166916,2019-11-14 00:00:00+03:00,in,False,-1,True,6,0,99,99
166916,2019-11-14 00:00:00+03:00,out,False,906406,True,4,0,104,104
166916,2019-11-14 00:00:00+03:00,out,True,906394,True,4,0,62,62
166916,2019-11-14 00:00:00+03:00,in,False,906404,False,9,1298,1542,244
166916,2019-11-14 00:00:00+03:00,out,True,906412,True,2,0,2,2
166916,2019-11-14 00:00:00+03:00,in,False,906400,False,5,548,689,141
166916,2019-11-14 00:00:00+03:00,out,True,906420,False,2,428,453,25
166916,2019-11-14 00:00:00+03:00,out,True,906404,False,5,263,318,55
166916,2019-11-14 00:00:00+03:00,out,True,906416,False,1,378,389,11
166916,2019-11-14 00:00:00+03:00,out,True,906396,False,5,396,458,62
166916,2019-11-14 00:00:00+03:00,out,True,906406,False,3,567,594,27
166916,2019-11-14 00:00:00+03:00,in,False,906406,False,14,1178,1549,371
166916,2019-11-14 00:00:00+03:00,out,False,906412,False,4,480,526,46
166916,2019-11-14 00:00:00+03:00,in,False,906416,False,1,23,47,24
166916,2019-11-14 00:00:00+03:00,in,False,906404,True,1,0,27,27
166916,2019-11-14 00:00:00+03:00,in,False,906412,False,1,62,73,11
166916,2019-11-14 00:00:00+03:00,out,False,906404,False,13,1793,1978,185
166916,2019-11-14 00:00:00+03:00,out,True,906400,False,9,312,368,56
166916,2019-11-14 00:00:00+03:00,in,False,906394,False,1,387,403,16
166916,2019-11-14 00:00:00+03:00,out,False,906400,False,2,105,121,16
166916,2019-11-14 00:00:00+03:00,out,True,906412,False,8,677,721,44
166916,2019-11-14 00:00:00+03:00,out,True,906406,True,1,0,16,16
166916,2019-11-14 00:00:00+03:00,out,True,906394,False,6,578,620,42
166916,2019-11-14 00:00:00+03:00,out,False,906412,True,2,0,16,16
166916,2019-11-14 00:00:00+03:00,out,False,906404,True,3,0,96,96
166916,2019-11-14 00:00:00+03:00,in,False,906410,False,5,220,338,118
166916,2019-11-14 00:00:00+03:00,out,True,906404,False,5,263,318,55
166916,2019-11-14 00:00:00+03:00,out,True,906420,False,2,428,453,25
166916,2019-11-15 00:00:00+03:00,out,True,906412,False,8,738,786,48
166916,2019-11-15 00:00:00+03:00,in,False,906404,False,9,1180,1406,226
166916,2019-11-15 00:00:00+03:00,out,True,906400,False,4,169,205,36
166916,2019-11-15 00:00:00+03:00,out,True,906412,True,2,0,46,46
166916,2019-11-15 00:00:00+03:00,in,False,-1,True,6,0,66,66
166916,2019-11-15 00:00:00+03:00,out,False,906410,False,2,155,180,25
166916,2019-11-15 00:00:00+03:00,out,True,906394,True,1,0,2,2
166916,2019-11-15 00:00:00+03:00,out,True,906400,True,2,0,27,27
166916,2019-11-15 00:00:00+03:00,in,False,906400,False,1,41,69,28
166916,2019-11-15 00:00:00+03:00,out,False,906396,False,1,63,71,8
166916,2019-11-15 00:00:00+03:00,out,False,906404,True,3,0,117,117
166916,2019-11-15 00:00:00+03:00,in,False,906410,False,6,648,813,165
166916,2019-11-15 00:00:00+03:00,out,False,906404,False,8,1079,1145,66
166916,2019-11-15 00:00:00+03:00,out,True,906406,False,4,253,287,34
166916,2019-11-15 00:00:00+03:00,out,False,906406,True,8,0,244,244
166916,2019-11-15 00:00:00+03:00,out,True,906404,False,1,46,57,11
166916,2019-11-15 00:00:00+03:00,out,True,906394,False,9,702,779,77
166916,2019-11-15 00:00:00+03:00,out,True,906416,False,2,643,681,38
166916,2019-11-15 00:00:00+03:00,out,True,906396,False,5,314,355,41
166916,2019-11-15 00:00:00+03:00,out,False,906406,False,12,1282,1396,114
166916,2019-11-15 00:00:00+03:00,out,False,906412,False,3,180,218,38
166916,2019-11-15 00:00:00+03:00,in,False,906406,False,13,1363,1700,337
166916,2019-11-15 00:00:00+03:00,out,True,906406,True,2,0,33,33
166916,2019-11-15 00:00:00+03:00,in,False,906404,False,9,1180,1406,226
166916,2019-11-16 00:00:00+03:00,out,True,906394,False,2,236,271,35
166916,2019-11-17 00:00:00+03:00,in,False,-1,True,2,0,193,193
166916,2019-11-18 00:00:00+03:00,out,True,906394,False,7,1138,1169,31
166916,2019-11-18 00:00:00+03:00,out,True,906400,True,3,0,3,3
166916,2019-11-18 00:00:00+03:00,out,True,906406,False,4,63,108,45
166916,2019-11-18 00:00:00+03:00,in,False,-1,True,11,0,297,297
166916,2019-11-18 00:00:00+03:00,out,False,906410,False,1,122,128,6
166916,2019-11-18 00:00:00+03:00,out,True,906412,False,4,374,394,20
166916,2019-11-18 00:00:00+03:00,out,True,906412,True,1,44,56,12
166916,2019-11-18 00:00:00+03:00,out,False,906406,False,19,1782,1979,197
166916,2019-11-18 00:00:00+03:00,out,False,906400,False,1,75,87,12
166916,2019-11-18 00:00:00+03:00,out,True,906394,True,2,0,35,35
166916,2019-11-18 00:00:00+03:00,out,True,906398,False,1,22,28,6
166916,2019-11-18 00:00:00+03:00,in,False,906410,False,13,1001,1309,308
166916,2019-11-18 00:00:00+03:00,in,False,906404,False,16,2522,2861,339
166916,2019-11-18 00:00:00+03:00,in,False,906396,False,1,84,108,24
166916,2019-11-18 00:00:00+03:00,out,False,906404,True,7,0,228,228
166916,2019-11-18 00:00:00+03:00,out,True,906396,False,4,1278,1316,38
166916,2019-11-18 00:00:00+03:00,out,True,906400,False,1,171,173,2
166916,2019-11-18 00:00:00+03:00,out,False,906404,False,9,830,1020,190
166916,2019-11-18 00:00:00+03:00,out,True,906404,False,3,162,192,30
166916,2019-11-18 00:00:00+03:00,in,False,906420,False,1,92,99,7
166916,2019-11-18 00:00:00+03:00,out,True,906398,True,1,0,12,12
166916,2019-11-18 00:00:00+03:00,in,False,906406,False,14,1666,2035,369
166916,2019-11-18 00:00:00+03:00,out,False,906396,False,3,310,323,13
166916,2019-11-18 00:00:00+03:00,in,False,906398,False,1,279,314,35
166916,2019-11-18 00:00:00+03:00,out,False,906406,True,5,0,68,68
166916,2019-11-18 00:00:00+03:00,out,True,906396,False,4,1278,1316,38
166916,2019-11-18 00:00:00+03:00,out,True,906398,False,1,22,28,6
166916,2019-11-19 00:00:00+03:00,out,False,906412,False,3,162,207,45
166916,2019-11-19 00:00:00+03:00,out,True,906394,False,5,151,166,15
166916,2019-11-19 00:00:00+03:00,in,False,906404,False,13,2145,2482,337
166916,2019-11-19 00:00:00+03:00,out,True,906394,True,5,0,71,71
166916,2019-11-19 00:00:00+03:00,out,True,906404,False,3,610,650,40
166916,2019-11-19 00:00:00+03:00,in,False,906406,False,18,2190,2617,427
166916,2019-11-19 00:00:00+03:00,in,False,906410,False,16,1420,1907,487
166916,2019-11-19 00:00:00+03:00,out,False,906406,False,14,1023,1192,169
166916,2019-11-19 00:00:00+03:00,out,False,906404,True,7,0,18,18
166916,2019-11-19 00:00:00+03:00,out,False,906406,True,4,0,89,89
166916,2019-11-19 00:00:00+03:00,out,False,906412,True,1,0,41,41
166916,2019-11-19 00:00:00+03:00,in,False,906398,False,3,274,370,96
166916,2019-11-19 00:00:00+03:00,out,False,906404,False,20,3247,3515,268
166916,2019-11-19 00:00:00+03:00,out,True,906416,False,4,1456,1506,50
166916,2019-11-19 00:00:00+03:00,out,True,906406,False,2,58,88,30
166916,2019-11-19 00:00:00+03:00,in,False,906396,False,4,575,679,104
166916,2019-11-19 00:00:00+03:00,out,True,906404,True,3,0,27,27
166916,2019-11-19 00:00:00+03:00,out,True,906396,False,6,391,443,52
166916,2019-11-19 00:00:00+03:00,out,True,906400,False,6,401,448,47
166916,2019-11-19 00:00:00+03:00,out,True,906400,True,3,0,22,22
166916,2019-11-19 00:00:00+03:00,in,False,906410,True,1,12,41,29
166916,2019-11-19 00:00:00+03:00,out,False,906394,False,3,767,807,40
166916,2019-11-19 00:00:00+03:00,out,True,906406,True,2,0,25,25
166916,2019-11-19 00:00:00+03:00,in,False,906420,False,1,43,58,15
166916,2019-11-19 00:00:00+03:00,out,True,906412,False,8,554,602,48
166916,2019-11-19 00:00:00+03:00,out,False,906396,False,4,468,485,17
166916,2019-11-19 00:00:00+03:00,in,False,-1,True,5,0,96,96
166916,2019-11-19 00:00:00+03:00,in,False,906394,False,1,78,106,28
166916,2019-11-19 00:00:00+03:00,out,False,906396,True,1,0,1,1
166916,2019-11-19 00:00:00+03:00,in,False,906400,False,4,449,553,104
166916,2019-11-19 00:00:00+03:00,out,True,906396,True,3,0,17,17
166916,2019-11-19 00:00:00+03:00,out,True,906396,False,6,391,443,52
166916,2019-11-19 00:00:00+03:00,in,False,-1,True,5,0,96,96
166916,2019-11-20 00:00:00+03:00,out,True,906406,False,4,228,272,44
166916,2019-11-20 00:00:00+03:00,out,True,906416,False,3,909,940,31
166916,2019-11-20 00:00:00+03:00,in,False,906404,True,1,31,66,35
166916,2019-11-20 00:00:00+03:00,out,True,906412,False,11,715,809,94
166916,2019-11-20 00:00:00+03:00,out,True,906394,False,11,3131,3225,94
166916,2019-11-20 00:00:00+03:00,out,True,906400,False,10,437,518,81
166916,2019-11-20 00:00:00+03:00,in,False,906396,False,1,79,104,25
166916,2019-11-20 00:00:00+03:00,out,True,906394,True,10,0,58,58
166916,2019-11-20 00:00:00+03:00,in,False,-1,True,5,0,108,108
166916,2019-11-20 00:00:00+03:00,out,True,906396,False,6,193,260,67
166916,2019-11-20 00:00:00+03:00,out,False,906396,True,1,0,13,13
166916,2019-11-20 00:00:00+03:00,out,False,906396,False,3,602,623,21
166916,2019-11-20 00:00:00+03:00,out,True,906412,True,3,34,83,49
166916,2019-11-20 00:00:00+03:00,out,True,906396,True,3,0,32,32
166916,2019-11-20 00:00:00+03:00,out,True,906406,True,3,0,40,40
166916,2019-11-20 00:00:00+03:00,out,True,906404,False,3,384,410,26
166916,2019-11-20 00:00:00+03:00,out,False,906394,False,3,286,308,22
166916,2019-11-20 00:00:00+03:00,out,False,906404,False,13,1733,1983,250
166916,2019-11-20 00:00:00+03:00,out,True,906416,True,1,0,60,60
166916,2019-11-20 00:00:00+03:00,in,False,906404,False,16,2158,2591,433
166916,2019-11-20 00:00:00+03:00,out,False,906404,True,3,0,46,46
166916,2019-11-20 00:00:00+03:00,out,False,906406,False,17,1263,1373,110
166916,2019-11-20 00:00:00+03:00,out,False,906400,False,4,301,336,35
166916,2019-11-20 00:00:00+03:00,out,True,906410,True,1,5,19,14
166916,2019-11-20 00:00:00+03:00,out,True,906400,True,1,0,0,0
166916,2019-11-20 00:00:00+03:00,out,False,906406,True,8,0,62,62
166916,2019-11-20 00:00:00+03:00,in,False,906406,False,10,881,1194,313
166916,2019-11-20 00:00:00+03:00,out,False,906410,False,1,6,14,8
166916,2019-11-20 00:00:00+03:00,in,False,906406,True,1,0,19,19
166916,2019-11-20 00:00:00+03:00,out,False,906400,True,1,0,6,6
166916,2019-11-20 00:00:00+03:00,in,False,906400,False,2,332,388,56
166916,2019-11-20 00:00:00+03:00,out,False,906412,False,1,28,36,8
166916,2019-11-20 00:00:00+03:00,in,False,906410,False,8,890,1114,224
166916,2019-11-20 00:00:00+03:00,out,True,906394,True,10,0,58,58
166916,2019-11-20 00:00:00+03:00,out,True,906394,False,11,3131,3225,94
166916,2019-11-20 00:00:00+03:00,out,False,906412,False,1,28,36,8
166916,2019-11-20 00:00:00+03:00,out,True,906412,True,3,34,83,49
166916,2019-11-21 00:00:00+03:00,out,True,906420,False,5,788,825,37
166916,2019-11-21 00:00:00+03:00,out,False,906396,False,3,389,399,10
166916,2019-11-21 00:00:00+03:00,out,False,906404,True,3,0,81,81
166916,2019-11-21 00:00:00+03:00,out,False,906406,True,3,0,23,23
166916,2019-11-21 00:00:00+03:00,out,True,906412,False,8,1270,1314,44
166916,2019-11-21 00:00:00+03:00,out,True,906404,True,1,0,9,9
166916,2019-11-21 00:00:00+03:00,out,True,906406,True,1,0,10,10
166916,2019-11-21 00:00:00+03:00,out,True,906412,True,4,0,58,58
166916,2019-11-21 00:00:00+03:00,out,True,906404,False,3,252,280,28
166916,2019-11-21 00:00:00+03:00,out,False,906406,False,3,645,689,44
166916,2019-11-21 00:00:00+03:00,out,True,906400,False,2,32,55,23
166916,2019-11-21 00:00:00+03:00,out,True,906396,False,10,656,729,73
166916,2019-11-21 00:00:00+03:00,out,False,906404,False,11,2123,2250,127
166916,2019-11-21 00:00:00+03:00,in,False,906404,False,18,2141,2553,412
166916,2019-11-21 00:00:00+03:00,in,False,906410,False,5,266,400,134
166916,2019-11-21 00:00:00+03:00,out,True,906398,True,1,0,29,29
166916,2019-11-21 00:00:00+03:00,out,True,906398,False,1,57,70,13
166916,2019-11-21 00:00:00+03:00,in,False,906398,False,1,167,178,11
166916,2019-11-21 00:00:00+03:00,out,True,906394,True,5,34,94,60
166916,2019-11-21 00:00:00+03:00,out,False,906400,False,6,455,471,16
166916,2019-11-21 00:00:00+03:00,out,True,906420,True,8,0,92,92
166916,2019-11-21 00:00:00+03:00,in,False,906396,False,3,386,492,106
166916,2019-11-21 00:00:00+03:00,in,False,906406,False,11,994,1334,340
166916,2019-11-21 00:00:00+03:00,in,False,906400,False,3,458,542,84
166916,2019-11-21 00:00:00+03:00,out,False,906420,True,2,0,44,44
166916,2019-11-21 00:00:00+03:00,out,True,906416,False,2,128,155,27
166916,2019-11-21 00:00:00+03:00,in,False,906412,False,1,46,69,23
166916,2019-11-21 00:00:00+03:00,out,False,906410,False,2,286,335,49
166916,2019-11-21 00:00:00+03:00,out,True,906394,False,12,1491,1601,110
166916,2019-11-21 00:00:00+03:00,out,True,906406,False,4,226,252,26
166916,2019-11-21 00:00:00+03:00,in,False,-1,True,12,0,321,321
166916,2019-11-21 00:00:00+03:00,out,True,906400,True,1,0,1,1
166916,2019-11-21 00:00:00+03:00,out,False,906420,True,2,0,44,44
166916,2019-11-22 00:00:00+03:00,in,False,906396,False,1,98,133,35
166916,2019-11-22 00:00:00+03:00,out,True,906406,True,3,0,31,31
166916,2019-11-22 00:00:00+03:00,in,False,906404,False,16,2475,2853,378
166916,2019-11-22 00:00:00+03:00,out,True,906396,True,1,0,1,1
166916,2019-11-22 00:00:00+03:00,out,False,906394,False,2,186,189,3
166916,2019-11-22 00:00:00+03:00,out,False,906396,False,1,34,40,6
166916,2019-11-22 00:00:00+03:00,in,False,906398,False,1,84,112,28
166916,2019-11-22 00:00:00+03:00,out,True,906396,False,16,783,948,165
166916,2019-11-22 00:00:00+03:00,out,True,906394,False,10,719,801,82
166916,2019-11-22 00:00:00+03:00,out,True,906404,True,1,0,0,0
166916,2019-11-22 00:00:00+03:00,out,True,906406,False,4,114,147,33
166916,2019-11-22 00:00:00+03:00,out,True,906392,False,1,88,90,2
166916,2019-11-22 00:00:00+03:00,out,False,906400,False,3,148,174,26
166916,2019-11-22 00:00:00+03:00,in,False,-1,True,4,0,210,210
166916,2019-11-22 00:00:00+03:00,out,True,906404,False,1,45,53,8
166916,2019-11-22 00:00:00+03:00,in,False,906406,False,13,798,1177,379
166916,2019-11-22 00:00:00+03:00,in,False,906404,True,1,1,31,30
166916,2019-11-22 00:00:00+03:00,out,False,906406,False,11,487,635,148
166916,2019-11-22 00:00:00+03:00,out,True,906412,True,6,0,86,86
166916,2019-11-22 00:00:00+03:00,out,True,906400,True,2,0,51,51
166916,2019-11-22 00:00:00+03:00,out,True,906394,True,6,15,100,85
166916,2019-11-22 00:00:00+03:00,in,False,906412,False,1,15,32,17
166916,2019-11-22 00:00:00+03:00,out,False,906406,True,11,0,116,116
166916,2019-11-22 00:00:00+03:00,out,True,906400,False,6,478,543,65
166916,2019-11-22 00:00:00+03:00,out,False,906404,False,15,2653,2786,133
166916,2019-11-22 00:00:00+03:00,out,False,906412,True,1,0,29,29
166916,2019-11-22 00:00:00+03:00,out,True,906416,False,3,874,925,51
166916,2019-11-22 00:00:00+03:00,out,True,906420,True,1,0,58,58
166916,2019-11-22 00:00:00+03:00,out,True,906412,False,9,1083,1140,57
166916,2019-11-22 00:00:00+03:00,in,False,906410,False,1,60,80,20
166916,2019-11-22 00:00:00+03:00,out,False,906404,True,2,0,102,102
166916,2019-11-22 00:00:00+03:00,in,False,906394,False,1,715,751,36
166916,2019-11-23 00:00:00+03:00,out,False,906416,True,1,0,25,25
166916,2019-11-25 00:00:00+03:00,in,False,906418,False,1,38,51,13
166916,2019-11-25 00:00:00+03:00,in,False,906404,False,10,1650,1882,232
166916,2019-11-25 00:00:00+03:00,out,True,906400,False,3,173,190,17
166916,2019-11-25 00:00:00+03:00,out,False,906394,False,6,1998,2015,17
166916,2019-11-25 00:00:00+03:00,in,False,906396,False,1,180,194,14
166916,2019-11-25 00:00:00+03:00,in,False,906394,False,1,264,292,28
166916,2019-11-25 00:00:00+03:00,out,True,906416,False,4,403,466,63
166916,2019-11-25 00:00:00+03:00,out,True,906406,True,1,0,15,15
166916,2019-11-25 00:00:00+03:00,out,False,906406,True,3,0,63,63
166916,2019-11-25 00:00:00+03:00,out,True,906394,False,7,1319,1352,33
166916,2019-11-25 00:00:00+03:00,in,False,906398,False,1,23,51,28
166916,2019-11-25 00:00:00+03:00,out,False,906412,False,4,211,276,65
166916,2019-11-25 00:00:00+03:00,in,False,906410,False,9,340,625,285
166916,2019-11-25 00:00:00+03:00,in,False,906416,False,1,66,80,14
166916,2019-11-25 00:00:00+03:00,out,True,906412,True,5,16,86,70
166916,2019-11-25 00:00:00+03:00,out,False,906412,True,1,0,28,28
166916,2019-11-25 00:00:00+03:00,out,True,906404,False,3,132,150,18
166916,2019-11-25 00:00:00+03:00,in,False,-1,True,7,0,144,144
166916,2019-11-25 00:00:00+03:00,out,False,906406,False,14,728,881,153
166916,2019-11-25 00:00:00+03:00,out,True,906406,False,4,121,141,20
166916,2019-11-25 00:00:00+03:00,in,False,906400,False,2,231,285,54
166916,2019-11-25 00:00:00+03:00,out,True,906404,True,1,0,0,0
166916,2019-11-25 00:00:00+03:00,out,False,906404,False,19,2340,2482,142
166916,2019-11-25 00:00:00+03:00,out,True,906396,False,3,83,131,48
166916,2019-11-25 00:00:00+03:00,out,False,906404,True,1,0,60,60
166916,2019-11-25 00:00:00+03:00,out,False,906416,False,1,47,58,11
166916,2019-11-25 00:00:00+03:00,out,True,906412,False,9,449,501,52
166916,2019-11-25 00:00:00+03:00,in,False,906406,False,15,1543,1891,348
166916,2019-11-25 00:00:00+03:00,out,True,906394,True,2,0,0,0
166916,2019-11-25 00:00:00+03:00,out,True,906398,False,1,40,46,6
166916,2019-11-25 00:00:00+03:00,out,False,906396,False,5,2072,2091,19
166916,2019-11-25 00:00:00+03:00,in,False,906412,False,2,73,100,27
166916,2019-11-25 00:00:00+03:00,in,False,906418,False,1,38,51,13
166916,2019-11-25 00:00:00+03:00,out,True,906394,False,7,1319,1352,33
166916,2019-11-26 00:00:00+03:00,out,True,906406,False,4,73,99,26
166916,2019-11-26 00:00:00+03:00,out,True,906406,True,1,0,0,0
166916,2019-11-26 00:00:00+03:00,in,False,906418,False,2,172,202,30
166916,2019-11-26 00:00:00+03:00,in,False,906404,False,15,2747,3183,436
166916,2019-11-26 00:00:00+03:00,out,True,906404,False,3,112,136,24
166916,2019-11-26 00:00:00+03:00,out,True,906396,True,1,0,0,0
166916,2019-11-26 00:00:00+03:00,out,False,906404,False,16,2119,2251,132
166916,2019-11-26 00:00:00+03:00,out,True,906416,False,1,803,811,8
166916,2019-11-26 00:00:00+03:00,out,True,906404,True,1,0,29,29
166916,2019-11-26 00:00:00+03:00,in,False,906420,False,1,15,23,8
166916,2019-11-26 00:00:00+03:00,in,False,906406,False,23,2117,2752,635
166916,2019-11-26 00:00:00+03:00,out,True,906420,False,4,630,652,22
166916,2019-11-26 00:00:00+03:00,out,True,906394,True,1,0,1,1
166916,2019-11-26 00:00:00+03:00,out,False,906412,False,1,29,50,21
166916,2019-11-26 00:00:00+03:00,out,True,906402,True,1,0,16,16
166916,2019-11-26 00:00:00+03:00,in,False,-1,True,8,0,118,118
166916,2019-11-26 00:00:00+03:00,out,True,906400,True,2,0,2,2
166916,2019-11-26 00:00:00+03:00,in,False,906400,False,1,63,98,35
166916,2019-11-26 00:00:00+03:00,out,False,906406,False,1,59,74,15
166916,2019-11-26 00:00:00+03:00,out,False,906404,True,1,0,10,10
166916,2019-11-26 00:00:00+03:00,out,True,906394,False,17,1260,1359,99
166916,2019-11-26 00:00:00+03:00,out,True,906396,False,3,335,362,27
166916,2019-11-26 00:00:00+03:00,out,True,906420,True,1,0,46,46
166916,2019-11-26 00:00:00+03:00,out,True,906412,True,2,0,2,2
166916,2019-11-26 00:00:00+03:00,out,True,906412,False,7,293,329,36
166916,2019-11-26 00:00:00+03:00,out,True,906400,False,3,92,114,22
166916,2019-11-26 00:00:00+03:00,out,False,906400,False,3,663,669,6
166916,2019-11-26 00:00:00+03:00,in,False,906406,False,23,2117,2752,635
166916,2019-11-26 00:00:00+03:00,out,True,906404,False,3,112,136,24
166916,2019-11-27 00:00:00+03:00,out,False,906394,False,5,300,325,25
166916,2019-11-27 00:00:00+03:00,out,False,906412,True,2,0,82,82
166916,2019-11-27 00:00:00+03:00,out,True,906404,True,1,0,0,0
166916,2019-11-27 00:00:00+03:00,out,True,906404,False,1,70,78,8
166916,2019-11-27 00:00:00+03:00,out,True,906420,False,4,747,782,35
166916,2019-11-27 00:00:00+03:00,out,True,906400,False,6,455,507,52
166916,2019-11-27 00:00:00+03:00,out,True,906396,False,15,1412,1537,125
166916,2019-11-27 00:00:00+03:00,in,False,906404,False,21,2103,2626,523
166916,2019-11-27 00:00:00+03:00,in,False,906418,False,1,17,34,17
166916,2019-11-27 00:00:00+03:00,out,False,906404,True,5,0,163,163
166916,2019-11-27 00:00:00+03:00,in,False,906400,False,1,84,116,32
166916,2019-11-27 00:00:00+03:00,in,False,906420,False,1,26,37,11
166916,2019-11-27 00:00:00+03:00,out,False,906412,False,3,177,222,45
166916,2019-11-27 00:00:00+03:00,out,True,906398,False,2,445,469,24
166916,2019-11-27 00:00:00+03:00,in,False,906398,False,1,406,435,29
166916,2019-11-27 00:00:00+03:00,in,False,906396,False,2,243,300,57
166916,2019-11-27 00:00:00+03:00,in,False,-1,True,14,0,280,280
166916,2019-11-27 00:00:00+03:00,out,True,906416,False,1,81,91,10
166916,2019-11-27 00:00:00+03:00,out,True,906394,False,10,1162,1240,78
166916,2019-11-27 00:00:00+03:00,out,True,906412,False,9,952,995,43
166916,2019-11-27 00:00:00+03:00,out,True,906398,True,2,0,50,50
166916,2019-11-27 00:00:00+03:00,out,False,906418,False,1,2,39,37
166916,2019-11-27 00:00:00+03:00,out,True,906394,True,5,0,45,45
166916,2019-11-27 00:00:00+03:00,out,False,906396,False,4,537,545,8
166916,2019-11-27 00:00:00+03:00,out,True,906418,True,2,0,23,23
166916,2019-11-27 00:00:00+03:00,in,False,906412,False,4,136,184,48
166916,2019-11-27 00:00:00+03:00,in,False,906410,False,4,316,421,105
166916,2019-11-27 00:00:00+03:00,out,True,906396,True,2,0,7,7
166916,2019-11-27 00:00:00+03:00,out,False,906404,False,15,1787,1959,172
166916,2019-11-27 00:00:00+03:00,out,True,906412,True,7,112,230,118
166916,2019-11-27 00:00:00+03:00,in,False,-1,True,14,0,280,280
166916,2019-11-27 00:00:00+03:00,out,False,906404,False,15,1787,1959,172
166916,2019-11-28 00:00:00+03:00,out,True,906406,True,2,0,25,25
166916,2019-11-28 00:00:00+03:00,out,True,906400,False,6,623,679,56
166916,2019-11-28 00:00:00+03:00,in,False,906400,False,3,235,346,111
166916,2019-11-28 00:00:00+03:00,out,False,906406,True,2,0,39,39
166916,2019-11-28 00:00:00+03:00,in,False,906410,False,5,299,510,211
166916,2019-11-28 00:00:00+03:00,out,False,906404,True,2,0,99,99
166916,2019-11-28 00:00:00+03:00,out,True,906396,False,4,210,242,32
166916,2019-11-28 00:00:00+03:00,out,False,906404,False,18,1645,1925,280
166916,2019-11-28 00:00:00+03:00,out,True,906412,True,5,0,47,47
166916,2019-11-28 00:00:00+03:00,out,False,906394,False,6,793,816,23
166916,2019-11-28 00:00:00+03:00,out,True,906394,False,10,651,724,73
166916,2019-11-28 00:00:00+03:00,in,False,906398,False,1,38,65,27
166916,2019-11-28 00:00:00+03:00,out,True,906412,False,17,1405,1502,97
166916,2019-11-28 00:00:00+03:00,in,False,906416,False,1,32,47,15
166916,2019-11-28 00:00:00+03:00,in,False,906412,False,2,45,70,25
166916,2019-11-28 00:00:00+03:00,out,True,906398,False,2,363,388,25
166916,2019-11-28 00:00:00+03:00,out,True,906416,True,1,0,47,47
166916,2019-11-28 00:00:00+03:00,in,False,906394,False,1,33,68,35
166916,2019-11-28 00:00:00+03:00,out,True,906416,False,2,618,649,31
166916,2019-11-28 00:00:00+03:00,out,False,906412,False,1,55,68,13
166916,2019-11-28 00:00:00+03:00,out,True,906392,False,1,775,787,12
166916,2019-11-28 00:00:00+03:00,out,True,906404,False,4,254,298,44
166916,2019-11-28 00:00:00+03:00,out,True,906418,False,1,178,181,3
166916,2019-11-28 00:00:00+03:00,out,False,906400,False,2,289,316,27
166916,2019-11-28 00:00:00+03:00,in,False,906406,False,16,1554,1991,437
166916,2019-11-28 00:00:00+03:00,out,False,906412,True,3,0,88,88
166916,2019-11-28 00:00:00+03:00,in,False,906396,False,2,898,944,46
166916,2019-11-28 00:00:00+03:00,out,False,906406,False,8,535,665,130
166916,2019-11-28 00:00:00+03:00,out,True,906406,False,5,205,245,40
166916,2019-11-28 00:00:00+03:00,out,False,906400,True,1,0,42,42
166916,2019-11-28 00:00:00+03:00,out,True,906394,True,13,0,113,113
166916,2019-11-28 00:00:00+03:00,out,False,906394,True,2,0,49,49
166916,2019-11-28 00:00:00+03:00,in,False,-1,True,13,0,290,290
166916,2019-11-28 00:00:00+03:00,in,False,906404,False,17,1846,2302,456
166916,2019-11-28 00:00:00+03:00,out,True,906406,False,5,205,245,40
166916,2019-11-28 00:00:00+03:00,in,False,906416,False,1,32,47,15
166916,2019-11-28 00:00:00+03:00,in,False,906400,False,3,235,346,111
166916,2019-11-28 00:00:00+03:00,out,False,906412,False,1,55,68,13
166916,2019-11-28 00:00:00+03:00,out,False,906400,True,1,0,42,42
166916,2019-11-28 00:00:00+03:00,out,True,906392,False,1,775,787,12
166936,2019-08-26 00:00:00+03:00,in,False,-1,True,1,0,2,2
166936,2019-08-27 00:00:00+03:00,out,False,896430,True,4,0,20,20
166936,2019-08-27 00:00:00+03:00,out,False,896428,True,8,0,171,171
166936,2019-08-27 00:00:00+03:00,in,False,896428,False,3,88,115,27
166936,2019-08-27 00:00:00+03:00,out,False,896430,False,5,287,318,31
166936,2019-08-27 00:00:00+03:00,out,False,896428,False,14,1205,1346,141
166936,2019-08-27 00:00:00+03:00,in,False,896428,False,3,88,115,27
166936,2019-08-27 00:00:00+03:00,out,False,896430,True,4,0,20,20
166936,2019-08-28 00:00:00+03:00,out,True,896428,True,1,0,1,1
166936,2019-08-28 00:00:00+03:00,out,False,896428,False,13,1854,2044,190
166936,2019-08-28 00:00:00+03:00,out,False,896428,True,6,0,82,82
166936,2019-08-28 00:00:00+03:00,in,False,896430,False,1,219,232,13
166936,2019-08-29 00:00:00+03:00,out,False,896428,True,2,0,110,110
166936,2019-08-29 00:00:00+03:00,out,True,896428,True,1,0,0,0
166936,2019-08-29 00:00:00+03:00,in,False,896428,False,1,140,175,35
166936,2019-08-29 00:00:00+03:00,out,False,896428,False,5,721,791,70
166936,2019-08-30 00:00:00+03:00,out,False,896428,True,13,0,271,271
166936,2019-08-30 00:00:00+03:00,in,False,896428,False,2,151,169,18
166936,2019-08-30 00:00:00+03:00,out,False,896428,False,29,2919,3279,360
166936,2019-08-30 00:00:00+03:00,out,False,896430,False,4,232,275,43
166936,2019-08-30 00:00:00+03:00,out,False,896430,True,1,0,35,35
166936,2019-08-30 00:00:00+03:00,out,False,896428,False,29,2919,3279,360
166936,2019-08-31 00:00:00+03:00,out,False,896428,True,2,0,6,6
166936,2019-08-31 00:00:00+03:00,out,False,896428,False,8,1760,1809,49
166936,2019-09-01 00:00:00+03:00,out,False,896428,False,1,142,169,27
166936,2019-09-02 00:00:00+03:00,out,False,896428,True,3,0,66,66
166936,2019-09-02 00:00:00+03:00,out,False,896428,False,21,2156,2377,221
166936,2019-09-02 00:00:00+03:00,in,False,896428,False,9,940,997,57
166936,2019-09-02 00:00:00+03:00,out,False,896428,True,3,0,66,66
166936,2019-09-02 00:00:00+03:00,in,False,896428,False,9,940,997,57
166936,2019-09-03 00:00:00+03:00,in,False,-1,True,1,0,15,15
166936,2019-09-03 00:00:00+03:00,out,False,896428,True,5,0,117,117
166936,2019-09-03 00:00:00+03:00,out,False,896428,False,7,735,757,22
166936,2019-09-03 00:00:00+03:00,in,False,896428,False,3,78,98,20
166936,2019-09-03 00:00:00+03:00,in,False,896428,False,3,78,98,20
166936,2019-09-04 00:00:00+03:00,out,False,896428,True,1,0,11,11
166936,2019-09-04 00:00:00+03:00,out,False,896428,False,7,364,427,63
166936,2019-09-04 00:00:00+03:00,in,False,896428,False,2,232,245,13
166936,2019-09-05 00:00:00+03:00,out,False,896428,False,4,349,375,26
166936,2019-09-06 00:00:00+03:00,in,False,-1,True,2,0,19,19
166936,2019-09-06 00:00:00+03:00,out,False,896428,True,1,0,38,38
166936,2019-09-06 00:00:00+03:00,out,False,896428,False,7,653,724,71
166936,2019-09-09 00:00:00+03:00,out,False,896428,False,2,202,207,5
166936,2019-09-10 00:00:00+03:00,out,False,896428,False,1,107,108,1
166936,2019-09-10 00:00:00+03:00,out,False,896428,True,1,0,8,8
166936,2019-09-10 00:00:00+03:00,out,False,896428,False,1,107,108,1
166936,2019-09-11 00:00:00+03:00,out,False,896428,False,3,683,692,9
166936,2019-09-11 00:00:00+03:00,in,False,896428,False,1,80,87,7
166936,2019-09-11 00:00:00+03:00,out,False,896428,True,1,0,1,1
166936,2019-09-11 00:00:00+03:00,out,False,896428,False,3,683,692,9
166936,2019-09-12 00:00:00+03:00,in,False,-1,True,1,0,10,10
166936,2019-09-13 00:00:00+03:00,out,False,896428,False,1,497,501,4
166936,2019-09-16 00:00:00+03:00,out,False,896428,True,5,0,192,192
166936,2019-09-16 00:00:00+03:00,in,False,896428,False,2,333,345,12
166936,2019-09-16 00:00:00+03:00,out,False,896428,False,11,1599,1712,113
166936,2019-09-16 00:00:00+03:00,in,False,-1,True,1,0,9,9
166936,2019-09-17 00:00:00+03:00,out,False,896428,False,1,60,69,9
166936,2019-09-19 00:00:00+03:00,in,False,-1,True,2,0,29,29
166936,2019-09-19 00:00:00+03:00,in,False,-1,True,2,0,29,29
166936,2019-09-24 00:00:00+03:00,in,False,-1,True,4,0,38,38
166936,2019-09-25 00:00:00+03:00,in,False,-1,True,2,0,4,4
166936,2019-10-01 00:00:00+03:00,in,False,-1,True,1,0,2,2
166936,2019-10-02 00:00:00+03:00,in,False,-1,True,2,0,4,4
166936,2019-10-03 00:00:00+03:00,in,False,-1,True,1,0,2,2
166936,2019-10-03 00:00:00+03:00,in,False,-1,True,1,0,2,2
166936,2019-10-10 00:00:00+03:00,in,False,-1,True,2,0,4,4
166936,2019-10-11 00:00:00+03:00,in,False,-1,True,1,0,2,2
166936,2019-10-14 00:00:00+03:00,in,False,-1,True,1,0,2,2
166936,2019-10-18 00:00:00+03:00,in,False,-1,True,2,0,4,4
166936,2019-10-29 00:00:00+03:00,in,False,-1,True,3,0,6,6
166936,2019-10-30 00:00:00+03:00,in,False,-1,True,1,0,2,2
166939,2019-10-10 00:00:00+03:00,in,False,-1,True,2,0,3,3
166939,2019-10-11 00:00:00+03:00,in,False,-1,True,27,0,54,54
166939,2019-10-31 00:00:00+03:00,out,False,951332,False,1,11,20,9
166939,2019-11-06 00:00:00+03:00,out,True,951332,True,2,0,10,10
166939,2019-11-07 00:00:00+03:00,out,True,955094,False,1,5,8,3
166939,2019-11-07 00:00:00+03:00,out,False,955094,False,1,7,20,13
166939,2019-11-08 00:00:00+03:00,in,False,-1,True,7,0,14,14
166939,2019-11-11 00:00:00+03:00,in,False,-1,True,2,0,2,2
166939,2019-11-11 00:00:00+03:00,in,False,954750,False,3,36,44,8
166939,2019-11-11 00:00:00+03:00,out,False,954750,False,3,27,49,22
166939,2019-11-12 00:00:00+03:00,out,True,955090,False,3,65,80,15
166939,2019-11-12 00:00:00+03:00,in,False,954750,False,19,977,1172,195
166939,2019-11-12 00:00:00+03:00,in,False,951332,False,1,152,184,32
166939,2019-11-12 00:00:00+03:00,out,False,954750,False,1,13,18,5
166939,2019-11-12 00:00:00+03:00,out,True,954750,True,1,0,14,14
166939,2019-11-12 00:00:00+03:00,in,False,-1,True,8,0,50,50
166939,2019-11-13 00:00:00+03:00,in,False,954750,False,10,796,1038,242
166939,2019-11-13 00:00:00+03:00,out,True,954750,False,1,19,27,8
166939,2019-11-13 00:00:00+03:00,out,True,954750,True,1,0,18,18
166939,2019-11-13 00:00:00+03:00,out,True,955090,False,1,3,9,6
166939,2019-11-13 00:00:00+03:00,in,False,-1,True,8,0,93,93
166939,2019-11-14 00:00:00+03:00,in,False,954750,False,23,1472,1975,503
166939,2019-11-14 00:00:00+03:00,in,False,-1,True,7,0,249,249
166939,2019-11-15 00:00:00+03:00,in,False,-1,True,5,0,77,77
166939,2019-11-15 00:00:00+03:00,out,False,954750,True,11,0,258,258
166939,2019-11-15 00:00:00+03:00,in,False,954750,False,8,610,791,181
166939,2019-11-15 00:00:00+03:00,out,True,955082,True,1,0,0,0
166939,2019-11-15 00:00:00+03:00,out,False,954750,False,13,1040,1196,156
166939,2019-11-15 00:00:00+03:00,out,True,954750,False,4,91,113,22
166939,2019-11-15 00:00:00+03:00,in,False,951332,False,4,199,309,110
166939,2019-11-15 00:00:00+03:00,out,True,954750,True,2,0,28,28
166939,2019-11-15 00:00:00+03:00,out,True,955090,False,3,122,140,18
166939,2019-11-16 00:00:00+03:00,out,False,954750,False,1,21,32,11
166939,2019-11-16 00:00:00+03:00,in,False,954750,False,6,583,729,146
166939,2019-11-16 00:00:00+03:00,out,True,954750,False,1,9,14,5
166939,2019-11-17 00:00:00+03:00,in,False,-1,True,1,0,92,92
166939,2019-11-18 00:00:00+03:00,in,False,951332,False,1,167,190,23
166939,2019-11-18 00:00:00+03:00,in,False,954750,True,1,1,26,25
166939,2019-11-18 00:00:00+03:00,in,False,-1,True,3,0,46,46
166939,2019-11-18 00:00:00+03:00,out,True,955090,False,4,181,207,26
166939,2019-11-18 00:00:00+03:00,in,False,954750,False,15,1705,2077,372
166939,2019-11-18 00:00:00+03:00,out,True,954750,False,4,42,66,24
166939,2019-11-18 00:00:00+03:00,out,True,954750,False,4,42,66,24
166939,2019-11-18 00:00:00+03:00,in,False,951332,False,1,167,190,23
166939,2019-11-19 00:00:00+03:00,in,False,-1,True,18,0,278,278
166939,2019-11-19 00:00:00+03:00,out,True,954750,True,1,0,4,4
166939,2019-11-19 00:00:00+03:00,in,False,951332,False,2,303,394,91
166939,2019-11-19 00:00:00+03:00,in,False,954750,False,10,1233,1473,240
166939,2019-11-20 00:00:00+03:00,out,True,955090,False,2,118,137,19
166939,2019-11-20 00:00:00+03:00,in,False,954750,False,16,1674,2055,381
166939,2019-11-20 00:00:00+03:00,out,False,954750,False,1,3,40,37
166939,2019-11-20 00:00:00+03:00,out,True,955090,True,2,0,0,0
166939,2019-11-20 00:00:00+03:00,out,True,954750,True,1,0,18,18
166939,2019-11-20 00:00:00+03:00,out,True,955068,True,2,0,0,0
166939,2019-11-21 00:00:00+03:00,in,False,954750,False,15,994,1361,367
166939,2019-11-21 00:00:00+03:00,out,False,954750,False,11,720,843,123
166939,2019-11-21 00:00:00+03:00,out,True,954750,False,1,66,72,6
166939,2019-11-21 00:00:00+03:00,out,True,955082,False,1,11,17,6
166939,2019-11-21 00:00:00+03:00,out,True,951332,False,1,19,28,9
166939,2019-11-21 00:00:00+03:00,out,True,955090,False,2,199,211,12
166939,2019-11-21 00:00:00+03:00,out,False,954750,True,6,0,118,118
166939,2019-11-21 00:00:00+03:00,in,False,-1,True,3,0,96,96
166939,2019-11-21 00:00:00+03:00,in,False,-1,True,3,0,96,96
166939,2019-11-21 00:00:00+03:00,out,True,955090,False,2,199,211,12
166939,2019-11-22 00:00:00+03:00,out,True,954750,False,1,49,55,6
166939,2019-11-22 00:00:00+03:00,out,True,955090,False,3,142,162,20
166939,2019-11-22 00:00:00+03:00,in,False,954750,False,14,1297,1627,330
166939,2019-11-22 00:00:00+03:00,in,False,-1,True,5,0,121,121
166939,2019-11-22 00:00:00+03:00,out,True,955082,False,2,54,73,19
166939,2019-11-23 00:00:00+03:00,in,False,954750,False,7,797,953,156
166939,2019-11-23 00:00:00+03:00,out,True,954750,False,1,11,32,21
166939,2019-11-23 00:00:00+03:00,out,True,955082,False,1,22,28,6
166939,2019-11-23 00:00:00+03:00,in,False,-1,True,3,0,75,75
166939,2019-11-24 00:00:00+03:00,in,False,954750,False,1,17,39,22
166939,2019-11-24 00:00:00+03:00,in,False,-1,True,4,0,128,128
166939,2019-11-25 00:00:00+03:00,out,True,955082,False,1,24,30,6
166939,2019-11-25 00:00:00+03:00,in,False,-1,True,24,0,245,245
166939,2019-11-25 00:00:00+03:00,in,False,954750,False,25,2826,3394,568
166939,2019-11-25 00:00:00+03:00,out,True,954750,False,2,23,35,12
166939,2019-11-25 00:00:00+03:00,out,True,955082,True,5,0,0,0
166939,2019-11-25 00:00:00+03:00,out,True,951332,True,1,0,0,0
166939,2019-11-25 00:00:00+03:00,out,True,955090,True,1,0,0,0
166939,2019-11-25 00:00:00+03:00,out,True,955086,False,1,8,14,6
166939,2019-11-25 00:00:00+03:00,in,False,-1,True,24,0,245,245
166939,2019-11-26 00:00:00+03:00,in,False,954750,False,22,2321,2822,501
166939,2019-11-26 00:00:00+03:00,out,True,954750,True,1,0,25,25
166939,2019-11-26 00:00:00+03:00,out,True,955090,False,2,54,66,12
166939,2019-11-26 00:00:00+03:00,in,False,-1,True,1,0,32,32
166939,2019-11-27 00:00:00+03:00,out,True,955082,True,1,0,16,16
166939,2019-11-27 00:00:00+03:00,out,True,955082,False,1,9,15,6
166939,2019-11-27 00:00:00+03:00,in,False,954750,False,15,1365,1712,347
166939,2019-11-27 00:00:00+03:00,in,False,-1,True,4,0,70,70
166939,2019-11-28 00:00:00+03:00,in,False,-1,True,3,0,73,73
166939,2019-11-28 00:00:00+03:00,out,True,955090,False,2,50,66,16
166939,2019-11-28 00:00:00+03:00,in,False,954750,False,13,1332,1626,294
166939,2019-11-28 00:00:00+03:00,out,True,955090,True,1,0,0,0
166939,2019-11-28 00:00:00+03:00,out,True,955082,False,1,28,38,10
166940,2019-08-27 00:00:00+03:00,in,False,897030,False,1,13,21,8
166940,2019-08-27 00:00:00+03:00,out,False,897030,False,1,469,480,11
166940,2019-08-28 00:00:00+03:00,in,False,-1,True,1,0,30,30
166940,2019-08-29 00:00:00+03:00,out,False,897030,False,1,87,100,13
166940,2019-08-29 00:00:00+03:00,out,False,897030,True,4,0,97,97
166940,2019-08-29 00:00:00+03:00,in,False,897030,False,1,56,79,23
166940,2019-08-29 00:00:00+03:00,out,False,897030,False,1,87,100,13
166940,2019-08-30 00:00:00+03:00,in,False,897030,False,1,84,89,5
166940,2019-08-30 00:00:00+03:00,in,False,-1,True,2,0,25,25
166940,2019-08-30 00:00:00+03:00,in,False,900458,False,1,9,18,9
166940,2019-08-30 00:00:00+03:00,out,False,897030,True,1,0,5,5
166940,2019-09-02 00:00:00+03:00,out,False,897030,True,1,0,10,10
166940,2019-09-03 00:00:00+03:00,out,False,897030,False,1,1175,1180,5
166940,2019-09-09 00:00:00+03:00,out,False,900458,True,1,0,6,6
166940,2019-09-10 00:00:00+03:00,out,False,900458,True,9,0,255,255
166940,2019-09-10 00:00:00+03:00,out,False,897030,True,1,0,11,11
166940,2019-09-10 00:00:00+03:00,out,False,900458,False,1,38,57,19
166940,2019-09-10 00:00:00+03:00,out,False,897030,False,1,25,44,19
166940,2019-09-11 00:00:00+03:00,out,False,897030,True,1,0,32,32
166940,2019-09-12 00:00:00+03:00,out,False,900458,False,4,67,107,40
166940,2019-09-12 00:00:00+03:00,out,False,897030,True,1,0,37,37
166940,2019-09-12 00:00:00+03:00,in,False,897030,False,1,10,22,12
166940,2019-09-12 00:00:00+03:00,out,False,900458,True,6,0,120,120
166940,2019-09-12 00:00:00+03:00,in,False,-1,True,3,0,2,2
166940,2019-09-12 00:00:00+03:00,in,False,-1,True,3,0,2,2
166940,2019-09-13 00:00:00+03:00,out,False,900458,True,1,0,28,28
166940,2019-09-25 00:00:00+03:00,out,False,910594,False,5,81,121,40
166940,2019-09-25 00:00:00+03:00,out,False,910594,True,23,0,452,452
166940,2019-09-25 00:00:00+03:00,in,False,-1,True,1,0,0,0
166940,2019-10-16 00:00:00+03:00,out,False,900458,True,1,0,14,14
166940,2019-10-21 00:00:00+03:00,out,False,900458,True,2,0,47,47
166940,2019-10-21 00:00:00+03:00,out,False,900458,False,2,228,253,25
166940,2019-10-23 00:00:00+03:00,out,False,900458,False,1,10,28,18
166940,2019-11-05 00:00:00+03:00,in,False,-1,True,3,0,3,3
166940,2019-11-10 00:00:00+03:00,in,False,-1,True,2,0,0,0
166940,2019-11-10 00:00:00+03:00,in,False,-1,True,2,0,0,0
166940,2019-11-15 00:00:00+03:00,in,False,-1,True,2,0,0,0
166940,2019-11-25 00:00:00+03:00,out,False,897030,True,10,0,180,180
166940,2019-11-25 00:00:00+03:00,out,True,897030,True,1,0,0,0
166940,2019-11-25 00:00:00+03:00,out,False,897030,False,9,744,840,96
166940,2019-11-26 00:00:00+03:00,in,False,-1,True,1,0,7,7
166940,2019-11-26 00:00:00+03:00,out,False,897030,True,20,0,346,346
166940,2019-11-26 00:00:00+03:00,out,False,897030,False,21,1578,1766,188
166940,2019-11-27 00:00:00+03:00,in,False,897030,False,2,18,46,28
166940,2019-11-27 00:00:00+03:00,in,False,-1,True,4,0,60,60
166940,2019-11-27 00:00:00+03:00,out,True,897030,True,1,0,5,5
166940,2019-11-27 00:00:00+03:00,out,False,972460,False,3,109,177,68
166940,2019-11-27 00:00:00+03:00,out,False,972460,True,5,0,65,65
166940,2019-11-27 00:00:00+03:00,out,True,972460,True,2,0,21,21
166940,2019-11-27 00:00:00+03:00,out,True,972460,False,1,6,10,4
166940,2019-11-27 00:00:00+03:00,in,False,972460,False,1,14,18,4
166940,2019-11-27 00:00:00+03:00,in,False,972460,False,1,14,18,4
166940,2019-11-28 00:00:00+03:00,in,False,-1,True,1,0,18,18
166940,2019-11-28 00:00:00+03:00,out,False,972460,False,18,1089,1266,177
166940,2019-11-28 00:00:00+03:00,out,False,972460,True,21,0,281,281
166940,2019-11-28 00:00:00+03:00,in,False,-1,True,1,0,18,18
166940,2019-11-28 00:00:00+03:00,out,False,972460,False,18,1089,1266,177
166941,2019-08-26 00:00:00+03:00,in,False,-1,True,2,0,1,1
166941,2019-08-27 00:00:00+03:00,out,False,896382,True,30,0,947,947
166941,2019-08-27 00:00:00+03:00,in,False,-1,True,2,0,31,31
166941,2019-08-27 00:00:00+03:00,in,False,896708,False,6,389,476,87
166941,2019-08-27 00:00:00+03:00,in,False,896382,False,3,312,364,52
166941,2019-08-27 00:00:00+03:00,out,False,896708,True,3,0,47,47
166941,2019-08-27 00:00:00+03:00,out,False,896382,False,40,5846,6696,850
166941,2019-08-27 00:00:00+03:00,out,False,896708,False,6,1274,1419,145
166941,2019-08-28 00:00:00+03:00,out,True,896382,True,2,0,3,3
166941,2019-08-28 00:00:00+03:00,out,False,896382,False,93,9893,11679,1786
166941,2019-08-28 00:00:00+03:00,out,False,896382,True,39,0,1206,1206
166941,2019-08-28 00:00:00+03:00,out,False,896708,False,3,1533,1575,42
166941,2019-08-28 00:00:00+03:00,out,False,896708,True,9,0,192,192
166941,2019-08-28 00:00:00+03:00,in,False,-1,True,9,0,95,95
166941,2019-08-28 00:00:00+03:00,in,False,896708,False,6,979,1052,73
166941,2019-08-28 00:00:00+03:00,in,False,896382,False,4,1198,1229,31
166941,2019-08-29 00:00:00+03:00,in,False,-1,True,9,0,77,77
166941,2019-08-29 00:00:00+03:00,out,False,896382,False,55,7491,8521,1030
166941,2019-08-29 00:00:00+03:00,in,False,896382,False,2,337,353,16
166941,2019-08-29 00:00:00+03:00,out,False,896382,True,23,0,759,759
166941,2019-08-29 00:00:00+03:00,out,True,896382,True,1,0,0,0
166941,2019-08-29 00:00:00+03:00,out,False,896708,True,4,0,82,82
166941,2019-08-29 00:00:00+03:00,out,False,896708,False,12,1659,1895,236
166941,2019-08-29 00:00:00+03:00,in,False,896708,False,10,714,849,135
166941,2019-08-30 00:00:00+03:00,in,False,-1,True,32,0,38,38
166941,2019-08-30 00:00:00+03:00,out,False,896708,False,4,319,394,75
166941,2019-08-30 00:00:00+03:00,out,False,896708,True,2,0,20,20
166941,2019-08-31 00:00:00+03:00,in,False,-1,True,2,0,1,1
166941,2019-08-31 00:00:00+03:00,in,False,-1,True,2,0,1,1
166941,2019-09-01 00:00:00+03:00,out,False,896390,True,1,0,1,1
166941,2019-09-01 00:00:00+03:00,out,False,896390,False,2,235,253,18
166941,2019-09-01 00:00:00+03:00,out,False,896382,False,1,6,27,21
166941,2019-09-01 00:00:00+03:00,in,False,896382,False,3,242,280,38
166941,2019-09-01 00:00:00+03:00,out,True,896382,True,1,0,0,0
166941,2019-09-01 00:00:00+03:00,out,False,896382,True,4,0,12,12
166941,2019-09-01 00:00:00+03:00,in,False,-1,True,5,0,9,9
166941,2019-09-01 00:00:00+03:00,in,False,896382,False,3,242,280,38
166941,2019-09-02 00:00:00+03:00,out,False,896382,True,24,0,472,472
166941,2019-09-02 00:00:00+03:00,out,False,896708,False,7,340,411,71
166941,2019-09-02 00:00:00+03:00,out,False,896382,False,27,2418,2836,418
166941,2019-09-02 00:00:00+03:00,out,False,896386,False,36,4136,4846,710
166941,2019-09-02 00:00:00+03:00,in,False,896708,False,10,1001,1124,123
166941,2019-09-02 00:00:00+03:00,in,False,896382,False,11,965,1079,114
166941,2019-09-02 00:00:00+03:00,out,False,896708,True,8,0,66,66
166941,2019-09-02 00:00:00+03:00,out,False,896386,True,40,0,1140,1140
166941,2019-09-02 00:00:00+03:00,in,False,-1,True,24,0,96,96
166941,2019-09-03 00:00:00+03:00,out,False,896382,True,16,0,413,413
166941,2019-09-03 00:00:00+03:00,in,False,896708,False,13,1672,1797,125
166941,2019-09-03 00:00:00+03:00,out,False,896708,True,10,0,264,264
166941,2019-09-03 00:00:00+03:00,out,False,896390,False,17,2738,3105,367
166941,2019-09-03 00:00:00+03:00,in,False,896382,False,6,491,565,74
166941,2019-09-03 00:00:00+03:00,in,False,-1,True,24,0,456,456
166941,2019-09-03 00:00:00+03:00,out,False,896384,False,13,2764,3014,250
166941,2019-09-03 00:00:00+03:00,out,False,896382,False,13,2128,2417,289
166941,2019-09-03 00:00:00+03:00,out,False,896708,False,20,3348,3703,355
166941,2019-09-03 00:00:00+03:00,out,False,896384,True,13,0,331,331
166941,2019-09-03 00:00:00+03:00,out,False,896390,True,8,0,191,191
166941,2019-09-03 00:00:00+03:00,out,False,896708,False,20,3348,3703,355
166941,2019-09-04 00:00:00+03:00,out,False,896390,True,3,0,0,0
166941,2019-09-04 00:00:00+03:00,in,False,-1,True,8,0,16,16
166941,2019-09-05 00:00:00+03:00,in,False,896382,False,2,47,69,22
166941,2019-09-05 00:00:00+03:00,out,False,896390,True,15,0,318,318
166941,2019-09-05 00:00:00+03:00,in,False,-1,True,9,0,92,92
166941,2019-09-05 00:00:00+03:00,out,False,896382,False,1,98,117,19
166941,2019-09-05 00:00:00+03:00,in,False,896708,False,2,428,445,17
166941,2019-09-05 00:00:00+03:00,out,False,896708,False,11,3235,3400,165
166941,2019-09-05 00:00:00+03:00,out,False,896384,False,2,350,395,45
166941,2019-09-05 00:00:00+03:00,out,False,896390,False,12,1434,1654,220
166941,2019-09-05 00:00:00+03:00,out,False,896708,True,6,0,79,79
166941,2019-09-05 00:00:00+03:00,out,False,896384,False,2,350,395,45
166941,2019-09-06 00:00:00+03:00,out,False,896390,True,18,0,489,489
166941,2019-09-06 00:00:00+03:00,out,False,896382,True,4,0,28,28
166941,2019-09-06 00:00:00+03:00,in,False,-1,True,7,0,73,73
166941,2019-09-06 00:00:00+03:00,in,False,896708,False,8,890,974,84
166941,2019-09-06 00:00:00+03:00,out,False,896390,False,20,3997,4348,351
166941,2019-09-06 00:00:00+03:00,out,False,896708,False,13,2568,2776,208
166941,2019-09-06 00:00:00+03:00,in,False,896382,False,2,28,51,23
166941,2019-09-06 00:00:00+03:00,out,False,896708,True,3,0,134,134
166941,2019-09-06 00:00:00+03:00,out,False,896382,True,4,0,28,28
166941,2019-09-07 00:00:00+03:00,in,False,896708,False,5,649,714,65
166941,2019-09-07 00:00:00+03:00,in,False,896382,False,1,62,85,23
166941,2019-09-07 00:00:00+03:00,out,False,896390,True,1,0,16,16
166941,2019-09-07 00:00:00+03:00,in,False,-1,True,5,0,94,94
166941,2019-09-07 00:00:00+03:00,out,False,896708,True,7,0,173,173
166941,2019-09-07 00:00:00+03:00,out,False,896708,False,9,771,920,149
166941,2019-09-08 00:00:00+03:00,in,False,-1,True,2,0,0,0
166941,2019-09-09 00:00:00+03:00,out,False,896708,True,1,0,3,3
166941,2019-09-09 00:00:00+03:00,in,False,-1,True,6,0,20,20
166941,2019-09-09 00:00:00+03:00,in,False,896382,False,1,77,96,19
166941,2019-09-09 00:00:00+03:00,out,False,896382,False,6,2164,2248,84
166941,2019-09-09 00:00:00+03:00,out,False,896382,True,6,0,28,28
166941,2019-09-09 00:00:00+03:00,out,False,896708,False,2,202,231,29
166941,2019-09-09 00:00:00+03:00,in,False,896708,False,3,400,438,38
166941,2019-09-09 00:00:00+03:00,in,False,896382,False,1,77,96,19
166941,2019-09-10 00:00:00+03:00,in,False,-1,True,1,0,31,31
166941,2019-09-10 00:00:00+03:00,in,False,896708,False,2,120,156,36
166941,2019-09-10 00:00:00+03:00,out,False,896708,False,2,598,622,24
166941,2019-09-10 00:00:00+03:00,in,False,896382,False,1,23,41,18
166941,2019-09-10 00:00:00+03:00,in,False,896382,False,1,23,41,18
166941,2019-09-11 00:00:00+03:00,in,False,-1,True,4,0,17,17
166941,2019-09-11 00:00:00+03:00,out,False,896708,True,8,0,13,13
166941,2019-09-11 00:00:00+03:00,out,False,896708,False,2,377,427,50
166941,2019-09-11 00:00:00+03:00,in,False,896708,False,1,368,377,9
166941,2019-09-11 00:00:00+03:00,out,False,896708,False,2,377,427,50
166941,2019-09-14 00:00:00+03:00,out,False,896382,True,6,0,0,0
166941,2019-09-16 00:00:00+03:00,in,False,-1,True,3,0,6,6
166941,2019-09-17 00:00:00+03:00,in,False,-1,True,1,0,2,2
166941,2019-09-18 00:00:00+03:00,in,False,-1,True,1,0,2,2
166941,2019-09-21 00:00:00+03:00,in,False,-1,True,1,0,2,2
166941,2019-09-24 00:00:00+03:00,in,False,-1,True,2,0,4,4
166941,2019-10-02 00:00:00+03:00,in,False,-1,True,1,0,2,2
166941,2019-10-02 00:00:00+03:00,in,False,-1,True,1,0,2,2
166946,2019-08-30 00:00:00+03:00,out,False,900742,False,1,55,64,9
166946,2019-08-30 00:00:00+03:00,in,False,900742,False,5,354,382,28
166946,2019-08-30 00:00:00+03:00,in,False,-1,True,6,0,36,36
166946,2019-09-04 00:00:00+03:00,out,False,900742,True,2,0,13,13
166946,2019-09-04 00:00:00+03:00,out,False,900746,True,2,0,17,17
166946,2019-09-04 00:00:00+03:00,out,True,900746,True,2,0,4,4
166946,2019-09-04 00:00:00+03:00,in,False,-1,True,24,0,177,177
166946,2019-09-04 00:00:00+03:00,out,False,900742,False,4,249,261,12
166946,2019-09-04 00:00:00+03:00,in,False,900746,True,1,1,15,14
166946,2019-09-04 00:00:00+03:00,in,False,900742,False,5,61,131,70
166946,2019-09-04 00:00:00+03:00,out,True,900742,True,5,0,28,28
166946,2019-09-04 00:00:00+03:00,out,False,900746,True,2,0,17,17
166946,2019-09-04 00:00:00+03:00,out,False,900742,True,2,0,13,13
166946,2019-09-04 00:00:00+03:00,in,False,-1,True,24,0,177,177
166946,2019-09-05 00:00:00+03:00,out,False,900746,False,8,995,1033,38
166946,2019-09-05 00:00:00+03:00,out,False,900746,True,2,0,8,8
166946,2019-09-06 00:00:00+03:00,out,False,900746,False,2,102,107,5
166946,2019-09-06 00:00:00+03:00,out,False,900746,True,1,0,2,2
166946,2019-09-06 00:00:00+03:00,out,False,900742,False,1,46,48,2
166946,2019-09-11 00:00:00+03:00,in,False,900746,True,1,0,15,15
166946,2019-09-11 00:00:00+03:00,in,False,900746,False,1,17,40,23
166946,2019-09-12 00:00:00+03:00,in,False,900742,False,3,106,131,25
166946,2019-09-12 00:00:00+03:00,in,False,900746,False,1,17,39,22
166946,2019-09-17 00:00:00+03:00,out,False,900742,False,1,26,29,3
166946,2019-09-17 00:00:00+03:00,out,False,900746,False,2,298,305,7
166946,2019-09-18 00:00:00+03:00,in,False,-1,True,2,0,17,17
166946,2019-09-18 00:00:00+03:00,in,False,900742,False,1,119,155,36
166946,2019-09-18 00:00:00+03:00,out,False,900746,False,2,186,189,3
166946,2019-09-18 00:00:00+03:00,in,False,-1,True,2,0,17,17
166946,2019-09-19 00:00:00+03:00,out,False,900746,False,1,97,100,3
166946,2019-09-19 00:00:00+03:00,in,False,-1,True,2,0,29,29
166946,2019-09-19 00:00:00+03:00,out,True,900746,True,1,0,1,1
166946,2019-09-20 00:00:00+03:00,in,False,-1,True,4,0,21,21
166946,2019-09-20 00:00:00+03:00,in,False,900746,False,7,212,390,178
166946,2019-09-20 00:00:00+03:00,out,False,900742,False,1,40,83,43
166946,2019-09-20 00:00:00+03:00,in,False,900742,False,2,138,153,15
166946,2019-09-20 00:00:00+03:00,out,False,900746,False,1,96,99,3
166946,2019-09-20 00:00:00+03:00,in,False,-1,False,4,108,180,72
166946,2019-09-23 00:00:00+03:00,in,False,-1,True,1,0,11,11
166946,2019-09-23 00:00:00+03:00,out,False,900746,False,4,568,595,27
166946,2019-09-23 00:00:00+03:00,in,False,900746,False,2,143,198,55
166946,2019-09-23 00:00:00+03:00,out,False,900742,False,1,77,86,9
166946,2019-09-23 00:00:00+03:00,out,False,900746,True,4,0,89,89
166946,2019-09-23 00:00:00+03:00,in,False,900742,False,2,123,158,35
166946,2019-09-24 00:00:00+03:00,out,False,900746,True,1,0,1,1
166946,2019-09-24 00:00:00+03:00,out,False,900746,False,3,294,308,14
166946,2019-09-24 00:00:00+03:00,in,False,900746,False,3,312,384,72
166946,2019-09-25 00:00:00+03:00,in,False,-1,True,1,0,3,3
166946,2019-09-25 00:00:00+03:00,in,False,900746,False,1,75,96,21
166946,2019-09-25 00:00:00+03:00,out,False,900746,False,1,109,112,3
166946,2019-09-26 00:00:00+03:00,in,False,900746,False,3,248,314,66
166946,2019-09-26 00:00:00+03:00,in,False,-1,True,2,0,64,64
166946,2019-09-26 00:00:00+03:00,out,False,900746,False,5,503,558,55
166946,2019-09-26 00:00:00+03:00,in,False,900742,False,2,172,207,35
166946,2019-09-26 00:00:00+03:00,in,False,900742,False,2,172,207,35
166946,2019-09-27 00:00:00+03:00,out,False,900746,False,6,429,480,51
166946,2019-09-27 00:00:00+03:00,out,True,900746,True,1,0,0,0
166946,2019-09-27 00:00:00+03:00,in,False,900746,False,5,438,563,125
166946,2019-10-04 00:00:00+03:00,in,False,-1,True,1,0,2,2
166946,2019-10-10 00:00:00+03:00,in,False,900742,False,1,13,36,23
166946,2019-10-14 00:00:00+03:00,in,False,-1,True,1,0,17,17
166946,2019-10-14 00:00:00+03:00,in,False,900746,False,1,8,28,20
166946,2019-10-14 00:00:00+03:00,in,False,900742,False,1,12,28,16
166955,2019-08-28 00:00:00+03:00,in,False,-1,True,1,0,21,21
166955,2019-08-29 00:00:00+03:00,in,False,-1,True,2,0,39,39
166955,2019-08-29 00:00:00+03:00,in,False,898560,False,3,142,254,112
166955,2019-08-29 00:00:00+03:00,in,False,-1,True,2,0,39,39
166955,2019-08-30 00:00:00+03:00,in,False,898558,False,1,25,55,30
166955,2019-08-30 00:00:00+03:00,in,False,898560,False,2,157,220,63
166955,2019-08-31 00:00:00+03:00,in,False,898558,False,1,61,88,27
166955,2019-09-02 00:00:00+03:00,in,False,898558,False,2,64,120,56
166955,2019-09-03 00:00:00+03:00,in,False,898558,False,1,39,72,33
166955,2019-09-03 00:00:00+03:00,in,False,898560,False,1,84,113,29
166955,2019-09-03 00:00:00+03:00,in,False,898558,False,1,39,72,33
166955,2019-09-03 00:00:00+03:00,in,False,898560,False,1,84,113,29
166955,2019-09-04 00:00:00+03:00,in,False,898558,False,3,32,117,85
166955,2019-09-04 00:00:00+03:00,in,False,898560,False,5,242,389,147
166955,2019-09-04 00:00:00+03:00,in,False,-1,True,1,0,33,33
166955,2019-09-05 00:00:00+03:00,in,False,898560,False,3,276,381,105
166955,2019-09-06 00:00:00+03:00,in,False,898558,False,1,45,75,30
166955,2019-09-17 00:00:00+03:00,in,False,898560,False,1,119,140,21
166955,2019-09-17 00:00:00+03:00,in,False,898558,False,2,157,203,46
166955,2019-09-17 00:00:00+03:00,in,False,898560,False,1,119,140,21
166955,2019-09-18 00:00:00+03:00,in,False,898560,False,3,125,234,109
166955,2019-09-18 00:00:00+03:00,in,False,898558,False,2,76,120,44
166955,2019-09-25 00:00:00+03:00,in,False,-1,True,2,0,14,14
166955,2019-09-25 00:00:00+03:00,in,False,898558,False,1,5,40,35
166955,2019-09-30 00:00:00+03:00,in,False,898560,False,1,7,45,38
166955,2019-09-30 00:00:00+03:00,in,False,898558,False,5,171,313,142
166955,2019-10-01 00:00:00+03:00,in,False,898558,False,1,57,88,31
166955,2019-10-01 00:00:00+03:00,in,False,-1,True,1,0,52,52
166955,2019-10-04 00:00:00+03:00,in,False,898558,False,2,68,131,63
166958,2019-08-28 00:00:00+03:00,in,False,-1,True,4,0,16,16
166958,2019-09-03 00:00:00+03:00,in,False,898422,False,3,23,49,26
166958,2019-09-03 00:00:00+03:00,in,False,-1,True,1,0,20,20
166958,2019-09-04 00:00:00+03:00,out,False,898422,True,4,0,6,6
166958,2019-09-04 00:00:00+03:00,in,False,-1,True,8,0,170,170
166958,2019-09-04 00:00:00+03:00,out,False,898422,False,2,183,248,65
166958,2019-09-04 00:00:00+03:00,in,False,898422,False,9,646,756,110
166958,2019-09-04 00:00:00+03:00,in,False,-1,True,8,0,170,170
166958,2019-09-04 00:00:00+03:00,out,False,898422,True,4,0,6,6
166958,2019-09-05 00:00:00+03:00,in,False,898422,False,15,1131,1271,140
166958,2019-09-05 00:00:00+03:00,in,False,-1,True,10,0,277,277
166958,2019-09-05 00:00:00+03:00,out,False,898422,False,1,133,137,4
166958,2019-09-06 00:00:00+03:00,in,False,898422,False,9,985,1035,50
166958,2019-09-06 00:00:00+03:00,in,False,-1,True,8,0,208,208
166958,2019-09-06 00:00:00+03:00,out,False,898422,True,1,0,26,26
166958,2019-09-07 00:00:00+03:00,in,False,-1,True,3,0,61,61
166958,2019-09-09 00:00:00+03:00,out,False,898422,False,4,333,388,55
166958,2019-09-09 00:00:00+03:00,in,False,-1,True,4,0,85,85
166958,2019-09-09 00:00:00+03:00,in,False,898422,False,16,1087,1165,78
166958,2019-09-09 00:00:00+03:00,in,False,898422,True,1,0,4,4
166958,2019-09-09 00:00:00+03:00,out,False,898422,False,4,333,388,55
166958,2019-09-10 00:00:00+03:00,out,False,898422,False,1,283,301,18
166958,2019-09-10 00:00:00+03:00,in,False,898422,False,6,387,419,32
166958,2019-09-10 00:00:00+03:00,in,False,-1,True,9,0,224,224
166958,2019-09-11 00:00:00+03:00,in,False,-1,True,7,0,160,160
166958,2019-09-11 00:00:00+03:00,in,False,898422,False,3,324,342,18
166958,2019-09-12 00:00:00+03:00,out,False,898422,False,1,88,105,17
166958,2019-09-12 00:00:00+03:00,in,False,898422,False,1,66,70,4
166958,2019-09-12 00:00:00+03:00,in,False,-1,True,8,0,240,240
166958,2019-09-13 00:00:00+03:00,out,False,898422,False,1,60,80,20
166958,2019-09-13 00:00:00+03:00,in,False,-1,True,15,0,391,391
166958,2019-09-13 00:00:00+03:00,out,False,898422,True,2,0,14,14
166958,2019-09-13 00:00:00+03:00,out,False,898422,False,1,60,80,20
166958,2019-09-16 00:00:00+03:00,in,False,-1,True,12,0,10,10
166958,2019-09-17 00:00:00+03:00,in,False,-1,True,23,0,11,11
166958,2019-09-18 00:00:00+03:00,out,False,898422,False,1,39,47,8
166958,2019-09-18 00:00:00+03:00,in,False,-1,True,28,0,9,9
166958,2019-09-19 00:00:00+03:00,in,False,-1,True,6,0,2,2
166958,2019-09-20 00:00:00+03:00,in,False,898422,False,1,6,11,5
166958,2019-09-20 00:00:00+03:00,out,False,898422,False,1,30,50,20
166958,2019-09-20 00:00:00+03:00,in,False,898422,False,1,6,11,5
166958,2019-09-23 00:00:00+03:00,in,False,-1,True,6,0,1,1
166958,2019-09-24 00:00:00+03:00,in,False,-1,True,39,0,19,19
166958,2019-09-25 00:00:00+03:00,in,False,-1,True,4,0,8,8
166958,2019-09-26 00:00:00+03:00,in,False,-1,True,4,0,8,8
166958,2019-09-27 00:00:00+03:00,in,False,-1,True,3,0,6,6
166958,2019-09-30 00:00:00+03:00,in,False,-1,True,1,0,2,2
166958,2019-09-30 00:00:00+03:00,in,False,-1,True,1,0,2,2
166958,2019-10-01 00:00:00+03:00,in,False,-1,True,3,0,6,6
166958,2019-10-02 00:00:00+03:00,in,False,-1,True,3,0,6,6
166958,2019-10-03 00:00:00+03:00,in,False,-1,True,2,0,4,4
166958,2019-10-03 00:00:00+03:00,out,False,898422,True,4,0,0,0
166958,2019-10-03 00:00:00+03:00,out,False,898422,True,4,0,0,0
166958,2019-10-09 00:00:00+03:00,in,False,-1,True,1,0,2,2
166958,2019-10-11 00:00:00+03:00,in,False,-1,True,1,0,2,2
166958,2019-10-11 00:00:00+03:00,in,False,-1,True,1,0,2,2
166958,2019-10-14 00:00:00+03:00,in,False,-1,True,1,0,2,2
166958,2019-10-15 00:00:00+03:00,in,False,-1,True,1,0,2,2
166958,2019-10-18 00:00:00+03:00,in,False,-1,True,1,0,2,2
166958,2019-10-21 00:00:00+03:00,in,False,-1,True,2,0,5,5
166958,2019-10-22 00:00:00+03:00,in,False,-1,True,4,0,8,8
166958,2019-10-23 00:00:00+03:00,in,False,-1,True,2,0,4,4
166958,2019-10-23 00:00:00+03:00,in,False,-1,True,2,0,4,4
166958,2019-10-26 00:00:00+03:00,in,False,-1,True,1,0,2,2
166958,2019-10-28 00:00:00+03:00,in,False,-1,True,1,0,2,2
166958,2019-10-29 00:00:00+03:00,in,False,-1,True,3,0,6,6
166958,2019-10-30 00:00:00+03:00,in,False,-1,True,4,0,9,9
166971,2019-08-28 00:00:00+03:00,in,False,-1,True,1,0,2,2
166971,2019-08-29 00:00:00+03:00,in,False,-1,True,1,0,2,2
166971,2019-09-02 00:00:00+03:00,in,False,-1,True,1,0,2,2
166971,2019-09-02 00:00:00+03:00,in,False,-1,True,1,0,2,2
166971,2019-09-06 00:00:00+03:00,in,False,-1,True,1,0,2,2
166971,2019-09-06 00:00:00+03:00,in,False,-1,True,1,0,2,2
166971,2019-09-13 00:00:00+03:00,in,False,-1,True,1,0,2,2
166971,2019-09-16 00:00:00+03:00,in,False,-1,True,1,0,2,2
166971,2019-09-19 00:00:00+03:00,in,False,-1,True,10,0,26,26
166971,2019-09-19 00:00:00+03:00,out,False,914630,False,2,20,44,24
166971,2019-09-19 00:00:00+03:00,out,False,914630,True,6,0,162,162
166971,2019-09-20 00:00:00+03:00,out,False,914630,True,1,0,31,31
166971,2019-09-23 00:00:00+03:00,out,False,914630,False,10,1680,1824,144
166971,2019-09-23 00:00:00+03:00,out,False,914630,True,11,0,563,563
166971,2019-10-01 00:00:00+03:00,in,False,-1,True,2,0,8,8
166971,2019-10-01 00:00:00+03:00,out,False,914630,False,14,3565,3788,223
166971,2019-10-01 00:00:00+03:00,out,False,914630,True,11,0,238,238
166971,2019-10-02 00:00:00+03:00,in,False,-1,True,1,0,4,4
166971,2019-10-02 00:00:00+03:00,out,False,914630,False,1,336,346,10
166971,2019-10-02 00:00:00+03:00,out,False,914630,True,8,0,176,176
166971,2019-10-02 00:00:00+03:00,in,False,914630,False,1,132,141,9
166971,2019-10-03 00:00:00+03:00,in,False,-1,True,1,0,30,30
166971,2019-10-03 00:00:00+03:00,out,False,914630,True,2,0,9,9
166971,2019-10-03 00:00:00+03:00,in,False,914630,False,1,558,572,14
166971,2019-10-04 00:00:00+03:00,in,False,914630,False,1,56,64,8
166971,2019-10-04 00:00:00+03:00,out,False,914630,False,4,284,361,77
166971,2019-10-04 00:00:00+03:00,out,False,914630,True,2,0,17,17
166971,2019-10-07 00:00:00+03:00,in,False,-1,True,1,0,20,20
166971,2019-10-07 00:00:00+03:00,in,False,914630,False,2,164,195,31
166971,2019-10-07 00:00:00+03:00,out,False,914630,False,4,822,883,61
166971,2019-10-07 00:00:00+03:00,out,False,914630,True,5,0,117,117
166971,2019-10-07 00:00:00+03:00,out,False,914630,False,4,822,883,61
166971,2019-10-08 00:00:00+03:00,out,False,914630,True,2,0,28,28
166971,2019-10-09 00:00:00+03:00,out,False,914630,False,5,506,572,66
166971,2019-10-10 00:00:00+03:00,out,False,914630,False,2,325,355,30
166971,2019-10-11 00:00:00+03:00,out,False,914630,False,1,64,78,14
166971,2019-10-14 00:00:00+03:00,out,False,914630,False,6,1134,1278,144
166971,2019-10-14 00:00:00+03:00,out,False,914630,True,1,0,15,15
166971,2019-10-15 00:00:00+03:00,out,False,914630,True,1,0,32,32
166971,2019-10-15 00:00:00+03:00,out,False,914630,False,1,176,196,20
166971,2019-10-17 00:00:00+03:00,out,False,914630,True,1,0,5,5
166971,2019-10-18 00:00:00+03:00,out,False,914630,True,1,0,15,15
166971,2019-10-18 00:00:00+03:00,out,False,914630,True,1,0,15,15
166971,2019-10-19 00:00:00+03:00,in,False,-1,True,12,0,0,0
166971,2019-10-19 00:00:00+03:00,in,False,-1,True,12,0,0,0
166971,2019-10-21 00:00:00+03:00,in,False,-1,True,3,0,53,53
166971,2019-10-21 00:00:00+03:00,in,False,914630,False,6,168,224,56
166971,2019-10-21 00:00:00+03:00,in,False,914630,False,6,168,224,56
166971,2019-10-22 00:00:00+03:00,in,False,914630,False,1,48,69,21
166971,2019-10-22 00:00:00+03:00,in,False,-1,True,1,0,23,23
166971,2019-10-23 00:00:00+03:00,in,False,914630,False,1,98,106,8
166971,2019-10-24 00:00:00+03:00,out,False,914630,False,2,823,857,34
166971,2019-10-24 00:00:00+03:00,out,False,914630,False,2,823,857,34
166971,2019-10-28 00:00:00+03:00,in,False,914630,False,2,31,69,38
166971,2019-10-28 00:00:00+03:00,out,False,914630,True,5,0,73,73
166971,2019-10-28 00:00:00+03:00,out,False,914630,False,1,190,212,22
166971,2019-10-28 00:00:00+03:00,in,False,-1,True,2,0,37,37
166971,2019-10-31 00:00:00+03:00,out,False,914630,False,4,84,108,24
166971,2019-10-31 00:00:00+03:00,in,False,-1,True,3,0,72,72
166971,2019-11-05 00:00:00+03:00,in,False,-1,True,3,0,68,68
166971,2019-11-05 00:00:00+03:00,in,False,914630,False,1,307,312,5
166971,2019-11-06 00:00:00+03:00,in,False,914630,False,1,34,49,15
166971,2019-11-07 00:00:00+03:00,in,False,-1,True,2,0,0,0
166971,2019-11-11 00:00:00+03:00,in,False,-1,True,2,0,2,2
166971,2019-11-12 00:00:00+03:00,in,False,-1,True,2,0,1,1
166971,2019-11-13 00:00:00+03:00,in,False,-1,True,1,0,1,1
166971,2019-11-15 00:00:00+03:00,in,False,-1,True,12,0,32,32
166971,2019-11-15 00:00:00+03:00,out,False,914630,False,2,53,136,83
166971,2019-11-15 00:00:00+03:00,in,False,914630,False,1,27,41,14
166971,2019-11-15 00:00:00+03:00,out,False,914630,True,3,0,143,143
166971,2019-11-19 00:00:00+03:00,in,False,-1,True,2,0,1,1
166971,2019-11-20 00:00:00+03:00,in,False,914630,False,1,149,168,19
166971,2019-11-20 00:00:00+03:00,in,False,-1,True,2,0,11,11
166971,2019-11-21 00:00:00+03:00,out,False,914630,True,4,0,131,131
166971,2019-11-21 00:00:00+03:00,out,False,914630,False,4,495,555,60
166971,2019-11-21 00:00:00+03:00,in,False,-1,True,8,0,208,208
166971,2019-11-22 00:00:00+03:00,out,False,914626,True,1,0,0,0
166971,2019-11-22 00:00:00+03:00,in,False,-1,True,1,0,24,24
166971,2019-11-25 00:00:00+03:00,out,False,914630,False,4,356,467,111
166971,2019-11-25 00:00:00+03:00,out,False,914630,True,3,0,0,0
166971,2019-11-28 00:00:00+03:00,out,False,914630,False,1,672,683,11
166971,2019-11-28 00:00:00+03:00,out,False,914630,True,1,0,60,60
166973,2019-09-02 00:00:00+03:00,in,False,901586,False,1,6,19,13
166973,2019-09-02 00:00:00+03:00,out,True,901588,True,1,0,3,3
166973,2019-09-02 00:00:00+03:00,out,False,901588,True,1,0,3,3
166973,2019-09-02 00:00:00+03:00,out,True,901584,True,1,0,16,16
166973,2019-09-02 00:00:00+03:00,out,False,901584,True,4,0,71,71
166973,2019-09-02 00:00:00+03:00,in,False,901588,False,2,25,53,28
166973,2019-09-02 00:00:00+03:00,out,False,901588,False,3,107,173,66
166973,2019-09-02 00:00:00+03:00,in,False,901584,False,2,71,89,18
166973,2019-09-02 00:00:00+03:00,out,False,901584,False,4,617,651,34
166973,2019-09-02 00:00:00+03:00,out,False,901584,True,4,0,71,71
166973,2019-09-03 00:00:00+03:00,out,False,901584,False,8,1029,1095,66
166973,2019-09-03 00:00:00+03:00,out,False,901588,False,3,423,442,19
166973,2019-09-03 00:00:00+03:00,out,False,901584,True,4,0,66,66
166973,2019-09-04 00:00:00+03:00,out,False,901584,False,2,204,210,6
166973,2019-09-04 00:00:00+03:00,out,False,901588,True,1,0,2,2
166973,2019-09-04 00:00:00+03:00,out,False,901588,False,2,234,280,46
166973,2019-09-05 00:00:00+03:00,out,False,901584,False,1,42,45,3
166973,2019-09-05 00:00:00+03:00,out,False,901584,True,2,0,34,34
166973,2019-09-05 00:00:00+03:00,out,False,901588,False,1,313,314,1
166973,2019-09-06 00:00:00+03:00,out,False,901588,False,3,1395,1402,7
166973,2019-09-06 00:00:00+03:00,in,False,901584,False,1,15,19,4
166973,2019-09-06 00:00:00+03:00,out,False,901584,False,1,324,327,3
166973,2019-09-06 00:00:00+03:00,in,False,901586,False,1,23,39,16
166973,2019-09-06 00:00:00+03:00,out,False,901584,True,1,0,3,3
166973,2019-09-07 00:00:00+03:00,out,False,901584,False,2,375,407,32
166973,2019-09-07 00:00:00+03:00,in,False,-1,True,1,0,43,43
166973,2019-09-09 00:00:00+03:00,out,False,901588,False,1,299,304,5
166973,2019-09-09 00:00:00+03:00,out,False,901584,False,1,239,264,25
166973,2019-09-09 00:00:00+03:00,in,False,901586,False,1,67,86,19
166973,2019-09-09 00:00:00+03:00,in,False,901588,False,1,157,165,8
166973,2019-09-09 00:00:00+03:00,out,False,901588,True,1,0,10,10
166973,2019-09-10 00:00:00+03:00,out,False,901588,False,2,123,140,17
166973,2019-09-10 00:00:00+03:00,in,False,-1,True,1,0,13,13
166973,2019-09-10 00:00:00+03:00,in,False,901588,False,1,159,164,5
166973,2019-09-10 00:00:00+03:00,out,False,901588,True,1,0,9,9
166973,2019-09-10 00:00:00+03:00,in,False,901588,False,1,159,164,5
166973,2019-09-11 00:00:00+03:00,out,False,901584,False,1,142,150,8
166973,2019-09-12 00:00:00+03:00,in,False,901584,False,1,4,7,3
166973,2019-09-12 00:00:00+03:00,out,False,901584,False,1,54,56,2
166973,2019-09-12 00:00:00+03:00,out,False,901588,False,2,315,319,4
166973,2019-09-12 00:00:00+03:00,out,False,901586,False,5,118,132,14
166973,2019-09-12 00:00:00+03:00,in,False,-1,True,2,0,25,25
166973,2019-09-13 00:00:00+03:00,in,False,901584,False,1,50,57,7
166973,2019-09-13 00:00:00+03:00,in,False,901588,False,1,29,33,4
166973,2019-09-13 00:00:00+03:00,in,False,-1,True,1,0,34,34
166973,2019-09-13 00:00:00+03:00,out,False,901588,False,1,71,73,2
166973,2019-09-13 00:00:00+03:00,in,False,-1,True,1,0,34,34
166973,2019-09-14 00:00:00+03:00,in,False,901586,False,1,184,190,6
166973,2019-09-14 00:00:00+03:00,out,False,901584,True,1,0,35,35
166973,2019-09-16 00:00:00+03:00,out,False,901584,True,1,0,17,17
166973,2019-09-16 00:00:00+03:00,in,False,901584,False,1,26,35,9
166973,2019-09-16 00:00:00+03:00,out,False,901588,False,2,451,459,8
166973,2019-09-16 00:00:00+03:00,out,False,901586,False,5,300,313,13
166973,2019-09-16 00:00:00+03:00,out,False,901584,False,3,295,318,23
166973,2019-09-16 00:00:00+03:00,in,False,901586,False,2,105,112,7
166973,2019-09-16 00:00:00+03:00,out,False,901588,False,2,451,459,8
166973,2019-09-16 00:00:00+03:00,out,False,901584,False,3,295,318,23
166973,2019-09-17 00:00:00+03:00,in,False,901584,False,2,87,101,14
166973,2019-09-17 00:00:00+03:00,in,False,901586,False,3,202,230,28
166973,2019-09-17 00:00:00+03:00,out,False,901586,False,6,812,869,57
166973,2019-09-17 00:00:00+03:00,out,False,901584,False,4,230,276,46
166973,2019-09-17 00:00:00+03:00,out,False,901584,True,1,0,27,27
166973,2019-09-17 00:00:00+03:00,in,False,901586,False,3,202,230,28
166973,2019-09-18 00:00:00+03:00,out,False,901586,False,7,614,670,56
166973,2019-09-18 00:00:00+03:00,in,False,-1,True,1,0,58,58
166973,2019-09-18 00:00:00+03:00,in,False,901586,False,1,230,236,6
166973,2019-09-19 00:00:00+03:00,out,False,901586,True,1,0,15,15
166973,2019-09-19 00:00:00+03:00,out,False,901584,True,2,0,76,76
166973,2019-09-19 00:00:00+03:00,out,False,901586,False,2,254,268,14
166973,2019-09-20 00:00:00+03:00,in,False,901584,False,2,436,451,15
166973,2019-09-20 00:00:00+03:00,out,False,901584,False,6,566,598,32
166973,2019-09-20 00:00:00+03:00,in,False,-1,True,1,0,3,3
166973,2019-09-20 00:00:00+03:00,in,False,901586,False,1,86,94,8
166973,2019-09-20 00:00:00+03:00,out,False,901584,True,1,0,60,60
166973,2019-09-23 00:00:00+03:00,out,False,901586,True,2,0,47,47
166973,2019-09-23 00:00:00+03:00,out,False,901586,False,9,486,551,65
166973,2019-09-24 00:00:00+03:00,in,False,901586,False,2,146,155,9
166973,2019-09-24 00:00:00+03:00,in,False,-1,True,1,0,1,1
166973,2019-09-24 00:00:00+03:00,out,False,901586,False,4,570,589,19
166973,2019-09-24 00:00:00+03:00,in,False,-1,True,1,0,1,1
166973,2019-09-25 00:00:00+03:00,in,False,901586,False,1,198,202,4
166973,2019-09-25 00:00:00+03:00,in,False,901584,False,2,66,74,8
166973,2019-09-25 00:00:00+03:00,out,False,901584,False,1,244,247,3
166973,2019-09-25 00:00:00+03:00,out,False,901586,False,4,400,419,19
166973,2019-09-25 00:00:00+03:00,out,True,901584,False,2,12,19,7
166973,2019-09-26 00:00:00+03:00,in,False,901584,False,4,292,316,24
166973,2019-09-26 00:00:00+03:00,in,False,901586,False,2,143,157,14
166973,2019-09-26 00:00:00+03:00,out,False,901586,False,3,367,385,18
166973,2019-09-26 00:00:00+03:00,out,False,901584,False,1,269,272,3
166973,2019-09-26 00:00:00+03:00,out,False,901586,True,1,0,27,27
166973,2019-09-27 00:00:00+03:00,in,False,901584,False,1,80,88,8
166973,2019-09-27 00:00:00+03:00,in,False,901586,False,2,191,200,9
166973,2019-09-27 00:00:00+03:00,out,False,901586,False,4,259,284,25
166973,2019-09-27 00:00:00+03:00,out,False,901586,True,1,0,60,60
166973,2019-09-30 00:00:00+03:00,in,False,901586,False,2,82,91,9
166973,2019-09-30 00:00:00+03:00,out,False,901586,True,1,0,5,5
166973,2019-09-30 00:00:00+03:00,out,False,901586,False,4,272,290,18
166973,2019-10-01 00:00:00+03:00,in,False,901584,False,2,115,123,8
166973,2019-10-01 00:00:00+03:00,out,False,901586,False,1,94,95,1
166973,2019-10-01 00:00:00+03:00,in,False,901588,False,1,19,28,9
166973,2019-10-02 00:00:00+03:00,out,False,901586,False,1,3,48,45
166973,2019-10-02 00:00:00+03:00,out,False,901584,False,3,765,781,16
166973,2019-10-03 00:00:00+03:00,in,False,901586,False,2,202,211,9
166973,2019-10-03 00:00:00+03:00,out,False,901586,False,2,183,221,38
166973,2019-10-03 00:00:00+03:00,out,False,901584,False,3,76,121,45
166973,2019-10-03 00:00:00+03:00,out,False,901584,True,6,0,98,98
166973,2019-10-04 00:00:00+03:00,out,False,901584,False,2,718,722,4
166973,2019-10-04 00:00:00+03:00,in,False,901584,False,1,27,31,4
166973,2019-10-04 00:00:00+03:00,in,False,901586,False,1,52,60,8
166973,2019-10-04 00:00:00+03:00,out,False,901586,False,1,44,46,2
166973,2019-10-04 00:00:00+03:00,out,False,901584,True,2,0,52,52
166973,2019-10-07 00:00:00+03:00,in,False,901584,False,2,121,135,14
166973,2019-10-07 00:00:00+03:00,out,False,901584,True,1,0,41,41
166973,2019-10-07 00:00:00+03:00,out,False,901586,False,2,119,126,7
166973,2019-10-07 00:00:00+03:00,out,False,901584,False,2,29,87,58
166973,2019-10-07 00:00:00+03:00,in,False,901586,False,1,158,162,4
166973,2019-10-08 00:00:00+03:00,in,False,901584,False,1,19,28,9
166973,2019-10-08 00:00:00+03:00,out,False,901584,False,1,77,80,3
166973,2019-10-09 00:00:00+03:00,in,False,901584,False,4,134,161,27
166973,2019-10-09 00:00:00+03:00,out,False,901584,False,3,259,292,33
166973,2019-10-09 00:00:00+03:00,out,False,901586,False,3,560,573,13
166973,2019-10-09 00:00:00+03:00,out,False,901588,False,1,117,121,4
166973,2019-10-09 00:00:00+03:00,in,False,901584,False,4,134,161,27
166973,2019-10-10 00:00:00+03:00,out,False,901584,False,3,345,356,11
166973,2019-10-11 00:00:00+03:00,in,False,901586,False,1,29,32,3
166973,2019-10-11 00:00:00+03:00,out,False,901586,False,4,212,232,20
166973,2019-10-11 00:00:00+03:00,out,False,901584,False,5,390,419,29
166973,2019-10-11 00:00:00+03:00,out,False,901584,True,1,0,9,9
166973,2019-10-11 00:00:00+03:00,out,False,901586,True,1,0,30,30
166973,2019-10-11 00:00:00+03:00,in,False,901584,False,1,65,71,6
166973,2019-10-11 00:00:00+03:00,out,False,901588,False,1,136,143,7
166973,2019-10-11 00:00:00+03:00,in,False,901584,False,1,65,71,6
166973,2019-10-14 00:00:00+03:00,in,False,901586,False,2,125,135,10
166973,2019-10-14 00:00:00+03:00,out,False,901588,False,9,747,817,70
166973,2019-10-14 00:00:00+03:00,out,False,901588,True,5,0,194,194
166973,2019-10-14 00:00:00+03:00,out,False,901586,False,2,128,154,26
166973,2019-10-14 00:00:00+03:00,out,False,901584,False,4,158,189,31
166973,2019-10-15 00:00:00+03:00,out,False,901588,False,2,366,372,6
166973,2019-10-15 00:00:00+03:00,in,False,901586,False,1,1,7,6
166973,2019-10-15 00:00:00+03:00,out,False,901588,True,3,0,112,112
166973,2019-10-15 00:00:00+03:00,out,False,901584,True,1,0,2,2
166973,2019-10-15 00:00:00+03:00,out,False,901584,False,1,21,26,5
166973,2019-10-16 00:00:00+03:00,out,False,901584,False,1,46,63,17
166973,2019-10-16 00:00:00+03:00,in,False,901584,False,4,531,554,23
166973,2019-10-17 00:00:00+03:00,out,False,901584,False,1,24,46,22
166973,2019-10-17 00:00:00+03:00,out,False,901584,True,1,0,34,34
166973,2019-10-17 00:00:00+03:00,in,False,901584,False,2,121,143,22
166973,2019-10-18 00:00:00+03:00,out,False,901584,False,5,276,320,44
166973,2019-10-18 00:00:00+03:00,out,True,901584,True,1,0,7,7
166973,2019-10-18 00:00:00+03:00,in,False,-1,True,1,0,18,18
166973,2019-10-18 00:00:00+03:00,out,False,901584,True,1,0,11,11
166973,2019-10-21 00:00:00+03:00,out,False,901584,False,2,76,102,26
166973,2019-10-21 00:00:00+03:00,in,False,901584,False,1,109,115,6
166973,2019-10-22 00:00:00+03:00,in,False,901588,False,1,46,50,4
166973,2019-10-22 00:00:00+03:00,in,False,901584,False,3,102,123,21
166973,2019-10-23 00:00:00+03:00,out,False,901584,False,1,93,112,19
166973,2019-10-23 00:00:00+03:00,out,False,901586,False,1,9,16,7
166973,2019-10-23 00:00:00+03:00,out,False,901584,True,1,0,16,16
166973,2019-10-24 00:00:00+03:00,out,False,901584,False,1,20,21,1
166973,2019-10-24 00:00:00+03:00,in,False,901586,False,1,95,117,22
166973,2019-10-24 00:00:00+03:00,in,False,901588,False,2,73,79,6
166973,2019-10-24 00:00:00+03:00,out,False,901584,True,2,0,4,4
166973,2019-10-25 00:00:00+03:00,out,False,901584,False,3,151,186,35
166973,2019-10-25 00:00:00+03:00,in,False,901588,False,1,89,93,4
166973,2019-10-25 00:00:00+03:00,in,False,901584,False,1,113,121,8
166973,2019-10-25 00:00:00+03:00,in,False,901584,False,1,113,121,8
166973,2019-10-28 00:00:00+03:00,in,False,901584,False,1,13,16,3
166973,2019-10-28 00:00:00+03:00,out,False,901584,True,2,0,61,61
166973,2019-10-29 00:00:00+03:00,out,False,901584,True,1,0,2,2
166973,2019-10-29 00:00:00+03:00,in,False,901584,False,2,124,141,17
166973,2019-10-29 00:00:00+03:00,out,False,901584,False,2,147,183,36
166973,2019-10-29 00:00:00+03:00,in,False,901586,False,2,122,159,37
166973,2019-10-29 00:00:00+03:00,in,False,901588,False,1,28,31,3
166973,2019-10-29 00:00:00+03:00,out,False,901584,False,2,147,183,36
166973,2019-10-30 00:00:00+03:00,in,False,901584,False,3,301,314,13
166973,2019-10-30 00:00:00+03:00,in,False,-1,True,1,0,45,45
166973,2019-10-30 00:00:00+03:00,out,False,901584,False,1,74,90,16
166973,2019-10-31 00:00:00+03:00,in,False,901584,False,3,122,136,14
166973,2019-10-31 00:00:00+03:00,in,False,901584,False,3,122,136,14
166973,2019-11-01 00:00:00+03:00,in,False,901584,False,3,110,128,18
166973,2019-11-01 00:00:00+03:00,out,False,901584,False,2,68,95,27
166973,2019-11-01 00:00:00+03:00,out,False,901588,False,2,349,351,2
166973,2019-11-01 00:00:00+03:00,in,False,901584,False,3,110,128,18
166973,2019-11-05 00:00:00+03:00,out,False,901584,False,1,22,38,16
166973,2019-11-05 00:00:00+03:00,out,False,901588,False,2,318,323,5
166973,2019-11-05 00:00:00+03:00,in,False,901584,False,2,32,51,19
166973,2019-11-06 00:00:00+03:00,in,False,-1,True,4,0,3,3
166973,2019-11-06 00:00:00+03:00,in,False,901588,False,2,133,145,12
166973,2019-11-06 00:00:00+03:00,in,False,901584,False,1,1,36,35
166973,2019-11-06 00:00:00+03:00,out,False,901588,False,1,73,81,8
166973,2019-11-06 00:00:00+03:00,out,False,901584,False,1,135,142,7
166973,2019-11-06 00:00:00+03:00,in,False,901586,False,1,88,97,9
166973,2019-11-06 00:00:00+03:00,out,False,901584,False,1,135,142,7
166973,2019-11-06 00:00:00+03:00,in,False,-1,True,4,0,3,3
166973,2019-11-07 00:00:00+03:00,in,False,901584,False,4,341,358,17
166973,2019-11-08 00:00:00+03:00,out,False,901588,False,1,2,12,10
166973,2019-11-08 00:00:00+03:00,out,False,901584,False,4,757,787,30
166973,2019-11-08 00:00:00+03:00,in,False,901584,False,1,49,55,6
166973,2019-11-08 00:00:00+03:00,out,False,901584,True,2,0,41,41
166973,2019-11-11 00:00:00+03:00,out,False,901584,True,2,0,63,63
166973,2019-11-12 00:00:00+03:00,in,False,901584,False,5,148,170,22
166973,2019-11-12 00:00:00+03:00,out,False,901584,False,3,313,336,23
166973,2019-11-12 00:00:00+03:00,out,False,901584,True,1,0,24,24
166973,2019-11-12 00:00:00+03:00,in,False,901588,False,1,65,79,14
166973,2019-11-12 00:00:00+03:00,out,False,901584,False,3,313,336,23
166973,2019-11-13 00:00:00+03:00,in,False,901584,False,2,50,57,7
166973,2019-11-13 00:00:00+03:00,out,False,901584,False,2,160,177,17
166973,2019-11-14 00:00:00+03:00,out,False,901584,True,2,0,4,4
166973,2019-11-14 00:00:00+03:00,in,False,901584,False,1,32,36,4
166973,2019-11-14 00:00:00+03:00,out,False,901584,False,4,84,142,58
166973,2019-11-15 00:00:00+03:00,in,False,901584,False,3,242,253,11
166973,2019-11-15 00:00:00+03:00,out,False,901584,False,4,263,285,22
166973,2019-11-15 00:00:00+03:00,in,False,901586,False,1,16,25,9
166973,2019-11-15 00:00:00+03:00,in,False,901588,False,1,40,46,6
166973,2019-11-18 00:00:00+03:00,out,False,901584,False,4,224,234,10
166973,2019-11-18 00:00:00+03:00,out,False,901586,True,2,0,3,3
166973,2019-11-18 00:00:00+03:00,in,False,901584,False,2,69,78,9
166973,2019-11-18 00:00:00+03:00,out,True,901586,True,1,0,1,1
166973,2019-11-18 00:00:00+03:00,in,False,901588,False,1,5,7,2
166973,2019-11-18 00:00:00+03:00,out,False,901586,False,8,632,652,20
166973,2019-11-18 00:00:00+03:00,in,False,901584,False,2,69,78,9
166973,2019-11-18 00:00:00+03:00,out,False,901584,False,4,224,234,10
166973,2019-11-18 00:00:00+03:00,out,False,901586,True,2,0,3,3
166973,2019-11-19 00:00:00+03:00,in,False,901584,False,5,464,491,27
166973,2019-11-19 00:00:00+03:00,in,False,901588,False,2,116,129,13
166973,2019-11-19 00:00:00+03:00,out,False,901586,False,2,170,188,18
166973,2019-11-19 00:00:00+03:00,out,False,901584,False,1,53,57,4
166973,2019-11-20 00:00:00+03:00,in,False,901588,False,1,13,16,3
166973,2019-11-20 00:00:00+03:00,in,False,901584,False,1,140,149,9
166973,2019-11-20 00:00:00+03:00,out,False,901584,False,2,72,84,12
166973,2019-11-20 00:00:00+03:00,out,False,901586,False,2,221,258,37
166973,2019-11-21 00:00:00+03:00,out,False,901584,False,1,96,101,5
166973,2019-11-21 00:00:00+03:00,in,False,901584,False,3,298,312,14
166973,2019-11-21 00:00:00+03:00,out,False,901586,False,2,295,352,57
166973,2019-11-21 00:00:00+03:00,in,False,901588,False,1,159,183,24
166973,2019-11-22 00:00:00+03:00,in,False,901588,False,1,360,363,3
166973,2019-11-22 00:00:00+03:00,out,False,901584,False,1,173,177,4
166973,2019-11-22 00:00:00+03:00,in,False,901584,False,2,51,62,11
166973,2019-11-22 00:00:00+03:00,in,False,901586,False,1,15,31,16
166973,2019-11-22 00:00:00+03:00,in,False,901584,False,2,51,62,11
166973,2019-11-25 00:00:00+03:00,out,False,901588,False,3,143,208,65
166973,2019-11-25 00:00:00+03:00,out,False,901584,False,7,644,767,123
166973,2019-11-25 00:00:00+03:00,out,False,901588,False,3,143,208,65
166973,2019-11-26 00:00:00+03:00,out,False,901584,True,1,0,9,9
166973,2019-11-26 00:00:00+03:00,out,False,901584,False,1,66,75,9
166973,2019-11-26 00:00:00+03:00,in,False,901586,False,1,165,178,13
166973,2019-11-26 00:00:00+03:00,in,False,901584,False,12,871,923,52
166973,2019-11-26 00:00:00+03:00,in,False,901588,False,3,252,261,9
166973,2019-11-27 00:00:00+03:00,in,False,901586,False,3,176,185,9
166973,2019-11-27 00:00:00+03:00,in,False,901588,False,3,186,195,9
166973,2019-11-27 00:00:00+03:00,in,False,901584,False,4,91,115,24
166973,2019-11-27 00:00:00+03:00,out,False,901584,False,1,166,175,9
166973,2019-11-27 00:00:00+03:00,in,False,-1,True,5,0,124,124
166973,2019-11-27 00:00:00+03:00,in,False,901588,False,3,186,195,9
166973,2019-11-27 00:00:00+03:00,in,False,-1,True,5,0,124,124
166973,2019-11-28 00:00:00+03:00,out,False,901584,False,5,333,400,67
166973,2019-11-28 00:00:00+03:00,in,False,901586,False,3,121,132,11
166973,2019-11-28 00:00:00+03:00,in,False,901584,False,5,433,452,19
166973,2019-11-28 00:00:00+03:00,in,False,-1,True,4,0,125,125
166973,2019-11-28 00:00:00+03:00,in,False,901584,False,5,433,452,19
166974,2019-08-30 00:00:00+03:00,in,False,900352,True,3,147,192,45
166974,2019-08-30 00:00:00+03:00,in,False,900354,False,1,9,28,19
166974,2019-08-30 00:00:00+03:00,in,False,900352,False,2,60,82,22
166974,2019-08-30 00:00:00+03:00,out,False,900354,True,2,0,16,16
166974,2019-08-30 00:00:00+03:00,in,False,900354,True,2,31,51,20
166974,2019-08-30 00:00:00+03:00,in,False,-1,True,14,0,171,171
166974,2019-08-30 00:00:00+03:00,out,False,900354,False,1,7,11,4
166974,2019-08-30 00:00:00+03:00,out,False,900352,True,2,0,19,19
166974,2019-09-02 00:00:00+03:00,in,False,900354,False,1,5,15,10
166974,2019-09-02 00:00:00+03:00,in,False,-1,True,2,0,17,17
166974,2019-09-02 00:00:00+03:00,out,False,900354,False,5,579,608,29
166974,2019-09-02 00:00:00+03:00,out,False,900352,True,1,0,23,23
166974,2019-09-02 00:00:00+03:00,out,False,900352,False,2,73,84,11
166974,2019-09-02 00:00:00+03:00,in,False,900352,False,2,200,220,20
166974,2019-09-02 00:00:00+03:00,out,False,900352,True,1,0,23,23
166974,2019-09-03 00:00:00+03:00,out,False,900354,False,4,122,144,22
166974,2019-09-03 00:00:00+03:00,in,False,-1,True,1,0,26,26
166974,2019-09-03 00:00:00+03:00,out,False,900352,False,3,495,509,14
166974,2019-09-03 00:00:00+03:00,in,False,900354,True,1,0,16,16
166974,2019-09-03 00:00:00+03:00,out,False,900354,True,8,0,23,23
166974,2019-09-03 00:00:00+03:00,in,False,900352,False,1,96,104,8
166974,2019-09-03 00:00:00+03:00,in,False,900354,False,1,8,17,9
166974,2019-09-04 00:00:00+03:00,out,False,900354,True,2,0,33,33
166974,2019-09-04 00:00:00+03:00,in,False,900352,False,1,85,93,8
166974,2019-09-04 00:00:00+03:00,in,False,-1,True,1,0,11,11
166974,2019-09-04 00:00:00+03:00,out,False,900352,False,1,150,158,8
166974,2019-09-04 00:00:00+03:00,out,False,900354,False,2,40,49,9
166974,2019-09-04 00:00:00+03:00,in,False,900354,False,2,234,260,26
166974,2019-09-04 00:00:00+03:00,out,False,900354,False,2,40,49,9
166974,2019-09-05 00:00:00+03:00,in,False,-1,True,1,0,16,16
166974,2019-09-05 00:00:00+03:00,out,False,900354,True,3,0,50,50
166974,2019-09-05 00:00:00+03:00,out,False,900354,False,10,889,946,57
166974,2019-09-05 00:00:00+03:00,in,False,900352,False,3,473,509,36
166974,2019-09-05 00:00:00+03:00,out,False,900352,False,3,107,123,16
166974,2019-09-06 00:00:00+03:00,out,False,900352,False,2,912,914,2
166974,2019-09-06 00:00:00+03:00,out,False,900354,False,8,613,669,56
166974,2019-09-06 00:00:00+03:00,out,False,900354,True,1,0,11,11
166974,2019-09-06 00:00:00+03:00,in,False,900354,False,2,378,397,19
166974,2019-09-06 00:00:00+03:00,in,False,-1,True,1,0,21,21
166974,2019-09-06 00:00:00+03:00,out,False,900352,False,2,912,914,2
166974,2019-09-09 00:00:00+03:00,in,False,900352,False,2,235,262,27
166974,2019-09-10 00:00:00+03:00,in,False,-1,True,7,0,60,60
166974,2019-09-10 00:00:00+03:00,out,False,900352,True,1,0,7,7
166974,2019-09-10 00:00:00+03:00,out,False,900352,False,2,668,684,16
166974,2019-09-10 00:00:00+03:00,in,False,900352,False,1,105,115,10
166974,2019-09-11 00:00:00+03:00,in,False,-1,True,3,0,32,32
166974,2019-09-11 00:00:00+03:00,in,False,900352,False,3,605,634,29
166974,2019-09-11 00:00:00+03:00,out,False,900352,True,1,0,8,8
166974,2019-09-11 00:00:00+03:00,out,False,900352,True,1,0,8,8
166974,2019-09-12 00:00:00+03:00,in,False,900352,False,2,457,488,31
166974,2019-09-12 00:00:00+03:00,out,False,900354,False,2,145,168,23
166974,2019-09-12 00:00:00+03:00,out,False,900352,True,17,0,130,130
166974,2019-09-12 00:00:00+03:00,out,False,900352,False,3,95,140,45
166974,2019-09-13 00:00:00+03:00,out,False,900354,True,1,0,47,47
166974,2019-09-13 00:00:00+03:00,out,False,900354,False,5,337,410,73
166974,2019-09-15 00:00:00+03:00,in,False,-1,True,1,0,11,11
166974,2019-09-16 00:00:00+03:00,in,False,900354,False,1,106,114,8
166974,2019-09-16 00:00:00+03:00,out,False,900352,False,1,90,100,10
166974,2019-09-16 00:00:00+03:00,in,False,-1,True,3,0,53,53
166974,2019-09-16 00:00:00+03:00,in,False,900352,False,2,522,538,16
166974,2019-09-16 00:00:00+03:00,out,False,900354,True,1,0,5,5
166974,2019-09-16 00:00:00+03:00,in,False,-1,True,3,0,53,53
166974,2019-09-17 00:00:00+03:00,in,False,900352,False,1,90,105,15
166974,2019-09-17 00:00:00+03:00,out,False,900352,False,1,98,111,13
166974,2019-09-17 00:00:00+03:00,in,False,-1,True,5,0,46,46
166974,2019-09-17 00:00:00+03:00,in,False,900352,False,1,90,105,15
166974,2019-09-18 00:00:00+03:00,out,False,900354,False,3,399,436,37
166974,2019-09-18 00:00:00+03:00,in,False,-1,True,1,0,4,4
166974,2019-09-18 00:00:00+03:00,in,False,900354,False,3,290,345,55
166974,2019-09-18 00:00:00+03:00,in,False,900352,False,1,360,377,17
166974,2019-09-18 00:00:00+03:00,out,False,900352,False,1,22,33,11
166974,2019-09-18 00:00:00+03:00,out,False,900352,True,1,0,4,4
166974,2019-09-19 00:00:00+03:00,in,False,-1,True,4,0,129,129
166974,2019-09-19 00:00:00+03:00,out,False,900354,True,1,0,4,4
166974,2019-09-19 00:00:00+03:00,out,False,900354,False,4,577,619,42
166974,2019-09-19 00:00:00+03:00,in,False,-1,True,4,0,129,129
166974,2019-09-20 00:00:00+03:00,out,False,900352,False,1,50,59,9
166974,2019-09-20 00:00:00+03:00,in,False,900354,False,6,837,941,104
166974,2019-09-20 00:00:00+03:00,out,False,900354,False,3,432,454,22
166974,2019-09-22 00:00:00+03:00,in,False,-1,True,1,0,8,8
166974,2019-09-23 00:00:00+03:00,out,False,900354,False,2,301,322,21
166974,2019-09-23 00:00:00+03:00,in,False,-1,True,1,0,36,36
166974,2019-09-23 00:00:00+03:00,in,False,900354,False,1,94,116,22
166974,2019-09-24 00:00:00+03:00,out,False,900354,True,4,0,164,164
166974,2019-09-24 00:00:00+03:00,in,False,-1,True,2,0,34,34
166974,2019-09-24 00:00:00+03:00,in,False,900352,False,1,248,263,15
166974,2019-09-24 00:00:00+03:00,in,False,900354,False,1,5,27,22
166974,2019-09-24 00:00:00+03:00,out,False,900352,False,2,214,262,48
166974,2019-09-24 00:00:00+03:00,out,False,900354,False,2,142,171,29
166974,2019-09-24 00:00:00+03:00,out,False,900352,True,1,0,14,14
166974,2019-09-25 00:00:00+03:00,out,False,900352,False,1,194,205,11
166974,2019-09-25 00:00:00+03:00,out,False,900354,False,4,574,615,41
166974,2019-09-25 00:00:00+03:00,in,False,-1,True,6,0,71,71
166974,2019-09-26 00:00:00+03:00,out,False,900354,False,1,47,60,13
166974,2019-09-26 00:00:00+03:00,out,False,900352,True,1,0,60,60
166974,2019-09-26 00:00:00+03:00,out,False,900354,True,3,0,45,45
166974,2019-09-26 00:00:00+03:00,in,False,900352,False,2,301,336,35
166974,2019-09-26 00:00:00+03:00,out,False,900352,False,2,184,225,41
166974,2019-09-27 00:00:00+03:00,in,False,900352,False,2,471,501,30
166974,2019-09-27 00:00:00+03:00,in,False,-1,True,1,0,7,7
166974,2019-09-30 00:00:00+03:00,in,False,-1,True,1,0,9,9
166974,2019-10-01 00:00:00+03:00,out,False,900354,True,1,0,5,5
166974,2019-10-01 00:00:00+03:00,out,False,900354,False,2,115,142,27
166974,2019-10-02 00:00:00+03:00,out,False,900354,False,2,81,111,30
166974,2019-10-02 00:00:00+03:00,in,False,900352,False,1,21,37,16
166974,2019-10-03 00:00:00+03:00,out,False,900354,False,3,342,366,24
166974,2019-10-03 00:00:00+03:00,in,False,900352,False,1,177,196,19
166974,2019-10-04 00:00:00+03:00,out,False,900352,True,1,0,0,0
166974,2019-10-04 00:00:00+03:00,in,False,-1,True,2,0,50,50
166974,2019-10-04 00:00:00+03:00,out,False,900354,True,1,0,6,6
166974,2019-10-04 00:00:00+03:00,in,False,900352,False,2,46,88,42
166974,2019-10-04 00:00:00+03:00,out,False,900354,False,3,475,514,39
166974,2019-10-04 00:00:00+03:00,out,False,900352,True,1,0,0,0
166974,2019-10-05 00:00:00+03:00,in,False,-1,True,1,0,8,8
166974,2019-10-07 00:00:00+03:00,in,False,900352,False,2,417,448,31
166974,2019-10-07 00:00:00+03:00,out,False,900354,True,3,0,168,168
166974,2019-10-07 00:00:00+03:00,out,False,900354,False,3,100,139,39
166974,2019-10-07 00:00:00+03:00,in,False,900354,False,2,338,371,33
166974,2019-10-07 00:00:00+03:00,in,False,900354,False,2,338,371,33
166974,2019-10-08 00:00:00+03:00,out,False,900354,False,3,283,328,45
166974,2019-10-08 00:00:00+03:00,in,False,-1,True,1,0,24,24
166974,2019-10-08 00:00:00+03:00,in,False,900354,False,2,361,394,33
166974,2019-10-08 00:00:00+03:00,in,False,900352,False,2,473,531,58
166974,2019-10-08 00:00:00+03:00,out,False,900354,True,9,0,304,304
166974,2019-10-09 00:00:00+03:00,in,False,900352,False,4,431,512,81
166974,2019-10-09 00:00:00+03:00,out,False,900354,True,2,0,37,37
166974,2019-10-09 00:00:00+03:00,out,False,900354,False,17,3000,3176,176
166974,2019-10-09 00:00:00+03:00,out,False,900352,True,1,0,18,18
166974,2019-10-09 00:00:00+03:00,in,False,900354,False,5,361,465,104
166974,2019-10-09 00:00:00+03:00,out,False,900352,False,1,516,518,2
166974,2019-10-09 00:00:00+03:00,in,False,-1,True,5,0,92,92
166974,2019-10-09 00:00:00+03:00,in,False,-1,True,5,0,92,92
166974,2019-10-09 00:00:00+03:00,in,False,900354,False,5,361,465,104
166974,2019-10-09 00:00:00+03:00,out,False,900354,False,17,3000,3176,176
166974,2019-10-10 00:00:00+03:00,out,False,900354,False,6,922,973,51
166974,2019-10-10 00:00:00+03:00,out,False,900354,True,5,0,73,73
166974,2019-10-10 00:00:00+03:00,in,False,-1,True,4,0,63,63
166974,2019-10-10 00:00:00+03:00,in,False,900354,False,7,982,1125,143
166974,2019-10-11 00:00:00+03:00,in,False,900352,False,6,897,993,96
166974,2019-10-11 00:00:00+03:00,out,False,900352,True,2,0,18,18
166974,2019-10-11 00:00:00+03:00,in,False,900354,False,1,36,63,27
166974,2019-10-11 00:00:00+03:00,in,False,-1,True,2,0,11,11
166974,2019-10-11 00:00:00+03:00,out,False,900354,False,4,513,548,35
166974,2019-10-11 00:00:00+03:00,out,False,900354,True,3,0,90,90
166974,2019-10-11 00:00:00+03:00,out,False,900352,False,1,188,202,14
166974,2019-10-12 00:00:00+03:00,in,False,900352,False,2,267,298,31
166974,2019-10-12 00:00:00+03:00,in,False,-1,True,1,0,10,10
166974,2019-10-14 00:00:00+03:00,in,False,900352,False,3,317,374,57
166974,2019-10-14 00:00:00+03:00,out,False,900352,True,2,0,71,71
166974,2019-10-14 00:00:00+03:00,in,False,-1,True,1,0,29,29
166974,2019-10-14 00:00:00+03:00,in,False,900354,False,8,875,997,122
166974,2019-10-14 00:00:00+03:00,out,False,900354,False,8,870,930,60
166974,2019-10-14 00:00:00+03:00,out,False,900354,True,1,0,53,53
166974,2019-10-15 00:00:00+03:00,in,False,900354,False,2,224,260,36
166974,2019-10-15 00:00:00+03:00,out,False,900352,True,2,0,19,19
166974,2019-10-15 00:00:00+03:00,in,False,-1,True,3,0,39,39
166974,2019-10-15 00:00:00+03:00,out,False,900354,False,4,297,352,55
166974,2019-10-15 00:00:00+03:00,out,False,900354,True,3,0,122,122
166974,2019-10-15 00:00:00+03:00,in,False,900352,False,4,608,672,64
166974,2019-10-15 00:00:00+03:00,out,False,900352,True,2,0,19,19
166974,2019-10-16 00:00:00+03:00,in,False,900352,False,4,674,734,60
166974,2019-10-16 00:00:00+03:00,out,False,900352,False,2,98,117,19
166974,2019-10-16 00:00:00+03:00,in,False,900354,False,5,830,915,85
166974,2019-10-16 00:00:00+03:00,in,False,-1,True,2,0,36,36
166974,2019-10-16 00:00:00+03:00,out,False,900354,True,1,0,60,60
166974,2019-10-16 00:00:00+03:00,out,False,900354,False,8,1012,1102,90
166974,2019-10-16 00:00:00+03:00,out,False,900354,True,1,0,60,60
166974,2019-10-17 00:00:00+03:00,out,False,900352,False,2,31,90,59
166974,2019-10-17 00:00:00+03:00,out,False,900354,True,2,0,13,13
166974,2019-10-17 00:00:00+03:00,out,False,900352,True,3,0,137,137
166974,2019-10-17 00:00:00+03:00,out,False,900354,False,6,936,978,42
166974,2019-10-17 00:00:00+03:00,in,False,900354,False,3,609,655,46
166974,2019-10-17 00:00:00+03:00,in,False,-1,True,3,0,33,33
166974,2019-10-17 00:00:00+03:00,in,False,900352,False,6,1008,1137,129
166974,2019-10-17 00:00:00+03:00,out,False,900354,True,2,0,13,13
166974,2019-10-18 00:00:00+03:00,out,False,900352,True,4,0,70,70
166974,2019-10-18 00:00:00+03:00,out,False,900354,True,4,0,166,166
166974,2019-10-18 00:00:00+03:00,out,False,900354,False,6,702,777,75
166974,2019-10-18 00:00:00+03:00,in,False,900354,False,12,1140,1365,225
166974,2019-10-18 00:00:00+03:00,out,False,900352,False,8,793,898,105
166974,2019-10-18 00:00:00+03:00,in,False,-1,True,2,0,49,49
166974,2019-10-18 00:00:00+03:00,in,False,900352,False,9,821,974,153
166974,2019-10-18 00:00:00+03:00,in,False,900352,False,9,821,974,153
166974,2019-10-18 00:00:00+03:00,in,False,900354,False,12,1140,1365,225
166974,2019-10-18 00:00:00+03:00,in,False,-1,True,2,0,49,49
166974,2019-10-19 00:00:00+03:00,in,False,-1,True,1,0,19,19
166974,2019-10-21 00:00:00+03:00,out,False,900352,True,17,0,441,441
166974,2019-10-21 00:00:00+03:00,in,False,900354,False,4,349,408,59
166974,2019-10-21 00:00:00+03:00,out,False,900354,False,19,1701,1945,244
166974,2019-10-21 00:00:00+03:00,out,False,900352,False,10,563,730,167
166974,2019-10-21 00:00:00+03:00,in,False,-1,True,3,0,49,49
166974,2019-10-21 00:00:00+03:00,in,False,900352,False,4,822,877,55
166974,2019-10-21 00:00:00+03:00,out,False,900354,True,8,0,189,189
166974,2019-10-21 00:00:00+03:00,out,False,900354,False,19,1701,1945,244
166974,2019-10-22 00:00:00+03:00,in,False,900352,False,5,535,613,78
166974,2019-10-22 00:00:00+03:00,in,False,900354,False,1,148,161,13
166974,2019-10-22 00:00:00+03:00,out,False,900352,False,4,888,939,51
166974,2019-10-22 00:00:00+03:00,out,False,900352,True,3,0,72,72
166974,2019-10-22 00:00:00+03:00,out,False,900354,False,6,1069,1159,90
166974,2019-10-22 00:00:00+03:00,in,False,-1,True,5,0,75,75
166974,2019-10-22 00:00:00+03:00,out,False,900352,False,4,888,939,51
166974,2019-10-23 00:00:00+03:00,out,False,900354,False,3,392,427,35
166974,2019-10-23 00:00:00+03:00,out,False,900352,False,2,165,197,32
166974,2019-10-23 00:00:00+03:00,out,False,900354,True,2,0,99,99
166974,2019-10-23 00:00:00+03:00,in,False,900352,False,4,644,699,55
166974,2019-10-23 00:00:00+03:00,in,False,900354,False,6,852,949,97
166974,2019-10-24 00:00:00+03:00,out,False,900354,True,1,0,14,14
166974,2019-10-24 00:00:00+03:00,out,False,900352,False,9,1057,1160,103
166974,2019-10-24 00:00:00+03:00,in,False,900352,False,10,1179,1356,177
166974,2019-10-24 00:00:00+03:00,in,False,900354,False,3,150,194,44
166974,2019-10-24 00:00:00+03:00,out,False,900354,False,6,766,868,102
166974,2019-10-24 00:00:00+03:00,out,False,900352,True,2,0,115,115
166974,2019-10-24 00:00:00+03:00,out,False,900354,False,6,766,868,102
166974,2019-10-24 00:00:00+03:00,in,False,900352,False,10,1179,1356,177
166974,2019-10-25 00:00:00+03:00,out,False,900352,False,2,144,146,2
166974,2019-10-25 00:00:00+03:00,in,False,900352,False,1,3,20,17
166974,2019-10-25 00:00:00+03:00,out,False,900354,False,7,1165,1223,58
166974,2019-10-25 00:00:00+03:00,out,False,900352,True,1,0,51,51
166974,2019-10-25 00:00:00+03:00,in,False,900354,False,3,1055,1103,48
166974,2019-10-25 00:00:00+03:00,out,False,900354,True,5,0,98,98
166974,2019-10-25 00:00:00+03:00,out,False,900352,False,2,144,146,2
166974,2019-10-26 00:00:00+03:00,in,False,-1,True,1,0,19,19
166974,2019-10-28 00:00:00+03:00,out,False,900354,True,4,0,44,44
166974,2019-10-28 00:00:00+03:00,in,False,900354,True,1,87,102,15
166974,2019-10-28 00:00:00+03:00,in,False,900354,False,5,296,396,100
166974,2019-10-28 00:00:00+03:00,out,False,900352,False,13,1557,1747,190
166974,2019-10-28 00:00:00+03:00,in,False,900352,False,7,691,801,110
166974,2019-10-28 00:00:00+03:00,in,False,-1,True,3,0,104,104
166974,2019-10-28 00:00:00+03:00,out,False,900352,True,1,0,61,61
166974,2019-10-28 00:00:00+03:00,out,False,900354,False,15,1385,1599,214
166974,2019-10-28 00:00:00+03:00,in,False,900352,False,7,691,801,110
166974,2019-10-29 00:00:00+03:00,out,False,900352,True,4,0,129,129
166974,2019-10-29 00:00:00+03:00,out,False,900352,False,9,887,980,93
166974,2019-10-29 00:00:00+03:00,in,False,900352,False,6,804,894,90
166974,2019-10-29 00:00:00+03:00,in,False,900354,False,3,515,563,48
166974,2019-10-29 00:00:00+03:00,out,False,900354,True,2,0,15,15
166974,2019-10-29 00:00:00+03:00,in,False,-1,True,1,0,9,9
166974,2019-10-29 00:00:00+03:00,out,False,900354,False,5,781,820,39
166974,2019-10-30 00:00:00+03:00,in,False,900354,False,6,738,838,100
166974,2019-10-30 00:00:00+03:00,out,False,900352,False,1,177,200,23
166974,2019-10-30 00:00:00+03:00,out,False,900354,True,1,0,1,1
166974,2019-10-30 00:00:00+03:00,in,False,900352,False,5,757,855,98
166974,2019-10-30 00:00:00+03:00,in,False,-1,True,1,0,2,2
166974,2019-10-30 00:00:00+03:00,out,False,900354,False,7,1011,1066,55
166974,2019-10-30 00:00:00+03:00,out,False,900354,True,1,0,1,1
166974,2019-10-30 00:00:00+03:00,in,False,900354,False,6,738,838,100
166974,2019-10-31 00:00:00+03:00,out,False,900352,True,1,0,2,2
166974,2019-10-31 00:00:00+03:00,in,False,900352,False,6,274,373,99
166974,2019-10-31 00:00:00+03:00,out,False,900354,True,2,0,15,15
166974,2019-10-31 00:00:00+03:00,in,False,900354,False,4,248,320,72
166974,2019-10-31 00:00:00+03:00,out,False,900354,False,9,847,906,59
166974,2019-10-31 00:00:00+03:00,out,False,900352,False,11,714,798,84
166974,2019-10-31 00:00:00+03:00,in,False,900354,False,4,248,320,72
166974,2019-11-01 00:00:00+03:00,out,False,900354,False,1,113,120,7
166974,2019-11-01 00:00:00+03:00,in,False,900352,False,1,71,92,21
166974,2019-11-01 00:00:00+03:00,in,False,-1,True,15,0,287,287
166974,2019-11-01 00:00:00+03:00,in,False,900354,False,1,13,42,29
166974,2019-11-04 00:00:00+03:00,in,False,-1,True,2,0,29,29
166974,2019-11-04 00:00:00+03:00,out,False,900354,False,2,130,163,33
166974,2019-11-04 00:00:00+03:00,out,False,900352,False,2,76,98,22
166974,2019-11-05 00:00:00+03:00,out,False,900354,False,7,423,510,87
166974,2019-11-05 00:00:00+03:00,in,False,-1,True,2,0,48,48
166974,2019-11-05 00:00:00+03:00,in,False,900352,False,1,40,59,19
166974,2019-11-05 00:00:00+03:00,out,False,900352,False,3,487,515,28
166974,2019-11-05 00:00:00+03:00,out,False,900354,True,1,0,38,38
166974,2019-11-05 00:00:00+03:00,in,False,900354,False,2,293,316,23
166974,2019-11-06 00:00:00+03:00,out,False,900352,False,5,330,358,28
166974,2019-11-06 00:00:00+03:00,out,False,900352,True,6,0,57,57
166974,2019-11-06 00:00:00+03:00,in,False,900352,False,5,622,691,69
166974,2019-11-06 00:00:00+03:00,out,False,900354,True,6,0,78,78
166974,2019-11-06 00:00:00+03:00,in,False,900354,False,2,222,255,33
166974,2019-11-06 00:00:00+03:00,out,False,900354,False,10,1125,1285,160
166974,2019-11-06 00:00:00+03:00,in,False,-1,True,3,0,32,32
166974,2019-11-06 00:00:00+03:00,out,False,900352,False,5,330,358,28
166974,2019-11-07 00:00:00+03:00,in,False,900354,False,3,728,761,33
166974,2019-11-07 00:00:00+03:00,in,False,-1,True,3,0,72,72
166974,2019-11-07 00:00:00+03:00,in,False,900352,False,6,365,523,158
166974,2019-11-07 00:00:00+03:00,out,False,900352,True,4,0,100,100
166974,2019-11-07 00:00:00+03:00,out,False,900352,False,3,288,302,14
166974,2019-11-07 00:00:00+03:00,out,False,900354,False,6,639,699,60
166974,2019-11-07 00:00:00+03:00,out,False,900354,True,12,0,231,231
166974,2019-11-08 00:00:00+03:00,in,False,900352,False,2,418,448,30
166974,2019-11-08 00:00:00+03:00,out,False,900352,False,13,1371,1483,112
166974,2019-11-08 00:00:00+03:00,out,False,900354,True,5,0,69,69
166974,2019-11-08 00:00:00+03:00,in,False,-1,True,3,0,57,57
166974,2019-11-08 00:00:00+03:00,out,False,900354,False,13,1375,1531,156
166974,2019-11-08 00:00:00+03:00,out,False,900352,True,7,0,194,194
166974,2019-11-08 00:00:00+03:00,in,False,900354,False,3,643,703,60
166974,2019-11-08 00:00:00+03:00,out,False,900352,False,13,1371,1483,112
166974,2019-11-11 00:00:00+03:00,in,False,900352,False,5,349,443,94
166974,2019-11-11 00:00:00+03:00,out,False,900354,True,6,0,188,188
166974,2019-11-11 00:00:00+03:00,in,False,-1,True,1,0,5,5
166974,2019-11-11 00:00:00+03:00,out,False,900352,False,5,454,578,124
166974,2019-11-11 00:00:00+03:00,out,False,900352,True,4,0,28,28
166974,2019-11-11 00:00:00+03:00,out,False,900354,False,11,925,1043,118
166974,2019-11-11 00:00:00+03:00,in,False,900354,False,7,896,1019,123
166974,2019-11-11 00:00:00+03:00,out,False,900352,False,5,454,578,124
166974,2019-11-12 00:00:00+03:00,in,False,900354,False,1,15,33,18
166974,2019-11-12 00:00:00+03:00,out,False,900352,True,2,0,24,24
166974,2019-11-12 00:00:00+03:00,in,False,-1,True,4,0,45,45
166974,2019-11-12 00:00:00+03:00,in,False,900352,False,4,521,610,89
166974,2019-11-12 00:00:00+03:00,out,False,900352,False,4,163,193,30
166974,2019-11-13 00:00:00+03:00,out,False,900352,False,3,690,711,21
166974,2019-11-13 00:00:00+03:00,in,False,900352,False,4,913,1014,101
166974,2019-11-13 00:00:00+03:00,in,False,-1,True,5,0,136,136
166974,2019-11-13 00:00:00+03:00,in,False,900354,False,1,56,72,16
166974,2019-11-13 00:00:00+03:00,out,False,900354,True,2,0,47,47
166974,2019-11-13 00:00:00+03:00,out,False,900354,False,4,740,780,40
166974,2019-11-13 00:00:00+03:00,in,False,-1,True,5,0,136,136
166974,2019-11-14 00:00:00+03:00,in,False,900352,False,4,682,742,60
166974,2019-11-14 00:00:00+03:00,out,False,900352,False,4,257,333,76
166974,2019-11-14 00:00:00+03:00,out,False,900352,False,4,257,333,76
166974,2019-11-15 00:00:00+03:00,out,False,900352,False,1,110,127,17
166974,2019-11-15 00:00:00+03:00,in,False,-1,True,1,0,13,13
166974,2019-11-15 00:00:00+03:00,out,False,900352,True,1,0,3,3
166974,2019-11-15 00:00:00+03:00,out,False,900354,True,1,0,18,18
166974,2019-11-15 00:00:00+03:00,in,False,900352,False,2,119,148,29
166974,2019-11-15 00:00:00+03:00,out,False,900354,False,1,227,237,10
166974,2019-11-18 00:00:00+03:00,out,False,900354,False,7,495,616,121
166974,2019-11-18 00:00:00+03:00,in,False,900352,False,2,324,352,28
166974,2019-11-18 00:00:00+03:00,out,False,900354,True,2,0,25,25
166974,2019-11-18 00:00:00+03:00,out,False,900352,False,8,560,650,90
166974,2019-11-18 00:00:00+03:00,in,False,900354,False,1,71,101,30
166974,2019-11-18 00:00:00+03:00,in,False,-1,True,2,0,20,20
166974,2019-11-18 00:00:00+03:00,out,False,900354,False,7,495,616,121
166974,2019-11-19 00:00:00+03:00,out,False,900352,False,4,859,902,43
166974,2019-11-19 00:00:00+03:00,out,False,900354,True,3,0,65,65
166974,2019-11-19 00:00:00+03:00,out,False,900354,False,5,328,422,94
166974,2019-11-19 00:00:00+03:00,in,False,-1,True,3,0,53,53
166974,2019-11-19 00:00:00+03:00,in,False,900352,False,2,704,750,46
166974,2019-11-20 00:00:00+03:00,out,False,900354,True,4,0,38,38
166974,2019-11-20 00:00:00+03:00,in,False,900352,False,3,802,847,45
166974,2019-11-20 00:00:00+03:00,out,False,900352,False,5,787,834,47
166974,2019-11-20 00:00:00+03:00,in,False,900354,False,1,146,170,24
166974,2019-11-20 00:00:00+03:00,out,False,900354,False,2,386,416,30
166974,2019-11-20 00:00:00+03:00,in,False,-1,True,3,0,40,40
166974,2019-11-20 00:00:00+03:00,out,False,900354,False,2,386,416,30
166974,2019-11-21 00:00:00+03:00,out,False,900352,True,8,0,92,92
166974,2019-11-21 00:00:00+03:00,in,False,900354,False,2,323,353,30
166974,2019-11-21 00:00:00+03:00,in,False,-1,True,3,0,51,51
166974,2019-11-21 00:00:00+03:00,out,False,900354,True,7,0,133,133
166974,2019-11-21 00:00:00+03:00,out,False,900354,False,5,919,1007,88
166974,2019-11-21 00:00:00+03:00,out,False,900352,False,9,1072,1139,67
166974,2019-11-21 00:00:00+03:00,in,False,900352,False,2,259,288,29
166974,2019-11-21 00:00:00+03:00,in,False,-1,True,3,0,51,51
166974,2019-11-22 00:00:00+03:00,out,False,900352,True,1,0,34,34
166974,2019-11-22 00:00:00+03:00,in,False,-1,True,2,0,20,20
166974,2019-11-22 00:00:00+03:00,in,False,900352,False,1,319,337,18
166974,2019-11-22 00:00:00+03:00,out,False,900352,False,4,205,254,49
166974,2019-11-22 00:00:00+03:00,out,False,900354,False,8,611,712,101
166974,2019-11-22 00:00:00+03:00,out,False,900354,True,4,0,46,46
166974,2019-11-23 00:00:00+03:00,out,False,900354,True,2,0,120,120
166974,2019-11-25 00:00:00+03:00,in,False,900352,False,1,167,182,15
166974,2019-11-25 00:00:00+03:00,out,False,900354,True,3,0,51,51
166974,2019-11-25 00:00:00+03:00,out,False,900354,False,9,1487,1671,184
166974,2019-11-25 00:00:00+03:00,in,False,900354,False,3,576,621,45
166974,2019-11-25 00:00:00+03:00,in,False,900354,False,3,576,621,45
166974,2019-11-26 00:00:00+03:00,out,False,900354,False,2,485,540,55
166974,2019-11-26 00:00:00+03:00,in,False,900354,False,3,678,734,56
166974,2019-11-26 00:00:00+03:00,in,False,900352,False,2,269,296,27
166974,2019-11-26 00:00:00+03:00,out,False,900352,False,3,219,244,25
166974,2019-11-26 00:00:00+03:00,out,False,900352,True,1,0,13,13
166974,2019-11-27 00:00:00+03:00,out,False,900352,False,8,675,797,122
166974,2019-11-27 00:00:00+03:00,out,False,900352,True,1,0,55,55
166974,2019-11-27 00:00:00+03:00,in,False,900354,False,3,65,118,53
166974,2019-11-27 00:00:00+03:00,in,False,900352,False,6,971,1084,113
166974,2019-11-27 00:00:00+03:00,out,False,900354,True,4,0,36,36
166974,2019-11-27 00:00:00+03:00,out,False,900354,False,2,177,186,9
166974,2019-11-27 00:00:00+03:00,out,False,900352,True,1,0,55,55
166974,2019-11-28 00:00:00+03:00,out,False,900352,True,3,0,13,13
166974,2019-11-28 00:00:00+03:00,in,False,900354,False,4,992,1059,67
166974,2019-11-28 00:00:00+03:00,in,False,900352,False,7,989,1165,176
166974,2019-11-28 00:00:00+03:00,out,False,900354,False,16,2272,2413,141
166974,2019-11-28 00:00:00+03:00,in,False,-1,True,3,0,64,64
166974,2019-11-28 00:00:00+03:00,out,False,900352,False,16,1623,1835,212
166974,2019-11-28 00:00:00+03:00,out,False,900354,True,10,0,104,104
166975,2019-08-29 00:00:00+03:00,in,False,899268,False,4,104,152,48
166975,2019-08-29 00:00:00+03:00,in,False,899892,False,1,72,83,11
166975,2019-08-29 00:00:00+03:00,in,False,-1,True,3,0,35,35
166975,2019-08-29 00:00:00+03:00,in,True,899900,False,1,236,281,45
166975,2019-08-31 00:00:00+03:00,in,False,-1,True,1,0,1,1
166975,2019-09-02 00:00:00+03:00,in,False,-1,True,3,0,33,33
166975,2019-09-05 00:00:00+03:00,in,False,-1,True,1,0,8,8
166975,2019-09-05 00:00:00+03:00,in,False,-1,True,4,0,62,62
166975,2019-09-05 00:00:00+03:00,in,False,899268,False,2,21,65,44
166975,2019-09-06 00:00:00+03:00,in,False,899268,False,1,283,299,16
166975,2019-09-07 00:00:00+03:00,in,False,-1,True,1,0,1,1
166975,2019-09-09 00:00:00+03:00,in,False,899268,False,1,61,83,22
166975,2019-09-09 00:00:00+03:00,in,False,899268,False,1,61,83,22
166975,2019-09-13 00:00:00+03:00,in,False,899268,False,1,93,114,21
166975,2019-09-16 00:00:00+03:00,in,False,-1,True,1,0,1,1
166975,2019-09-16 00:00:00+03:00,in,False,-1,True,1,0,1,1
166975,2019-09-18 00:00:00+03:00,in,False,899900,False,1,146,217,71
166975,2019-09-18 00:00:00+03:00,in,False,899900,False,1,146,217,71
166975,2019-09-23 00:00:00+03:00,in,False,899268,True,1,0,18,18
166975,2019-09-23 00:00:00+03:00,in,False,-1,True,1,0,6,6
166975,2019-09-24 00:00:00+03:00,in,False,-1,True,1,0,2,2
166975,2019-09-26 00:00:00+03:00,in,False,899268,False,1,7,28,21
166975,2019-10-01 00:00:00+03:00,in,False,-1,True,1,0,1,1
166975,2019-10-02 00:00:00+03:00,in,False,899268,False,1,49,73,24
166975,2019-10-02 00:00:00+03:00,in,False,899898,False,1,978,1001,23
166975,2019-10-06 00:00:00+03:00,in,False,-1,True,2,0,11,11
166975,2019-10-08 00:00:00+03:00,in,False,899268,False,1,31,57,26
166975,2019-10-09 00:00:00+03:00,in,False,899268,False,1,175,194,19
166975,2019-10-10 00:00:00+03:00,in,False,-1,True,1,0,81,81
166975,2019-10-10 00:00:00+03:00,in,False,899268,False,1,103,124,21
166975,2019-10-13 00:00:00+03:00,in,False,-1,True,1,0,6,6
166975,2019-10-14 00:00:00+03:00,in,False,899906,False,1,626,645,19
166975,2019-10-14 00:00:00+03:00,in,False,-1,True,1,0,10,10
166975,2019-10-16 00:00:00+03:00,in,False,899268,False,1,250,275,25
166975,2019-10-17 00:00:00+03:00,in,False,-1,True,1,0,11,11
166975,2019-10-18 00:00:00+03:00,in,False,899892,False,1,11,55,44
166975,2019-10-21 00:00:00+03:00,in,False,899892,False,1,108,148,40
166975,2019-10-21 00:00:00+03:00,in,False,899268,False,1,77,98,21
166975,2019-10-22 00:00:00+03:00,in,False,899268,False,1,117,134,17
166975,2019-10-23 00:00:00+03:00,in,False,899268,False,1,87,109,22
166975,2019-10-24 00:00:00+03:00,in,False,-1,True,1,0,4,4
166975,2019-10-29 00:00:00+03:00,in,False,899268,False,1,94,120,26
166975,2019-10-30 00:00:00+03:00,in,False,-1,True,1,0,9,9
166975,2019-10-30 00:00:00+03:00,in,False,899268,False,1,384,408,24
166975,2019-11-01 00:00:00+03:00,in,False,899268,True,1,0,22,22
166975,2019-11-08 00:00:00+03:00,in,False,899268,False,2,290,342,52
166975,2019-11-08 00:00:00+03:00,in,False,-1,True,1,0,9,9
166975,2019-11-11 00:00:00+03:00,in,False,899898,False,1,202,229,27
166975,2019-11-12 00:00:00+03:00,in,False,899912,False,1,189,208,19
166975,2019-11-13 00:00:00+03:00,in,False,899268,False,3,231,303,72
166975,2019-11-14 00:00:00+03:00,in,False,-1,True,1,0,29,29
166975,2019-11-16 00:00:00+03:00,in,False,-1,True,1,0,1,1
166975,2019-11-19 00:00:00+03:00,in,False,899268,False,1,437,461,24
166975,2019-11-21 00:00:00+03:00,in,False,-1,True,1,0,7,7
166975,2019-11-22 00:00:00+03:00,in,False,899268,False,1,39,53,14
166975,2019-11-26 00:00:00+03:00,in,False,-1,True,1,0,2,2
166975,2019-11-26 00:00:00+03:00,in,False,899268,False,1,215,241,26
166975,2019-11-27 00:00:00+03:00,in,False,-1,True,1,0,2,2
166975,2019-11-27 00:00:00+03:00,in,False,899268,False,1,18,37,19
166983,2019-09-02 00:00:00+03:00,out,False,901884,False,4,300,357,57
166983,2019-09-02 00:00:00+03:00,out,True,901880,True,1,0,7,7
166983,2019-09-02 00:00:00+03:00,out,False,901880,True,5,0,98,98
166983,2019-09-02 00:00:00+03:00,out,False,901880,False,4,341,408,67
166983,2019-09-02 00:00:00+03:00,in,False,901884,False,4,758,805,47
166983,2019-09-02 00:00:00+03:00,out,False,901884,True,1,0,3,3
166983,2019-09-02 00:00:00+03:00,in,False,-1,True,5,0,93,93
166983,2019-09-02 00:00:00+03:00,in,False,901880,False,10,691,745,54
166983,2019-09-03 00:00:00+03:00,out,False,901884,True,18,0,366,366
166983,2019-09-03 00:00:00+03:00,in,False,901884,False,1,766,771,5
166983,2019-09-03 00:00:00+03:00,in,False,-1,True,1,0,14,14
166983,2019-09-03 00:00:00+03:00,out,False,901884,False,27,3792,4086,294
166983,2019-09-03 00:00:00+03:00,out,False,901886,True,4,0,25,25
166983,2019-09-03 00:00:00+03:00,out,False,901886,False,14,1683,1898,215
166983,2019-09-03 00:00:00+03:00,out,True,901884,False,1,68,101,33
166983,2019-09-03 00:00:00+03:00,in,True,901880,False,1,28,31,3
166983,2019-09-03 00:00:00+03:00,in,False,901880,False,29,1908,2047,139
166983,2019-09-03 00:00:00+03:00,out,False,901880,False,33,1879,2413,534
166983,2019-09-03 00:00:00+03:00,in,False,901894,False,3,321,394,73
166983,2019-09-03 00:00:00+03:00,in,False,901886,False,2,251,303,52
166983,2019-09-03 00:00:00+03:00,out,True,901884,True,1,0,14,14
166983,2019-09-03 00:00:00+03:00,out,False,901880,True,10,0,190,190
166983,2019-09-03 00:00:00+03:00,in,False,-1,True,1,0,14,14
166983,2019-09-04 00:00:00+03:00,in,True,901884,False,3,328,351,23
166983,2019-09-04 00:00:00+03:00,out,False,901884,True,5,0,175,175
166983,2019-09-04 00:00:00+03:00,out,True,901884,True,1,0,27,27
166983,2019-09-04 00:00:00+03:00,in,False,-1,True,3,0,3,3
166983,2019-09-04 00:00:00+03:00,in,False,901894,False,6,968,1091,123
166983,2019-09-04 00:00:00+03:00,out,True,901884,False,3,200,225,25
166983,2019-09-04 00:00:00+03:00,out,False,901880,True,6,0,79,79
166983,2019-09-04 00:00:00+03:00,out,False,901880,False,21,2521,2901,380
166983,2019-09-04 00:00:00+03:00,in,False,-1,True,9,0,244,244
166983,2019-09-04 00:00:00+03:00,out,False,901884,False,20,4026,4281,255
166983,2019-09-04 00:00:00+03:00,in,False,901880,False,14,1482,1532,50
166983,2019-09-04 00:00:00+03:00,in,False,901884,False,2,351,382,31
166983,2019-09-04 00:00:00+03:00,in,False,901880,False,14,1482,1532,50
166983,2019-09-05 00:00:00+03:00,in,False,-1,True,3,0,49,49
166983,2019-09-05 00:00:00+03:00,in,False,901880,False,16,1173,1248,75
166983,2019-09-05 00:00:00+03:00,out,False,901884,False,14,1109,1236,127
166983,2019-09-05 00:00:00+03:00,out,False,901880,False,6,934,1030,96
166983,2019-09-05 00:00:00+03:00,in,False,901880,True,1,0,8,8
166983,2019-09-05 00:00:00+03:00,in,False,901894,False,3,188,264,76
166983,2019-09-05 00:00:00+03:00,in,False,901884,False,7,603,730,127
166983,2019-09-05 00:00:00+03:00,out,False,901884,True,8,0,183,183
166983,2019-09-06 00:00:00+03:00,in,False,-1,True,3,0,12,12
166983,2019-09-06 00:00:00+03:00,in,False,901880,False,16,3431,3530,99
166983,2019-09-06 00:00:00+03:00,out,False,901884,False,14,1128,1371,243
166983,2019-09-06 00:00:00+03:00,out,False,901880,False,20,2048,2283,235
166983,2019-09-06 00:00:00+03:00,in,False,901884,False,4,240,285,45
166983,2019-09-06 00:00:00+03:00,in,False,901894,False,2,217,267,50
166983,2019-09-06 00:00:00+03:00,out,False,901880,True,5,0,266,266
166983,2019-09-07 00:00:00+03:00,in,False,901880,False,23,2987,3085,98
166983,2019-09-07 00:00:00+03:00,out,False,901880,False,16,906,1120,214
166983,2019-09-07 00:00:00+03:00,out,False,901884,True,1,0,28,28
166983,2019-09-07 00:00:00+03:00,out,False,901884,False,2,241,245,4
166983,2019-09-07 00:00:00+03:00,out,False,901880,True,12,0,425,425
166983,2019-09-07 00:00:00+03:00,in,False,901884,False,6,1337,1422,85
166983,2019-09-07 00:00:00+03:00,in,False,901894,False,3,97,188,91
166983,2019-09-07 00:00:00+03:00,in,False,-1,True,2,0,48,48
166983,2019-09-07 00:00:00+03:00,out,False,901880,False,16,906,1120,214
166983,2019-09-08 00:00:00+03:00,in,False,901886,False,1,20,47,27
166983,2019-09-08 00:00:00+03:00,out,False,901884,False,18,1314,1627,313
166983,2019-09-08 00:00:00+03:00,out,False,901880,False,2,100,148,48
166983,2019-09-08 00:00:00+03:00,in,False,901884,False,8,1655,1743,88
166983,2019-09-08 00:00:00+03:00,in,False,901880,False,8,761,799,38
166983,2019-09-08 00:00:00+03:00,out,False,901886,True,3,0,13,13
166983,2019-09-08 00:00:00+03:00,in,False,-1,True,1,0,28,28
166983,2019-09-08 00:00:00+03:00,out,False,901886,False,6,274,347,73
166983,2019-09-08 00:00:00+03:00,out,False,901884,True,11,0,240,240
166983,2019-09-08 00:00:00+03:00,in,False,901894,False,1,40,84,44
166983,2019-09-08 00:00:00+03:00,out,False,901880,True,2,0,74,74
166983,2019-09-09 00:00:00+03:00,out,False,901886,True,23,0,420,420
166983,2019-09-09 00:00:00+03:00,out,False,901880,False,17,2198,2352,154
166983,2019-09-09 00:00:00+03:00,out,False,901880,True,5,0,79,79
166983,2019-09-09 00:00:00+03:00,in,False,901886,False,3,194,227,33
166983,2019-09-09 00:00:00+03:00,in,False,901884,False,8,2556,2636,80
166983,2019-09-09 00:00:00+03:00,out,False,901884,False,7,1972,2048,76
166983,2019-09-09 00:00:00+03:00,in,False,901880,False,17,2550,2622,72
166983,2019-09-09 00:00:00+03:00,in,False,-1,True,7,0,212,212
166983,2019-09-09 00:00:00+03:00,in,False,901894,False,2,150,198,48
166983,2019-09-09 00:00:00+03:00,out,False,901886,False,20,2084,2387,303
166983,2019-09-09 00:00:00+03:00,out,True,901884,False,1,96,101,5
166983,2019-09-09 00:00:00+03:00,in,True,901886,False,1,46,57,11
166983,2019-09-09 00:00:00+03:00,out,False,901884,True,1,0,22,22
166983,2019-09-10 00:00:00+03:00,out,True,901884,False,3,722,744,22
166983,2019-09-10 00:00:00+03:00,in,False,901880,False,29,3217,3361,144
166983,2019-09-10 00:00:00+03:00,in,False,901884,False,5,604,670,66
166983,2019-09-10 00:00:00+03:00,out,False,901880,True,13,0,277,277
166983,2019-09-10 00:00:00+03:00,out,False,901880,False,40,2936,3433,497
166983,2019-09-10 00:00:00+03:00,in,False,-1,True,5,0,117,117
166983,2019-09-10 00:00:00+03:00,in,False,901894,False,5,544,705,161
166983,2019-09-10 00:00:00+03:00,out,False,901884,True,1,0,41,41
166983,2019-09-10 00:00:00+03:00,out,False,901884,False,15,2927,3127,200
166983,2019-09-11 00:00:00+03:00,out,False,901880,False,3,82,122,40
166983,2019-09-11 00:00:00+03:00,out,False,901884,False,30,5601,5981,380
166983,2019-09-11 00:00:00+03:00,in,False,901886,False,5,487,607,120
166983,2019-09-11 00:00:00+03:00,in,False,-1,True,7,0,191,191
166983,2019-09-11 00:00:00+03:00,in,False,901884,False,14,1558,1816,258
166983,2019-09-11 00:00:00+03:00,out,False,901886,True,12,0,187,187
166983,2019-09-11 00:00:00+03:00,out,False,901884,True,18,0,398,398
166983,2019-09-11 00:00:00+03:00,out,False,901886,False,14,1772,1924,152
166983,2019-09-11 00:00:00+03:00,in,False,901880,False,6,697,726,29
166983,2019-09-11 00:00:00+03:00,out,False,901880,True,73,0,2732,2732
166983,2019-09-11 00:00:00+03:00,in,False,901894,False,5,576,652,76
166983,2019-09-11 00:00:00+03:00,in,False,901880,False,6,697,726,29
166983,2019-09-12 00:00:00+03:00,in,False,-1,True,7,0,282,282
166983,2019-09-12 00:00:00+03:00,out,False,901880,True,3,0,129,129
166983,2019-09-12 00:00:00+03:00,out,True,901884,False,4,1155,1200,45
166983,2019-09-12 00:00:00+03:00,out,False,901884,True,2,0,41,41
166983,2019-09-12 00:00:00+03:00,out,False,901886,True,16,0,380,380
166983,2019-09-12 00:00:00+03:00,in,False,901886,False,3,106,181,75
166983,2019-09-12 00:00:00+03:00,out,False,901884,False,20,3544,3799,255
166983,2019-09-12 00:00:00+03:00,in,False,901880,False,14,2235,2297,62
166983,2019-09-12 00:00:00+03:00,out,False,901886,False,28,3368,3693,325
166983,2019-09-12 00:00:00+03:00,in,False,909134,False,4,1082,1217,135
166983,2019-09-12 00:00:00+03:00,out,False,901880,False,12,2789,2915,126
166983,2019-09-12 00:00:00+03:00,in,False,901884,False,13,1867,2085,218
166983,2019-09-13 00:00:00+03:00,in,False,-1,True,6,0,343,343
166983,2019-09-13 00:00:00+03:00,out,True,901884,True,1,0,27,27
166983,2019-09-13 00:00:00+03:00,out,False,901880,True,20,0,444,444
166983,2019-09-13 00:00:00+03:00,out,True,901884,False,2,134,158,24
166983,2019-09-13 00:00:00+03:00,in,False,901880,False,39,4149,4315,166
166983,2019-09-13 00:00:00+03:00,out,False,901880,False,37,3576,4067,491
166983,2019-09-13 00:00:00+03:00,out,False,901884,False,1,51,60,9
166983,2019-09-13 00:00:00+03:00,in,False,901884,False,8,2031,2119,88
166983,2019-09-13 00:00:00+03:00,out,False,901884,True,4,0,32,32
166983,2019-09-13 00:00:00+03:00,in,False,909134,False,5,612,695,83
166983,2019-09-13 00:00:00+03:00,in,False,909134,False,5,612,695,83
166983,2019-09-14 00:00:00+03:00,out,False,901886,True,8,0,172,172
166983,2019-09-14 00:00:00+03:00,out,False,901886,False,14,3407,3608,201
166983,2019-09-14 00:00:00+03:00,out,False,901884,True,5,0,105,105
166983,2019-09-14 00:00:00+03:00,out,False,901884,False,6,1037,1126,89
166983,2019-09-14 00:00:00+03:00,in,False,901886,False,3,463,531,68
166983,2019-09-14 00:00:00+03:00,out,True,901884,False,1,192,202,10
166983,2019-09-14 00:00:00+03:00,out,False,901880,True,4,0,165,165
166983,2019-09-14 00:00:00+03:00,in,False,901880,False,17,4070,4170,100
166983,2019-09-14 00:00:00+03:00,in,False,-1,True,3,0,83,83
166983,2019-09-14 00:00:00+03:00,out,False,901880,False,11,1045,1199,154
166983,2019-09-14 00:00:00+03:00,in,False,901884,False,3,1168,1181,13
166983,2019-09-15 00:00:00+03:00,in,False,909134,False,1,14,43,29
166983,2019-09-15 00:00:00+03:00,out,False,901886,False,28,3332,3856,524
166983,2019-09-15 00:00:00+03:00,in,False,901880,False,14,1258,1325,67
166983,2019-09-15 00:00:00+03:00,in,False,-1,True,1,0,93,93
166983,2019-09-15 00:00:00+03:00,out,False,901880,True,3,0,83,83
166983,2019-09-15 00:00:00+03:00,out,False,901886,True,17,0,295,295
166983,2019-09-15 00:00:00+03:00,in,False,901886,False,2,234,258,24
166983,2019-09-15 00:00:00+03:00,out,False,901880,False,7,1275,1313,38
166983,2019-09-16 00:00:00+03:00,out,True,901884,True,1,0,0,0
166983,2019-09-16 00:00:00+03:00,in,False,909134,False,1,84,131,47
166983,2019-09-16 00:00:00+03:00,in,False,901884,False,9,833,961,128
166983,2019-09-16 00:00:00+03:00,out,False,901884,False,31,5019,5360,341
166983,2019-09-16 00:00:00+03:00,out,False,901880,True,8,0,211,211
166983,2019-09-16 00:00:00+03:00,out,False,901884,True,15,0,359,359
166983,2019-09-16 00:00:00+03:00,out,False,901880,False,17,2933,3178,245
166983,2019-09-16 00:00:00+03:00,in,False,-1,True,2,0,32,32
166983,2019-09-16 00:00:00+03:00,in,False,901880,False,11,1847,1893,46
166983,2019-09-16 00:00:00+03:00,out,True,901884,False,1,97,115,18
166983,2019-09-17 00:00:00+03:00,out,False,901880,True,14,0,469,469
166983,2019-09-17 00:00:00+03:00,out,False,901884,True,4,0,79,79
166983,2019-09-17 00:00:00+03:00,in,False,909134,False,1,143,162,19
166983,2019-09-17 00:00:00+03:00,out,True,901880,False,1,16,28,12
166983,2019-09-17 00:00:00+03:00,in,False,901884,False,5,1514,1601,87
166983,2019-09-17 00:00:00+03:00,out,False,901884,False,7,910,971,61
166983,2019-09-17 00:00:00+03:00,out,False,901880,False,28,2062,2421,359
166983,2019-09-17 00:00:00+03:00,in,False,901880,False,20,2542,2643,101
166983,2019-09-17 00:00:00+03:00,out,True,901884,False,5,755,793,38
166983,2019-09-17 00:00:00+03:00,in,False,-1,True,2,0,36,36
166983,2019-09-17 00:00:00+03:00,out,False,901880,True,14,0,469,469
166983,2019-09-18 00:00:00+03:00,out,False,901884,False,20,1978,2315,337
166983,2019-09-18 00:00:00+03:00,out,False,901884,True,17,0,470,470
166983,2019-09-18 00:00:00+03:00,in,False,901884,False,7,1477,1589,112
166983,2019-09-18 00:00:00+03:00,out,False,901880,False,29,1991,2428,437
166983,2019-09-18 00:00:00+03:00,in,False,909134,False,2,223,273,50
166983,2019-09-18 00:00:00+03:00,out,False,901880,True,11,0,277,277
166983,2019-09-18 00:00:00+03:00,in,False,-1,True,6,0,682,682
166983,2019-09-18 00:00:00+03:00,in,False,901880,False,19,1718,1809,91
166983,2019-09-18 00:00:00+03:00,in,False,901884,False,7,1477,1589,112
166983,2019-09-18 00:00:00+03:00,out,False,901884,False,20,1978,2315,337
166983,2019-09-19 00:00:00+03:00,in,False,-1,True,2,0,25,25
166983,2019-09-19 00:00:00+03:00,out,True,901884,True,1,0,0,0
166983,2019-09-19 00:00:00+03:00,in,False,909134,False,2,154,237,83
166983,2019-09-19 00:00:00+03:00,out,False,901884,True,1,0,38,38
166983,2019-09-19 00:00:00+03:00,out,False,901884,False,11,7187,7284,97
166983,2019-09-19 00:00:00+03:00,out,False,901880,True,11,0,288,288
166983,2019-09-19 00:00:00+03:00,out,False,901880,False,31,2525,2974,449
166983,2019-09-19 00:00:00+03:00,in,False,901884,False,9,1624,1779,155
166983,2019-09-19 00:00:00+03:00,out,True,901884,False,2,127,139,12
166983,2019-09-19 00:00:00+03:00,in,False,901880,False,16,1225,1292,67
166983,2019-09-19 00:00:00+03:00,in,False,901880,False,16,1225,1292,67
166983,2019-09-20 00:00:00+03:00,in,False,901880,False,22,2529,2676,147
166983,2019-09-20 00:00:00+03:00,in,False,901884,False,3,781,794,13
166983,2019-09-20 00:00:00+03:00,out,False,901880,True,10,0,371,371
166983,2019-09-20 00:00:00+03:00,out,False,901884,False,26,3121,3392,271
166983,2019-09-20 00:00:00+03:00,in,False,-1,True,1,0,56,56
166983,2019-09-20 00:00:00+03:00,in,False,909134,False,6,474,579,105
166983,2019-09-20 00:00:00+03:00,out,False,901884,True,4,0,105,105
166983,2019-09-20 00:00:00+03:00,out,True,901884,False,1,257,263,6
166983,2019-09-20 00:00:00+03:00,out,True,901884,True,1,0,41,41
166983,2019-09-20 00:00:00+03:00,in,False,-1,True,4,0,184,184
166983,2019-09-20 00:00:00+03:00,out,False,901880,False,24,1448,1759,311
166983,2019-09-20 00:00:00+03:00,out,False,901880,False,24,1448,1759,311
166983,2019-09-21 00:00:00+03:00,out,False,901880,False,11,754,902,148
166983,2019-09-21 00:00:00+03:00,in,False,901880,False,12,1166,1220,54
166983,2019-09-21 00:00:00+03:00,out,False,901884,False,2,353,399,46
166983,2019-09-21 00:00:00+03:00,out,False,901880,True,4,0,86,86
166983,2019-09-21 00:00:00+03:00,out,True,901884,False,2,671,690,19
166983,2019-09-21 00:00:00+03:00,in,False,-1,True,1,0,72,72
166983,2019-09-22 00:00:00+03:00,in,False,909134,False,2,310,366,56
166983,2019-09-22 00:00:00+03:00,in,False,-1,True,2,0,35,35
166983,2019-09-22 00:00:00+03:00,out,False,901884,False,18,1532,1788,256
166983,2019-09-22 00:00:00+03:00,in,False,901880,False,9,1054,1111,57
166983,2019-09-22 00:00:00+03:00,in,False,901884,False,5,622,714,92
166983,2019-09-22 00:00:00+03:00,out,False,901884,True,12,0,309,309
166983,2019-09-23 00:00:00+03:00,in,False,901880,False,20,2972,3091,119
166983,2019-09-23 00:00:00+03:00,out,False,901880,True,3,0,150,150
166983,2019-09-23 00:00:00+03:00,in,False,909134,False,1,201,226,25
166983,2019-09-23 00:00:00+03:00,out,False,901880,False,26,3541,3878,337
166983,2019-09-23 00:00:00+03:00,out,False,901884,False,9,965,1072,107
166983,2019-09-23 00:00:00+03:00,out,False,901884,True,3,0,37,37
166983,2019-09-23 00:00:00+03:00,in,False,901884,False,6,758,834,76
166983,2019-09-23 00:00:00+03:00,out,True,901884,False,1,41,47,6
166983,2019-09-23 00:00:00+03:00,in,False,-1,True,3,0,64,64
166983,2019-09-23 00:00:00+03:00,out,False,901880,False,26,3541,3878,337
166983,2019-09-24 00:00:00+03:00,in,True,901880,False,1,12,15,3
166983,2019-09-24 00:00:00+03:00,out,False,901880,False,38,3012,3541,529
166983,2019-09-24 00:00:00+03:00,out,False,901884,True,9,0,237,237
166983,2019-09-24 00:00:00+03:00,out,True,901880,False,2,28,51,23
166983,2019-09-24 00:00:00+03:00,out,False,909134,True,1,0,5,5
166983,2019-09-24 00:00:00+03:00,in,False,901880,False,15,2524,2596,72
166983,2019-09-24 00:00:00+03:00,in,False,909134,False,1,3,19,16
166983,2019-09-24 00:00:00+03:00,in,False,-1,True,5,0,166,166
166983,2019-09-24 00:00:00+03:00,out,True,901884,True,1,0,39,39
166983,2019-09-24 00:00:00+03:00,out,False,901884,False,7,1503,1574,71
166983,2019-09-24 00:00:00+03:00,in,False,901884,False,6,1952,2057,105
166983,2019-09-24 00:00:00+03:00,out,True,901884,False,4,640,687,47
166983,2019-09-24 00:00:00+03:00,out,False,901880,True,11,0,149,149
166983,2019-09-24 00:00:00+03:00,out,False,901880,True,11,0,149,149
166983,2019-09-24 00:00:00+03:00,out,True,901884,False,4,640,687,47
166983,2019-09-24 00:00:00+03:00,in,False,901880,False,15,2524,2596,72
166983,2019-09-25 00:00:00+03:00,in,False,901884,False,13,1516,1727,211
166983,2019-09-25 00:00:00+03:00,out,False,901880,False,6,428,507,79
166983,2019-09-25 00:00:00+03:00,out,False,901884,False,37,3805,4410,605
166983,2019-09-25 00:00:00+03:00,in,False,901880,False,11,3195,3251,56
166983,2019-09-25 00:00:00+03:00,in,False,-1,True,4,0,144,144
166983,2019-09-25 00:00:00+03:00,in,False,909134,False,5,562,671,109
166983,2019-09-25 00:00:00+03:00,out,False,901884,True,18,0,435,435
166983,2019-09-25 00:00:00+03:00,out,False,901880,True,4,0,97,97
166983,2019-09-25 00:00:00+03:00,out,False,901884,True,18,0,435,435
166983,2019-09-26 00:00:00+03:00,out,True,901880,False,1,82,92,10
166983,2019-09-26 00:00:00+03:00,in,False,901884,False,5,1526,1592,66
166983,2019-09-26 00:00:00+03:00,out,True,901884,False,2,350,368,18
166983,2019-09-26 00:00:00+03:00,in,False,909134,False,5,1362,1603,241
166983,2019-09-26 00:00:00+03:00,in,False,-1,True,2,0,48,48
166983,2019-09-26 00:00:00+03:00,out,False,909134,True,1,0,4,4
166983,2019-09-26 00:00:00+03:00,in,False,901880,False,22,3234,3368,134
166983,2019-09-26 00:00:00+03:00,out,True,901884,True,1,0,2,2
166983,2019-09-26 00:00:00+03:00,out,False,901880,False,24,1697,1976,279
166983,2019-09-26 00:00:00+03:00,out,False,901884,False,6,2829,2862,33
166983,2019-09-26 00:00:00+03:00,out,False,901880,True,5,0,117,117
166983,2019-09-26 00:00:00+03:00,out,False,901884,True,7,0,190,190
166983,2019-09-27 00:00:00+03:00,in,False,901880,False,25,3874,4030,156
166983,2019-09-27 00:00:00+03:00,out,True,901880,True,1,0,1,1
166983,2019-09-27 00:00:00+03:00,in,False,-1,True,11,0,319,319
166983,2019-09-27 00:00:00+03:00,out,False,901884,False,8,757,857,100
166983,2019-09-27 00:00:00+03:00,out,True,901884,True,1,0,24,24
166983,2019-09-27 00:00:00+03:00,in,False,909134,False,4,694,854,160
166983,2019-09-27 00:00:00+03:00,out,False,901880,True,4,0,81,81
166983,2019-09-27 00:00:00+03:00,in,False,-1,True,1,0,32,32
166983,2019-09-27 00:00:00+03:00,out,False,901880,False,19,1616,1892,276
166983,2019-09-27 00:00:00+03:00,out,True,901884,False,2,397,414,17
166983,2019-09-27 00:00:00+03:00,out,False,901884,True,6,0,189,189
166983,2019-09-27 00:00:00+03:00,out,False,-1,True,1,0,0,0
166983,2019-09-27 00:00:00+03:00,in,False,901884,False,12,3563,3781,218
166983,2019-09-27 00:00:00+03:00,out,True,901880,True,1,0,1,1
166983,2019-09-28 00:00:00+03:00,in,False,909134,False,3,246,332,86
166983,2019-09-28 00:00:00+03:00,out,False,901884,False,2,81,119,38
166983,2019-09-28 00:00:00+03:00,in,False,901884,False,8,1167,1304,137
166983,2019-09-28 00:00:00+03:00,out,False,901880,False,20,1473,1762,289
166983,2019-09-28 00:00:00+03:00,out,False,901880,True,11,0,206,206
166983,2019-09-28 00:00:00+03:00,in,False,901880,False,16,1980,2101,121
166983,2019-09-29 00:00:00+03:00,in,False,901880,False,14,1052,1118,66
166983,2019-09-29 00:00:00+03:00,out,False,901884,True,10,0,190,190
166983,2019-09-29 00:00:00+03:00,out,False,901880,True,1,0,5,5
166983,2019-09-29 00:00:00+03:00,in,False,901884,False,7,687,793,106
166983,2019-09-29 00:00:00+03:00,out,False,901884,False,16,848,1094,246
166983,2019-09-30 00:00:00+03:00,in,False,901880,False,21,2436,2562,126
166983,2019-09-30 00:00:00+03:00,in,False,-1,True,3,0,133,133
166983,2019-09-30 00:00:00+03:00,in,False,901880,True,2,0,18,18
166983,2019-09-30 00:00:00+03:00,out,False,901884,True,1,0,3,3
166983,2019-09-30 00:00:00+03:00,out,False,901880,False,45,4755,5351,596
166983,2019-09-30 00:00:00+03:00,out,False,901880,True,11,0,209,209
166983,2019-09-30 00:00:00+03:00,in,False,901884,False,8,1173,1280,107
166983,2019-09-30 00:00:00+03:00,in,False,909134,False,4,504,624,120
166983,2019-09-30 00:00:00+03:00,out,False,901884,False,9,871,970,99
166983,2019-09-30 00:00:00+03:00,in,False,901880,False,21,2436,2562,126
166983,2019-10-01 00:00:00+03:00,out,False,901880,True,16,0,516,516
166983,2019-10-01 00:00:00+03:00,in,False,901884,False,2,87,115,28
166983,2019-10-01 00:00:00+03:00,in,False,901880,True,1,0,6,6
166983,2019-10-01 00:00:00+03:00,out,False,901884,True,4,0,187,187
166983,2019-10-01 00:00:00+03:00,out,True,901884,True,1,0,0,0
166983,2019-10-01 00:00:00+03:00,in,False,909134,False,6,817,1045,228
166983,2019-10-01 00:00:00+03:00,in,False,901880,False,22,2574,2661,87
166983,2019-10-01 00:00:00+03:00,in,False,-1,True,1,0,28,28
166983,2019-10-01 00:00:00+03:00,out,False,901884,False,6,1201,1280,79
166983,2019-10-01 00:00:00+03:00,out,False,901880,False,41,4170,4892,722
166983,2019-10-01 00:00:00+03:00,out,False,901880,True,16,0,516,516
166983,2019-10-02 00:00:00+03:00,in,False,909134,False,3,1281,1344,63
166983,2019-10-02 00:00:00+03:00,out,False,901884,False,18,2050,2275,225
166983,2019-10-02 00:00:00+03:00,in,False,-1,True,4,0,39,39
166983,2019-10-02 00:00:00+03:00,out,False,901880,True,8,0,209,209
166983,2019-10-02 00:00:00+03:00,out,False,901880,False,20,1725,1931,206
166983,2019-10-02 00:00:00+03:00,in,False,901884,False,7,1152,1279,127
166983,2019-10-02 00:00:00+03:00,out,False,901884,True,15,0,223,223
166983,2019-10-02 00:00:00+03:00,in,False,901880,False,20,2305,2416,111
166983,2019-10-03 00:00:00+03:00,out,False,901884,False,7,2343,2396,53
166983,2019-10-03 00:00:00+03:00,in,False,-1,True,4,0,113,113
166983,2019-10-03 00:00:00+03:00,in,False,901884,False,1,38,57,19
166983,2019-10-03 00:00:00+03:00,in,True,901884,False,1,5,23,18
166983,2019-10-03 00:00:00+03:00,in,False,901880,False,24,3221,3322,101
166983,2019-10-03 00:00:00+03:00,in,False,909134,False,4,702,855,153
166983,2019-10-03 00:00:00+03:00,out,False,901880,False,30,2194,2570,376
166983,2019-10-03 00:00:00+03:00,out,False,901880,True,16,0,338,338
166983,2019-10-03 00:00:00+03:00,out,True,901884,True,1,0,7,7
166983,2019-10-03 00:00:00+03:00,out,False,901884,True,6,0,37,37
166983,2019-10-03 00:00:00+03:00,in,False,909134,False,4,702,855,153
166983,2019-10-03 00:00:00+03:00,in,False,901880,False,24,3221,3322,101
166983,2019-10-04 00:00:00+03:00,in,False,901880,False,16,1918,1991,73
166983,2019-10-04 00:00:00+03:00,out,False,901886,True,19,0,358,358
166983,2019-10-04 00:00:00+03:00,in,False,901886,False,2,121,149,28
166983,2019-10-04 00:00:00+03:00,out,False,901880,True,5,0,22,22
166983,2019-10-04 00:00:00+03:00,in,False,-1,True,4,0,124,124
166983,2019-10-04 00:00:00+03:00,out,False,901884,False,2,665,678,13
166983,2019-10-04 00:00:00+03:00,out,True,901884,False,3,217,252,35
166983,2019-10-04 00:00:00+03:00,out,False,901884,True,1,0,28,28
166983,2019-10-04 00:00:00+03:00,out,False,901880,False,25,1595,1848,253
166983,2019-10-04 00:00:00+03:00,out,False,901886,False,19,998,1282,284
166983,2019-10-04 00:00:00+03:00,in,False,901884,False,4,882,942,60
166983,2019-10-04 00:00:00+03:00,out,False,901886,True,19,0,358,358
166983,2019-10-05 00:00:00+03:00,out,False,901880,True,8,0,198,198
166983,2019-10-05 00:00:00+03:00,in,False,-1,True,2,0,23,23
166983,2019-10-05 00:00:00+03:00,in,True,901884,False,1,136,156,20
166983,2019-10-05 00:00:00+03:00,out,False,901886,False,10,1214,1409,195
166983,2019-10-05 00:00:00+03:00,in,False,901880,False,21,2203,2315,112
166983,2019-10-05 00:00:00+03:00,in,False,909134,False,2,137,226,89
166983,2019-10-05 00:00:00+03:00,in,False,901886,False,2,215,259,44
166983,2019-10-05 00:00:00+03:00,in,False,901880,True,1,0,13,13
166983,2019-10-05 00:00:00+03:00,out,False,901880,False,14,1075,1312,237
166983,2019-10-05 00:00:00+03:00,out,False,901886,True,8,0,194,194
166983,2019-10-05 00:00:00+03:00,out,True,901884,False,1,1,28,27
166983,2019-10-05 00:00:00+03:00,in,False,901884,False,7,538,653,115
166983,2019-10-05 00:00:00+03:00,in,True,901880,False,1,39,43,4
166983,2019-10-05 00:00:00+03:00,out,False,901884,True,6,0,86,86
166983,2019-10-05 00:00:00+03:00,out,False,901884,False,13,1226,1408,182
166983,2019-10-06 00:00:00+03:00,in,False,901880,False,19,1829,1916,87
166983,2019-10-06 00:00:00+03:00,in,False,901884,False,4,489,562,73
166983,2019-10-06 00:00:00+03:00,out,False,901880,True,1,0,13,13
166983,2019-10-06 00:00:00+03:00,out,False,901884,False,21,1007,1336,329
166983,2019-10-06 00:00:00+03:00,out,False,901884,True,8,0,153,153
166983,2019-10-06 00:00:00+03:00,in,False,909134,False,2,80,132,52
166983,2019-10-06 00:00:00+03:00,out,False,901880,False,3,149,165,16
166983,2019-10-06 00:00:00+03:00,in,False,-1,True,3,0,165,165
166983,2019-10-06 00:00:00+03:00,out,False,901884,True,8,0,153,153
166983,2019-10-07 00:00:00+03:00,out,False,901880,True,10,0,366,366
166983,2019-10-07 00:00:00+03:00,in,False,901884,False,4,240,264,24
166983,2019-10-07 00:00:00+03:00,in,False,-1,True,2,0,39,39
166983,2019-10-07 00:00:00+03:00,out,False,901886,False,1,11,24,13
166983,2019-10-07 00:00:00+03:00,out,False,901880,False,18,2324,2552,228
166983,2019-10-07 00:00:00+03:00,out,False,901884,False,22,2510,2796,286
166983,2019-10-07 00:00:00+03:00,out,False,901884,True,7,0,189,189
166983,2019-10-07 00:00:00+03:00,in,False,909134,False,3,628,741,113
166983,2019-10-07 00:00:00+03:00,in,False,901880,False,36,5046,5265,219
166983,2019-10-07 00:00:00+03:00,out,False,901884,True,7,0,189,189
166983,2019-10-08 00:00:00+03:00,in,False,901880,False,31,6275,6427,152
166983,2019-10-08 00:00:00+03:00,out,False,901880,False,14,2396,2559,163
166983,2019-10-08 00:00:00+03:00,in,False,901886,False,2,660,717,57
166983,2019-10-08 00:00:00+03:00,in,False,901880,True,1,0,15,15
166983,2019-10-08 00:00:00+03:00,out,True,901884,True,1,0,23,23
166983,2019-10-08 00:00:00+03:00,out,False,901884,False,13,2136,2280,144
166983,2019-10-08 00:00:00+03:00,in,False,-1,True,1,0,17,17
166983,2019-10-08 00:00:00+03:00,out,False,901884,True,8,0,260,260
166983,2019-10-08 00:00:00+03:00,out,False,901886,False,16,1635,1809,174
166983,2019-10-08 00:00:00+03:00,out,False,901886,True,4,0,91,91
166983,2019-10-08 00:00:00+03:00,in,False,901884,False,14,3997,4128,131
166983,2019-10-08 00:00:00+03:00,out,False,901880,True,5,0,262,262
166983,2019-10-08 00:00:00+03:00,out,True,901880,True,1,0,1,1
166983,2019-10-08 00:00:00+03:00,out,False,901880,True,5,0,262,262
166983,2019-10-08 00:00:00+03:00,out,True,901884,True,1,0,23,23
166983,2019-10-09 00:00:00+03:00,out,False,901886,False,12,1040,1208,168
166983,2019-10-09 00:00:00+03:00,out,False,901880,False,12,1365,1503,138
166983,2019-10-09 00:00:00+03:00,in,True,901880,False,2,39,51,12
166983,2019-10-09 00:00:00+03:00,out,False,901884,False,21,2193,2468,275
166983,2019-10-09 00:00:00+03:00,in,False,909134,False,1,76,117,41
166983,2019-10-09 00:00:00+03:00,out,False,901880,True,4,0,33,33
166983,2019-10-09 00:00:00+03:00,in,False,901886,False,1,22,37,15
166983,2019-10-09 00:00:00+03:00,in,False,901884,False,7,890,995,105
166983,2019-10-09 00:00:00+03:00,out,False,901886,True,14,0,192,192
166983,2019-10-09 00:00:00+03:00,in,False,901880,False,24,4159,4275,116
166983,2019-10-09 00:00:00+03:00,in,False,-1,True,2,0,38,38
166983,2019-10-09 00:00:00+03:00,out,False,901884,True,9,0,189,189
166983,2019-10-10 00:00:00+03:00,out,False,901880,True,15,0,405,405
166983,2019-10-10 00:00:00+03:00,out,False,901880,False,22,1803,2085,282
166983,2019-10-10 00:00:00+03:00,in,False,901880,False,27,3116,3248,132
166983,2019-10-10 00:00:00+03:00,out,True,901886,True,1,0,0,0
166983,2019-10-10 00:00:00+03:00,out,False,901886,True,8,0,211,211
166983,2019-10-10 00:00:00+03:00,in,False,-1,True,3,0,41,41
166983,2019-10-10 00:00:00+03:00,in,False,901886,False,2,135,183,48
166983,2019-10-10 00:00:00+03:00,out,False,901886,False,24,2134,2358,224
166983,2019-10-10 00:00:00+03:00,in,False,901884,False,5,848,925,77
166983,2019-10-10 00:00:00+03:00,out,False,901884,True,3,0,39,39
166983,2019-10-10 00:00:00+03:00,out,False,901884,False,6,3600,3648,48
166983,2019-10-11 00:00:00+03:00,out,False,901886,False,6,569,667,98
166983,2019-10-11 00:00:00+03:00,in,False,901886,False,1,250,279,29
166983,2019-10-11 00:00:00+03:00,out,False,901884,True,1,0,5,5
166983,2019-10-11 00:00:00+03:00,in,False,901884,False,4,1594,1677,83
166983,2019-10-11 00:00:00+03:00,out,False,901880,False,25,1754,2052,298
166983,2019-10-11 00:00:00+03:00,out,False,901886,True,7,0,118,118
166983,2019-10-11 00:00:00+03:00,out,False,901880,True,9,0,198,198
166983,2019-10-11 00:00:00+03:00,in,False,901880,False,16,1969,2030,61
166983,2019-10-11 00:00:00+03:00,out,False,901884,False,7,2237,2311,74
166983,2019-10-11 00:00:00+03:00,in,False,-1,True,1,0,1,1
166983,2019-10-11 00:00:00+03:00,out,False,901880,False,25,1754,2052,298
166983,2019-10-12 00:00:00+03:00,out,False,901886,True,9,0,248,248
166983,2019-10-12 00:00:00+03:00,out,False,901880,True,9,0,242,242
166983,2019-10-12 00:00:00+03:00,out,False,901886,False,20,1504,1821,317
166983,2019-10-12 00:00:00+03:00,out,False,901884,False,3,2839,2881,42
166983,2019-10-12 00:00:00+03:00,in,False,901884,False,11,1207,1401,194
166983,2019-10-12 00:00:00+03:00,in,False,-1,True,1,0,20,20
166983,2019-10-12 00:00:00+03:00,out,False,901884,True,1,0,7,7
166983,2019-10-12 00:00:00+03:00,out,True,901884,True,1,0,27,27
166983,2019-10-12 00:00:00+03:00,in,False,901880,False,23,3347,3493,146
166983,2019-10-12 00:00:00+03:00,out,False,901880,False,7,1118,1212,94
166983,2019-10-12 00:00:00+03:00,in,False,901886,False,1,216,219,3
166983,2019-10-12 00:00:00+03:00,in,False,909134,False,2,638,756,118
166983,2019-10-12 00:00:00+03:00,in,True,901886,False,1,53,73,20
166983,2019-10-12 00:00:00+03:00,out,False,901886,False,20,1504,1821,317
166983,2019-10-12 00:00:00+03:00,out,False,901880,True,9,0,242,242
166983,2019-10-13 00:00:00+03:00,out,False,901880,True,7,0,243,243
166983,2019-10-13 00:00:00+03:00,out,False,909134,True,1,0,3,3
166983,2019-10-13 00:00:00+03:00,out,False,901884,True,12,0,290,290
166983,2019-10-13 00:00:00+03:00,out,False,901880,False,10,1457,1579,122
166983,2019-10-13 00:00:00+03:00,in,False,-1,True,1,0,9,9
166983,2019-10-13 00:00:00+03:00,in,False,909134,False,4,337,499,162
166983,2019-10-13 00:00:00+03:00,out,False,901884,False,13,1237,1406,169
166983,2019-10-13 00:00:00+03:00,in,False,901880,False,16,1690,1793,103
166983,2019-10-13 00:00:00+03:00,in,False,901884,False,5,591,657,66
166983,2019-10-13 00:00:00+03:00,out,False,901880,False,10,1457,1579,122
166983,2019-10-13 00:00:00+03:00,in,False,901880,False,16,1690,1793,103
166983,2019-10-13 00:00:00+03:00,out,False,909134,True,1,0,3,3
166983,2019-10-14 00:00:00+03:00,out,False,901886,False,8,590,731,141
166983,2019-10-14 00:00:00+03:00,in,False,901880,False,22,2556,2683,127
166983,2019-10-14 00:00:00+03:00,in,False,909134,False,2,399,640,241
166983,2019-10-14 00:00:00+03:00,out,True,901880,True,1,0,1,1
166983,2019-10-14 00:00:00+03:00,in,False,901884,False,10,946,1078,132
166983,2019-10-14 00:00:00+03:00,out,False,901884,False,28,4368,4639,271
166983,2019-10-14 00:00:00+03:00,out,False,901880,False,25,3304,3630,326
166983,2019-10-14 00:00:00+03:00,in,False,-1,True,3,0,24,24
166983,2019-10-14 00:00:00+03:00,out,False,901886,True,4,0,74,74
166983,2019-10-14 00:00:00+03:00,out,True,901886,False,1,51,60,9
166983,2019-10-14 00:00:00+03:00,out,True,901884,False,2,310,331,21
166983,2019-10-14 00:00:00+03:00,out,False,901880,True,10,0,285,285
166983,2019-10-14 00:00:00+03:00,out,False,901884,True,12,0,161,161
166983,2019-10-14 00:00:00+03:00,in,False,-1,True,3,0,24,24
166983,2019-10-14 00:00:00+03:00,out,False,901884,False,28,4368,4639,271
166983,2019-10-14 00:00:00+03:00,out,False,901884,True,12,0,161,161
166983,2019-10-14 00:00:00+03:00,out,True,901886,False,1,51,60,9
166983,2019-10-15 00:00:00+03:00,in,False,901886,False,2,153,185,32
166983,2019-10-15 00:00:00+03:00,out,False,901886,True,3,0,115,115
166983,2019-10-15 00:00:00+03:00,in,False,901884,False,6,358,454,96
166983,2019-10-15 00:00:00+03:00,in,False,-1,True,1,0,19,19
166983,2019-10-15 00:00:00+03:00,out,False,901886,False,13,1451,1612,161
166983,2019-10-15 00:00:00+03:00,out,False,901884,False,9,2831,2985,154
166983,2019-10-15 00:00:00+03:00,out,False,901880,True,6,0,207,207
166983,2019-10-15 00:00:00+03:00,out,True,901884,True,1,0,2,2
166983,2019-10-15 00:00:00+03:00,in,False,909134,False,2,469,515,46
166983,2019-10-15 00:00:00+03:00,in,False,901880,False,16,1752,1825,73
166983,2019-10-15 00:00:00+03:00,out,False,901880,False,31,3136,3415,279
166983,2019-10-15 00:00:00+03:00,out,False,901884,False,9,2831,2985,154
166983,2019-10-16 00:00:00+03:00,out,False,901886,True,8,0,200,200
166983,2019-10-16 00:00:00+03:00,out,False,901884,False,21,1923,2169,246
166983,2019-10-16 00:00:00+03:00,out,False,901886,False,18,1594,1860,266
166983,2019-10-16 00:00:00+03:00,in,False,901880,False,20,2293,2385,92
166983,2019-10-16 00:00:00+03:00,in,False,909134,False,1,782,823,41
166983,2019-10-16 00:00:00+03:00,in,False,-1,True,1,0,18,18
166983,2019-10-16 00:00:00+03:00,in,False,901886,False,1,77,98,21
166983,2019-10-16 00:00:00+03:00,out,False,901884,True,12,0,297,297
166983,2019-10-16 00:00:00+03:00,out,False,901880,True,3,0,105,105
166983,2019-10-16 00:00:00+03:00,in,False,901884,False,4,664,718,54
166983,2019-10-16 00:00:00+03:00,out,False,901880,False,20,2104,2356,252
166983,2019-10-16 00:00:00+03:00,out,False,901884,True,12,0,297,297
166983,2019-10-17 00:00:00+03:00,out,False,901880,False,14,1409,1595,186
166983,2019-10-17 00:00:00+03:00,out,False,901884,False,26,2400,2798,398
166983,2019-10-17 00:00:00+03:00,out,False,901880,True,7,0,172,172
166983,2019-10-17 00:00:00+03:00,in,False,901880,False,17,3340,3442,102
166983,2019-10-17 00:00:00+03:00,in,False,901880,True,1,0,2,2
166983,2019-10-17 00:00:00+03:00,in,False,901884,False,7,553,634,81
166983,2019-10-17 00:00:00+03:00,in,False,-1,True,3,0,174,174
166983,2019-10-17 00:00:00+03:00,in,False,909134,False,4,621,726,105
166983,2019-10-17 00:00:00+03:00,out,False,901884,True,12,0,248,248
166983,2019-10-17 00:00:00+03:00,out,False,901884,False,26,2400,2798,398
166983,2019-10-18 00:00:00+03:00,out,False,901884,True,4,0,79,79
166983,2019-10-18 00:00:00+03:00,in,True,901880,False,1,24,29,5
166983,2019-10-18 00:00:00+03:00,in,False,909134,False,1,217,235,18
166983,2019-10-18 00:00:00+03:00,out,False,901880,False,15,3371,3559,188
166983,2019-10-18 00:00:00+03:00,out,True,901884,False,1,71,81,10
166983,2019-10-18 00:00:00+03:00,in,True,901884,False,1,34,52,18
166983,2019-10-18 00:00:00+03:00,in,False,901886,False,3,154,232,78
166983,2019-10-18 00:00:00+03:00,out,False,901886,False,11,784,988,204
166983,2019-10-18 00:00:00+03:00,in,False,901880,False,29,2598,2773,175
166983,2019-10-18 00:00:00+03:00,out,False,901880,True,5,0,220,220
166983,2019-10-18 00:00:00+03:00,out,False,901886,True,6,0,256,256
166983,2019-10-18 00:00:00+03:00,in,False,901884,False,6,1367,1423,56
166983,2019-10-18 00:00:00+03:00,in,False,-1,True,1,0,11,11
166983,2019-10-18 00:00:00+03:00,out,False,901884,False,26,3390,3745,355
166983,2019-10-19 00:00:00+03:00,out,False,901886,True,4,0,128,128
166983,2019-10-19 00:00:00+03:00,out,False,901886,False,4,211,274,63
166983,2019-10-19 00:00:00+03:00,in,False,901886,False,3,217,280,63
166983,2019-10-19 00:00:00+03:00,in,False,909134,False,5,791,940,149
166983,2019-10-19 00:00:00+03:00,out,False,901884,True,7,0,192,192
166983,2019-10-19 00:00:00+03:00,out,False,901884,False,11,1069,1198,129
166983,2019-10-19 00:00:00+03:00,in,False,901884,False,11,1677,1812,135
166983,2019-10-19 00:00:00+03:00,in,False,-1,True,2,0,140,140
166983,2019-10-19 00:00:00+03:00,out,False,901880,False,2,113,133,20
166983,2019-10-19 00:00:00+03:00,in,False,901880,False,12,3282,3361,79
166983,2019-10-19 00:00:00+03:00,in,False,-1,True,2,0,140,140
166983,2019-10-20 00:00:00+03:00,in,False,901884,False,4,425,486,61
166983,2019-10-20 00:00:00+03:00,in,False,-1,True,3,0,102,102
166983,2019-10-20 00:00:00+03:00,out,False,901880,False,5,564,606,42
166983,2019-10-20 00:00:00+03:00,out,False,901880,True,1,0,14,14
166983,2019-10-20 00:00:00+03:00,out,False,901884,True,11,0,210,210
166983,2019-10-20 00:00:00+03:00,in,False,901880,False,19,3120,3212,92
166983,2019-10-20 00:00:00+03:00,in,True,901880,False,1,45,48,3
166983,2019-10-20 00:00:00+03:00,out,False,901884,False,19,3881,4158,277
166983,2019-10-20 00:00:00+03:00,in,False,909134,False,2,146,180,34
166983,2019-10-20 00:00:00+03:00,out,False,901880,True,1,0,14,14
166983,2019-10-20 00:00:00+03:00,in,False,901880,False,19,3120,3212,92
166983,2019-10-21 00:00:00+03:00,out,False,901880,False,10,889,1031,142
166983,2019-10-21 00:00:00+03:00,out,False,901886,False,16,2336,2547,211
166983,2019-10-21 00:00:00+03:00,in,False,901884,False,3,154,182,28
166983,2019-10-21 00:00:00+03:00,in,False,-1,True,5,0,79,79
166983,2019-10-21 00:00:00+03:00,in,False,901886,False,2,170,199,29
166983,2019-10-21 00:00:00+03:00,out,True,901884,False,1,32,44,12
166983,2019-10-21 00:00:00+03:00,out,False,901880,True,7,0,172,172
166983,2019-10-21 00:00:00+03:00,out,False,901886,True,10,0,129,129
166983,2019-10-21 00:00:00+03:00,in,False,909134,False,2,533,600,67
166983,2019-10-21 00:00:00+03:00,out,False,901884,False,30,2959,3323,364
166983,2019-10-21 00:00:00+03:00,in,False,901880,False,30,3852,4008,156
166983,2019-10-21 00:00:00+03:00,out,False,901884,True,10,0,259,259
166983,2019-10-21 00:00:00+03:00,in,False,901886,False,2,170,199,29
166983,2019-10-21 00:00:00+03:00,in,False,909134,False,2,533,600,67
166983,2019-10-22 00:00:00+03:00,out,True,901886,False,1,98,103,5
166983,2019-10-22 00:00:00+03:00,in,False,901884,False,2,58,72,14
166983,2019-10-22 00:00:00+03:00,in,False,901886,False,2,403,457,54
166983,2019-10-22 00:00:00+03:00,out,False,901884,False,13,1320,1525,205
166983,2019-10-22 00:00:00+03:00,in,False,909134,False,1,127,151,24
166983,2019-10-22 00:00:00+03:00,out,False,901880,True,6,0,124,124
166983,2019-10-22 00:00:00+03:00,out,True,901880,True,1,0,0,0
166983,2019-10-22 00:00:00+03:00,in,False,-1,True,3,0,220,220
166983,2019-10-22 00:00:00+03:00,out,False,901886,True,16,0,267,267
166983,2019-10-22 00:00:00+03:00,out,False,901880,False,10,987,1092,105
166983,2019-10-22 00:00:00+03:00,out,False,901886,False,32,3114,3496,382
166983,2019-10-22 00:00:00+03:00,out,False,901884,True,15,0,326,326
166983,2019-10-22 00:00:00+03:00,in,False,901880,False,24,3558,3716,158
166983,2019-10-23 00:00:00+03:00,in,False,909134,False,3,587,656,69
166983,2019-10-23 00:00:00+03:00,in,False,-1,True,5,0,115,115
166983,2019-10-23 00:00:00+03:00,out,True,901884,False,1,13,22,9
166983,2019-10-23 00:00:00+03:00,out,False,901884,False,10,1732,1822,90
166983,2019-10-23 00:00:00+03:00,out,False,901886,True,17,0,504,504
166983,2019-10-23 00:00:00+03:00,out,False,901880,False,14,1201,1373,172
166983,2019-10-23 00:00:00+03:00,out,False,901884,True,2,0,45,45
166983,2019-10-23 00:00:00+03:00,in,False,901884,False,8,1231,1333,102
166983,2019-10-23 00:00:00+03:00,out,False,901886,False,25,2887,3138,251
166983,2019-10-23 00:00:00+03:00,in,False,901880,False,27,4923,5062,139
166983,2019-10-23 00:00:00+03:00,in,False,901884,False,8,1231,1333,102
166983,2019-10-23 00:00:00+03:00,out,False,901886,True,17,0,504,504
166983,2019-10-23 00:00:00+03:00,out,False,901884,True,2,0,45,45
166983,2019-10-24 00:00:00+03:00,out,False,901880,False,29,4504,4946,442
166983,2019-10-24 00:00:00+03:00,out,False,901884,False,21,4036,4336,300
166983,2019-10-24 00:00:00+03:00,in,False,-1,True,11,0,470,470
166983,2019-10-24 00:00:00+03:00,in,False,901884,True,1,1,8,7
166983,2019-10-24 00:00:00+03:00,in,False,901884,False,6,976,1063,87
166983,2019-10-24 00:00:00+03:00,out,True,901880,True,1,0,0,0
166983,2019-10-24 00:00:00+03:00,out,True,901884,True,2,0,96,96
166983,2019-10-24 00:00:00+03:00,in,False,901880,False,33,6967,7150,183
166983,2019-10-24 00:00:00+03:00,in,False,909134,False,12,2156,2694,538
166983,2019-10-24 00:00:00+03:00,out,False,901880,True,6,0,198,198
166983,2019-10-24 00:00:00+03:00,out,False,901884,True,3,0,47,47
166983,2019-10-24 00:00:00+03:00,out,False,901884,True,3,0,47,47
166983,2019-10-25 00:00:00+03:00,in,False,901886,False,4,524,554,30
166983,2019-10-25 00:00:00+03:00,out,True,901884,False,4,378,433,55
166983,2019-10-25 00:00:00+03:00,in,False,-1,True,3,0,116,116
166983,2019-10-25 00:00:00+03:00,in,False,909134,False,3,367,476,109
166983,2019-10-25 00:00:00+03:00,out,False,901880,True,3,0,21,21
166983,2019-10-25 00:00:00+03:00,out,False,901880,False,21,2323,2616,293
166983,2019-10-25 00:00:00+03:00,out,False,901886,True,9,0,116,116
166983,2019-10-25 00:00:00+03:00,out,False,901884,False,13,2138,2295,157
166983,2019-10-25 00:00:00+03:00,out,False,901886,False,24,4292,4576,284
166983,2019-10-25 00:00:00+03:00,out,False,901884,True,1,0,3,3
166983,2019-10-25 00:00:00+03:00,in,False,901884,False,7,4143,4211,68
166983,2019-10-25 00:00:00+03:00,out,True,901884,True,3,0,59,59
166983,2019-10-25 00:00:00+03:00,out,True,901886,False,1,111,118,7
166983,2019-10-25 00:00:00+03:00,in,False,901880,False,20,2891,3006,115
166983,2019-10-25 00:00:00+03:00,out,False,901886,False,24,4292,4576,284
166983,2019-10-26 00:00:00+03:00,out,False,901884,True,1,0,18,18
166983,2019-10-26 00:00:00+03:00,out,False,901880,True,5,0,88,88
166983,2019-10-26 00:00:00+03:00,in,True,901886,False,1,53,75,22
166983,2019-10-26 00:00:00+03:00,out,True,901884,False,6,1265,1338,73
166983,2019-10-26 00:00:00+03:00,out,True,901884,True,1,0,2,2
166983,2019-10-26 00:00:00+03:00,out,False,901886,True,5,0,151,151
166983,2019-10-26 00:00:00+03:00,in,False,901886,False,10,920,1088,168
166983,2019-10-26 00:00:00+03:00,in,False,901884,False,7,1407,1521,114
166983,2019-10-26 00:00:00+03:00,out,False,901886,False,28,4282,4556,274
166983,2019-10-26 00:00:00+03:00,in,False,-1,True,2,0,91,91
166983,2019-10-26 00:00:00+03:00,out,False,901880,False,7,709,799,90
166983,2019-10-26 00:00:00+03:00,in,False,909134,False,8,633,966,333
166983,2019-10-26 00:00:00+03:00,out,False,901884,False,8,1132,1185,53
166983,2019-10-26 00:00:00+03:00,in,False,901880,False,23,4032,4170,138
166983,2019-10-26 00:00:00+03:00,out,True,901880,True,2,0,0,0
166983,2019-10-26 00:00:00+03:00,out,False,901884,True,1,0,18,18
166983,2019-10-27 00:00:00+03:00,in,False,901880,False,25,5035,5171,136
166983,2019-10-27 00:00:00+03:00,out,False,901886,False,15,2689,2912,223
166983,2019-10-27 00:00:00+03:00,out,False,901884,True,14,0,339,339
166983,2019-10-27 00:00:00+03:00,out,False,901880,True,4,0,51,51
166983,2019-10-27 00:00:00+03:00,out,False,901880,False,4,621,664,43
166983,2019-10-27 00:00:00+03:00,in,False,-1,True,2,0,2,2
166983,2019-10-27 00:00:00+03:00,out,False,901884,False,34,2785,3221,436
166983,2019-10-27 00:00:00+03:00,out,False,901886,True,1,0,11,11
166983,2019-10-27 00:00:00+03:00,in,False,901884,False,6,593,635,42
166983,2019-10-27 00:00:00+03:00,out,True,901880,True,1,0,0,0
166983,2019-10-27 00:00:00+03:00,in,False,901886,False,2,426,485,59
166983,2019-10-27 00:00:00+03:00,out,True,901880,False,1,45,55,10
166983,2019-10-27 00:00:00+03:00,out,False,901884,False,34,2785,3221,436
166983,2019-10-27 00:00:00+03:00,out,False,901884,True,14,0,339,339
166983,2019-10-28 00:00:00+03:00,in,False,-1,True,1,0,11,11
166983,2019-10-28 00:00:00+03:00,out,False,901886,False,39,6169,6748,579
166983,2019-10-28 00:00:00+03:00,out,False,901884,False,12,3419,3576,157
166983,2019-10-28 00:00:00+03:00,in,False,901880,False,26,2429,2596,167
166983,2019-10-28 00:00:00+03:00,in,False,901880,True,1,0,4,4
166983,2019-10-28 00:00:00+03:00,out,False,901886,True,20,0,350,350
166983,2019-10-28 00:00:00+03:00,out,False,901880,False,31,3789,4141,352
166983,2019-10-28 00:00:00+03:00,in,False,909134,False,4,814,994,180
166983,2019-10-28 00:00:00+03:00,in,False,901886,False,4,593,707,114
166983,2019-10-28 00:00:00+03:00,out,False,901884,True,3,0,138,138
166983,2019-10-28 00:00:00+03:00,in,False,901884,False,14,3019,3231,212
166983,2019-10-28 00:00:00+03:00,out,False,901880,True,17,0,443,443
166983,2019-10-28 00:00:00+03:00,out,False,909134,True,1,0,5,5
166983,2019-10-28 00:00:00+03:00,out,True,901880,True,1,0,0,0
166983,2019-10-28 00:00:00+03:00,out,True,901884,False,1,330,338,8
166983,2019-10-28 00:00:00+03:00,in,False,901886,False,4,593,707,114
166983,2019-10-29 00:00:00+03:00,out,True,901880,True,1,0,0,0
166983,2019-10-29 00:00:00+03:00,in,False,901880,False,33,4119,4296,177
166983,2019-10-29 00:00:00+03:00,out,False,901886,False,19,4240,4502,262
166983,2019-10-29 00:00:00+03:00,out,False,901884,False,19,2627,2906,279
166983,2019-10-29 00:00:00+03:00,out,True,901884,False,4,336,376,40
166983,2019-10-29 00:00:00+03:00,out,False,901884,True,6,0,103,103
166983,2019-10-29 00:00:00+03:00,out,False,901880,False,18,2150,2462,312
166983,2019-10-29 00:00:00+03:00,in,False,909134,False,3,280,363,83
166983,2019-10-29 00:00:00+03:00,out,False,901880,True,3,0,33,33
166983,2019-10-29 00:00:00+03:00,in,False,901886,False,3,348,412,64
166983,2019-10-29 00:00:00+03:00,out,False,901886,True,21,0,427,427
166983,2019-10-29 00:00:00+03:00,in,False,-1,True,4,0,76,76
166983,2019-10-29 00:00:00+03:00,in,False,901884,False,4,1551,1627,76
166983,2019-10-29 00:00:00+03:00,in,False,901880,False,33,4119,4296,177
166983,2019-10-29 00:00:00+03:00,out,False,901880,True,3,0,33,33
166983,2019-10-30 00:00:00+03:00,out,False,901880,False,30,3709,4101,392
166983,2019-10-30 00:00:00+03:00,out,False,901886,False,15,2540,2738,198
166983,2019-10-30 00:00:00+03:00,in,False,909134,True,1,1,43,42
166983,2019-10-30 00:00:00+03:00,out,False,901884,True,4,0,20,20
166983,2019-10-30 00:00:00+03:00,in,False,-1,True,3,0,56,56
166983,2019-10-30 00:00:00+03:00,out,False,901886,True,8,0,357,357
166983,2019-10-30 00:00:00+03:00,out,False,901880,True,10,0,206,206
166983,2019-10-30 00:00:00+03:00,out,False,901884,False,13,2132,2250,118
166983,2019-10-30 00:00:00+03:00,in,False,901884,False,9,945,1042,97
166983,2019-10-30 00:00:00+03:00,in,False,901886,False,4,290,325,35
166983,2019-10-30 00:00:00+03:00,in,False,901880,False,18,1750,1827,77
166983,2019-10-30 00:00:00+03:00,out,True,901884,False,1,33,64,31
166983,2019-10-30 00:00:00+03:00,in,False,909134,False,7,522,742,220
166983,2019-10-30 00:00:00+03:00,out,False,901886,True,8,0,357,357
166983,2019-10-31 00:00:00+03:00,in,False,-1,True,1,0,21,21
166983,2019-10-31 00:00:00+03:00,in,False,901880,False,19,3013,3110,97
166983,2019-10-31 00:00:00+03:00,in,False,901886,False,3,462,523,61
166983,2019-10-31 00:00:00+03:00,out,False,901886,False,11,1070,1200,130
166983,2019-10-31 00:00:00+03:00,out,False,901884,True,21,0,537,537
166983,2019-10-31 00:00:00+03:00,out,False,901886,True,8,0,287,287
166983,2019-10-31 00:00:00+03:00,out,False,901884,False,21,1614,1865,251
166983,2019-10-31 00:00:00+03:00,out,True,901880,False,1,106,110,4
166983,2019-10-31 00:00:00+03:00,out,False,909134,True,1,0,5,5
166983,2019-10-31 00:00:00+03:00,in,False,909134,False,2,96,167,71
166983,2019-10-31 00:00:00+03:00,in,False,901884,False,6,573,655,82
166983,2019-10-31 00:00:00+03:00,out,False,901880,False,11,1513,1659,146
166983,2019-10-31 00:00:00+03:00,out,False,901886,False,11,1070,1200,130
166983,2019-10-31 00:00:00+03:00,in,False,901880,False,19,3013,3110,97
166983,2019-11-01 00:00:00+03:00,out,False,901886,True,20,0,469,469
166983,2019-11-01 00:00:00+03:00,out,False,901884,False,19,4202,4457,255
166983,2019-11-01 00:00:00+03:00,out,False,901886,False,25,3473,3787,314
166983,2019-11-01 00:00:00+03:00,in,False,901884,False,2,306,330,24
166983,2019-11-01 00:00:00+03:00,out,False,901884,True,2,0,13,13
166983,2019-11-01 00:00:00+03:00,out,True,901886,True,1,0,0,0
166983,2019-11-01 00:00:00+03:00,out,True,901884,False,1,66,77,11
166983,2019-11-01 00:00:00+03:00,in,False,901880,False,24,2967,3088,121
166983,2019-11-01 00:00:00+03:00,in,False,901886,False,3,398,449,51
166983,2019-11-01 00:00:00+03:00,out,False,901880,False,17,2682,2872,190
166983,2019-11-01 00:00:00+03:00,out,False,901880,True,8,0,186,186
166983,2019-11-01 00:00:00+03:00,in,False,901884,False,2,306,330,24
166983,2019-11-02 00:00:00+03:00,in,False,-1,True,7,0,268,268
166983,2019-11-02 00:00:00+03:00,out,False,901886,False,22,2998,3286,288
166983,2019-11-02 00:00:00+03:00,in,False,901884,False,8,900,1052,152
166983,2019-11-02 00:00:00+03:00,out,False,901880,True,8,0,102,102
166983,2019-11-02 00:00:00+03:00,in,False,901886,False,2,1446,1468,22
166983,2019-11-02 00:00:00+03:00,out,False,901880,False,3,100,165,65
166983,2019-11-02 00:00:00+03:00,in,False,901880,False,21,3029,3135,106
166983,2019-11-02 00:00:00+03:00,out,False,901884,False,20,1697,1998,301
166983,2019-11-02 00:00:00+03:00,out,False,901884,True,10,0,273,273
166983,2019-11-02 00:00:00+03:00,out,False,901886,True,8,0,214,214
166983,2019-11-02 00:00:00+03:00,out,False,901880,True,8,0,102,102
166983,2019-11-03 00:00:00+03:00,out,False,901884,False,6,622,707,85
166983,2019-11-03 00:00:00+03:00,in,False,-1,True,5,0,300,300
166983,2019-11-03 00:00:00+03:00,out,False,901884,True,4,0,34,34
166983,2019-11-03 00:00:00+03:00,out,False,901880,False,10,1414,1570,156
166983,2019-11-03 00:00:00+03:00,in,False,901884,False,3,697,744,47
166983,2019-11-03 00:00:00+03:00,out,False,901880,True,8,0,157,157
166983,2019-11-03 00:00:00+03:00,in,False,901880,False,10,2763,2814,51
166983,2019-11-03 00:00:00+03:00,in,False,909134,False,3,215,291,76
166983,2019-11-03 00:00:00+03:00,in,False,-1,True,5,0,300,300
166983,2019-11-03 00:00:00+03:00,out,False,901880,True,8,0,157,157
166983,2019-11-04 00:00:00+03:00,out,False,901880,True,8,0,242,242
166983,2019-11-04 00:00:00+03:00,in,False,901884,False,6,764,864,100
166983,2019-11-04 00:00:00+03:00,out,False,901884,True,1,0,60,60
166983,2019-11-04 00:00:00+03:00,out,False,901880,False,12,1133,1263,130
166983,2019-11-04 00:00:00+03:00,in,False,-1,True,2,0,9,9
166983,2019-11-04 00:00:00+03:00,in,False,901880,False,16,1501,1564,63
166983,2019-11-04 00:00:00+03:00,out,False,901886,True,9,0,358,358
166983,2019-11-04 00:00:00+03:00,out,False,901884,False,1,7,12,5
166983,2019-11-04 00:00:00+03:00,in,False,901886,False,2,129,171,42
166983,2019-11-04 00:00:00+03:00,out,True,901880,True,1,0,0,0
166983,2019-11-04 00:00:00+03:00,out,False,901886,False,7,803,882,79
166983,2019-11-04 00:00:00+03:00,in,False,901884,False,6,764,864,100
166983,2019-11-05 00:00:00+03:00,in,False,901884,False,4,1260,1285,25
166983,2019-11-05 00:00:00+03:00,out,False,901886,False,33,2020,2404,384
166983,2019-11-05 00:00:00+03:00,in,False,901880,False,14,2113,2185,72
166983,2019-11-05 00:00:00+03:00,in,False,909134,False,1,69,111,42
166983,2019-11-05 00:00:00+03:00,in,False,-1,True,1,0,29,29
166983,2019-11-05 00:00:00+03:00,out,False,901886,True,13,0,276,276
166983,2019-11-05 00:00:00+03:00,in,False,901886,False,5,276,372,96
166983,2019-11-05 00:00:00+03:00,out,False,901884,True,2,0,65,65
166983,2019-11-05 00:00:00+03:00,out,False,901880,True,5,0,164,164
166983,2019-11-05 00:00:00+03:00,out,False,901880,False,14,2415,2558,143
166983,2019-11-05 00:00:00+03:00,out,True,901884,False,1,90,103,13
166983,2019-11-05 00:00:00+03:00,out,False,901884,False,13,2647,2764,117
166983,2019-11-05 00:00:00+03:00,out,False,901886,False,33,2020,2404,384
166983,2019-11-06 00:00:00+03:00,in,False,901886,False,3,264,327,63
166983,2019-11-06 00:00:00+03:00,out,False,901884,False,11,560,684,124
166983,2019-11-06 00:00:00+03:00,out,False,901884,True,12,0,291,291
166983,2019-11-06 00:00:00+03:00,out,False,901880,True,2,0,63,63
166983,2019-11-06 00:00:00+03:00,in,False,901880,False,23,2976,3088,112
166983,2019-11-06 00:00:00+03:00,out,False,901880,False,9,820,943,123
166983,2019-11-06 00:00:00+03:00,in,False,901884,False,7,606,691,85
166983,2019-11-06 00:00:00+03:00,out,False,901886,True,2,0,78,78
166983,2019-11-06 00:00:00+03:00,in,False,-1,True,2,0,41,41
166983,2019-11-06 00:00:00+03:00,in,False,909134,False,4,1112,1367,255
166983,2019-11-06 00:00:00+03:00,out,False,901886,False,10,935,1069,134
166983,2019-11-07 00:00:00+03:00,in,False,901884,False,5,745,838,93
166983,2019-11-07 00:00:00+03:00,in,False,-1,True,3,0,13,13
166983,2019-11-07 00:00:00+03:00,out,False,901884,True,5,0,80,80
166983,2019-11-07 00:00:00+03:00,in,False,909134,False,2,198,237,39
166983,2019-11-07 00:00:00+03:00,out,False,901884,False,16,2119,2286,167
166983,2019-11-07 00:00:00+03:00,out,True,901884,False,2,183,216,33
166983,2019-11-07 00:00:00+03:00,in,False,901886,False,4,506,581,75
166983,2019-11-07 00:00:00+03:00,in,False,901880,False,27,2907,3058,151
166983,2019-11-07 00:00:00+03:00,out,False,901886,True,12,0,438,438
166983,2019-11-07 00:00:00+03:00,out,False,901886,False,16,1231,1508,277
166983,2019-11-07 00:00:00+03:00,out,False,901880,False,17,2182,2390,208
166983,2019-11-07 00:00:00+03:00,out,False,901886,True,12,0,438,438
166983,2019-11-08 00:00:00+03:00,out,True,901884,False,1,117,124,7
166983,2019-11-08 00:00:00+03:00,out,False,901884,True,8,0,158,158
166983,2019-11-08 00:00:00+03:00,in,False,901880,False,24,4122,4227,105
166983,2019-11-08 00:00:00+03:00,out,True,901880,True,2,0,0,0
166983,2019-11-08 00:00:00+03:00,out,False,901880,False,29,3513,3928,415
166983,2019-11-08 00:00:00+03:00,out,False,901886,True,13,0,390,390
166983,2019-11-08 00:00:00+03:00,in,False,909134,False,1,89,102,13
166983,2019-11-08 00:00:00+03:00,out,False,901886,False,21,1662,2070,408
166983,2019-11-08 00:00:00+03:00,in,False,-1,True,3,0,138,138
166983,2019-11-08 00:00:00+03:00,out,False,901884,False,25,3055,3341,286
166983,2019-11-08 00:00:00+03:00,in,False,901884,False,4,525,570,45
166983,2019-11-08 00:00:00+03:00,in,False,901886,False,6,344,504,160
166983,2019-11-08 00:00:00+03:00,out,False,901880,True,13,0,484,484
166983,2019-11-08 00:00:00+03:00,out,True,901880,True,2,0,0,0
166983,2019-11-08 00:00:00+03:00,out,False,901886,False,21,1662,2070,408
166983,2019-11-09 00:00:00+03:00,in,False,901886,False,1,153,179,26
166983,2019-11-09 00:00:00+03:00,out,False,901886,True,10,0,237,237
166983,2019-11-09 00:00:00+03:00,in,False,901880,False,25,4834,4951,117
166983,2019-11-09 00:00:00+03:00,out,True,901880,True,2,0,0,0
166983,2019-11-09 00:00:00+03:00,out,False,901886,False,7,597,700,103
166983,2019-11-09 00:00:00+03:00,out,False,901880,False,21,2836,3138,302
166983,2019-11-09 00:00:00+03:00,in,False,-1,True,5,0,227,227
166983,2019-11-09 00:00:00+03:00,in,False,901884,False,4,316,391,75
166983,2019-11-09 00:00:00+03:00,out,False,901880,True,24,0,721,721
166983,2019-11-09 00:00:00+03:00,out,False,901884,False,1,34,59,25
166983,2019-11-09 00:00:00+03:00,in,False,901886,False,1,153,179,26
166983,2019-11-09 00:00:00+03:00,in,False,901880,False,25,4834,4951,117
166983,2019-11-10 00:00:00+03:00,in,False,909134,False,4,740,864,124
166983,2019-11-10 00:00:00+03:00,out,False,901880,False,20,3117,3462,345
166983,2019-11-10 00:00:00+03:00,in,False,901884,False,10,1702,1839,137
166983,2019-11-10 00:00:00+03:00,out,False,901884,False,14,746,949,203
166983,2019-11-10 00:00:00+03:00,out,False,901884,True,18,0,414,414
166983,2019-11-10 00:00:00+03:00,in,False,901880,False,9,2003,2039,36
166983,2019-11-10 00:00:00+03:00,out,True,901880,False,1,103,111,8
166983,2019-11-10 00:00:00+03:00,in,False,-1,True,5,0,112,112
166983,2019-11-10 00:00:00+03:00,out,False,901880,True,4,0,99,99
166983,2019-11-11 00:00:00+03:00,in,False,901884,False,6,1515,1603,88
166983,2019-11-11 00:00:00+03:00,in,False,901886,False,1,39,61,22
166983,2019-11-11 00:00:00+03:00,out,False,901880,False,33,3253,3705,452
166983,2019-11-11 00:00:00+03:00,out,False,901884,False,26,3030,3369,339
166983,2019-11-11 00:00:00+03:00,in,False,-1,True,3,0,260,260
166983,2019-11-11 00:00:00+03:00,out,False,901880,True,9,0,340,340
166983,2019-11-11 00:00:00+03:00,in,False,901880,False,20,2224,2317,93
166983,2019-11-11 00:00:00+03:00,out,False,901884,True,4,0,52,52
166983,2019-11-11 00:00:00+03:00,out,False,901886,False,31,3388,3843,455
166983,2019-11-11 00:00:00+03:00,in,False,909134,False,1,23,63,40
166983,2019-11-11 00:00:00+03:00,out,False,901886,True,9,0,197,197
166983,2019-11-11 00:00:00+03:00,in,False,901884,False,6,1515,1603,88
166983,2019-11-11 00:00:00+03:00,out,False,901880,True,9,0,340,340
166983,2019-11-12 00:00:00+03:00,out,False,901884,True,1,0,4,4
166983,2019-11-12 00:00:00+03:00,in,False,901886,False,3,338,382,44
166983,2019-11-12 00:00:00+03:00,out,True,901884,False,4,571,601,30
166983,2019-11-12 00:00:00+03:00,in,False,901880,False,36,5903,6118,215
166983,2019-11-12 00:00:00+03:00,out,False,901880,True,4,0,126,126
166983,2019-11-12 00:00:00+03:00,out,False,901884,False,14,1759,1944,185
166983,2019-11-12 00:00:00+03:00,out,False,901880,False,20,2461,2825,364
166983,2019-11-12 00:00:00+03:00,in,False,901884,False,9,1339,1417,78
166983,2019-11-12 00:00:00+03:00,in,False,909134,False,6,1334,1676,342
166983,2019-11-12 00:00:00+03:00,in,False,901880,True,1,0,13,13
166983,2019-11-12 00:00:00+03:00,out,False,901886,False,17,1425,1717,292
166983,2019-11-12 00:00:00+03:00,out,False,901886,True,8,0,271,271
166983,2019-11-12 00:00:00+03:00,in,False,-1,True,3,0,130,130
166983,2019-11-12 00:00:00+03:00,out,False,901880,True,4,0,126,126
166983,2019-11-12 00:00:00+03:00,in,False,909134,False,6,1334,1676,342
166983,2019-11-13 00:00:00+03:00,out,False,901884,False,27,3228,3576,348
166983,2019-11-13 00:00:00+03:00,in,False,901880,False,20,4388,4474,86
166983,2019-11-13 00:00:00+03:00,in,False,-1,True,2,0,322,322
166983,2019-11-13 00:00:00+03:00,out,False,901880,False,26,3153,3558,405
166983,2019-11-13 00:00:00+03:00,out,False,901884,True,5,0,215,215
166983,2019-11-13 00:00:00+03:00,out,False,901880,True,7,0,172,172
166983,2019-11-13 00:00:00+03:00,in,False,901884,False,8,3191,3276,85
166983,2019-11-13 00:00:00+03:00,in,False,909134,False,4,336,437,101
166983,2019-11-13 00:00:00+03:00,out,True,901884,False,1,101,112,11
166983,2019-11-13 00:00:00+03:00,out,False,901880,True,7,0,172,172
166983,2019-11-14 00:00:00+03:00,out,False,901886,True,5,0,104,104
166983,2019-11-14 00:00:00+03:00,out,False,901884,True,24,0,350,350
166983,2019-11-14 00:00:00+03:00,out,False,901880,False,21,1302,1604,302
166983,2019-11-14 00:00:00+03:00,in,False,-1,True,5,0,107,107
166983,2019-11-14 00:00:00+03:00,in,False,901880,False,21,2063,2171,108
166983,2019-11-14 00:00:00+03:00,out,True,901884,True,2,0,93,93
166983,2019-11-14 00:00:00+03:00,out,False,901884,False,35,2741,3200,459
166983,2019-11-14 00:00:00+03:00,in,False,901884,False,3,324,380,56
166983,2019-11-14 00:00:00+03:00,in,False,901886,False,2,644,687,43
166983,2019-11-14 00:00:00+03:00,out,False,901880,True,7,0,227,227
166983,2019-11-14 00:00:00+03:00,out,True,901884,False,1,83,90,7
166983,2019-11-14 00:00:00+03:00,out,False,901886,False,19,1706,2122,416
166983,2019-11-14 00:00:00+03:00,in,True,901884,False,1,117,136,19
166983,2019-11-14 00:00:00+03:00,out,False,901886,False,19,1706,2122,416
166983,2019-11-15 00:00:00+03:00,in,False,909134,False,2,175,225,50
166983,2019-11-15 00:00:00+03:00,out,False,901880,True,14,0,442,442
166983,2019-11-15 00:00:00+03:00,out,False,901884,False,23,5005,5290,285
166983,2019-11-15 00:00:00+03:00,in,False,-1,True,7,0,520,520
166983,2019-11-15 00:00:00+03:00,in,False,901880,False,19,3000,3100,100
166983,2019-11-15 00:00:00+03:00,in,False,901884,False,6,593,649,56
166983,2019-11-15 00:00:00+03:00,out,False,901884,True,9,0,101,101
166983,2019-11-15 00:00:00+03:00,out,False,901880,False,23,2194,2506,312
166983,2019-11-15 00:00:00+03:00,out,True,901884,True,1,0,2,2
166983,2019-11-15 00:00:00+03:00,out,False,901880,True,14,0,442,442
166983,2019-11-16 00:00:00+03:00,out,False,901880,False,11,744,892,148
166983,2019-11-16 00:00:00+03:00,in,False,901886,False,4,707,777,70
166983,2019-11-16 00:00:00+03:00,out,False,901884,False,14,2021,2214,193
166983,2019-11-16 00:00:00+03:00,out,False,901880,True,3,0,14,14
166983,2019-11-16 00:00:00+03:00,out,False,901886,True,11,0,242,242
166983,2019-11-16 00:00:00+03:00,out,False,901886,False,17,768,1032,264
166983,2019-11-16 00:00:00+03:00,out,False,901884,True,8,0,201,201
166983,2019-11-16 00:00:00+03:00,in,False,909134,False,7,1361,1622,261
166983,2019-11-16 00:00:00+03:00,in,False,-1,True,3,0,79,79
166983,2019-11-16 00:00:00+03:00,in,False,901884,False,13,1758,1847,89
166983,2019-11-16 00:00:00+03:00,in,False,-1,True,3,0,79,79
166983,2019-11-16 00:00:00+03:00,in,False,901884,False,13,1758,1847,89
166983,2019-11-16 00:00:00+03:00,out,False,901886,True,11,0,242,242
166983,2019-11-17 00:00:00+03:00,out,True,901880,True,1,0,0,0
166983,2019-11-17 00:00:00+03:00,in,False,-1,True,4,0,156,156
166983,2019-11-17 00:00:00+03:00,out,False,901884,True,16,0,232,232
166983,2019-11-17 00:00:00+03:00,out,False,901880,False,7,742,836,94
166983,2019-11-17 00:00:00+03:00,out,False,901880,True,6,0,105,105
166983,2019-11-17 00:00:00+03:00,in,False,901880,False,21,5093,5206,113
166983,2019-11-17 00:00:00+03:00,in,True,901884,False,1,21,30,9
166983,2019-11-17 00:00:00+03:00,out,False,901884,False,24,3042,3438,396
166983,2019-11-17 00:00:00+03:00,in,True,909134,False,1,3,29,26
166983,2019-11-17 00:00:00+03:00,in,False,901884,False,2,136,173,37
166983,2019-11-17 00:00:00+03:00,in,False,909134,False,4,400,576,176
166983,2019-11-17 00:00:00+03:00,in,False,-1,True,1,0,90,90
166983,2019-11-18 00:00:00+03:00,in,False,901880,False,30,5082,5248,166
166983,2019-11-18 00:00:00+03:00,in,False,909134,False,4,440,567,127
166983,2019-11-18 00:00:00+03:00,out,True,901884,False,1,23,30,7
166983,2019-11-18 00:00:00+03:00,in,False,901884,False,12,1472,1602,130
166983,2019-11-18 00:00:00+03:00,out,False,901880,False,20,2389,2630,241
166983,2019-11-18 00:00:00+03:00,in,False,-1,True,5,0,555,555
166983,2019-11-18 00:00:00+03:00,out,False,901884,True,13,0,264,264
166983,2019-11-18 00:00:00+03:00,out,False,901880,True,15,0,314,314
166983,2019-11-18 00:00:00+03:00,in,False,901880,True,1,0,8,8
166983,2019-11-18 00:00:00+03:00,out,True,901880,True,7,0,0,0
166983,2019-11-18 00:00:00+03:00,out,False,901884,False,39,3167,3658,491
166983,2019-11-18 00:00:00+03:00,out,False,901880,True,15,0,314,314
166983,2019-11-18 00:00:00+03:00,in,False,901880,False,30,5082,5248,166
166983,2019-11-19 00:00:00+03:00,in,False,-1,True,5,0,173,173
166983,2019-11-19 00:00:00+03:00,in,False,901884,False,6,1719,1784,65
166983,2019-11-19 00:00:00+03:00,in,False,901886,False,6,308,408,100
166983,2019-11-19 00:00:00+03:00,in,False,909134,False,1,107,149,42
166983,2019-11-19 00:00:00+03:00,out,False,901884,True,5,0,100,100
166983,2019-11-19 00:00:00+03:00,out,False,901886,False,31,1953,2418,465
166983,2019-11-19 00:00:00+03:00,in,False,901880,False,17,2472,2580,108
166983,2019-11-19 00:00:00+03:00,out,False,901880,True,10,0,376,376
166983,2019-11-19 00:00:00+03:00,out,False,901884,False,9,921,1009,88
166983,2019-11-19 00:00:00+03:00,out,False,901880,False,23,6342,6619,277
166983,2019-11-19 00:00:00+03:00,out,False,901886,True,12,0,346,346
166983,2019-11-20 00:00:00+03:00,in,False,901884,False,4,409,470,61
166983,2019-11-20 00:00:00+03:00,out,False,901880,True,11,0,122,122
166983,2019-11-20 00:00:00+03:00,in,False,901886,False,1,47,61,14
166983,2019-11-20 00:00:00+03:00,out,False,901886,False,13,1431,1581,150
166983,2019-11-20 00:00:00+03:00,out,False,901880,False,30,2166,2602,436
166983,2019-11-20 00:00:00+03:00,in,False,901880,False,21,2145,2245,100
166983,2019-11-20 00:00:00+03:00,out,False,901884,False,3,445,466,21
166983,2019-11-20 00:00:00+03:00,in,False,909134,False,1,114,153,39
166983,2019-11-20 00:00:00+03:00,in,False,-1,True,2,0,52,52
166983,2019-11-20 00:00:00+03:00,in,False,909134,False,1,114,153,39
166983,2019-11-21 00:00:00+03:00,in,False,901884,False,7,2144,2196,52
166983,2019-11-21 00:00:00+03:00,in,False,901880,False,21,2543,2655,112
166983,2019-11-21 00:00:00+03:00,out,False,901884,False,16,1717,1939,222
166983,2019-11-21 00:00:00+03:00,out,False,901886,True,10,0,278,278
166983,2019-11-21 00:00:00+03:00,out,True,901884,True,4,0,63,63
166983,2019-11-21 00:00:00+03:00,in,True,901884,False,2,122,146,24
166983,2019-11-21 00:00:00+03:00,out,False,901886,False,30,2512,2904,392
166983,2019-11-21 00:00:00+03:00,out,False,901884,True,5,0,114,114
166983,2019-11-21 00:00:00+03:00,in,True,901880,False,1,36,39,3
166983,2019-11-21 00:00:00+03:00,out,False,901880,False,23,4014,4294,280
166983,2019-11-21 00:00:00+03:00,out,False,901880,True,4,0,73,73
166983,2019-11-21 00:00:00+03:00,in,False,901886,False,2,89,136,47
166983,2019-11-21 00:00:00+03:00,in,False,-1,True,10,0,392,392
166983,2019-11-21 00:00:00+03:00,in,True,901880,False,1,36,39,3
166983,2019-11-22 00:00:00+03:00,out,False,901884,False,6,629,685,56
166983,2019-11-22 00:00:00+03:00,out,False,901880,False,30,3721,4141,420
166983,2019-11-22 00:00:00+03:00,out,False,901884,True,1,0,7,7
166983,2019-11-22 00:00:00+03:00,in,False,901886,False,4,196,240,44
166983,2019-11-22 00:00:00+03:00,in,False,901884,False,6,1853,1928,75
166983,2019-11-22 00:00:00+03:00,in,False,-1,True,9,0,596,596
166983,2019-11-22 00:00:00+03:00,out,False,901886,False,23,1782,2062,280
166983,2019-11-22 00:00:00+03:00,out,True,901880,True,1,0,0,0
166983,2019-11-22 00:00:00+03:00,out,True,901884,False,3,181,209,28
166983,2019-11-22 00:00:00+03:00,out,False,901880,True,7,0,126,126
166983,2019-11-22 00:00:00+03:00,in,False,901880,False,32,4446,4637,191
166983,2019-11-22 00:00:00+03:00,out,False,901886,True,11,0,190,190
166983,2019-11-22 00:00:00+03:00,in,False,909134,False,5,598,771,173
166983,2019-11-22 00:00:00+03:00,out,True,901880,True,1,0,0,0
166983,2019-11-22 00:00:00+03:00,in,False,-1,True,9,0,596,596
166983,2019-11-22 00:00:00+03:00,in,False,901884,False,6,1853,1928,75
166983,2019-11-23 00:00:00+03:00,in,False,-1,True,8,0,511,511
166983,2019-11-23 00:00:00+03:00,in,False,901886,False,2,149,176,27
166983,2019-11-23 00:00:00+03:00,out,False,901880,True,9,0,197,197
166983,2019-11-23 00:00:00+03:00,out,False,901880,False,14,666,901,235
166983,2019-11-23 00:00:00+03:00,out,True,901884,False,1,92,111,19
166983,2019-11-23 00:00:00+03:00,out,False,901886,False,20,1301,1640,339
166983,2019-11-23 00:00:00+03:00,in,False,901880,False,32,2559,2745,186
166983,2019-11-23 00:00:00+03:00,out,False,901884,True,1,0,59,59
166983,2019-11-23 00:00:00+03:00,out,False,901886,True,13,0,419,419
166983,2019-11-23 00:00:00+03:00,out,True,901884,False,1,92,111,19
166983,2019-11-23 00:00:00+03:00,out,False,901886,True,13,0,419,419
166983,2019-11-24 00:00:00+03:00,out,False,901880,False,19,3206,3498,292
166983,2019-11-24 00:00:00+03:00,out,False,901880,True,12,0,326,326
166983,2019-11-24 00:00:00+03:00,in,False,901884,False,4,1125,1178,53
166983,2019-11-24 00:00:00+03:00,in,True,901884,False,1,85,95,10
166983,2019-11-24 00:00:00+03:00,in,False,909134,False,2,349,400,51
166983,2019-11-24 00:00:00+03:00,out,False,901884,False,14,3169,3436,267
166983,2019-11-24 00:00:00+03:00,out,False,901884,True,8,0,249,249
166983,2019-11-24 00:00:00+03:00,in,False,-1,True,6,0,145,145
166983,2019-11-24 00:00:00+03:00,out,True,901880,False,1,53,72,19
166983,2019-11-24 00:00:00+03:00,in,False,901880,False,17,3271,3354,83
166983,2019-11-24 00:00:00+03:00,in,True,901880,False,1,21,25,4
166983,2019-11-24 00:00:00+03:00,out,False,901884,True,8,0,249,249
166983,2019-11-25 00:00:00+03:00,out,False,901880,False,21,3096,3379,283
166983,2019-11-25 00:00:00+03:00,in,False,909134,False,2,258,309,51
166983,2019-11-25 00:00:00+03:00,out,False,901884,True,6,0,104,104
166983,2019-11-25 00:00:00+03:00,in,False,901880,True,1,0,2,2
166983,2019-11-25 00:00:00+03:00,out,True,901884,True,1,0,0,0
166983,2019-11-25 00:00:00+03:00,out,False,901884,False,19,2321,2523,202
166983,2019-11-25 00:00:00+03:00,out,False,901886,False,17,2323,2550,227
166983,2019-11-25 00:00:00+03:00,out,False,901880,True,5,0,126,126
166983,2019-11-25 00:00:00+03:00,in,False,901884,False,7,1931,2007,76
166983,2019-11-25 00:00:00+03:00,out,True,901880,True,1,0,0,0
166983,2019-11-25 00:00:00+03:00,out,False,901886,True,5,0,151,151
166983,2019-11-25 00:00:00+03:00,in,False,901880,False,26,6507,6628,121
166983,2019-11-25 00:00:00+03:00,in,False,-1,True,5,0,292,292
166983,2019-11-25 00:00:00+03:00,in,False,901886,False,6,1060,1159,99
166983,2019-11-26 00:00:00+03:00,out,False,901880,True,12,0,264,264
166983,2019-11-26 00:00:00+03:00,in,True,901880,False,1,11,18,7
166983,2019-11-26 00:00:00+03:00,in,False,909134,False,1,19,37,18
166983,2019-11-26 00:00:00+03:00,in,False,-1,True,2,0,426,426
166983,2019-11-26 00:00:00+03:00,out,True,901884,False,4,475,539,64
166983,2019-11-26 00:00:00+03:00,out,False,901886,True,11,0,362,362
166983,2019-11-26 00:00:00+03:00,out,False,901880,False,16,1791,1992,201
166983,2019-11-26 00:00:00+03:00,out,False,901884,True,9,0,306,306
166983,2019-11-26 00:00:00+03:00,out,False,901886,False,31,3280,3677,397
166983,2019-11-26 00:00:00+03:00,in,False,901880,False,17,3147,3223,76
166983,2019-11-26 00:00:00+03:00,out,True,901884,True,1,0,0,0
166983,2019-11-26 00:00:00+03:00,out,False,901884,False,21,2975,3164,189
166983,2019-11-26 00:00:00+03:00,in,False,901884,False,4,152,216,64
166983,2019-11-26 00:00:00+03:00,out,False,901886,True,11,0,362,362
166983,2019-11-27 00:00:00+03:00,out,False,901884,True,7,0,184,184
166983,2019-11-27 00:00:00+03:00,out,False,901884,False,31,2702,3053,351
166983,2019-11-27 00:00:00+03:00,in,False,901886,False,8,616,765,149
166983,2019-11-27 00:00:00+03:00,out,False,901886,False,6,444,526,82
166983,2019-11-27 00:00:00+03:00,in,True,901884,False,1,66,74,8
166983,2019-11-27 00:00:00+03:00,out,False,901880,True,3,0,115,115
166983,2019-11-27 00:00:00+03:00,out,True,901880,True,2,0,0,0
166983,2019-11-27 00:00:00+03:00,in,False,901884,False,10,2072,2239,167
166983,2019-11-27 00:00:00+03:00,in,False,909134,False,1,65,93,28
166983,2019-11-27 00:00:00+03:00,in,False,901880,False,26,3248,3399,151
166983,2019-11-27 00:00:00+03:00,in,False,-1,True,3,0,105,105
166983,2019-11-27 00:00:00+03:00,out,False,901886,True,3,0,99,99
166983,2019-11-27 00:00:00+03:00,out,False,901880,False,25,1849,2114,265
166983,2019-11-28 00:00:00+03:00,in,False,901884,False,12,2608,2710,102
166983,2019-11-28 00:00:00+03:00,out,False,901884,True,2,0,46,46
166983,2019-11-28 00:00:00+03:00,out,True,901884,False,3,122,155,33
166983,2019-11-28 00:00:00+03:00,out,False,901884,False,5,310,356,46
166983,2019-11-28 00:00:00+03:00,in,False,901886,False,2,114,147,33
166983,2019-11-28 00:00:00+03:00,out,False,901880,True,6,0,186,186
166983,2019-11-28 00:00:00+03:00,in,False,909134,False,3,272,384,112
166983,2019-11-28 00:00:00+03:00,out,True,901880,True,2,0,0,0
166983,2019-11-28 00:00:00+03:00,out,False,901880,False,26,1972,2266,294
166983,2019-11-28 00:00:00+03:00,out,False,901886,False,18,1523,1839,316
166983,2019-11-28 00:00:00+03:00,in,False,901880,False,20,3321,3414,93
166983,2019-11-28 00:00:00+03:00,out,False,901886,True,10,0,259,259
166983,2019-11-28 00:00:00+03:00,in,False,-1,True,1,0,366,366
166985,2019-08-29 00:00:00+03:00,in,False,-1,True,1,0,2,2
166985,2019-09-05 00:00:00+03:00,in,False,904284,False,2,23,60,37
166985,2019-09-13 00:00:00+03:00,in,False,904284,False,1,25,51,26
166985,2019-09-20 00:00:00+03:00,in,False,904284,False,1,2,15,13
166985,2019-09-21 00:00:00+03:00,in,False,904284,False,1,20,42,22
166985,2019-09-25 00:00:00+03:00,in,False,904284,False,1,58,73,15
166985,2019-10-02 00:00:00+03:00,in,False,904284,False,1,33,48,15
166985,2019-10-07 00:00:00+03:00,in,False,904284,False,1,1,25,24
166985,2019-10-11 00:00:00+03:00,in,False,904284,False,1,8,22,14
166985,2019-10-14 00:00:00+03:00,in,False,904284,False,1,1,15,14
166985,2019-10-20 00:00:00+03:00,in,False,-1,True,1,0,11,11
166985,2019-10-21 00:00:00+03:00,in,False,904284,False,1,28,42,14
166985,2019-10-22 00:00:00+03:00,in,False,904284,False,1,2,16,14
166985,2019-10-23 00:00:00+03:00,in,False,904284,False,3,48,80,32
166985,2019-10-25 00:00:00+03:00,in,False,904284,False,1,57,72,15
166985,2019-10-29 00:00:00+03:00,in,False,904284,False,2,37,66,29
166985,2019-10-30 00:00:00+03:00,in,False,904284,False,3,114,162,48
166985,2019-11-01 00:00:00+03:00,in,False,904284,False,1,24,43,19
166985,2019-11-05 00:00:00+03:00,in,False,-1,True,1,0,16,16
166985,2019-11-07 00:00:00+03:00,in,False,904284,False,1,43,72,29
166985,2019-11-07 00:00:00+03:00,in,False,904284,False,1,43,72,29
166985,2019-11-08 00:00:00+03:00,in,False,-1,True,2,0,7,7
166985,2019-11-08 00:00:00+03:00,in,False,904284,False,3,104,143,39
166985,2019-11-12 00:00:00+03:00,in,False,-1,True,1,0,32,32
166985,2019-11-12 00:00:00+03:00,in,False,904284,False,2,53,83,30
166985,2019-11-13 00:00:00+03:00,in,False,904284,False,2,96,122,26
166985,2019-11-15 00:00:00+03:00,in,False,904284,False,1,147,162,15
166985,2019-11-17 00:00:00+03:00,in,False,904284,False,1,84,103,19
166985,2019-11-18 00:00:00+03:00,in,False,904284,False,2,75,103,28
166985,2019-11-20 00:00:00+03:00,in,False,904284,False,1,189,203,14
166985,2019-11-20 00:00:00+03:00,in,False,904284,False,1,189,203,14
166985,2019-11-21 00:00:00+03:00,in,False,904284,False,2,129,172,43
166985,2019-11-25 00:00:00+03:00,in,False,904284,False,2,892,925,33
166985,2019-11-26 00:00:00+03:00,in,False,904284,False,3,143,180,37
166985,2019-11-27 00:00:00+03:00,in,False,904284,False,2,49,74,25
166985,2019-11-27 00:00:00+03:00,in,False,-1,True,1,0,30,30
166985,2019-11-28 00:00:00+03:00,in,False,904284,False,3,296,335,39
166993,2019-09-03 00:00:00+03:00,out,True,901178,True,1,0,4,4
166993,2019-09-03 00:00:00+03:00,out,False,901178,True,2,0,16,16
166993,2019-09-04 00:00:00+03:00,out,False,901178,True,2,0,22,22
166993,2019-09-04 00:00:00+03:00,out,True,901178,True,1,0,16,16
166993,2019-09-05 00:00:00+03:00,out,False,901178,True,2,0,38,38
166993,2019-09-06 00:00:00+03:00,in,False,-1,True,1,0,4,4
166993,2019-09-06 00:00:00+03:00,in,False,901178,False,2,64,81,17
166993,2019-09-07 00:00:00+03:00,in,False,-1,True,3,0,47,47
166993,2019-09-07 00:00:00+03:00,out,False,901178,True,1,0,15,15
166993,2019-09-07 00:00:00+03:00,in,False,901178,False,2,54,64,10
166993,2019-09-07 00:00:00+03:00,out,False,901178,True,1,0,15,15
166993,2019-09-08 00:00:00+03:00,in,False,-1,True,2,0,36,36
166993,2019-09-08 00:00:00+03:00,in,False,901178,False,4,84,108,24
166993,2019-09-08 00:00:00+03:00,in,False,-1,True,2,0,36,36
166993,2019-09-09 00:00:00+03:00,in,True,901178,False,1,13,17,4
166993,2019-09-09 00:00:00+03:00,in,False,-1,True,3,0,8,8
166993,2019-09-09 00:00:00+03:00,in,False,901178,False,2,49,61,12
166993,2019-09-09 00:00:00+03:00,out,False,901178,True,1,0,15,15
166993,2019-09-09 00:00:00+03:00,in,False,-1,True,1,0,12,12
166993,2019-09-10 00:00:00+03:00,in,False,901178,False,3,134,154,20
166993,2019-09-10 00:00:00+03:00,out,False,901178,False,2,28,53,25
166993,2019-09-10 00:00:00+03:00,out,False,901178,True,3,0,62,62
166993,2019-09-10 00:00:00+03:00,out,False,901178,False,2,28,53,25
166993,2019-09-10 00:00:00+03:00,in,False,901178,False,3,134,154,20
166993,2019-09-11 00:00:00+03:00,in,False,-1,True,1,0,10,10
166993,2019-09-12 00:00:00+03:00,in,False,901178,False,7,587,634,47
166993,2019-09-13 00:00:00+03:00,in,False,-1,True,1,0,3,3
166993,2019-09-13 00:00:00+03:00,in,False,901178,False,7,1164,1210,46
166993,2019-09-14 00:00:00+03:00,in,True,901178,False,1,27,34,7
166993,2019-09-14 00:00:00+03:00,in,False,901178,False,19,1734,1893,159
166993,2019-09-14 00:00:00+03:00,out,True,901178,True,1,0,0,0
166993,2019-09-15 00:00:00+03:00,in,False,-1,True,4,0,124,124
166993,2019-09-15 00:00:00+03:00,in,False,901178,False,13,1089,1237,148
166993,2019-09-15 00:00:00+03:00,in,False,-1,True,4,0,124,124
166993,2019-09-16 00:00:00+03:00,in,False,-1,True,3,0,4,4
166993,2019-09-16 00:00:00+03:00,in,False,901178,False,16,894,991,97
166993,2019-09-17 00:00:00+03:00,in,False,901178,False,4,371,437,66
166993,2019-09-17 00:00:00+03:00,in,False,-1,True,2,0,31,31
166993,2019-09-17 00:00:00+03:00,in,True,901178,False,1,62,64,2
166993,2019-09-17 00:00:00+03:00,in,True,901178,False,1,62,64,2
166993,2019-09-18 00:00:00+03:00,in,False,901178,False,5,323,367,44
166993,2019-09-18 00:00:00+03:00,out,False,901178,False,2,62,114,52
166993,2019-09-19 00:00:00+03:00,in,False,901178,False,14,1197,1299,102
166993,2019-09-20 00:00:00+03:00,in,False,-1,True,8,0,96,96
166993,2019-09-20 00:00:00+03:00,out,False,901178,False,3,136,177,41
166993,2019-09-20 00:00:00+03:00,in,False,901178,False,28,1681,1945,264
166993,2019-09-21 00:00:00+03:00,in,False,901178,False,16,1052,1187,135
166993,2019-09-21 00:00:00+03:00,in,False,-1,True,2,0,27,27
166993,2019-09-22 00:00:00+03:00,in,False,901178,False,9,830,917,87
166993,2019-09-22 00:00:00+03:00,in,False,-1,True,2,0,3,3
166993,2019-09-23 00:00:00+03:00,in,False,-1,True,19,0,264,264
166993,2019-09-23 00:00:00+03:00,out,False,901178,True,2,0,13,13
166993,2019-09-23 00:00:00+03:00,in,False,901178,False,36,2348,2725,377
166993,2019-09-24 00:00:00+03:00,in,False,-1,True,9,0,216,216
166993,2019-09-24 00:00:00+03:00,in,False,901178,False,37,2182,2534,352
166993,2019-09-24 00:00:00+03:00,in,False,901178,False,37,2182,2534,352
166993,2019-09-25 00:00:00+03:00,in,True,901178,False,1,166,168,2
166993,2019-09-25 00:00:00+03:00,in,False,901178,False,19,1395,1609,214
166993,2019-09-25 00:00:00+03:00,in,False,-1,True,6,0,109,109
166993,2019-09-26 00:00:00+03:00,in,False,-1,True,1,0,4,4
166993,2019-09-26 00:00:00+03:00,in,False,901178,False,2,97,117,20
166993,2019-09-27 00:00:00+03:00,in,False,901178,False,3,145,172,27
166993,2019-09-27 00:00:00+03:00,in,False,-1,True,1,0,3,3
166993,2019-09-30 00:00:00+03:00,in,False,901178,False,4,310,351,41
166993,2019-10-01 00:00:00+03:00,out,False,901178,True,1,0,25,25
166993,2019-10-01 00:00:00+03:00,in,False,-1,True,1,0,2,2
166993,2019-10-01 00:00:00+03:00,in,False,-1,True,1,0,2,2
166993,2019-10-02 00:00:00+03:00,in,False,901178,False,8,669,720,51
166993,2019-10-02 00:00:00+03:00,in,False,-1,True,2,0,62,62
166993,2019-10-03 00:00:00+03:00,in,False,901178,False,2,114,126,12
166993,2019-10-03 00:00:00+03:00,out,True,901178,True,1,0,0,0
166993,2019-10-03 00:00:00+03:00,out,True,901178,True,1,0,0,0
166993,2019-10-04 00:00:00+03:00,in,False,901178,False,6,921,957,36
166993,2019-10-07 00:00:00+03:00,in,False,901178,False,16,649,789,140
166993,2019-10-07 00:00:00+03:00,in,False,-1,True,5,0,0,0
166997,2019-09-03 00:00:00+03:00,in,False,-1,True,1,0,2,2
166997,2019-09-04 00:00:00+03:00,in,False,-1,True,3,0,57,57
166997,2019-09-04 00:00:00+03:00,in,False,903312,False,5,356,446,90
166997,2019-09-04 00:00:00+03:00,in,False,-1,True,3,0,57,57
166997,2019-09-05 00:00:00+03:00,out,False,903318,False,4,378,413,35
166997,2019-09-05 00:00:00+03:00,in,False,903318,False,1,262,316,54
166997,2019-09-05 00:00:00+03:00,in,False,903312,False,3,196,212,16
166997,2019-09-05 00:00:00+03:00,in,False,903318,False,1,262,316,54
166997,2019-09-06 00:00:00+03:00,out,False,903318,True,2,0,80,80
166997,2019-09-06 00:00:00+03:00,out,False,905432,True,16,0,477,477
166997,2019-09-06 00:00:00+03:00,in,False,903318,False,5,916,987,71
166997,2019-09-06 00:00:00+03:00,out,False,903318,False,9,1470,1587,117
166997,2019-09-06 00:00:00+03:00,out,False,905432,False,23,3859,4158,299
166997,2019-09-06 00:00:00+03:00,in,False,903312,False,2,67,97,30
166997,2019-09-06 00:00:00+03:00,out,True,903318,True,1,0,12,12
166997,2019-09-06 00:00:00+03:00,out,True,903318,False,1,96,100,4
166997,2019-09-06 00:00:00+03:00,out,True,903318,False,1,96,100,4
166997,2019-09-07 00:00:00+03:00,in,False,903318,False,1,81,163,82
166997,2019-09-07 00:00:00+03:00,in,False,903312,False,1,26,74,48
166997,2019-09-09 00:00:00+03:00,out,False,905432,True,22,0,510,510
166997,2019-09-09 00:00:00+03:00,out,True,903318,True,3,0,81,81
166997,2019-09-09 00:00:00+03:00,in,False,903318,False,5,663,698,35
166997,2019-09-09 00:00:00+03:00,out,False,903318,True,18,0,345,345
166997,2019-09-09 00:00:00+03:00,out,False,905432,False,48,4378,5133,755
166997,2019-09-09 00:00:00+03:00,out,True,903318,False,2,144,153,9
166997,2019-09-09 00:00:00+03:00,out,True,905430,True,1,0,14,14
166997,2019-09-09 00:00:00+03:00,in,False,903312,False,1,58,63,5
166997,2019-09-09 00:00:00+03:00,out,False,903318,False,23,3090,3460,370
166997,2019-09-09 00:00:00+03:00,out,False,905432,True,22,0,510,510
166997,2019-09-10 00:00:00+03:00,in,False,903318,False,5,921,957,36
166997,2019-09-10 00:00:00+03:00,out,True,903318,False,3,181,217,36
166997,2019-09-10 00:00:00+03:00,out,False,903312,True,1,0,1,1
166997,2019-09-10 00:00:00+03:00,in,False,-1,True,2,0,549,549
166997,2019-09-10 00:00:00+03:00,out,False,903318,False,6,586,692,106
166997,2019-09-10 00:00:00+03:00,out,False,905432,True,19,0,412,412
166997,2019-09-10 00:00:00+03:00,in,False,905430,False,9,2450,2503,53
166997,2019-09-10 00:00:00+03:00,out,True,903312,False,1,35,48,13
166997,2019-09-10 00:00:00+03:00,out,False,905430,True,14,0,334,334
166997,2019-09-10 00:00:00+03:00,out,False,903318,True,6,0,175,175
166997,2019-09-10 00:00:00+03:00,out,False,905430,False,36,4452,5047,595
166997,2019-09-10 00:00:00+03:00,out,False,905432,False,33,4561,5059,498
166997,2019-09-10 00:00:00+03:00,in,False,903312,False,8,846,898,52
166997,2019-09-10 00:00:00+03:00,in,False,905430,False,9,2450,2503,53
166997,2019-09-10 00:00:00+03:00,out,False,905432,False,33,4561,5059,498
166997,2019-09-11 00:00:00+03:00,out,False,905430,True,5,0,65,65
166997,2019-09-11 00:00:00+03:00,out,False,903318,True,1,0,6,6
166997,2019-09-11 00:00:00+03:00,out,False,905432,True,16,0,491,491
166997,2019-09-11 00:00:00+03:00,out,False,905432,False,25,3226,3622,396
166997,2019-09-11 00:00:00+03:00,out,False,903312,True,3,0,22,22
166997,2019-09-11 00:00:00+03:00,out,False,909502,False,5,806,909,103
166997,2019-09-11 00:00:00+03:00,out,False,909502,True,1,0,9,9
166997,2019-09-11 00:00:00+03:00,out,True,903312,True,1,0,33,33
166997,2019-09-11 00:00:00+03:00,out,False,903318,False,5,1267,1334,67
166997,2019-09-11 00:00:00+03:00,out,True,903318,True,2,0,35,35
166997,2019-09-11 00:00:00+03:00,out,False,-1,True,1,0,1,1
166997,2019-09-11 00:00:00+03:00,in,False,903312,False,4,490,607,117
166997,2019-09-11 00:00:00+03:00,in,False,905430,False,8,866,922,56
166997,2019-09-11 00:00:00+03:00,in,False,903318,False,12,2432,2511,79
166997,2019-09-11 00:00:00+03:00,out,False,903312,False,4,368,437,69
166997,2019-09-11 00:00:00+03:00,out,False,905430,False,6,1246,1343,97
166997,2019-09-11 00:00:00+03:00,in,False,-1,True,7,0,41,41
166997,2019-09-11 00:00:00+03:00,out,False,-1,True,1,0,1,1
166997,2019-09-11 00:00:00+03:00,in,False,903312,False,4,490,607,117
166997,2019-09-12 00:00:00+03:00,out,False,903312,False,5,1014,1078,64
166997,2019-09-12 00:00:00+03:00,out,False,905430,True,12,0,346,346
166997,2019-09-12 00:00:00+03:00,out,False,903312,True,1,0,51,51
166997,2019-09-12 00:00:00+03:00,in,False,903312,False,10,975,1145,170
166997,2019-09-12 00:00:00+03:00,out,False,903318,False,14,3476,3668,192
166997,2019-09-12 00:00:00+03:00,in,False,905430,False,2,498,513,15
166997,2019-09-12 00:00:00+03:00,out,False,909502,False,27,3448,3883,435
166997,2019-09-12 00:00:00+03:00,out,False,909502,True,23,0,662,662
166997,2019-09-12 00:00:00+03:00,in,False,903312,True,1,1,21,20
166997,2019-09-12 00:00:00+03:00,out,False,905432,False,19,2129,2399,270
166997,2019-09-12 00:00:00+03:00,out,False,905430,False,23,3953,4297,344
166997,2019-09-12 00:00:00+03:00,out,False,905432,True,12,0,137,137
166997,2019-09-12 00:00:00+03:00,in,False,-1,True,4,0,185,185
166997,2019-09-12 00:00:00+03:00,in,False,903318,False,6,2303,2364,61
166997,2019-09-12 00:00:00+03:00,in,False,903312,False,10,975,1145,170
166997,2019-09-12 00:00:00+03:00,out,False,905430,True,12,0,346,346
166997,2019-09-12 00:00:00+03:00,in,False,905430,False,2,498,513,15
166997,2019-09-13 00:00:00+03:00,out,False,903318,False,16,6747,7007,260
166997,2019-09-13 00:00:00+03:00,out,False,903312,True,1,0,6,6
166997,2019-09-13 00:00:00+03:00,in,False,903318,False,18,2980,3110,130
166997,2019-09-13 00:00:00+03:00,out,False,905430,True,5,0,207,207
166997,2019-09-13 00:00:00+03:00,out,False,903318,True,5,0,139,139
166997,2019-09-13 00:00:00+03:00,in,False,905430,True,1,0,12,12
166997,2019-09-13 00:00:00+03:00,out,False,909502,True,24,0,463,463
166997,2019-09-13 00:00:00+03:00,in,False,905430,False,4,397,433,36
166997,2019-09-13 00:00:00+03:00,out,True,909502,True,1,0,0,0
166997,2019-09-13 00:00:00+03:00,in,False,-1,True,5,0,137,137
166997,2019-09-13 00:00:00+03:00,out,False,905430,False,11,1594,1754,160
166997,2019-09-13 00:00:00+03:00,out,True,905430,True,1,0,8,8
166997,2019-09-13 00:00:00+03:00,out,False,909502,False,36,3705,4317,612
166997,2019-09-13 00:00:00+03:00,out,True,903318,True,1,0,20,20
166997,2019-09-13 00:00:00+03:00,in,False,903312,False,9,1765,1827,62
166997,2019-09-14 00:00:00+03:00,in,False,-1,True,6,0,134,134
166997,2019-09-14 00:00:00+03:00,out,False,905430,False,39,5853,6627,774
166997,2019-09-14 00:00:00+03:00,out,False,905430,True,18,0,524,524
166997,2019-09-14 00:00:00+03:00,in,False,903318,False,12,2542,2623,81
166997,2019-09-14 00:00:00+03:00,out,False,903318,False,17,3878,4104,226
166997,2019-09-14 00:00:00+03:00,out,False,903318,True,9,0,227,227
166997,2019-09-14 00:00:00+03:00,in,False,905430,False,15,2122,2254,132
166997,2019-09-14 00:00:00+03:00,in,False,903312,False,1,41,46,5
166997,2019-09-15 00:00:00+03:00,in,False,903312,False,1,19,32,13
166997,2019-09-15 00:00:00+03:00,out,False,903318,False,2,258,284,26
166997,2019-09-15 00:00:00+03:00,out,True,903318,True,1,0,22,22
166997,2019-09-15 00:00:00+03:00,in,False,-1,True,1,0,0,0
166997,2019-09-15 00:00:00+03:00,in,False,903318,False,8,928,1005,77
166997,2019-09-15 00:00:00+03:00,in,False,-1,True,1,0,0,0
166997,2019-09-16 00:00:00+03:00,out,False,903318,False,19,4617,4964,347
166997,2019-09-16 00:00:00+03:00,in,False,-1,True,13,0,255,255
166997,2019-09-16 00:00:00+03:00,in,False,903318,False,15,2825,2927,102
166997,2019-09-16 00:00:00+03:00,out,False,905432,True,28,0,675,675
166997,2019-09-16 00:00:00+03:00,out,False,905430,True,22,0,616,616
166997,2019-09-16 00:00:00+03:00,out,False,905430,False,21,2375,2743,368
166997,2019-09-16 00:00:00+03:00,in,False,903312,False,6,601,666,65
166997,2019-09-16 00:00:00+03:00,out,False,903318,True,5,0,191,191
166997,2019-09-16 00:00:00+03:00,in,False,905430,False,3,695,713,18
166997,2019-09-16 00:00:00+03:00,out,False,905432,False,36,2906,3585,679
166997,2019-09-17 00:00:00+03:00,out,False,909502,True,4,0,160,160
166997,2019-09-17 00:00:00+03:00,out,True,903318,True,1,0,5,5
166997,2019-09-17 00:00:00+03:00,out,False,903318,False,22,4193,4516,323
166997,2019-09-17 00:00:00+03:00,out,True,903312,True,1,0,16,16
166997,2019-09-17 00:00:00+03:00,in,False,-1,True,9,0,178,178
166997,2019-09-17 00:00:00+03:00,out,False,909502,False,14,1942,2214,272
166997,2019-09-17 00:00:00+03:00,out,False,905430,True,11,0,412,412
166997,2019-09-17 00:00:00+03:00,in,False,903312,False,5,325,397,72
166997,2019-09-17 00:00:00+03:00,out,False,903312,False,1,414,423,9
166997,2019-09-17 00:00:00+03:00,out,True,903318,False,8,906,953,47
166997,2019-09-17 00:00:00+03:00,out,False,905430,False,23,3732,4108,376
166997,2019-09-17 00:00:00+03:00,in,False,903318,False,12,2355,2469,114
166997,2019-09-17 00:00:00+03:00,out,False,903318,True,11,0,196,196
166997,2019-09-17 00:00:00+03:00,out,False,905430,True,11,0,412,412
166997,2019-09-17 00:00:00+03:00,in,False,-1,True,9,0,178,178
166997,2019-09-18 00:00:00+03:00,in,False,903318,False,4,732,770,38
166997,2019-09-18 00:00:00+03:00,out,True,903318,False,3,55,65,10
166997,2019-09-18 00:00:00+03:00,out,False,905430,True,14,0,394,394
166997,2019-09-18 00:00:00+03:00,in,False,-1,True,1,0,14,14
166997,2019-09-18 00:00:00+03:00,out,False,909502,False,19,1452,1780,328
166997,2019-09-18 00:00:00+03:00,out,False,909502,True,12,0,421,421
166997,2019-09-18 00:00:00+03:00,in,False,903312,False,2,57,85,28
166997,2019-09-18 00:00:00+03:00,out,True,914036,True,1,0,6,6
166997,2019-09-18 00:00:00+03:00,out,False,903318,True,5,0,189,189
166997,2019-09-18 00:00:00+03:00,out,False,903318,False,8,1060,1161,101
166997,2019-09-18 00:00:00+03:00,out,False,905430,False,20,2802,3127,325
166997,2019-09-18 00:00:00+03:00,in,False,905430,False,3,461,477,16
166997,2019-09-19 00:00:00+03:00,out,False,903318,True,10,0,303,303
166997,2019-09-19 00:00:00+03:00,out,False,903312,False,2,302,327,25
166997,2019-09-19 00:00:00+03:00,in,False,903312,False,2,96,117,21
166997,2019-09-19 00:00:00+03:00,in,False,-1,True,4,0,24,24
166997,2019-09-19 00:00:00+03:00,out,True,903318,False,5,786,805,19
166997,2019-09-19 00:00:00+03:00,in,False,903318,False,4,1160,1198,38
166997,2019-09-19 00:00:00+03:00,out,False,914036,True,7,0,196,196
166997,2019-09-19 00:00:00+03:00,out,False,914036,False,10,1125,1275,150
166997,2019-09-19 00:00:00+03:00,out,True,903312,True,1,0,27,27
166997,2019-09-19 00:00:00+03:00,out,False,903318,False,11,1667,1893,226
166997,2019-09-19 00:00:00+03:00,out,True,903312,False,1,26,37,11
166997,2019-09-19 00:00:00+03:00,out,False,914036,True,7,0,196,196
166997,2019-09-19 00:00:00+03:00,out,False,914036,False,10,1125,1275,150
166997,2019-09-20 00:00:00+03:00,out,False,903318,False,27,5291,5724,433
166997,2019-09-20 00:00:00+03:00,in,False,903318,False,8,2161,2214,53
166997,2019-09-20 00:00:00+03:00,out,False,903318,True,18,0,580,580
166997,2019-09-20 00:00:00+03:00,out,False,909502,False,46,4833,5625,792
166997,2019-09-20 00:00:00+03:00,out,False,903312,False,3,278,307,29
166997,2019-09-20 00:00:00+03:00,out,True,903318,False,2,127,137,10
166997,2019-09-20 00:00:00+03:00,in,False,-1,True,4,0,136,136
166997,2019-09-20 00:00:00+03:00,in,False,905430,False,7,549,592,43
166997,2019-09-20 00:00:00+03:00,in,False,903312,False,3,397,434,37
166997,2019-09-20 00:00:00+03:00,out,True,903318,True,1,0,6,6
166997,2019-09-20 00:00:00+03:00,out,False,909502,True,39,0,1054,1054
166997,2019-09-20 00:00:00+03:00,out,False,905430,False,44,3715,4551,836
166997,2019-09-20 00:00:00+03:00,out,False,905430,True,29,0,804,804
166997,2019-09-20 00:00:00+03:00,in,False,905430,False,7,549,592,43
166997,2019-09-21 00:00:00+03:00,out,False,903318,False,13,2895,3065,170
166997,2019-09-21 00:00:00+03:00,in,False,-1,True,11,0,319,319
166997,2019-09-21 00:00:00+03:00,in,False,905430,False,18,2142,2287,145
166997,2019-09-21 00:00:00+03:00,in,False,903318,False,20,3898,4155,257
166997,2019-09-21 00:00:00+03:00,out,True,903318,True,1,0,21,21
166997,2019-09-21 00:00:00+03:00,out,False,903318,True,3,0,74,74
166997,2019-09-21 00:00:00+03:00,out,False,905430,False,48,6610,7351,741
166997,2019-09-21 00:00:00+03:00,out,False,905430,True,37,0,644,644
166997,2019-09-21 00:00:00+03:00,out,False,903312,False,1,254,265,11
166997,2019-09-21 00:00:00+03:00,out,True,903318,False,1,260,264,4
166997,2019-09-21 00:00:00+03:00,in,False,903312,False,4,177,303,126
166997,2019-09-21 00:00:00+03:00,out,True,903318,False,1,260,264,4
166997,2019-09-22 00:00:00+03:00,in,False,903312,False,2,194,233,39
166997,2019-09-22 00:00:00+03:00,out,False,903318,True,2,0,72,72
166997,2019-09-22 00:00:00+03:00,out,False,909502,False,18,2988,3288,300
166997,2019-09-22 00:00:00+03:00,out,False,903318,False,13,2739,2897,158
166997,2019-09-22 00:00:00+03:00,in,False,-1,True,8,0,460,460
166997,2019-09-22 00:00:00+03:00,in,False,903318,False,10,2654,2737,83
166997,2019-09-22 00:00:00+03:00,out,False,909502,True,12,0,337,337
166997,2019-09-23 00:00:00+03:00,out,False,909502,False,32,3312,3764,452
166997,2019-09-23 00:00:00+03:00,out,False,905430,False,26,4228,4624,396
166997,2019-09-23 00:00:00+03:00,in,False,903318,False,6,804,847,43
166997,2019-09-23 00:00:00+03:00,in,False,905430,False,1,105,110,5
166997,2019-09-23 00:00:00+03:00,out,False,903312,True,4,0,170,170
166997,2019-09-23 00:00:00+03:00,out,False,909502,True,12,0,262,262
166997,2019-09-23 00:00:00+03:00,out,False,903318,False,25,2801,3153,352
166997,2019-09-23 00:00:00+03:00,in,False,-1,True,1,0,68,68
166997,2019-09-23 00:00:00+03:00,out,False,905430,True,7,0,188,188
166997,2019-09-23 00:00:00+03:00,out,False,903318,True,7,0,195,195
166997,2019-09-23 00:00:00+03:00,out,False,903312,False,5,282,370,88
166997,2019-09-23 00:00:00+03:00,in,False,903312,False,4,409,460,51
166997,2019-09-24 00:00:00+03:00,in,False,905430,False,5,939,962,23
166997,2019-09-24 00:00:00+03:00,out,True,903318,False,2,250,256,6
166997,2019-09-24 00:00:00+03:00,out,False,903318,False,32,7112,7544,432
166997,2019-09-24 00:00:00+03:00,out,False,905430,True,3,0,53,53
166997,2019-09-24 00:00:00+03:00,out,False,909502,True,22,0,667,667
166997,2019-09-24 00:00:00+03:00,out,False,909502,False,54,4688,5407,719
166997,2019-09-24 00:00:00+03:00,in,False,-1,True,4,0,227,227
166997,2019-09-24 00:00:00+03:00,out,False,903318,True,7,0,200,200
166997,2019-09-24 00:00:00+03:00,in,False,903318,False,10,1600,1663,63
166997,2019-09-24 00:00:00+03:00,out,False,905430,False,20,2924,3276,352
166997,2019-09-24 00:00:00+03:00,in,False,903312,False,3,373,629,256
166997,2019-09-24 00:00:00+03:00,in,False,903318,False,10,1600,1663,63
166997,2019-09-25 00:00:00+03:00,out,False,905430,False,19,3090,3407,317
166997,2019-09-25 00:00:00+03:00,out,False,903318,True,4,0,79,79
166997,2019-09-25 00:00:00+03:00,in,False,905430,False,5,510,536,26
166997,2019-09-25 00:00:00+03:00,out,False,905430,True,7,0,181,181
166997,2019-09-25 00:00:00+03:00,out,False,909502,True,19,0,558,558
166997,2019-09-25 00:00:00+03:00,in,False,903318,False,6,455,495,40
166997,2019-09-25 00:00:00+03:00,out,True,903318,False,1,100,110,10
166997,2019-09-25 00:00:00+03:00,out,False,909502,False,31,2498,3057,559
166997,2019-09-25 00:00:00+03:00,out,False,903318,False,15,2360,2604,244
166997,2019-09-25 00:00:00+03:00,in,False,-1,True,14,0,436,436
166997,2019-09-26 00:00:00+03:00,in,False,903312,False,9,887,1052,165
166997,2019-09-26 00:00:00+03:00,out,True,903318,False,1,25,27,2
166997,2019-09-26 00:00:00+03:00,in,False,903318,False,7,609,663,54
166997,2019-09-26 00:00:00+03:00,in,False,903312,True,1,0,15,15
166997,2019-09-26 00:00:00+03:00,out,False,903318,False,14,2488,2694,206
166997,2019-09-26 00:00:00+03:00,out,False,903318,True,5,0,111,111
166997,2019-09-26 00:00:00+03:00,in,False,-1,True,3,0,53,53
166997,2019-09-26 00:00:00+03:00,in,False,905430,False,3,608,625,17
166997,2019-09-26 00:00:00+03:00,out,False,905430,False,48,5492,6320,828
166997,2019-09-26 00:00:00+03:00,out,False,905430,True,22,0,681,681
166997,2019-09-26 00:00:00+03:00,in,False,903318,False,7,609,663,54
166997,2019-09-27 00:00:00+03:00,in,False,905430,False,8,1021,1073,52
166997,2019-09-27 00:00:00+03:00,out,False,905430,True,15,0,344,344
166997,2019-09-27 00:00:00+03:00,out,True,903318,True,3,0,55,55
166997,2019-09-27 00:00:00+03:00,in,False,-1,True,8,0,565,565
166997,2019-09-27 00:00:00+03:00,in,False,903312,False,1,59,111,52
166997,2019-09-27 00:00:00+03:00,out,False,909502,False,29,4780,5317,537
166997,2019-09-27 00:00:00+03:00,out,False,903318,True,3,0,91,91
166997,2019-09-27 00:00:00+03:00,out,False,903318,False,17,3989,4257,268
166997,2019-09-27 00:00:00+03:00,out,False,905430,False,37,4156,4718,562
166997,2019-09-27 00:00:00+03:00,in,False,903318,False,9,1333,1386,53
166997,2019-09-27 00:00:00+03:00,out,False,909502,True,7,0,176,176
166997,2019-09-27 00:00:00+03:00,out,False,909502,True,7,0,176,176
166997,2019-09-27 00:00:00+03:00,in,False,903318,False,9,1333,1386,53
166997,2019-09-28 00:00:00+03:00,out,True,903318,True,1,0,29,29
166997,2019-09-28 00:00:00+03:00,out,False,905430,False,61,3779,4912,1133
166997,2019-09-28 00:00:00+03:00,in,False,905430,False,4,242,259,17
166997,2019-09-28 00:00:00+03:00,out,False,903318,True,7,0,200,200
166997,2019-09-28 00:00:00+03:00,in,False,-1,True,6,0,195,195
166997,2019-09-28 00:00:00+03:00,out,False,909502,False,31,2789,3314,525
166997,2019-09-28 00:00:00+03:00,out,False,905430,True,46,0,1210,1210
166997,2019-09-28 00:00:00+03:00,in,False,903318,False,17,2397,2531,134
166997,2019-09-28 00:00:00+03:00,out,False,909502,True,19,0,603,603
166997,2019-09-28 00:00:00+03:00,out,False,903318,False,9,370,526,156
166997,2019-09-28 00:00:00+03:00,out,False,909502,True,19,0,603,603
166997,2019-09-28 00:00:00+03:00,out,False,905430,False,61,3779,4912,1133
166997,2019-09-29 00:00:00+03:00,out,False,903312,True,1,0,20,20
166997,2019-09-29 00:00:00+03:00,out,False,903318,False,25,3265,3646,381
166997,2019-09-29 00:00:00+03:00,out,False,903318,True,6,0,111,111
166997,2019-09-29 00:00:00+03:00,in,False,-1,True,2,0,18,18
166997,2019-09-29 00:00:00+03:00,in,False,903318,True,1,1,6,5
166997,2019-09-29 00:00:00+03:00,in,False,903318,False,3,330,341,11
166997,2019-09-30 00:00:00+03:00,out,False,903312,False,7,949,1099,150
166997,2019-09-30 00:00:00+03:00,in,False,-1,True,3,0,124,124
166997,2019-09-30 00:00:00+03:00,out,False,903318,False,31,5385,5894,509
166997,2019-09-30 00:00:00+03:00,out,False,903318,True,10,0,215,215
166997,2019-09-30 00:00:00+03:00,in,False,903312,False,1,210,227,17
166997,2019-09-30 00:00:00+03:00,in,False,903318,False,4,895,921,26
166997,2019-09-30 00:00:00+03:00,out,False,909502,True,1,0,9,9
166997,2019-10-01 00:00:00+03:00,out,False,905432,True,25,0,591,591
166997,2019-10-01 00:00:00+03:00,out,False,905432,False,19,2666,3038,372
166997,2019-10-01 00:00:00+03:00,in,False,903318,False,7,1056,1102,46
166997,2019-10-01 00:00:00+03:00,in,False,-1,True,3,0,119,119
166997,2019-10-01 00:00:00+03:00,out,False,903318,False,3,563,621,58
166997,2019-10-01 00:00:00+03:00,out,False,903318,True,2,0,45,45
166997,2019-10-01 00:00:00+03:00,in,False,905432,False,3,358,378,20
166997,2019-10-01 00:00:00+03:00,out,False,905432,False,19,2666,3038,372
166997,2019-10-02 00:00:00+03:00,out,False,903318,True,4,0,185,185
166997,2019-10-02 00:00:00+03:00,in,False,903318,False,5,2123,2165,42
166997,2019-10-02 00:00:00+03:00,out,False,905432,True,10,0,329,329
166997,2019-10-02 00:00:00+03:00,in,False,905432,False,1,648,652,4
166997,2019-10-02 00:00:00+03:00,out,False,909502,False,37,2936,3517,581
166997,2019-10-02 00:00:00+03:00,out,False,905432,False,20,4357,4666,309
166997,2019-10-02 00:00:00+03:00,out,False,903318,False,4,743,807,64
166997,2019-10-02 00:00:00+03:00,out,False,909502,True,31,0,618,618
166997,2019-10-02 00:00:00+03:00,out,False,905432,True,10,0,329,329
166997,2019-10-03 00:00:00+03:00,out,False,905432,True,48,0,1138,1138
166997,2019-10-03 00:00:00+03:00,out,False,903318,False,35,3942,4432,490
166997,2019-10-03 00:00:00+03:00,in,False,903318,False,4,322,360,38
166997,2019-10-03 00:00:00+03:00,in,False,905432,False,3,812,827,15
166997,2019-10-03 00:00:00+03:00,out,False,905432,False,67,5204,6258,1054
166997,2019-10-03 00:00:00+03:00,out,False,903318,True,18,0,496,496
166997,2019-10-03 00:00:00+03:00,out,False,903318,True,18,0,496,496
166997,2019-10-03 00:00:00+03:00,out,False,905432,True,48,0,1138,1138
166997,2019-10-03 00:00:00+03:00,out,False,903318,False,35,3942,4432,490
166997,2019-10-04 00:00:00+03:00,in,False,903318,False,2,457,469,12
166997,2019-10-04 00:00:00+03:00,out,False,905432,True,31,0,779,779
166997,2019-10-04 00:00:00+03:00,out,False,903318,True,10,0,329,329
166997,2019-10-04 00:00:00+03:00,in,False,-1,True,1,0,29,29
166997,2019-10-04 00:00:00+03:00,out,False,905432,False,70,6058,7205,1147
166997,2019-10-04 00:00:00+03:00,in,False,903312,False,1,119,179,60
166997,2019-10-04 00:00:00+03:00,out,False,903318,False,22,2432,2798,366
166997,2019-10-04 00:00:00+03:00,out,False,905432,True,31,0,779,779
166997,2019-10-04 00:00:00+03:00,out,False,905432,False,70,6058,7205,1147
166997,2019-10-05 00:00:00+03:00,out,False,903312,False,1,178,215,37
166997,2019-10-05 00:00:00+03:00,out,False,903318,False,1,181,199,18
166997,2019-10-05 00:00:00+03:00,out,False,903318,True,1,0,29,29
166997,2019-10-05 00:00:00+03:00,in,False,903318,False,4,455,520,65
166997,2019-10-05 00:00:00+03:00,in,False,-1,True,2,0,102,102
166997,2019-10-05 00:00:00+03:00,out,False,903312,True,1,0,24,24
166997,2019-10-05 00:00:00+03:00,in,False,903312,False,4,164,223,59
166997,2019-10-06 00:00:00+03:00,in,False,-1,True,2,0,118,118
166997,2019-10-06 00:00:00+03:00,out,False,903318,False,21,4272,4568,296
166997,2019-10-06 00:00:00+03:00,in,False,903312,False,1,39,55,16
166997,2019-10-06 00:00:00+03:00,out,False,903318,True,8,0,196,196
166997,2019-10-06 00:00:00+03:00,in,False,903318,False,4,200,235,35
166997,2019-10-06 00:00:00+03:00,out,True,903318,True,1,0,0,0
166997,2019-10-07 00:00:00+03:00,out,False,903312,True,1,0,21,21
166997,2019-10-07 00:00:00+03:00,in,False,903318,True,1,113,123,10
166997,2019-10-07 00:00:00+03:00,in,False,-1,True,2,0,48,48
166997,2019-10-07 00:00:00+03:00,out,False,903318,True,15,0,364,364
166997,2019-10-07 00:00:00+03:00,in,False,903318,False,4,889,911,22
166997,2019-10-07 00:00:00+03:00,in,False,903312,False,2,57,116,59
166997,2019-10-07 00:00:00+03:00,out,False,903318,False,24,3843,4167,324
166997,2019-10-07 00:00:00+03:00,out,False,903312,False,3,401,440,39
166997,2019-10-07 00:00:00+03:00,out,True,903318,False,1,16,22,6
166997,2019-10-08 00:00:00+03:00,out,False,903318,False,4,1535,1590,55
166997,2019-10-08 00:00:00+03:00,in,False,-1,True,3,0,195,195
166997,2019-10-08 00:00:00+03:00,in,False,903318,False,1,168,175,7
166997,2019-10-08 00:00:00+03:00,out,False,903318,True,2,0,8,8
166997,2019-10-08 00:00:00+03:00,out,False,903318,True,2,0,8,8
166997,2019-10-09 00:00:00+03:00,in,False,903318,False,2,274,291,17
166997,2019-10-09 00:00:00+03:00,out,False,903318,False,34,4292,4786,494
166997,2019-10-09 00:00:00+03:00,out,False,909502,False,42,3695,4394,699
166997,2019-10-09 00:00:00+03:00,out,False,903318,True,14,0,398,398
166997,2019-10-09 00:00:00+03:00,in,False,903318,True,1,57,61,4
166997,2019-10-09 00:00:00+03:00,out,False,909502,True,27,0,676,676
166997,2019-10-09 00:00:00+03:00,in,False,-1,True,6,0,124,124
166997,2019-10-09 00:00:00+03:00,in,False,903312,False,1,2,3,1
166997,2019-10-09 00:00:00+03:00,out,False,903318,False,34,4292,4786,494
166997,2019-10-09 00:00:00+03:00,out,False,909502,False,42,3695,4394,699
166997,2019-10-10 00:00:00+03:00,out,False,909502,True,14,0,455,455
166997,2019-10-10 00:00:00+03:00,out,False,909502,False,25,2263,2676,413
166997,2019-10-10 00:00:00+03:00,in,False,-1,True,6,0,191,191
166997,2019-10-10 00:00:00+03:00,out,False,903318,False,9,2991,3144,153
166997,2019-10-10 00:00:00+03:00,out,False,903318,True,9,0,300,300
166997,2019-10-10 00:00:00+03:00,out,False,903312,False,1,23,37,14
166997,2019-10-10 00:00:00+03:00,in,False,903312,False,1,69,82,13
166997,2019-10-10 00:00:00+03:00,in,False,903318,False,4,882,907,25
166997,2019-10-10 00:00:00+03:00,out,False,903318,False,9,2991,3144,153
166997,2019-10-10 00:00:00+03:00,out,False,903318,True,9,0,300,300
166997,2019-10-11 00:00:00+03:00,out,False,909502,True,11,0,291,291
166997,2019-10-11 00:00:00+03:00,in,False,903318,False,3,97,117,20
166997,2019-10-11 00:00:00+03:00,out,False,909502,False,20,1328,1677,349
166997,2019-10-11 00:00:00+03:00,out,False,903318,False,22,2537,2895,358
166997,2019-10-11 00:00:00+03:00,in,False,903312,False,2,835,863,28
166997,2019-10-11 00:00:00+03:00,out,False,903318,True,14,0,366,366
166997,2019-10-11 00:00:00+03:00,out,False,909502,True,11,0,291,291
166997,2019-10-11 00:00:00+03:00,out,False,903318,False,22,2537,2895,358
166997,2019-10-12 00:00:00+03:00,out,False,903318,True,4,0,141,141
166997,2019-10-12 00:00:00+03:00,out,False,903318,False,3,539,582,43
166997,2019-10-12 00:00:00+03:00,in,False,903318,False,1,83,97,14
166997,2019-10-13 00:00:00+03:00,out,False,903318,False,1,109,122,13
166997,2019-10-13 00:00:00+03:00,out,False,903318,True,2,0,66,66
166997,2019-10-13 00:00:00+03:00,in,False,903318,False,1,193,198,5
166997,2019-10-14 00:00:00+03:00,in,False,-1,True,1,0,10,10
166997,2019-10-14 00:00:00+03:00,out,False,903318,False,10,2971,3164,193
166997,2019-10-14 00:00:00+03:00,out,False,903318,True,9,0,278,278
166997,2019-10-14 00:00:00+03:00,out,False,903318,True,9,0,278,278
166997,2019-10-15 00:00:00+03:00,out,True,903318,False,4,212,251,39
166997,2019-10-15 00:00:00+03:00,in,False,903318,False,3,436,487,51
166997,2019-10-15 00:00:00+03:00,in,False,-1,True,2,0,13,13
166997,2019-10-15 00:00:00+03:00,in,False,903312,False,2,342,409,67
166997,2019-10-15 00:00:00+03:00,out,False,903318,True,9,0,381,381
166997,2019-10-15 00:00:00+03:00,out,False,903318,False,18,3529,3776,247
166997,2019-10-15 00:00:00+03:00,in,False,903318,False,3,436,487,51
166997,2019-10-16 00:00:00+03:00,out,False,903318,True,6,0,169,169
166997,2019-10-16 00:00:00+03:00,out,False,903318,False,20,1512,1889,377
166997,2019-10-16 00:00:00+03:00,in,False,903318,False,3,1079,1117,38
166997,2019-10-16 00:00:00+03:00,out,True,903318,False,1,38,58,20
166997,2019-10-17 00:00:00+03:00,out,False,903318,True,3,0,25,25
166997,2019-10-17 00:00:00+03:00,in,False,903318,False,1,27,34,7
166997,2019-10-17 00:00:00+03:00,out,False,903318,False,1,279,288,9
166997,2019-10-17 00:00:00+03:00,in,False,903312,False,1,92,112,20
166997,2019-10-18 00:00:00+03:00,in,False,903318,False,3,505,516,11
166997,2019-10-18 00:00:00+03:00,out,False,903318,False,35,8127,8690,563
166997,2019-10-18 00:00:00+03:00,out,False,903318,True,19,0,659,659
166997,2019-10-18 00:00:00+03:00,in,False,-1,True,3,0,73,73
166997,2019-10-19 00:00:00+03:00,in,False,903318,False,1,59,70,11
166997,2019-10-19 00:00:00+03:00,in,False,-1,True,1,0,3,3
166997,2019-10-19 00:00:00+03:00,out,False,903318,True,1,0,10,10
166997,2019-10-19 00:00:00+03:00,out,False,903318,False,1,1967,1988,21
166997,2019-10-20 00:00:00+03:00,in,False,903318,False,1,112,156,44
166997,2019-10-20 00:00:00+03:00,out,False,903318,False,5,1142,1198,56
166997,2019-10-20 00:00:00+03:00,in,False,903312,False,1,106,127,21
166997,2019-10-20 00:00:00+03:00,in,False,903312,False,1,106,127,21
166997,2019-10-21 00:00:00+03:00,out,False,903318,True,2,0,59,59
166997,2019-10-21 00:00:00+03:00,out,False,903318,False,9,612,749,137
166997,2019-10-21 00:00:00+03:00,in,False,903318,False,2,162,181,19
166997,2019-10-22 00:00:00+03:00,in,False,903318,False,1,423,440,17
166997,2019-10-22 00:00:00+03:00,in,False,-1,True,3,0,107,107
166997,2019-10-22 00:00:00+03:00,out,False,903318,True,18,0,550,550
166997,2019-10-22 00:00:00+03:00,out,False,903318,False,34,9819,10338,519
166997,2019-10-22 00:00:00+03:00,in,False,903312,False,1,188,193,5
166997,2019-10-23 00:00:00+03:00,in,False,-1,True,3,0,180,180
166997,2019-10-23 00:00:00+03:00,in,False,903318,False,2,129,145,16
166997,2019-10-23 00:00:00+03:00,out,False,903318,True,16,0,523,523
166997,2019-10-23 00:00:00+03:00,out,False,903318,False,14,1549,1752,203
166997,2019-10-23 00:00:00+03:00,in,False,903312,False,1,36,96,60
166997,2019-10-24 00:00:00+03:00,out,False,903318,False,3,606,697,91
166997,2019-10-24 00:00:00+03:00,in,False,903318,False,1,102,110,8
166997,2019-10-25 00:00:00+03:00,in,False,903312,False,1,153,158,5
166997,2019-10-25 00:00:00+03:00,in,False,903312,False,1,153,158,5
166997,2019-10-27 00:00:00+03:00,in,False,903312,False,3,160,186,26
166997,2019-10-28 00:00:00+03:00,in,False,903312,False,2,57,120,63
166997,2019-10-28 00:00:00+03:00,out,False,903318,False,10,2377,2562,185
166997,2019-10-28 00:00:00+03:00,in,False,903318,False,1,19,23,4
166997,2019-10-28 00:00:00+03:00,out,False,903318,True,3,0,108,108
166997,2019-10-30 00:00:00+03:00,in,False,903312,False,1,609,614,5
166997,2019-10-31 00:00:00+03:00,out,False,903318,True,6,0,133,133
166997,2019-10-31 00:00:00+03:00,out,False,903318,False,14,1824,2054,230
166997,2019-10-31 00:00:00+03:00,in,False,903318,False,3,939,954,15
166997,2019-10-31 00:00:00+03:00,in,False,903312,False,1,130,140,10
166997,2019-10-31 00:00:00+03:00,in,False,-1,True,1,0,45,45
166997,2019-10-31 00:00:00+03:00,in,False,-1,True,1,0,45,45
166997,2019-10-31 00:00:00+03:00,out,False,903318,False,14,1824,2054,230
166997,2019-10-31 00:00:00+03:00,in,False,903318,False,3,939,954,15
166997,2019-11-01 00:00:00+03:00,out,False,903318,False,6,357,478,121
166997,2019-11-01 00:00:00+03:00,in,False,-1,True,1,0,93,93
166997,2019-11-01 00:00:00+03:00,in,False,903318,False,1,314,358,44
166997,2019-11-01 00:00:00+03:00,out,False,903318,True,3,0,71,71
166997,2019-11-02 00:00:00+03:00,out,False,905432,True,24,0,582,582
166997,2019-11-02 00:00:00+03:00,in,False,905432,False,2,135,147,12
166997,2019-11-02 00:00:00+03:00,out,False,903318,False,7,562,730,168
166997,2019-11-02 00:00:00+03:00,in,False,-1,True,1,0,20,20
166997,2019-11-02 00:00:00+03:00,out,False,909502,False,23,1145,1554,409
166997,2019-11-02 00:00:00+03:00,out,False,909502,True,18,0,490,490
166997,2019-11-02 00:00:00+03:00,out,False,905432,False,38,2261,2917,656
166997,2019-11-02 00:00:00+03:00,in,False,903312,False,1,7,18,11
166997,2019-11-03 00:00:00+03:00,out,False,905432,True,39,0,977,977
166997,2019-11-03 00:00:00+03:00,in,False,905432,False,2,33,41,8
166997,2019-11-03 00:00:00+03:00,in,False,903318,False,3,398,425,27
166997,2019-11-03 00:00:00+03:00,out,False,903318,False,3,339,380,41
166997,2019-11-03 00:00:00+03:00,in,False,903312,False,2,153,161,8
166997,2019-11-03 00:00:00+03:00,out,False,905432,False,38,1392,2003,611
166997,2019-11-04 00:00:00+03:00,in,False,-1,True,2,0,93,93
166997,2019-11-04 00:00:00+03:00,out,False,903318,False,3,93,120,27
166997,2019-11-05 00:00:00+03:00,out,False,903312,True,1,0,15,15
166997,2019-11-05 00:00:00+03:00,in,False,903318,False,1,21,62,41
166997,2019-11-05 00:00:00+03:00,out,False,903318,False,2,84,90,6
166997,2019-11-05 00:00:00+03:00,in,False,903312,False,1,100,107,7
166997,2019-11-05 00:00:00+03:00,in,False,-1,True,2,0,73,73
166997,2019-11-05 00:00:00+03:00,out,False,903312,False,1,30,44,14
166997,2019-11-06 00:00:00+03:00,out,False,903318,False,1,4,9,5
166997,2019-11-06 00:00:00+03:00,in,False,903312,False,1,17,28,11
166997,2019-11-06 00:00:00+03:00,out,False,903318,True,3,0,77,77
166997,2019-11-06 00:00:00+03:00,in,False,903312,False,1,17,28,11
166997,2019-11-07 00:00:00+03:00,out,False,903318,True,3,0,52,52
166997,2019-11-07 00:00:00+03:00,in,False,-1,True,1,0,51,51
166997,2019-11-07 00:00:00+03:00,out,False,903318,False,7,651,804,153
166997,2019-11-08 00:00:00+03:00,out,False,903318,False,5,1205,1303,98
166997,2019-11-09 00:00:00+03:00,in,False,-1,True,1,0,39,39
166997,2019-11-10 00:00:00+03:00,in,False,-1,True,1,0,35,35
166997,2019-11-10 00:00:00+03:00,in,False,-1,True,1,0,35,35
166997,2019-11-11 00:00:00+03:00,out,False,903318,False,2,355,374,19
166997,2019-11-15 00:00:00+03:00,in,False,903318,False,1,100,138,38
166997,2019-11-16 00:00:00+03:00,in,False,903312,False,1,48,73,25
166997,2019-11-18 00:00:00+03:00,out,False,903318,False,6,503,595,92
166997,2019-11-18 00:00:00+03:00,in,False,903312,False,2,113,142,29
166997,2019-11-18 00:00:00+03:00,out,False,903318,True,1,0,55,55
166997,2019-11-18 00:00:00+03:00,in,False,903312,False,2,113,142,29
166997,2019-11-19 00:00:00+03:00,out,False,903318,True,1,0,60,60
166997,2019-11-19 00:00:00+03:00,in,False,903312,False,1,75,93,18
166997,2019-11-19 00:00:00+03:00,out,False,903318,False,1,26,54,28
166997,2019-11-22 00:00:00+03:00,in,False,903312,False,1,46,56,10
167002,2019-08-30 00:00:00+03:00,out,False,900492,False,1,3,4,1
167002,2019-08-30 00:00:00+03:00,in,False,900492,False,1,19,28,9
167002,2019-09-02 00:00:00+03:00,out,False,900492,True,5,0,148,148
167002,2019-09-02 00:00:00+03:00,in,False,-1,True,1,0,6,6
167002,2019-09-02 00:00:00+03:00,in,False,900492,True,1,0,27,27
167002,2019-09-02 00:00:00+03:00,out,False,900492,False,1,169,174,5
167002,2019-09-04 00:00:00+03:00,in,False,900492,False,2,17,34,17
167002,2019-09-09 00:00:00+03:00,out,False,900492,False,1,3,30,27
167002,2019-09-09 00:00:00+03:00,out,False,900492,True,2,0,59,59
167002,2019-09-10 00:00:00+03:00,out,False,900492,True,1,0,46,46
167002,2019-09-11 00:00:00+03:00,out,False,900492,True,3,0,129,129
167002,2019-09-11 00:00:00+03:00,out,False,900492,False,1,18,48,30
167002,2019-09-12 00:00:00+03:00,out,False,900492,False,4,595,678,83
167002,2019-09-12 00:00:00+03:00,in,False,-1,True,6,0,4,4
167002,2019-09-12 00:00:00+03:00,out,False,900492,True,1,0,22,22
167002,2019-09-13 00:00:00+03:00,out,False,900492,False,1,34,48,14
167002,2019-09-15 00:00:00+03:00,out,False,900492,False,2,187,216,29
167002,2019-09-15 00:00:00+03:00,out,False,900492,True,1,0,36,36
167002,2019-09-16 00:00:00+03:00,out,False,900492,False,3,485,527,42
167002,2019-09-16 00:00:00+03:00,out,False,900492,True,2,0,106,106
167002,2019-09-16 00:00:00+03:00,in,False,-1,True,2,0,4,4
167002,2019-09-16 00:00:00+03:00,out,False,900492,False,3,485,527,42
167002,2019-09-17 00:00:00+03:00,out,False,900492,False,5,330,436,106
167002,2019-09-17 00:00:00+03:00,out,False,900492,True,2,0,60,60
167002,2019-09-17 00:00:00+03:00,in,False,-1,True,7,0,8,8
167002,2019-09-19 00:00:00+03:00,out,False,900492,False,7,799,906,107
167002,2019-09-19 00:00:00+03:00,out,False,900492,True,2,0,116,116
167002,2019-09-19 00:00:00+03:00,in,False,900492,False,1,11,47,36
167002,2019-09-20 00:00:00+03:00,out,False,900492,False,5,245,301,56
167002,2019-09-20 00:00:00+03:00,out,False,900492,True,5,0,101,101
167002,2019-09-22 00:00:00+03:00,out,False,900492,True,8,0,392,392
167002,2019-09-22 00:00:00+03:00,out,False,900492,False,2,91,127,36
167002,2019-09-23 00:00:00+03:00,in,False,900492,False,1,450,476,26
167002,2019-09-23 00:00:00+03:00,out,False,900492,True,6,0,282,282
167002,2019-09-23 00:00:00+03:00,in,False,-1,True,1,0,31,31
167002,2019-09-23 00:00:00+03:00,out,False,900492,False,8,93,276,183
167002,2019-09-24 00:00:00+03:00,out,False,900492,True,2,0,73,73
167002,2019-09-24 00:00:00+03:00,out,False,900492,False,3,11,59,48
167002,2019-09-25 00:00:00+03:00,in,False,900492,False,2,69,86,17
167002,2019-09-25 00:00:00+03:00,in,False,-1,True,1,0,0,0
167002,2019-09-25 00:00:00+03:00,out,False,900492,True,2,0,82,82
167002,2019-09-25 00:00:00+03:00,out,False,900492,False,2,421,454,33
167002,2019-09-26 00:00:00+03:00,out,False,900492,False,5,479,555,76
167002,2019-09-26 00:00:00+03:00,out,False,900492,True,2,0,21,21
167002,2019-09-26 00:00:00+03:00,in,False,-1,True,1,0,61,61
167002,2019-09-26 00:00:00+03:00,in,False,900492,False,1,47,54,7
167002,2019-09-26 00:00:00+03:00,in,False,900492,False,1,47,54,7
167002,2019-09-27 00:00:00+03:00,out,False,900492,False,3,379,436,57
167002,2019-09-27 00:00:00+03:00,out,False,900492,True,3,0,82,82
167002,2019-09-27 00:00:00+03:00,out,False,900492,True,3,0,82,82
167002,2019-09-30 00:00:00+03:00,out,False,900492,True,2,0,66,66
167002,2019-09-30 00:00:00+03:00,out,False,900492,False,2,17,87,70
167002,2019-10-01 00:00:00+03:00,in,False,-1,True,2,0,6,6
167002,2019-10-01 00:00:00+03:00,out,False,900492,False,6,284,368,84
167002,2019-10-01 00:00:00+03:00,out,False,900492,True,2,0,60,60
167002,2019-10-02 00:00:00+03:00,out,False,900492,False,1,29,37,8
167002,2019-10-03 00:00:00+03:00,out,False,900492,False,1,83,91,8
167002,2019-10-04 00:00:00+03:00,out,False,900492,False,5,523,610,87
167002,2019-10-04 00:00:00+03:00,in,False,-1,True,1,0,8,8
167002,2019-10-04 00:00:00+03:00,out,False,900492,False,5,523,610,87
167002,2019-10-06 00:00:00+03:00,out,False,900492,True,5,0,186,186
167002,2019-10-07 00:00:00+03:00,out,False,900492,True,5,0,181,181
167002,2019-10-08 00:00:00+03:00,out,False,900492,False,2,26,34,8
167002,2019-10-08 00:00:00+03:00,out,False,900492,True,2,0,101,101
167002,2019-10-08 00:00:00+03:00,in,False,-1,True,9,0,3,3
167002,2019-10-09 00:00:00+03:00,in,False,900492,False,1,71,91,20
167002,2019-10-09 00:00:00+03:00,in,False,-1,True,3,0,0,0
167002,2019-10-09 00:00:00+03:00,out,False,900492,True,2,0,45,45
167002,2019-10-09 00:00:00+03:00,out,False,900492,False,2,21,58,37
167002,2019-10-10 00:00:00+03:00,in,False,900492,False,1,7,17,10
167002,2019-10-10 00:00:00+03:00,out,False,900492,False,3,227,270,43
167002,2019-10-10 00:00:00+03:00,out,False,900492,True,3,0,142,142
167002,2019-10-10 00:00:00+03:00,out,False,900492,False,3,227,270,43
167002,2019-10-14 00:00:00+03:00,out,False,900492,False,1,32,44,12
167002,2019-10-14 00:00:00+03:00,out,False,900492,True,2,0,23,23
167002,2019-10-15 00:00:00+03:00,out,False,900492,True,4,0,33,33
167002,2019-10-15 00:00:00+03:00,out,False,900492,False,2,143,165,22
167002,2019-10-16 00:00:00+03:00,in,False,900492,False,1,284,295,11
167002,2019-10-16 00:00:00+03:00,out,False,900492,False,1,5,38,33
167002,2019-10-18 00:00:00+03:00,out,False,900492,True,3,0,16,16
167002,2019-10-18 00:00:00+03:00,in,False,-1,True,8,0,101,101
167002,2019-10-18 00:00:00+03:00,out,False,900492,False,6,365,488,123
167002,2019-10-18 00:00:00+03:00,out,False,900492,True,3,0,16,16
167002,2019-10-18 00:00:00+03:00,in,False,-1,True,8,0,101,101
167002,2019-10-23 00:00:00+03:00,in,False,-1,True,4,0,1,1
167002,2019-10-24 00:00:00+03:00,out,False,900492,False,4,537,629,92
167002,2019-10-24 00:00:00+03:00,out,False,900492,True,2,0,67,67
167002,2019-10-25 00:00:00+03:00,in,False,900492,False,1,62,76,14
167002,2019-10-25 00:00:00+03:00,out,False,900492,True,2,0,33,33
167002,2019-10-25 00:00:00+03:00,out,False,900492,False,8,248,366,118
167002,2019-10-26 00:00:00+03:00,out,False,900492,True,1,0,61,61
167002,2019-10-27 00:00:00+03:00,out,False,900492,True,1,0,57,57
167002,2019-10-28 00:00:00+03:00,out,False,900492,False,1,242,256,14
167002,2019-10-28 00:00:00+03:00,in,False,900492,False,1,12,27,15
167002,2019-10-28 00:00:00+03:00,out,False,900492,True,2,0,97,97
167002,2019-10-29 00:00:00+03:00,in,False,-1,True,1,0,30,30
167002,2019-10-29 00:00:00+03:00,out,False,900492,True,4,0,115,115
167002,2019-10-29 00:00:00+03:00,out,False,900492,False,4,440,503,63
167002,2019-10-29 00:00:00+03:00,in,False,-1,True,1,0,30,30
167002,2019-10-30 00:00:00+03:00,out,False,900492,False,3,382,448,66
167002,2019-10-30 00:00:00+03:00,out,False,900492,True,2,0,52,52
167002,2019-10-31 00:00:00+03:00,out,False,900492,True,2,0,35,35
167002,2019-11-01 00:00:00+03:00,out,False,900492,True,2,0,38,38
167002,2019-11-01 00:00:00+03:00,in,False,-1,True,4,0,2,2
167002,2019-11-01 00:00:00+03:00,in,False,900492,False,1,88,99,11
167002,2019-11-04 00:00:00+03:00,out,False,900492,True,2,0,30,30
167002,2019-11-04 00:00:00+03:00,out,False,900492,False,1,156,186,30
167002,2019-11-04 00:00:00+03:00,out,False,900492,False,1,156,186,30
167002,2019-11-05 00:00:00+03:00,out,False,900492,True,2,0,61,61
167002,2019-11-05 00:00:00+03:00,out,False,900492,True,2,0,61,61
167002,2019-11-06 00:00:00+03:00,in,False,-1,True,4,0,3,3
167002,2019-11-11 00:00:00+03:00,out,False,900492,True,1,0,13,13
167002,2019-11-16 00:00:00+03:00,in,False,-1,True,1,0,2,2
167002,2019-11-16 00:00:00+03:00,in,False,-1,True,1,0,2,2
167002,2019-11-17 00:00:00+03:00,out,False,900492,False,1,29,36,7
167002,2019-11-19 00:00:00+03:00,out,False,900492,False,1,123,129,6
167002,2019-11-20 00:00:00+03:00,in,False,-1,True,2,0,0,0
167002,2019-11-20 00:00:00+03:00,out,False,900492,True,1,0,28,28
167002,2019-11-21 00:00:00+03:00,out,False,900492,True,1,0,43,43
167002,2019-11-21 00:00:00+03:00,out,False,900492,False,4,95,135,40
167002,2019-11-22 00:00:00+03:00,out,False,900492,False,1,446,456,10
167002,2019-11-22 00:00:00+03:00,out,False,900492,True,1,0,11,11
167002,2019-11-22 00:00:00+03:00,out,False,900492,False,1,446,456,10
167002,2019-11-24 00:00:00+03:00,out,False,900492,True,3,0,18,18
167002,2019-11-25 00:00:00+03:00,out,False,900492,True,1,0,33,33
167002,2019-11-25 00:00:00+03:00,in,False,-1,True,6,0,4,4
167002,2019-11-25 00:00:00+03:00,in,False,900492,False,1,64,83,19
167002,2019-11-26 00:00:00+03:00,in,False,-1,True,1,0,2,2
167002,2019-11-26 00:00:00+03:00,out,False,900492,False,3,393,422,29
167002,2019-11-26 00:00:00+03:00,out,False,900492,True,1,0,33,33
167002,2019-11-27 00:00:00+03:00,out,False,900492,False,3,493,534,41
167002,2019-11-27 00:00:00+03:00,out,False,900492,True,4,0,192,192
167002,2019-11-27 00:00:00+03:00,out,False,900492,False,3,493,534,41
167002,2019-11-28 00:00:00+03:00,in,False,900492,False,1,156,172,16
167002,2019-11-28 00:00:00+03:00,out,False,900492,True,1,0,3,3
167002,2019-11-28 00:00:00+03:00,out,False,900492,False,1,183,198,15
167003,2019-08-30 00:00:00+03:00,in,False,-1,True,1,0,2,2
167003,2019-09-01 00:00:00+03:00,in,False,-1,True,1,0,2,2
167003,2019-09-02 00:00:00+03:00,in,False,901498,False,1,3,34,31
167003,2019-09-02 00:00:00+03:00,in,False,901492,False,2,54,82,28
167003,2019-09-02 00:00:00+03:00,in,False,901492,False,2,54,82,28
167003,2019-09-03 00:00:00+03:00,in,False,901492,False,1,17,24,7
167003,2019-09-03 00:00:00+03:00,out,False,901492,True,1,0,23,23
167003,2019-09-06 00:00:00+03:00,in,False,901492,False,1,3,28,25
167003,2019-09-06 00:00:00+03:00,in,False,901492,False,1,3,28,25
167003,2019-09-10 00:00:00+03:00,in,False,901498,False,1,23,83,60
167003,2019-09-12 00:00:00+03:00,in,False,901492,False,1,112,135,23
167003,2019-09-13 00:00:00+03:00,in,False,901492,False,1,77,102,25
167003,2019-09-16 00:00:00+03:00,in,False,901492,False,1,246,267,21
167003,2019-09-17 00:00:00+03:00,in,False,901492,False,2,114,155,41
167003,2019-09-24 00:00:00+03:00,in,False,901492,False,1,74,97,23
167003,2019-09-27 00:00:00+03:00,out,False,901492,False,1,17,26,9
167003,2019-09-27 00:00:00+03:00,in,False,901492,False,2,71,134,63
167003,2019-09-27 00:00:00+03:00,in,False,901492,False,2,71,134,63
167003,2019-09-30 00:00:00+03:00,in,False,901492,False,3,355,434,79
167003,2019-10-02 00:00:00+03:00,in,False,901492,False,1,19,46,27
167003,2019-10-03 00:00:00+03:00,in,False,901498,False,2,53,175,122
167003,2019-10-08 00:00:00+03:00,in,False,-1,True,1,0,58,58
167003,2019-10-08 00:00:00+03:00,in,False,901492,False,1,238,262,24
167003,2019-10-08 00:00:00+03:00,in,False,901492,False,1,238,262,24
167003,2019-10-10 00:00:00+03:00,in,False,901492,False,1,32,66,34
167003,2019-10-10 00:00:00+03:00,in,False,901492,False,1,32,66,34
167003,2019-10-15 00:00:00+03:00,in,False,-1,True,1,0,1,1
167003,2019-10-17 00:00:00+03:00,in,False,901492,False,1,80,107,27
167003,2019-10-18 00:00:00+03:00,in,False,-1,True,1,0,19,19
167003,2019-10-18 00:00:00+03:00,in,False,-1,True,1,0,19,19
167003,2019-10-22 00:00:00+03:00,in,False,901498,False,1,119,171,52
167003,2019-10-24 00:00:00+03:00,in,False,901492,False,1,55,78,23
167003,2019-10-28 00:00:00+03:00,in,False,901492,False,1,65,89,24
167003,2019-10-30 00:00:00+03:00,in,False,901492,False,2,402,444,42
167003,2019-10-30 00:00:00+03:00,in,False,901492,False,2,402,444,42
167003,2019-11-06 00:00:00+03:00,in,False,901492,False,1,49,72,23
167003,2019-11-07 00:00:00+03:00,in,False,-1,True,1,0,16,16
167003,2019-11-07 00:00:00+03:00,in,False,901492,False,1,483,508,25
167003,2019-11-07 00:00:00+03:00,in,False,-1,True,1,0,16,16
167003,2019-11-08 00:00:00+03:00,in,False,901492,False,1,51,78,27
167003,2019-11-15 00:00:00+03:00,in,False,901492,False,1,148,171,23
167003,2019-11-15 00:00:00+03:00,in,False,-1,True,1,0,26,26
167003,2019-11-19 00:00:00+03:00,in,False,901492,False,1,103,125,22
167003,2019-11-20 00:00:00+03:00,in,False,901492,False,1,25,47,22
167003,2019-11-22 00:00:00+03:00,in,False,-1,True,1,0,69,69
167003,2019-11-26 00:00:00+03:00,in,False,901492,False,1,93,140,47
167003,2019-11-28 00:00:00+03:00,in,False,-1,True,1,0,19,19
167003,2019-11-28 00:00:00+03:00,out,False,901492,False,1,18,40,22
167004,2019-08-30 00:00:00+03:00,out,False,900826,True,2,0,55,55
167004,2019-08-30 00:00:00+03:00,out,False,900826,False,1,120,137,17
167004,2019-09-02 00:00:00+03:00,in,False,-1,True,2,0,0,0
167004,2019-09-03 00:00:00+03:00,out,False,900826,True,6,0,231,231
167004,2019-09-03 00:00:00+03:00,out,False,900826,False,3,865,929,64
167004,2019-09-03 00:00:00+03:00,in,False,-1,True,1,0,28,28
167004,2019-09-03 00:00:00+03:00,out,False,900826,False,3,865,929,64
167004,2019-09-04 00:00:00+03:00,out,False,900826,False,3,889,922,33
167004,2019-09-04 00:00:00+03:00,out,False,900826,False,3,889,922,33
167004,2019-09-05 00:00:00+03:00,out,False,900826,True,8,0,214,214
167004,2019-09-05 00:00:00+03:00,in,False,-1,True,1,0,30,30
167004,2019-09-05 00:00:00+03:00,out,False,900826,False,20,4555,4842,287
167004,2019-09-05 00:00:00+03:00,in,False,900826,False,3,730,755,25
167004,2019-09-05 00:00:00+03:00,in,False,900826,False,3,730,755,25
167004,2019-09-06 00:00:00+03:00,out,False,900826,False,1,275,282,7
167004,2019-09-07 00:00:00+03:00,out,False,900826,True,1,0,10,10
167004,2019-09-07 00:00:00+03:00,out,False,900826,False,1,5,24,19
167004,2019-09-08 00:00:00+03:00,in,False,900826,False,2,66,82,16
167004,2019-09-08 00:00:00+03:00,out,False,900826,True,9,0,214,214
167004,2019-09-08 00:00:00+03:00,out,False,900826,False,5,1196,1271,75
167004,2019-09-08 00:00:00+03:00,in,False,-1,True,4,0,24,24
167004,2019-09-09 00:00:00+03:00,out,False,900826,False,1,56,63,7
167004,2019-09-10 00:00:00+03:00,out,False,900826,True,1,0,51,51
167004,2019-09-10 00:00:00+03:00,out,False,900826,False,4,122,236,114
167004,2019-09-11 00:00:00+03:00,in,False,900826,False,1,50,61,11
167004,2019-09-11 00:00:00+03:00,out,False,900826,False,4,451,492,41
167004,2019-09-12 00:00:00+03:00,out,False,900826,False,5,468,524,56
167004,2019-09-12 00:00:00+03:00,in,False,900826,False,1,32,43,11
167004,2019-09-12 00:00:00+03:00,out,False,900826,True,2,0,99,99
167004,2019-09-12 00:00:00+03:00,out,False,900826,True,2,0,99,99
167004,2019-09-13 00:00:00+03:00,in,False,900826,False,1,52,69,17
167004,2019-09-13 00:00:00+03:00,in,False,-1,True,2,0,60,60
167004,2019-09-13 00:00:00+03:00,out,False,900826,False,4,269,303,34
167004,2019-09-13 00:00:00+03:00,in,False,-1,True,2,0,60,60
167004,2019-09-14 00:00:00+03:00,out,False,900826,True,4,0,116,116
167004,2019-09-14 00:00:00+03:00,in,False,900826,False,1,11,17,6
167004,2019-09-15 00:00:00+03:00,out,False,900826,False,3,219,261,42
167004,2019-09-15 00:00:00+03:00,out,False,900826,True,1,0,52,52
167004,2019-09-15 00:00:00+03:00,in,False,-1,True,1,0,4,4
167004,2019-09-16 00:00:00+03:00,out,False,900826,False,1,359,373,14
167004,2019-09-16 00:00:00+03:00,out,False,900826,True,1,0,42,42
167004,2019-09-16 00:00:00+03:00,in,False,900826,False,1,119,136,17
167004,2019-09-16 00:00:00+03:00,out,False,900826,False,1,359,373,14
167004,2019-09-18 00:00:00+03:00,in,False,-1,True,6,0,31,31
167004,2019-09-18 00:00:00+03:00,out,False,900826,False,2,166,195,29
167004,2019-09-19 00:00:00+03:00,out,False,900826,True,1,0,33,33
167004,2019-09-19 00:00:00+03:00,out,False,900826,False,3,734,792,58
167004,2019-09-19 00:00:00+03:00,out,False,900826,True,1,0,33,33
167004,2019-09-20 00:00:00+03:00,out,False,900826,True,1,0,60,60
167004,2019-09-22 00:00:00+03:00,out,False,900826,True,7,0,264,264
167004,2019-09-22 00:00:00+03:00,in,False,900826,False,1,575,585,10
167004,2019-09-22 00:00:00+03:00,out,False,900826,False,11,562,682,120
167004,2019-09-22 00:00:00+03:00,in,False,-1,True,1,0,0,0
167004,2019-09-23 00:00:00+03:00,out,False,900826,False,1,297,305,8
167004,2019-09-24 00:00:00+03:00,out,False,900826,False,3,667,719,52
167004,2019-09-26 00:00:00+03:00,out,False,900826,False,3,199,229,30
167004,2019-09-26 00:00:00+03:00,out,False,900826,True,2,0,113,113
167004,2019-09-26 00:00:00+03:00,in,False,900826,False,1,478,490,12
167004,2019-09-27 00:00:00+03:00,out,False,900826,False,10,1353,1472,119
167004,2019-09-27 00:00:00+03:00,in,False,-1,True,2,0,60,60
167004,2019-09-27 00:00:00+03:00,out,False,900826,True,4,0,155,155
167004,2019-09-27 00:00:00+03:00,in,False,900826,False,1,88,94,6
167004,2019-09-27 00:00:00+03:00,in,False,-1,True,2,0,60,60
167004,2019-09-27 00:00:00+03:00,in,False,900826,False,1,88,94,6
167004,2019-09-29 00:00:00+03:00,out,False,900826,False,2,118,138,20
167004,2019-10-01 00:00:00+03:00,in,False,-1,True,3,0,34,34
167004,2019-10-01 00:00:00+03:00,out,False,900826,False,9,561,702,141
167004,2019-10-01 00:00:00+03:00,in,False,900826,False,1,43,53,10
167004,2019-10-02 00:00:00+03:00,in,False,-1,True,1,0,30,30
167004,2019-10-02 00:00:00+03:00,out,False,900826,False,2,98,110,12
167004,2019-10-03 00:00:00+03:00,out,False,900826,False,3,391,431,40
167004,2019-10-06 00:00:00+03:00,out,False,900826,True,3,0,137,137
167004,2019-10-06 00:00:00+03:00,out,False,900826,False,5,550,625,75
167004,2019-10-07 00:00:00+03:00,in,False,900826,False,1,150,173,23
167004,2019-10-07 00:00:00+03:00,in,False,-1,True,1,0,30,30
167004,2019-10-07 00:00:00+03:00,out,False,900826,False,1,295,301,6
167004,2019-10-08 00:00:00+03:00,out,False,900826,False,7,307,403,96
167004,2019-10-09 00:00:00+03:00,out,False,900826,False,9,1510,1605,95
167004,2019-10-09 00:00:00+03:00,in,False,-1,True,6,0,141,141
167004,2019-10-09 00:00:00+03:00,out,False,900826,True,4,0,201,201
167004,2019-10-09 00:00:00+03:00,in,False,900826,False,5,683,744,61
167004,2019-10-10 00:00:00+03:00,out,False,900826,False,6,308,437,129
167004,2019-10-10 00:00:00+03:00,out,False,900826,True,2,0,55,55
167004,2019-10-10 00:00:00+03:00,in,False,900826,False,1,66,79,13
167004,2019-10-11 00:00:00+03:00,in,False,900826,False,1,291,303,12
167004,2019-10-12 00:00:00+03:00,out,False,900826,False,6,916,974,58
167004,2019-10-12 00:00:00+03:00,in,False,-1,True,3,0,60,60
167004,2019-10-12 00:00:00+03:00,out,False,900826,True,3,0,92,92
167004,2019-10-13 00:00:00+03:00,out,False,900826,False,6,315,431,116
167004,2019-10-13 00:00:00+03:00,out,False,900826,True,1,0,10,10
167004,2019-10-14 00:00:00+03:00,out,False,900826,True,1,0,51,51
167004,2019-10-14 00:00:00+03:00,in,False,-1,True,1,0,31,31
167004,2019-10-15 00:00:00+03:00,out,False,900826,True,3,0,93,93
167004,2019-10-15 00:00:00+03:00,out,False,900826,False,2,698,718,20
167004,2019-10-15 00:00:00+03:00,in,False,900826,False,1,158,167,9
167004,2019-10-16 00:00:00+03:00,out,False,900826,False,1,380,388,8
167004,2019-10-16 00:00:00+03:00,out,False,900826,True,1,0,28,28
167004,2019-10-17 00:00:00+03:00,out,False,900826,True,1,0,53,53
167004,2019-10-17 00:00:00+03:00,in,False,900826,False,1,105,117,12
167004,2019-10-17 00:00:00+03:00,out,False,900826,False,1,712,717,5
167004,2019-10-18 00:00:00+03:00,out,False,900826,False,1,149,168,19
167004,2019-10-18 00:00:00+03:00,in,False,900826,False,1,34,40,6
167004,2019-10-18 00:00:00+03:00,out,False,900826,True,1,0,49,49
167004,2019-10-20 00:00:00+03:00,in,False,-1,True,3,0,61,61
167004,2019-10-20 00:00:00+03:00,out,False,900826,False,6,797,922,125
167004,2019-10-20 00:00:00+03:00,out,False,900826,True,4,0,89,89
167004,2019-10-20 00:00:00+03:00,in,False,900826,False,2,59,72,13
167004,2019-10-20 00:00:00+03:00,out,False,900826,True,4,0,89,89
167004,2019-10-22 00:00:00+03:00,out,False,900826,True,5,0,186,186
167004,2019-10-22 00:00:00+03:00,out,False,900826,False,4,733,765,32
167004,2019-10-22 00:00:00+03:00,in,False,900826,False,1,128,138,10
167004,2019-10-23 00:00:00+03:00,out,False,900826,True,2,0,87,87
167004,2019-10-23 00:00:00+03:00,out,False,900826,False,3,157,189,32
167004,2019-10-23 00:00:00+03:00,in,False,900826,False,1,30,45,15
167004,2019-10-23 00:00:00+03:00,in,False,-1,True,14,0,65,65
167004,2019-10-24 00:00:00+03:00,out,False,900826,False,1,208,221,13
167004,2019-10-25 00:00:00+03:00,in,False,900826,False,1,73,82,9
167004,2019-10-25 00:00:00+03:00,out,False,900826,False,2,37,92,55
167004,2019-10-25 00:00:00+03:00,in,False,-1,True,1,0,31,31
167004,2019-10-26 00:00:00+03:00,out,False,900826,False,2,965,990,25
167004,2019-10-26 00:00:00+03:00,in,False,-1,True,1,0,0,0
167004,2019-10-26 00:00:00+03:00,in,False,900826,False,1,50,55,5
167004,2019-10-26 00:00:00+03:00,in,False,900826,False,1,50,55,5
167004,2019-10-27 00:00:00+03:00,in,False,-1,True,7,0,37,37
167004,2019-10-27 00:00:00+03:00,out,False,900826,False,10,1646,1795,149
167004,2019-10-27 00:00:00+03:00,in,False,900826,False,1,368,375,7
167004,2019-10-27 00:00:00+03:00,out,False,900826,True,5,0,185,185
167004,2019-10-28 00:00:00+03:00,out,False,900826,False,2,508,533,25
167004,2019-10-28 00:00:00+03:00,in,False,-1,True,3,0,0,0
167004,2019-10-28 00:00:00+03:00,out,False,900826,False,2,508,533,25
167004,2019-10-29 00:00:00+03:00,out,False,900826,True,4,0,54,54
167004,2019-10-29 00:00:00+03:00,in,False,900826,False,2,665,677,12
167004,2019-10-29 00:00:00+03:00,in,False,-1,True,2,0,2,2
167004,2019-10-29 00:00:00+03:00,out,False,900826,False,7,845,920,75
167004,2019-10-29 00:00:00+03:00,out,False,900826,True,4,0,54,54
167004,2019-10-30 00:00:00+03:00,in,False,900826,False,1,103,113,10
167004,2019-10-30 00:00:00+03:00,in,False,-1,True,1,0,32,32
167004,2019-10-31 00:00:00+03:00,out,False,900826,False,6,528,586,58
167004,2019-10-31 00:00:00+03:00,out,False,900826,True,6,0,67,67
167004,2019-10-31 00:00:00+03:00,in,False,900826,False,2,334,355,21
167004,2019-11-01 00:00:00+03:00,out,False,900826,False,1,444,457,13
167004,2019-11-01 00:00:00+03:00,in,False,-1,True,1,0,30,30
167004,2019-11-01 00:00:00+03:00,in,False,-1,True,1,0,30,30
167004,2019-11-02 00:00:00+03:00,out,False,900826,True,8,0,220,220
167004,2019-11-02 00:00:00+03:00,in,False,-1,True,8,0,28,28
167004,2019-11-02 00:00:00+03:00,out,False,900826,False,11,1523,1739,216
167004,2019-11-02 00:00:00+03:00,in,False,900826,False,1,59,68,9
167004,2019-11-03 00:00:00+03:00,in,False,900826,False,2,76,100,24
167004,2019-11-03 00:00:00+03:00,out,False,900826,False,1,126,147,21
167004,2019-11-03 00:00:00+03:00,out,False,900826,True,6,0,86,86
167004,2019-11-03 00:00:00+03:00,in,False,-1,True,3,0,0,0
167004,2019-11-05 00:00:00+03:00,in,False,-1,True,2,0,21,21
167004,2019-11-05 00:00:00+03:00,in,False,900826,False,2,377,387,10
167004,2019-11-05 00:00:00+03:00,out,False,900826,True,18,0,651,651
167004,2019-11-05 00:00:00+03:00,out,False,900826,False,4,526,571,45
167004,2019-11-06 00:00:00+03:00,out,False,900826,False,8,689,901,212
167004,2019-11-06 00:00:00+03:00,in,False,900826,False,2,254,275,21
167004,2019-11-06 00:00:00+03:00,out,False,900826,False,8,689,901,212
167004,2019-11-07 00:00:00+03:00,out,False,900826,False,7,745,851,106
167004,2019-11-07 00:00:00+03:00,in,False,900826,False,2,443,458,15
167004,2019-11-07 00:00:00+03:00,out,False,900826,True,2,0,68,68
167004,2019-11-08 00:00:00+03:00,out,False,900826,True,9,0,83,83
167004,2019-11-08 00:00:00+03:00,in,False,900826,False,1,149,163,14
167004,2019-11-08 00:00:00+03:00,out,False,900826,False,4,578,644,66
167004,2019-11-08 00:00:00+03:00,in,False,-1,True,1,0,30,30
167004,2019-11-08 00:00:00+03:00,out,False,900826,True,9,0,83,83
167004,2019-11-09 00:00:00+03:00,in,False,900826,False,3,174,215,41
167004,2019-11-09 00:00:00+03:00,in,False,-1,True,1,0,0,0
167004,2019-11-09 00:00:00+03:00,out,False,900826,False,13,1990,2167,177
167004,2019-11-09 00:00:00+03:00,out,False,900826,True,4,0,76,76
167004,2019-11-10 00:00:00+03:00,in,False,900826,False,1,58,62,4
167004,2019-11-10 00:00:00+03:00,in,False,-1,True,1,0,30,30
167004,2019-11-10 00:00:00+03:00,out,False,900826,False,9,1200,1326,126
167004,2019-11-10 00:00:00+03:00,out,False,900826,True,8,0,216,216
167004,2019-11-11 00:00:00+03:00,out,False,900826,False,3,154,186,32
167004,2019-11-11 00:00:00+03:00,in,False,-1,True,1,0,0,0
167004,2019-11-11 00:00:00+03:00,in,False,900826,False,8,1078,1163,85
167004,2019-11-11 00:00:00+03:00,out,False,900826,True,2,0,80,80
167004,2019-11-12 00:00:00+03:00,out,False,900826,False,8,684,794,110
167004,2019-11-12 00:00:00+03:00,in,False,-1,True,3,0,0,0
167004,2019-11-12 00:00:00+03:00,out,False,900826,True,3,0,77,77
167004,2019-11-12 00:00:00+03:00,in,False,900826,False,5,750,794,44
167004,2019-11-13 00:00:00+03:00,in,False,-1,True,16,0,123,123
167004,2019-11-13 00:00:00+03:00,in,False,900826,False,8,837,954,117
167004,2019-11-13 00:00:00+03:00,out,False,900826,False,3,440,486,46
167004,2019-11-13 00:00:00+03:00,in,False,900826,False,8,837,954,117
167004,2019-11-14 00:00:00+03:00,out,False,900826,True,2,0,43,43
167004,2019-11-14 00:00:00+03:00,in,False,900826,False,3,319,343,24
167004,2019-11-14 00:00:00+03:00,out,False,900826,False,3,333,377,44
167004,2019-11-14 00:00:00+03:00,in,False,-1,True,41,0,1,1
167004,2019-11-15 00:00:00+03:00,out,False,900826,False,5,1255,1304,49
167004,2019-11-15 00:00:00+03:00,in,False,-1,True,8,0,2,2
167004,2019-11-17 00:00:00+03:00,in,False,900826,False,2,123,147,24
167004,2019-11-17 00:00:00+03:00,out,False,900826,True,13,0,445,445
167004,2019-11-17 00:00:00+03:00,out,False,900826,False,7,576,705,129
167004,2019-11-18 00:00:00+03:00,in,False,900826,False,2,127,151,24
167004,2019-11-18 00:00:00+03:00,in,False,-1,True,2,0,16,16
167004,2019-11-18 00:00:00+03:00,out,False,900826,False,13,1325,1550,225
167004,2019-11-19 00:00:00+03:00,out,False,900826,True,4,0,181,181
167004,2019-11-19 00:00:00+03:00,out,False,900826,False,4,321,388,67
167004,2019-11-19 00:00:00+03:00,in,False,900826,False,2,70,84,14
167004,2019-11-20 00:00:00+03:00,in,False,-1,True,15,0,16,16
167004,2019-11-20 00:00:00+03:00,out,False,900826,False,4,555,608,53
167004,2019-11-20 00:00:00+03:00,out,False,900826,True,1,0,22,22
167004,2019-11-21 00:00:00+03:00,out,False,900826,False,6,759,818,59
167004,2019-11-21 00:00:00+03:00,in,False,-1,True,2,0,61,61
167004,2019-11-21 00:00:00+03:00,in,False,900826,False,2,158,172,14
167004,2019-11-21 00:00:00+03:00,out,False,900826,True,2,0,28,28
167004,2019-11-22 00:00:00+03:00,out,False,900826,False,6,481,569,88
167004,2019-11-22 00:00:00+03:00,out,False,900826,True,4,0,83,83
167004,2019-11-23 00:00:00+03:00,out,False,900826,False,1,81,86,5
167004,2019-11-24 00:00:00+03:00,in,False,-1,True,2,0,24,24
167004,2019-11-24 00:00:00+03:00,out,False,900826,True,3,0,82,82
167004,2019-11-24 00:00:00+03:00,out,False,900826,False,4,177,247,70
167004,2019-11-25 00:00:00+03:00,out,False,900826,False,2,186,205,19
167004,2019-11-26 00:00:00+03:00,in,False,900826,False,1,94,104,10
167004,2019-11-26 00:00:00+03:00,in,False,-1,True,5,0,2,2
167004,2019-11-26 00:00:00+03:00,out,False,900826,False,1,168,176,8
167004,2019-11-27 00:00:00+03:00,in,False,900826,False,1,66,86,20
167004,2019-11-28 00:00:00+03:00,out,False,900826,True,2,0,88,88
167004,2019-11-28 00:00:00+03:00,out,False,900826,False,2,347,381,34
167004,2019-11-28 00:00:00+03:00,in,False,900826,False,1,66,79,13
167004,2019-11-28 00:00:00+03:00,out,False,900826,True,2,0,88,88
167009,2019-08-28 00:00:00+03:00,in,False,898414,False,8,759,835,76
167009,2019-08-28 00:00:00+03:00,out,False,898902,False,1,6,32,26
167009,2019-08-28 00:00:00+03:00,in,False,-1,True,5,0,12,12
167009,2019-08-28 00:00:00+03:00,out,False,898414,False,4,167,229,62
167009,2019-08-28 00:00:00+03:00,out,False,898414,True,8,0,90,90
167009,2019-08-28 00:00:00+03:00,in,False,898414,False,8,759,835,76
167009,2019-08-29 00:00:00+03:00,in,False,898414,False,15,845,1021,176
167009,2019-08-29 00:00:00+03:00,out,False,898906,True,7,0,63,63
167009,2019-08-29 00:00:00+03:00,in,False,-1,True,14,0,315,315
167009,2019-08-29 00:00:00+03:00,out,False,898902,True,1,0,11,11
167009,2019-08-29 00:00:00+03:00,out,False,898902,False,1,65,102,37
167009,2019-08-29 00:00:00+03:00,out,False,898414,True,16,0,291,291
167009,2019-08-29 00:00:00+03:00,out,False,898906,False,4,106,195,89
167009,2019-08-29 00:00:00+03:00,in,False,898414,True,1,0,6,6
167009,2019-08-29 00:00:00+03:00,out,False,898414,False,31,2410,2838,428
167009,2019-08-29 00:00:00+03:00,in,False,-1,True,14,0,315,315
167009,2019-08-30 00:00:00+03:00,in,False,898906,False,1,72,77,5
167009,2019-08-30 00:00:00+03:00,out,True,898906,True,1,0,0,0
167009,2019-08-30 00:00:00+03:00,in,False,-1,True,42,0,17,17
167009,2019-08-30 00:00:00+03:00,out,False,898906,True,17,0,351,351
167009,2019-08-30 00:00:00+03:00,out,False,898906,False,27,3283,3689,406
167009,2019-08-30 00:00:00+03:00,in,False,898906,False,1,72,77,5
167009,2019-08-31 00:00:00+03:00,out,False,898902,True,6,0,141,141
167009,2019-08-31 00:00:00+03:00,in,False,-1,True,129,0,1866,1866
167009,2019-08-31 00:00:00+03:00,out,False,898902,False,9,505,723,218
167009,2019-08-31 00:00:00+03:00,out,False,898920,True,8,0,220,220
167009,2019-08-31 00:00:00+03:00,in,False,898906,False,3,293,352,59
167009,2019-08-31 00:00:00+03:00,in,False,898920,False,8,841,992,151
167009,2019-08-31 00:00:00+03:00,out,False,898920,False,15,2135,2432,297
167009,2019-08-31 00:00:00+03:00,out,False,898920,False,15,2135,2432,297
167009,2019-09-01 00:00:00+03:00,in,False,-1,True,3,0,116,116
167009,2019-09-01 00:00:00+03:00,in,False,898920,False,5,637,680,43
167009,2019-09-01 00:00:00+03:00,out,False,898920,False,14,1117,1311,194
167009,2019-09-01 00:00:00+03:00,out,False,898920,False,14,1117,1311,194
167009,2019-09-02 00:00:00+03:00,out,False,898902,False,1,90,114,24
167009,2019-09-02 00:00:00+03:00,in,False,-1,True,109,0,1676,1676
167009,2019-09-02 00:00:00+03:00,out,False,898906,False,32,2275,2892,617
167009,2019-09-02 00:00:00+03:00,out,False,898906,True,4,0,174,174
167009,2019-09-02 00:00:00+03:00,in,False,898906,False,7,560,632,72
167009,2019-09-02 00:00:00+03:00,in,False,-1,True,109,0,1676,1676
167009,2019-09-03 00:00:00+03:00,out,False,898906,False,23,1508,1847,339
167009,2019-09-03 00:00:00+03:00,out,False,898902,True,3,0,15,15
167009,2019-09-03 00:00:00+03:00,in,False,-1,True,3,0,65,65
167009,2019-09-03 00:00:00+03:00,out,False,898906,True,12,0,452,452
167009,2019-09-03 00:00:00+03:00,in,False,898906,False,8,1206,1298,92
167011,2019-08-28 00:00:00+03:00,in,False,-1,True,1,0,2,2
167011,2019-08-28 00:00:00+03:00,in,False,-1,True,1,0,2,2
167011,2019-08-29 00:00:00+03:00,out,False,899788,True,2,0,59,59
167011,2019-08-29 00:00:00+03:00,out,False,899972,True,1,0,41,41
167011,2019-08-29 00:00:00+03:00,out,False,899932,False,4,461,520,59
167011,2019-08-29 00:00:00+03:00,out,False,899932,True,5,0,116,116
167011,2019-08-29 00:00:00+03:00,out,False,899788,False,2,81,113,32
167011,2019-08-29 00:00:00+03:00,out,False,899968,True,1,0,56,56
167011,2019-08-29 00:00:00+03:00,out,False,899790,False,2,50,109,59
167011,2019-08-29 00:00:00+03:00,in,False,-1,True,1,0,17,17
167011,2019-08-29 00:00:00+03:00,out,False,899790,True,8,0,232,232
167011,2019-08-30 00:00:00+03:00,in,False,-1,True,15,0,720,720
167011,2019-08-30 00:00:00+03:00,out,False,899790,True,42,0,916,916
167011,2019-08-30 00:00:00+03:00,out,False,899788,True,24,0,570,570
167011,2019-08-30 00:00:00+03:00,out,False,899968,True,31,0,769,769
167011,2019-08-30 00:00:00+03:00,out,False,899932,False,35,5812,6411,599
167011,2019-08-30 00:00:00+03:00,out,False,899964,False,21,3485,3814,329
167011,2019-08-30 00:00:00+03:00,out,False,899932,True,43,0,973,973
167011,2019-08-30 00:00:00+03:00,out,True,899972,True,1,0,0,0
167011,2019-08-30 00:00:00+03:00,out,False,899968,False,19,3554,3851,297
167011,2019-08-30 00:00:00+03:00,out,False,899964,True,14,0,427,427
167011,2019-08-30 00:00:00+03:00,out,False,899972,False,19,2835,3166,331
167011,2019-08-30 00:00:00+03:00,out,False,899790,False,29,3552,4085,533
167011,2019-08-30 00:00:00+03:00,out,False,899972,True,16,0,455,455
167011,2019-08-30 00:00:00+03:00,out,True,899932,True,1,0,2,2
167011,2019-08-30 00:00:00+03:00,out,False,899788,False,18,2287,2527,240
167011,2019-08-30 00:00:00+03:00,out,False,899788,True,24,0,570,570
167011,2019-08-30 00:00:00+03:00,out,False,899964,True,14,0,427,427
167011,2019-08-30 00:00:00+03:00,out,False,899968,False,19,3554,3851,297
167011,2019-08-30 00:00:00+03:00,out,False,899932,False,35,5812,6411,599
167011,2019-08-31 00:00:00+03:00,in,False,-1,True,4,0,177,177
167011,2019-08-31 00:00:00+03:00,out,False,899964,False,1,370,376,6
167011,2019-08-31 00:00:00+03:00,out,False,899932,False,11,3289,3464,175
167011,2019-08-31 00:00:00+03:00,out,False,899790,False,12,3043,3309,266
167011,2019-08-31 00:00:00+03:00,out,False,899932,True,14,0,314,314
167011,2019-08-31 00:00:00+03:00,out,False,899790,True,11,0,320,320
167011,2019-08-31 00:00:00+03:00,out,False,899964,False,1,370,376,6
167011,2019-09-01 00:00:00+03:00,in,False,-1,True,1,0,30,30
167011,2019-09-02 00:00:00+03:00,out,False,899790,False,31,4597,5198,601
167011,2019-09-02 00:00:00+03:00,out,False,899968,False,23,5462,5768,306
167011,2019-09-02 00:00:00+03:00,out,False,899790,True,62,0,1472,1472
167011,2019-09-02 00:00:00+03:00,out,True,899964,True,1,0,0,0
167011,2019-09-02 00:00:00+03:00,out,False,899964,False,26,5806,6257,451
167011,2019-09-02 00:00:00+03:00,out,False,899932,True,57,0,1159,1159
167011,2019-09-02 00:00:00+03:00,out,False,899972,False,3,522,568,46
167011,2019-09-02 00:00:00+03:00,out,False,899972,True,2,0,36,36
167011,2019-09-02 00:00:00+03:00,in,False,-1,True,24,0,690,690
167011,2019-09-02 00:00:00+03:00,out,False,899932,False,44,9906,10692,786
167011,2019-09-02 00:00:00+03:00,out,False,899788,True,69,0,1275,1275
167011,2019-09-02 00:00:00+03:00,out,True,899932,True,1,0,3,3
167011,2019-09-02 00:00:00+03:00,out,False,899964,True,21,0,532,532
167011,2019-09-02 00:00:00+03:00,out,False,899968,True,10,0,276,276
167011,2019-09-02 00:00:00+03:00,out,False,899788,False,19,2375,2862,487
167011,2019-09-02 00:00:00+03:00,out,False,899972,True,2,0,36,36
167011,2019-09-03 00:00:00+03:00,out,False,899790,False,37,5439,6132,693
167011,2019-09-03 00:00:00+03:00,out,False,899788,False,26,3800,4243,443
167011,2019-09-03 00:00:00+03:00,out,False,899964,False,13,4764,4913,149
167011,2019-09-03 00:00:00+03:00,out,False,899972,False,8,3292,3393,101
167011,2019-09-03 00:00:00+03:00,out,False,899788,True,46,0,1136,1136
167011,2019-09-03 00:00:00+03:00,out,False,899932,True,63,0,1389,1389
167011,2019-09-03 00:00:00+03:00,out,False,899968,False,20,3540,3909,369
167011,2019-09-03 00:00:00+03:00,out,False,899790,True,56,0,1561,1561
167011,2019-09-03 00:00:00+03:00,out,False,899964,True,28,0,810,810
167011,2019-09-03 00:00:00+03:00,in,False,-1,True,10,0,280,280
167011,2019-09-03 00:00:00+03:00,out,False,899968,True,32,0,361,361
167011,2019-09-03 00:00:00+03:00,out,False,899932,False,44,8831,9555,724
167011,2019-09-03 00:00:00+03:00,out,False,899972,True,8,0,180,180
167011,2019-09-03 00:00:00+03:00,out,False,899964,True,28,0,810,810
167011,2019-09-04 00:00:00+03:00,out,False,899790,True,59,0,1538,1538
167011,2019-09-04 00:00:00+03:00,out,True,899932,True,1,0,0,0
167011,2019-09-04 00:00:00+03:00,out,False,899932,False,43,8538,9313,775
167011,2019-09-04 00:00:00+03:00,out,False,899788,False,16,4524,4775,251
167011,2019-09-04 00:00:00+03:00,out,False,899964,False,21,5776,6020,244
167011,2019-09-04 00:00:00+03:00,out,False,899972,False,3,313,337,24
167011,2019-09-04 00:00:00+03:00,out,False,899972,True,12,0,294,294
167011,2019-09-04 00:00:00+03:00,out,False,899964,True,5,0,205,205
167011,2019-09-04 00:00:00+03:00,out,False,899968,False,2,225,250,25
167011,2019-09-04 00:00:00+03:00,out,False,899790,False,36,10035,10762,727
167011,2019-09-04 00:00:00+03:00,out,False,899932,True,43,0,1021,1021
167011,2019-09-04 00:00:00+03:00,in,False,-1,True,19,0,621,621
167011,2019-09-04 00:00:00+03:00,out,False,899788,True,19,0,348,348
167011,2019-09-05 00:00:00+03:00,out,False,899972,True,6,0,94,94
167011,2019-09-05 00:00:00+03:00,out,False,899932,True,11,0,225,225
167011,2019-09-05 00:00:00+03:00,out,False,899790,True,20,0,512,512
167011,2019-09-05 00:00:00+03:00,out,False,899788,True,12,0,217,217
167011,2019-09-05 00:00:00+03:00,out,False,899790,False,40,8930,9676,746
167011,2019-09-05 00:00:00+03:00,out,False,899964,True,10,0,207,207
167011,2019-09-05 00:00:00+03:00,out,False,899968,False,23,6867,7257,390
167011,2019-09-05 00:00:00+03:00,out,False,-1,True,1,0,0,0
167011,2019-09-05 00:00:00+03:00,out,False,899788,False,16,5017,5310,293
167011,2019-09-05 00:00:00+03:00,out,False,899932,False,15,3887,4149,262
167011,2019-09-05 00:00:00+03:00,out,True,899932,True,1,0,0,0
167011,2019-09-05 00:00:00+03:00,out,False,899964,False,27,6910,7324,414
167011,2019-09-05 00:00:00+03:00,in,False,-1,True,18,0,646,646
167011,2019-09-05 00:00:00+03:00,out,False,899972,False,10,7357,7450,93
167011,2019-09-05 00:00:00+03:00,out,False,899968,True,18,0,346,346
167011,2019-09-05 00:00:00+03:00,out,False,-1,True,1,0,0,0
167011,2019-09-06 00:00:00+03:00,out,False,899788,False,19,2531,2805,274
167011,2019-09-06 00:00:00+03:00,out,False,899932,False,9,3406,3528,122
167011,2019-09-06 00:00:00+03:00,out,False,899790,False,16,5183,5440,257
167011,2019-09-06 00:00:00+03:00,out,False,899932,True,1,0,33,33
167011,2019-09-06 00:00:00+03:00,out,False,899968,True,15,0,262,262
167011,2019-09-06 00:00:00+03:00,out,False,899788,True,21,0,350,350
167011,2019-09-06 00:00:00+03:00,out,False,899972,False,14,2319,2499,180
167011,2019-09-06 00:00:00+03:00,out,True,899972,True,1,0,0,0
167011,2019-09-06 00:00:00+03:00,out,False,899790,True,9,0,114,114
167011,2019-09-06 00:00:00+03:00,out,False,899972,True,22,0,376,376
167011,2019-09-06 00:00:00+03:00,out,False,899968,False,14,3941,4171,230
167011,2019-09-06 00:00:00+03:00,in,False,-1,True,21,0,851,851
167011,2019-09-06 00:00:00+03:00,out,False,899964,False,19,4327,4589,262
167011,2019-09-06 00:00:00+03:00,out,False,899964,True,3,0,9,9
167011,2019-09-06 00:00:00+03:00,out,True,899972,True,1,0,0,0
167011,2019-09-08 00:00:00+03:00,in,False,-1,True,1,0,30,30
167011,2019-09-09 00:00:00+03:00,out,False,899932,False,15,4647,4897,250
167011,2019-09-09 00:00:00+03:00,out,False,899972,False,2,581,618,37
167011,2019-09-09 00:00:00+03:00,out,False,899964,True,17,0,304,304
167011,2019-09-09 00:00:00+03:00,out,False,899788,True,19,0,400,400
167011,2019-09-09 00:00:00+03:00,in,False,-1,True,27,0,848,848
167011,2019-09-09 00:00:00+03:00,out,False,899932,True,6,0,100,100
167011,2019-09-09 00:00:00+03:00,out,False,899790,False,34,6749,7337,588
167011,2019-09-09 00:00:00+03:00,out,False,899788,False,20,4948,5305,357
167011,2019-09-09 00:00:00+03:00,out,False,899964,False,12,1754,2043,289
167011,2019-09-09 00:00:00+03:00,out,False,899968,True,4,0,125,125
167011,2019-09-09 00:00:00+03:00,out,False,899968,False,5,1564,1634,70
167011,2019-09-09 00:00:00+03:00,out,False,-1,True,1,0,0,0
167011,2019-09-09 00:00:00+03:00,out,True,899788,True,1,0,0,0
167011,2019-09-09 00:00:00+03:00,out,False,899790,True,27,0,817,817
167011,2019-09-09 00:00:00+03:00,out,False,899972,True,9,0,185,185
167011,2019-09-10 00:00:00+03:00,out,False,899968,True,16,0,479,479
167011,2019-09-10 00:00:00+03:00,out,False,899788,True,11,0,165,165
167011,2019-09-10 00:00:00+03:00,out,False,899932,True,7,0,275,275
167011,2019-09-10 00:00:00+03:00,out,False,899790,False,13,3647,3880,233
167011,2019-09-10 00:00:00+03:00,out,False,899788,False,22,5035,5333,298
167011,2019-09-10 00:00:00+03:00,out,False,899972,True,2,0,98,98
167011,2019-09-10 00:00:00+03:00,out,False,899968,False,20,4949,5381,432
167011,2019-09-10 00:00:00+03:00,out,False,899790,True,19,0,400,400
167011,2019-09-10 00:00:00+03:00,out,False,899972,False,9,2556,2695,139
167011,2019-09-10 00:00:00+03:00,out,False,899932,False,17,5661,5895,234
167011,2019-09-10 00:00:00+03:00,in,False,-1,True,20,0,797,797
167011,2019-09-10 00:00:00+03:00,out,False,899788,False,22,5035,5333,298
167011,2019-09-11 00:00:00+03:00,out,False,899790,True,16,0,243,243
167011,2019-09-11 00:00:00+03:00,out,False,899968,False,24,4459,4904,445
167011,2019-09-11 00:00:00+03:00,in,False,-1,True,5,0,232,232
167011,2019-09-11 00:00:00+03:00,out,False,899932,False,12,3709,3881,172
167011,2019-09-11 00:00:00+03:00,out,False,899964,False,12,3787,3972,185
167011,2019-09-11 00:00:00+03:00,out,False,899972,True,15,0,176,176
167011,2019-09-11 00:00:00+03:00,out,False,899968,True,17,0,395,395
167011,2019-09-11 00:00:00+03:00,out,False,899790,False,31,8902,9391,489
167011,2019-09-11 00:00:00+03:00,out,False,899788,False,24,3271,3675,404
167011,2019-09-11 00:00:00+03:00,out,False,899932,True,10,0,109,109
167011,2019-09-11 00:00:00+03:00,out,True,899972,True,1,0,2,2
167011,2019-09-11 00:00:00+03:00,out,True,899968,True,1,0,1,1
167011,2019-09-11 00:00:00+03:00,out,False,899964,True,9,0,265,265
167011,2019-09-11 00:00:00+03:00,out,False,899788,True,29,0,547,547
167011,2019-09-11 00:00:00+03:00,out,False,899972,False,6,1038,1114,76
167011,2019-09-11 00:00:00+03:00,out,False,899968,True,17,0,395,395
167011,2019-09-11 00:00:00+03:00,in,False,-1,True,5,0,232,232
167011,2019-09-11 00:00:00+03:00,out,True,899972,True,1,0,2,2
167011,2019-09-11 00:00:00+03:00,out,False,899964,True,9,0,265,265
167011,2019-09-12 00:00:00+03:00,in,False,-1,True,4,0,134,134
167011,2019-09-12 00:00:00+03:00,out,False,899788,False,32,6662,7293,631
167011,2019-09-12 00:00:00+03:00,out,False,899968,True,1,0,33,33
167011,2019-09-12 00:00:00+03:00,out,True,899788,True,1,0,0,0
167011,2019-09-12 00:00:00+03:00,out,False,899972,False,3,847,887,40
167011,2019-09-12 00:00:00+03:00,out,True,899932,True,1,0,1,1
167011,2019-09-12 00:00:00+03:00,out,False,899932,False,20,5904,6147,243
167011,2019-09-12 00:00:00+03:00,out,False,899964,True,8,0,158,158
167011,2019-09-12 00:00:00+03:00,out,False,899932,True,14,0,330,330
167011,2019-09-12 00:00:00+03:00,out,False,899964,False,13,6044,6278,234
167011,2019-09-12 00:00:00+03:00,out,False,899968,False,2,334,391,57
167011,2019-09-12 00:00:00+03:00,out,False,899788,True,11,0,240,240
167011,2019-09-13 00:00:00+03:00,out,False,899790,False,11,3756,3997,241
167011,2019-09-13 00:00:00+03:00,in,False,-1,True,1,0,7,7
167011,2019-09-13 00:00:00+03:00,out,False,899790,True,10,0,342,342
167011,2019-09-13 00:00:00+03:00,out,False,899788,True,16,0,471,471
167011,2019-09-13 00:00:00+03:00,out,False,899972,True,2,0,51,51
167011,2019-09-13 00:00:00+03:00,out,False,899932,True,7,0,191,191
167011,2019-09-13 00:00:00+03:00,out,False,899972,False,2,46,72,26
167011,2019-09-13 00:00:00+03:00,out,False,899968,True,1,0,13,13
167011,2019-09-13 00:00:00+03:00,out,False,899968,False,5,966,1058,92
167011,2019-09-13 00:00:00+03:00,out,False,899964,False,26,4108,4537,429
167011,2019-09-13 00:00:00+03:00,out,False,899964,True,15,0,466,466
167011,2019-09-13 00:00:00+03:00,in,False,-1,True,8,0,411,411
167011,2019-09-13 00:00:00+03:00,out,False,899788,False,21,6620,6979,359
167011,2019-09-13 00:00:00+03:00,out,False,899932,False,21,5262,5562,300
167011,2019-09-14 00:00:00+03:00,in,False,-1,True,2,0,78,78
167011,2019-09-14 00:00:00+03:00,in,False,-1,True,2,0,78,78
167011,2019-09-15 00:00:00+03:00,in,False,-1,True,2,0,76,76
167011,2019-09-16 00:00:00+03:00,out,False,899790,True,15,0,289,289
167011,2019-09-16 00:00:00+03:00,out,False,899972,True,2,0,5,5
167011,2019-09-16 00:00:00+03:00,out,False,899964,False,17,4324,4531,207
167011,2019-09-16 00:00:00+03:00,out,False,899788,False,8,1848,1998,150
167011,2019-09-16 00:00:00+03:00,out,False,899788,True,6,0,209,209
167011,2019-09-16 00:00:00+03:00,in,False,-1,True,6,0,117,117
167011,2019-09-16 00:00:00+03:00,out,False,899972,False,2,200,210,10
167011,2019-09-16 00:00:00+03:00,out,False,899968,False,8,3956,4102,146
167011,2019-09-16 00:00:00+03:00,out,False,899790,False,10,5176,5332,156
167011,2019-09-16 00:00:00+03:00,out,False,899968,True,5,0,170,170
167011,2019-09-16 00:00:00+03:00,out,False,899932,True,36,0,852,852
167011,2019-09-16 00:00:00+03:00,out,False,899932,False,15,5395,5639,244
167011,2019-09-16 00:00:00+03:00,out,False,899964,True,15,0,448,448
167011,2019-09-16 00:00:00+03:00,out,False,899790,True,15,0,289,289
167011,2019-09-16 00:00:00+03:00,out,False,899932,False,15,5395,5639,244
167011,2019-09-17 00:00:00+03:00,out,False,899790,True,37,0,762,762
167011,2019-09-17 00:00:00+03:00,out,False,899972,False,2,611,638,27
167011,2019-09-17 00:00:00+03:00,out,True,899968,True,1,0,0,0
167011,2019-09-17 00:00:00+03:00,out,False,899932,False,17,6369,6622,253
167011,2019-09-17 00:00:00+03:00,out,False,899932,True,4,0,57,57
167011,2019-09-17 00:00:00+03:00,out,False,899968,False,13,4504,4767,263
167011,2019-09-17 00:00:00+03:00,out,False,-1,True,1,0,0,0
167011,2019-09-17 00:00:00+03:00,out,False,899788,False,4,1367,1428,61
167011,2019-09-17 00:00:00+03:00,out,False,899790,False,12,3629,3842,213
167011,2019-09-17 00:00:00+03:00,in,False,-1,True,6,0,327,327
167011,2019-09-17 00:00:00+03:00,out,False,899972,True,3,0,53,53
167011,2019-09-17 00:00:00+03:00,out,False,899788,True,11,0,224,224
167011,2019-09-17 00:00:00+03:00,out,False,899968,True,7,0,171,171
167011,2019-09-17 00:00:00+03:00,out,False,899968,True,7,0,171,171
167011,2019-09-18 00:00:00+03:00,out,False,899790,False,4,1104,1186,82
167011,2019-09-18 00:00:00+03:00,out,False,899964,True,26,0,362,362
167011,2019-09-18 00:00:00+03:00,out,False,899972,False,3,795,840,45
167011,2019-09-18 00:00:00+03:00,out,False,899932,False,17,6099,6454,355
167011,2019-09-18 00:00:00+03:00,out,False,899968,True,11,0,316,316
167011,2019-09-18 00:00:00+03:00,out,True,899788,True,1,0,0,0
167011,2019-09-18 00:00:00+03:00,in,False,-1,True,12,0,491,491
167011,2019-09-18 00:00:00+03:00,out,False,899788,True,3,0,125,125
167011,2019-09-18 00:00:00+03:00,out,False,899932,True,13,0,288,288
167011,2019-09-18 00:00:00+03:00,out,False,899964,False,19,6277,6614,337
167011,2019-09-18 00:00:00+03:00,out,False,899788,False,4,1269,1339,70
167011,2019-09-18 00:00:00+03:00,out,False,899968,False,15,3448,3701,253
167011,2019-09-18 00:00:00+03:00,out,False,899932,False,17,6099,6454,355
167011,2019-09-19 00:00:00+03:00,out,False,899932,False,11,2409,2558,149
167011,2019-09-19 00:00:00+03:00,out,False,899972,False,1,4,32,28
167011,2019-09-19 00:00:00+03:00,out,False,899790,False,3,485,559,74
167011,2019-09-19 00:00:00+03:00,out,False,899788,False,6,411,540,129
167011,2019-09-19 00:00:00+03:00,out,False,899964,False,11,1907,2043,136
167011,2019-09-19 00:00:00+03:00,out,False,899972,True,1,0,24,24
167011,2019-09-19 00:00:00+03:00,out,False,899932,True,1,0,42,42
167011,2019-09-19 00:00:00+03:00,out,False,899788,True,10,0,130,130
167011,2019-09-19 00:00:00+03:00,out,False,899790,True,2,0,61,61
167011,2019-09-19 00:00:00+03:00,in,False,-1,True,18,0,762,762
167011,2019-09-19 00:00:00+03:00,out,False,899788,False,6,411,540,129
167011,2019-09-19 00:00:00+03:00,out,False,899932,True,1,0,42,42
167011,2019-09-20 00:00:00+03:00,out,False,899790,False,1,173,193,20
167011,2019-09-20 00:00:00+03:00,out,False,899932,True,1,0,2,2
167011,2019-09-20 00:00:00+03:00,out,False,899932,False,6,1677,1755,78
167011,2019-09-20 00:00:00+03:00,out,False,899964,True,3,0,15,15
167011,2019-09-20 00:00:00+03:00,out,False,899964,False,5,1287,1358,71
167011,2019-09-20 00:00:00+03:00,out,False,899788,True,5,0,136,136
167011,2019-09-20 00:00:00+03:00,out,False,899788,False,8,3096,3179,83
167011,2019-09-21 00:00:00+03:00,in,False,-1,True,1,0,35,35
167011,2019-09-23 00:00:00+03:00,out,False,899932,False,3,635,659,24
167011,2019-09-23 00:00:00+03:00,in,False,-1,True,2,0,65,65
167011,2019-09-23 00:00:00+03:00,out,False,899788,True,10,0,175,175
167011,2019-09-23 00:00:00+03:00,out,False,899788,False,11,1979,2193,214
167011,2019-09-23 00:00:00+03:00,out,False,899790,True,1,0,8,8
167011,2019-09-23 00:00:00+03:00,out,False,899932,True,11,0,11,11
167011,2019-09-25 00:00:00+03:00,in,False,-1,True,4,0,9,9
167012,2019-08-28 00:00:00+03:00,out,False,898434,False,1,6,60,54
167012,2019-08-28 00:00:00+03:00,out,False,898434,True,1,0,58,58
167012,2019-08-28 00:00:00+03:00,out,True,898434,True,2,0,121,121
167012,2019-08-28 00:00:00+03:00,in,False,-1,True,1,0,21,21
167012,2019-08-29 00:00:00+03:00,in,False,-1,True,3,0,76,76
167012,2019-08-29 00:00:00+03:00,out,False,898434,True,4,0,114,114
167012,2019-08-30 00:00:00+03:00,in,False,-1,True,1,0,32,32
167012,2019-08-30 00:00:00+03:00,out,False,899076,True,1,0,25,25
167012,2019-08-30 00:00:00+03:00,out,True,898434,True,1,0,33,33
167012,2019-08-30 00:00:00+03:00,in,False,-1,True,2,0,11,11
167012,2019-08-30 00:00:00+03:00,out,True,899076,True,1,0,22,22
167012,2019-08-30 00:00:00+03:00,out,False,898434,True,1,0,21,21
167016,2019-10-23 00:00:00+03:00,out,False,916424,True,5,0,78,78
167016,2019-10-23 00:00:00+03:00,in,False,-1,True,24,0,159,159
167016,2019-10-23 00:00:00+03:00,in,False,916424,False,16,623,801,178
167016,2019-10-23 00:00:00+03:00,out,False,-1,True,3,0,196,196
167016,2019-10-23 00:00:00+03:00,in,False,916424,True,1,0,10,10
167016,2019-10-23 00:00:00+03:00,in,False,-1,True,24,0,159,159
167016,2019-10-24 00:00:00+03:00,in,False,916424,False,20,742,945,203
167016,2019-10-24 00:00:00+03:00,out,False,-1,True,1,0,11,11
167016,2019-10-24 00:00:00+03:00,in,False,-1,True,42,0,480,480
167016,2019-10-24 00:00:00+03:00,out,False,916424,True,2,0,22,22
167016,2019-10-24 00:00:00+03:00,in,False,916424,False,20,742,945,203
167016,2019-10-25 00:00:00+03:00,in,False,916424,False,11,807,919,112
167016,2019-10-25 00:00:00+03:00,in,False,-1,True,32,0,279,279
167016,2019-10-25 00:00:00+03:00,out,False,-1,True,1,0,16,16
167016,2019-10-26 00:00:00+03:00,in,False,916424,False,1,34,52,18
167016,2019-10-26 00:00:00+03:00,in,False,-1,True,15,0,142,142
167016,2019-10-27 00:00:00+03:00,in,False,-1,True,13,0,108,108
167016,2019-10-27 00:00:00+03:00,in,False,916424,False,4,87,117,30
167016,2019-10-27 00:00:00+03:00,out,False,916424,True,2,0,49,49
167016,2019-10-27 00:00:00+03:00,in,False,916424,False,4,87,117,30
167016,2019-10-28 00:00:00+03:00,in,False,916424,False,17,1348,1540,192
167016,2019-10-28 00:00:00+03:00,in,False,-1,True,32,0,333,333
167016,2019-10-28 00:00:00+03:00,out,False,-1,True,1,0,13,13
167016,2019-10-28 00:00:00+03:00,out,False,916424,True,1,0,10,10
167016,2019-10-28 00:00:00+03:00,in,False,-1,True,32,0,333,333
167016,2019-10-29 00:00:00+03:00,in,False,-1,True,29,0,310,310
167016,2019-10-29 00:00:00+03:00,in,False,916424,False,13,905,1052,147
167016,2019-10-29 00:00:00+03:00,in,False,916424,False,13,905,1052,147
167016,2019-10-30 00:00:00+03:00,out,False,916424,True,2,0,39,39
167016,2019-10-30 00:00:00+03:00,out,False,-1,True,1,0,11,11
167016,2019-10-30 00:00:00+03:00,in,False,916424,True,1,0,9,9
167016,2019-10-30 00:00:00+03:00,in,False,916424,False,29,1942,2242,300
167016,2019-10-30 00:00:00+03:00,in,False,-1,True,25,0,141,141
167016,2019-10-30 00:00:00+03:00,out,False,916424,True,2,0,39,39
167016,2019-10-31 00:00:00+03:00,in,False,-1,True,25,0,180,180
167016,2019-10-31 00:00:00+03:00,in,False,916424,False,16,2424,2573,149
167016,2019-10-31 00:00:00+03:00,in,False,916424,False,16,2424,2573,149
167016,2019-11-01 00:00:00+03:00,in,False,-1,True,26,0,315,315
167016,2019-11-01 00:00:00+03:00,out,False,916424,True,1,0,10,10
167016,2019-11-01 00:00:00+03:00,in,False,916424,False,13,1013,1158,145
167016,2019-11-02 00:00:00+03:00,in,False,-1,True,7,0,80,80
167016,2019-11-03 00:00:00+03:00,in,False,916424,False,4,168,227,59
167016,2019-11-03 00:00:00+03:00,in,False,916424,True,1,0,7,7
167016,2019-11-03 00:00:00+03:00,in,False,-1,True,18,0,154,154
167016,2019-11-03 00:00:00+03:00,in,False,-1,True,18,0,154,154
167016,2019-11-04 00:00:00+03:00,in,False,-1,True,6,0,134,134
167016,2019-11-05 00:00:00+03:00,in,False,916424,False,20,1524,1678,154
167016,2019-11-05 00:00:00+03:00,in,False,-1,True,43,0,413,413
167016,2019-11-05 00:00:00+03:00,out,False,-1,True,1,0,15,15
167016,2019-11-06 00:00:00+03:00,out,False,-1,True,1,0,6,6
167016,2019-11-06 00:00:00+03:00,in,False,916424,False,27,2306,2557,251
167016,2019-11-06 00:00:00+03:00,out,False,916424,True,1,0,9,9
167016,2019-11-06 00:00:00+03:00,in,False,-1,True,21,0,160,160
167016,2019-11-06 00:00:00+03:00,in,False,916424,False,27,2306,2557,251
167016,2019-11-06 00:00:00+03:00,in,False,-1,True,21,0,160,160
167016,2019-11-07 00:00:00+03:00,in,False,916424,False,13,1084,1222,138
167016,2019-11-07 00:00:00+03:00,out,False,-1,True,2,0,33,33
167016,2019-11-07 00:00:00+03:00,out,False,916424,True,1,0,24,24
167016,2019-11-07 00:00:00+03:00,in,False,-1,True,23,0,229,229
167016,2019-11-08 00:00:00+03:00,in,False,-1,True,23,0,152,152
167016,2019-11-08 00:00:00+03:00,out,False,916424,True,4,0,76,76
167016,2019-11-08 00:00:00+03:00,in,False,916424,False,14,1076,1199,123
167016,2019-11-09 00:00:00+03:00,in,False,-1,True,15,0,208,208
167016,2019-11-09 00:00:00+03:00,in,False,916424,False,7,890,960,70
167016,2019-11-09 00:00:00+03:00,out,False,916424,True,2,0,16,16
167016,2019-11-10 00:00:00+03:00,in,False,-1,True,9,0,73,73
167016,2019-11-10 00:00:00+03:00,in,False,916424,False,4,117,166,49
167016,2019-11-11 00:00:00+03:00,out,False,916424,True,3,0,52,52
167016,2019-11-11 00:00:00+03:00,in,False,916424,False,19,2201,2385,184
167016,2019-11-11 00:00:00+03:00,in,False,-1,True,30,0,237,237
167016,2019-11-12 00:00:00+03:00,out,False,-1,True,6,0,96,96
167016,2019-11-12 00:00:00+03:00,in,False,916424,False,15,1367,1491,124
167016,2019-11-12 00:00:00+03:00,out,False,916424,True,1,0,11,11
167016,2019-11-12 00:00:00+03:00,in,False,-1,True,17,0,104,104
167016,2019-11-13 00:00:00+03:00,in,False,-1,True,26,0,221,221
167016,2019-11-13 00:00:00+03:00,in,False,916424,False,8,398,463,65
167016,2019-11-13 00:00:00+03:00,out,False,916424,True,1,0,6,6
167016,2019-11-14 00:00:00+03:00,in,False,916424,False,11,666,790,124
167016,2019-11-14 00:00:00+03:00,in,False,-1,True,23,0,240,240
167016,2019-11-15 00:00:00+03:00,in,False,-1,True,37,0,169,169
167016,2019-11-15 00:00:00+03:00,out,True,962658,True,10,0,52,52
167016,2019-11-15 00:00:00+03:00,out,False,-1,True,2,0,31,31
167016,2019-11-15 00:00:00+03:00,in,False,962902,False,7,724,794,70
167016,2019-11-15 00:00:00+03:00,out,False,962658,False,23,1496,1774,278
167016,2019-11-15 00:00:00+03:00,in,False,962658,False,24,1889,2065,176
167016,2019-11-15 00:00:00+03:00,out,False,962904,True,2,0,43,43
167016,2019-11-15 00:00:00+03:00,out,True,916424,True,13,0,57,57
167016,2019-11-15 00:00:00+03:00,in,False,916424,False,14,1183,1326,143
167016,2019-11-15 00:00:00+03:00,out,False,962902,False,10,334,477,143
167016,2019-11-15 00:00:00+03:00,out,True,962658,False,1,3,11,8
167016,2019-11-15 00:00:00+03:00,out,False,916424,False,3,159,178,19
167016,2019-11-15 00:00:00+03:00,out,True,962902,True,7,0,45,45
167016,2019-11-15 00:00:00+03:00,out,False,962658,True,5,0,87,87
167016,2019-11-15 00:00:00+03:00,out,True,916424,False,1,6,9,3
167016,2019-11-15 00:00:00+03:00,out,False,916424,True,2,0,17,17
167016,2019-11-15 00:00:00+03:00,out,False,962902,False,10,334,477,143
167016,2019-11-15 00:00:00+03:00,in,False,962658,False,24,1889,2065,176
167016,2019-11-16 00:00:00+03:00,in,False,-1,True,18,0,202,202
167016,2019-11-16 00:00:00+03:00,out,False,962658,False,7,276,397,121
167016,2019-11-16 00:00:00+03:00,in,False,962658,False,8,303,344,41
167016,2019-11-16 00:00:00+03:00,out,False,962902,False,38,1511,2270,759
167016,2019-11-16 00:00:00+03:00,out,False,962658,True,4,0,91,91
167016,2019-11-16 00:00:00+03:00,in,False,962902,False,10,758,796,38
167016,2019-11-16 00:00:00+03:00,out,True,962902,True,3,0,18,18
167016,2019-11-16 00:00:00+03:00,out,False,962902,True,15,0,527,527
167016,2019-11-16 00:00:00+03:00,out,True,962902,True,3,0,18,18
167016,2019-11-16 00:00:00+03:00,out,False,962902,False,38,1511,2270,759
167016,2019-11-17 00:00:00+03:00,in,False,-1,True,6,0,164,164
167016,2019-11-17 00:00:00+03:00,out,False,962658,True,1,0,29,29
167016,2019-11-17 00:00:00+03:00,out,False,962658,False,7,82,220,138
167016,2019-11-17 00:00:00+03:00,in,False,962658,False,11,922,1009,87
167016,2019-11-17 00:00:00+03:00,in,False,-1,True,6,0,164,164
167016,2019-11-18 00:00:00+03:00,in,False,-1,True,94,0,1464,1464
167016,2019-11-18 00:00:00+03:00,out,True,962902,True,4,0,23,23
167016,2019-11-18 00:00:00+03:00,out,False,962658,False,9,188,307,119
167016,2019-11-18 00:00:00+03:00,in,False,916424,False,9,739,807,68
167016,2019-11-18 00:00:00+03:00,in,False,962658,False,22,1429,1632,203
167016,2019-11-18 00:00:00+03:00,out,False,916424,True,1,0,60,60
167016,2019-11-18 00:00:00+03:00,out,False,962902,True,4,0,53,53
167016,2019-11-18 00:00:00+03:00,out,False,962658,True,5,0,103,103
167016,2019-11-18 00:00:00+03:00,out,False,916424,False,4,522,559,37
167016,2019-11-18 00:00:00+03:00,in,False,962902,False,26,3150,3343,193
167016,2019-11-18 00:00:00+03:00,out,False,962902,False,32,2511,3004,493
167016,2019-11-18 00:00:00+03:00,out,True,916424,True,1,0,7,7
167016,2019-11-18 00:00:00+03:00,out,True,962658,True,9,0,52,52
167016,2019-11-18 00:00:00+03:00,in,False,916424,False,9,739,807,68
167016,2019-11-19 00:00:00+03:00,out,False,916424,False,7,422,502,80
167016,2019-11-19 00:00:00+03:00,in,False,962658,False,33,5375,5713,338
167016,2019-11-19 00:00:00+03:00,out,False,962902,True,7,0,229,229
167016,2019-11-19 00:00:00+03:00,out,False,962658,True,3,0,54,54
167016,2019-11-19 00:00:00+03:00,out,True,916424,True,6,0,38,38
167016,2019-11-19 00:00:00+03:00,out,False,962902,False,11,323,499,176
167016,2019-11-19 00:00:00+03:00,out,True,962658,True,7,0,40,40
167016,2019-11-19 00:00:00+03:00,in,False,-1,True,37,0,588,588
167016,2019-11-19 00:00:00+03:00,in,False,916424,False,8,601,689,88
167016,2019-11-19 00:00:00+03:00,out,False,962658,False,15,778,964,186
167016,2019-11-19 00:00:00+03:00,out,False,916424,True,2,0,17,17
167016,2019-11-19 00:00:00+03:00,in,False,962902,False,22,1856,2045,189
167016,2019-11-19 00:00:00+03:00,out,False,962658,False,15,778,964,186
167016,2019-11-20 00:00:00+03:00,out,False,962658,False,37,1354,1874,520
167016,2019-11-20 00:00:00+03:00,out,True,962658,True,1,0,6,6
167016,2019-11-20 00:00:00+03:00,out,False,962658,True,10,0,270,270
167016,2019-11-20 00:00:00+03:00,in,False,962658,False,38,3251,3505,254
167016,2019-11-20 00:00:00+03:00,out,False,962902,False,32,2123,2659,536
167016,2019-11-20 00:00:00+03:00,out,True,916424,True,4,0,34,34
167016,2019-11-20 00:00:00+03:00,in,False,-1,True,35,0,317,317
167016,2019-11-20 00:00:00+03:00,in,False,916424,False,10,1035,1129,94
167016,2019-11-20 00:00:00+03:00,in,False,962902,False,25,1868,2077,209
167016,2019-11-20 00:00:00+03:00,out,False,916424,False,7,1861,1946,85
167016,2019-11-20 00:00:00+03:00,out,True,962902,True,1,0,6,6
167016,2019-11-20 00:00:00+03:00,out,False,962902,True,14,0,426,426
167016,2019-11-21 00:00:00+03:00,out,False,962902,True,15,0,323,323
167016,2019-11-21 00:00:00+03:00,out,True,962658,True,4,0,24,24
167016,2019-11-21 00:00:00+03:00,out,True,962902,True,3,0,17,17
167016,2019-11-21 00:00:00+03:00,out,False,962658,False,12,425,557,132
167016,2019-11-21 00:00:00+03:00,in,False,916424,False,14,1397,1577,180
167016,2019-11-21 00:00:00+03:00,in,False,-1,True,57,0,752,752
167016,2019-11-21 00:00:00+03:00,in,False,962902,False,25,2512,2719,207
167016,2019-11-21 00:00:00+03:00,out,False,916424,False,7,589,653,64
167016,2019-11-21 00:00:00+03:00,out,True,916424,True,1,0,9,9
167016,2019-11-21 00:00:00+03:00,out,True,916424,False,2,76,78,2
167016,2019-11-21 00:00:00+03:00,out,False,962902,False,22,2316,2637,321
167016,2019-11-21 00:00:00+03:00,in,False,962658,False,32,2542,2797,255
167016,2019-11-21 00:00:00+03:00,out,False,962658,True,1,0,17,17
167016,2019-11-21 00:00:00+03:00,out,True,962902,False,1,7,19,12
167016,2019-11-21 00:00:00+03:00,out,False,962658,True,1,0,17,17
167016,2019-11-21 00:00:00+03:00,in,False,-1,True,57,0,752,752
167016,2019-11-22 00:00:00+03:00,in,False,916424,False,9,379,492,113
167016,2019-11-22 00:00:00+03:00,out,True,962658,False,4,239,256,17
167016,2019-11-22 00:00:00+03:00,out,True,962902,True,1,0,5,5
167016,2019-11-22 00:00:00+03:00,in,False,962658,False,31,3371,3632,261
167016,2019-11-22 00:00:00+03:00,out,True,962658,True,1,0,0,0
167016,2019-11-22 00:00:00+03:00,out,False,962658,False,11,1812,2016,204
167016,2019-11-22 00:00:00+03:00,in,False,962902,False,26,2198,2419,221
167016,2019-11-22 00:00:00+03:00,out,False,962902,False,5,495,568,73
167016,2019-11-22 00:00:00+03:00,out,False,916424,False,6,978,1046,68
167016,2019-11-22 00:00:00+03:00,out,False,962902,True,5,0,106,106
167016,2019-11-22 00:00:00+03:00,out,False,962658,True,4,0,129,129
167016,2019-11-22 00:00:00+03:00,out,True,962902,False,6,587,677,90
167016,2019-11-22 00:00:00+03:00,in,False,-1,True,22,0,151,151
167016,2019-11-22 00:00:00+03:00,in,False,-1,True,22,0,151,151
167016,2019-11-22 00:00:00+03:00,out,False,962902,False,5,495,568,73
167016,2019-11-22 00:00:00+03:00,out,True,962658,True,1,0,0,0
167016,2019-11-23 00:00:00+03:00,in,False,-1,True,7,0,407,407
167016,2019-11-23 00:00:00+03:00,out,False,962658,False,3,108,162,54
167016,2019-11-23 00:00:00+03:00,in,False,962658,False,3,183,202,19
167016,2019-11-23 00:00:00+03:00,out,False,962902,False,25,994,1482,488
167016,2019-11-23 00:00:00+03:00,out,False,962902,True,6,0,150,150
167016,2019-11-23 00:00:00+03:00,out,False,962658,True,1,0,19,19
167016,2019-11-23 00:00:00+03:00,in,False,962902,False,2,123,132,9
167016,2019-11-24 00:00:00+03:00,in,False,962658,False,13,873,975,102
167016,2019-11-24 00:00:00+03:00,out,False,962658,True,5,0,178,178
167016,2019-11-24 00:00:00+03:00,in,False,916424,False,2,272,299,27
167016,2019-11-24 00:00:00+03:00,in,False,-1,True,11,0,401,401
167016,2019-11-24 00:00:00+03:00,out,False,962658,False,11,939,1128,189
167016,2019-11-25 00:00:00+03:00,out,True,916424,False,5,364,376,12
167016,2019-11-25 00:00:00+03:00,out,False,962658,True,8,0,207,207
167016,2019-11-25 00:00:00+03:00,out,False,962902,False,30,1038,1581,543
167016,2019-11-25 00:00:00+03:00,out,False,962658,False,15,526,737,211
167016,2019-11-25 00:00:00+03:00,in,False,962902,False,17,891,1000,109
167016,2019-11-25 00:00:00+03:00,out,True,962658,False,4,298,313,15
167016,2019-11-25 00:00:00+03:00,out,True,962902,False,4,313,344,31
167016,2019-11-25 00:00:00+03:00,in,False,962658,False,34,2119,2387,268
167016,2019-11-25 00:00:00+03:00,out,False,916424,True,1,0,35,35
167016,2019-11-25 00:00:00+03:00,out,True,962658,True,1,0,8,8
167016,2019-11-25 00:00:00+03:00,out,False,962902,True,6,0,97,97
167016,2019-11-25 00:00:00+03:00,in,False,-1,True,14,0,166,166
167016,2019-11-25 00:00:00+03:00,out,False,916424,False,8,967,1086,119
167016,2019-11-25 00:00:00+03:00,in,False,916424,False,19,1633,1826,193
167016,2019-11-25 00:00:00+03:00,out,False,962658,True,8,0,207,207
167016,2019-11-25 00:00:00+03:00,out,False,962658,False,15,526,737,211
167016,2019-11-26 00:00:00+03:00,in,False,962658,False,28,1685,2001,316
167016,2019-11-26 00:00:00+03:00,in,False,916424,False,8,416,536,120
167016,2019-11-26 00:00:00+03:00,in,False,962902,False,21,870,992,122
167016,2019-11-26 00:00:00+03:00,out,False,962658,False,3,156,189,33
167016,2019-11-26 00:00:00+03:00,in,False,-1,True,2,0,57,57
167016,2019-11-26 00:00:00+03:00,out,True,962902,False,3,181,237,56
167016,2019-11-26 00:00:00+03:00,out,False,916424,False,4,909,947,38
167016,2019-11-26 00:00:00+03:00,out,True,962658,False,4,314,345,31
167016,2019-11-26 00:00:00+03:00,out,False,962902,False,26,748,1100,352
167016,2019-11-26 00:00:00+03:00,out,True,916424,False,2,292,329,37
167016,2019-11-26 00:00:00+03:00,out,False,962902,True,2,0,13,13
167016,2019-11-26 00:00:00+03:00,in,False,962902,False,21,870,992,122
167016,2019-11-26 00:00:00+03:00,out,True,962902,False,3,181,237,56
167016,2019-11-26 00:00:00+03:00,out,False,962658,False,3,156,189,33
167016,2019-11-27 00:00:00+03:00,in,False,-1,True,17,0,167,167
167016,2019-11-27 00:00:00+03:00,out,False,962658,True,9,0,236,236
167016,2019-11-27 00:00:00+03:00,out,True,916424,True,2,0,45,45
167016,2019-11-27 00:00:00+03:00,out,False,962658,False,31,1730,2133,403
167016,2019-11-27 00:00:00+03:00,out,True,916424,False,3,250,274,24
167016,2019-11-27 00:00:00+03:00,in,False,962902,False,31,2277,2460,183
167016,2019-11-27 00:00:00+03:00,in,False,916424,False,17,1495,1640,145
167016,2019-11-27 00:00:00+03:00,out,True,962658,True,1,0,25,25
167016,2019-11-27 00:00:00+03:00,in,False,962658,False,21,1398,1536,138
167016,2019-11-27 00:00:00+03:00,out,True,962902,False,2,211,228,17
167016,2019-11-27 00:00:00+03:00,out,False,916424,False,7,772,840,68
167016,2019-11-27 00:00:00+03:00,out,False,962902,False,27,1084,1598,514
167016,2019-11-27 00:00:00+03:00,out,False,916424,True,3,0,30,30
167016,2019-11-27 00:00:00+03:00,out,True,962658,False,1,17,19,2
167016,2019-11-27 00:00:00+03:00,out,False,962902,True,2,0,83,83
167016,2019-11-27 00:00:00+03:00,in,False,962658,False,21,1398,1536,138
167016,2019-11-28 00:00:00+03:00,in,False,-1,True,10,0,84,84
167016,2019-11-28 00:00:00+03:00,in,False,962902,False,11,839,899,60
167016,2019-11-28 00:00:00+03:00,out,False,916424,False,7,953,1026,73
167016,2019-11-28 00:00:00+03:00,out,True,916424,False,5,616,627,11
167016,2019-11-28 00:00:00+03:00,out,False,962658,False,24,483,853,370
167016,2019-11-28 00:00:00+03:00,out,False,962658,True,8,0,166,166
167016,2019-11-28 00:00:00+03:00,in,False,916424,False,9,777,925,148
167016,2019-11-28 00:00:00+03:00,in,False,962658,False,33,2565,2828,263
167016,2019-11-28 00:00:00+03:00,out,False,962902,False,26,1121,1567,446
167016,2019-11-28 00:00:00+03:00,out,True,962902,False,4,86,134,48
167016,2019-11-28 00:00:00+03:00,out,False,916424,True,1,0,11,11
167016,2019-11-28 00:00:00+03:00,out,False,962658,True,8,0,166,166
167031,2019-09-17 00:00:00+03:00,out,False,910520,True,5,0,41,41
167031,2019-09-17 00:00:00+03:00,out,False,910520,False,9,741,882,141
167031,2019-09-18 00:00:00+03:00,in,False,-1,True,1,0,45,45
167031,2019-09-18 00:00:00+03:00,out,False,910530,False,29,2423,2780,357
167031,2019-09-18 00:00:00+03:00,out,False,910532,True,6,0,103,103
167031,2019-09-18 00:00:00+03:00,out,False,910530,True,23,0,570,570
167031,2019-09-18 00:00:00+03:00,out,False,910532,False,5,350,465,115
167031,2019-09-18 00:00:00+03:00,in,False,-1,True,1,0,45,45
167031,2019-09-19 00:00:00+03:00,out,False,910520,True,10,0,173,173
167031,2019-09-19 00:00:00+03:00,out,False,910520,False,10,346,473,127
167031,2019-09-20 00:00:00+03:00,out,False,910532,False,3,519,562,43
167031,2019-09-20 00:00:00+03:00,in,False,-1,True,1,0,5,5
167031,2019-09-21 00:00:00+03:00,in,False,910516,False,1,195,212,17
167031,2019-09-21 00:00:00+03:00,in,False,910516,False,1,195,212,17
167031,2019-09-23 00:00:00+03:00,out,False,910520,False,1,169,176,7
167031,2019-09-23 00:00:00+03:00,out,False,910520,False,1,169,176,7
167031,2019-09-24 00:00:00+03:00,out,False,910532,False,2,229,237,8
167031,2019-09-24 00:00:00+03:00,out,False,910532,False,2,229,237,8
167031,2019-09-25 00:00:00+03:00,out,False,910532,False,4,489,505,16
167031,2019-09-25 00:00:00+03:00,out,False,910530,False,13,3148,3221,73
167031,2019-09-25 00:00:00+03:00,in,False,910516,False,6,502,604,102
167031,2019-09-25 00:00:00+03:00,out,False,910530,True,6,0,108,108
167031,2019-09-26 00:00:00+03:00,out,False,910530,False,15,956,1127,171
167031,2019-09-26 00:00:00+03:00,out,False,910532,False,14,1093,1243,150
167031,2019-09-26 00:00:00+03:00,out,False,910520,False,2,31,44,13
167031,2019-09-26 00:00:00+03:00,in,False,910516,False,3,86,143,57
167031,2019-09-26 00:00:00+03:00,out,True,910524,True,1,0,0,0
167031,2019-09-26 00:00:00+03:00,out,False,910524,True,8,0,107,107
167031,2019-09-26 00:00:00+03:00,out,False,910524,False,14,1441,1580,139
167031,2019-09-26 00:00:00+03:00,out,False,910530,True,11,0,270,270
167031,2019-09-26 00:00:00+03:00,out,False,910532,True,12,0,268,268
167031,2019-09-26 00:00:00+03:00,out,False,910532,True,12,0,268,268
167031,2019-09-27 00:00:00+03:00,in,False,910516,False,1,81,151,70
167031,2019-09-30 00:00:00+03:00,out,False,910524,True,6,0,107,107
167031,2019-09-30 00:00:00+03:00,out,False,910524,False,2,187,199,12
167031,2019-09-30 00:00:00+03:00,out,False,910532,True,4,0,90,90
167031,2019-09-30 00:00:00+03:00,out,False,910532,False,6,275,305,30
167031,2019-09-30 00:00:00+03:00,out,False,910532,False,6,275,305,30
167031,2019-10-01 00:00:00+03:00,out,False,910524,False,3,546,577,31
167031,2019-10-01 00:00:00+03:00,out,False,910524,True,2,0,30,30
167031,2019-10-01 00:00:00+03:00,in,False,910516,False,1,125,144,19
167031,2019-10-03 00:00:00+03:00,in,False,910516,False,2,110,136,26
167031,2019-10-03 00:00:00+03:00,out,False,910524,True,16,0,564,564
167031,2019-10-03 00:00:00+03:00,out,False,910524,False,31,3504,3778,274
167031,2019-10-03 00:00:00+03:00,in,False,-1,True,2,0,35,35
167031,2019-10-04 00:00:00+03:00,out,False,910520,True,5,0,163,163
167031,2019-10-04 00:00:00+03:00,in,False,910516,False,1,18,33,15
167031,2019-10-04 00:00:00+03:00,out,False,910520,False,6,874,933,59
167031,2019-10-04 00:00:00+03:00,out,False,910524,False,2,198,208,10
167031,2019-10-07 00:00:00+03:00,out,False,910520,False,2,522,542,20
167031,2019-10-08 00:00:00+03:00,out,False,910520,False,6,1343,1390,47
167031,2019-10-08 00:00:00+03:00,out,False,910530,False,28,2016,2353,337
167031,2019-10-08 00:00:00+03:00,out,False,910520,True,3,0,117,117
167031,2019-10-08 00:00:00+03:00,in,False,910516,False,1,9,23,14
167031,2019-10-08 00:00:00+03:00,out,False,910530,True,16,0,394,394
167031,2019-10-09 00:00:00+03:00,out,False,910520,True,3,0,84,84
167031,2019-10-09 00:00:00+03:00,out,False,910530,True,4,0,123,123
167031,2019-10-09 00:00:00+03:00,out,False,910532,False,11,919,1001,82
167031,2019-10-09 00:00:00+03:00,out,False,910520,False,11,570,737,167
167031,2019-10-09 00:00:00+03:00,out,False,910530,False,15,1119,1346,227
167031,2019-10-09 00:00:00+03:00,out,False,910532,True,2,0,39,39
167031,2019-10-09 00:00:00+03:00,out,False,910520,False,11,570,737,167
167031,2019-10-10 00:00:00+03:00,in,False,910516,False,1,71,95,24
167031,2019-10-10 00:00:00+03:00,out,False,910530,False,73,5681,6368,687
167031,2019-10-10 00:00:00+03:00,out,False,910532,True,5,0,98,98
167031,2019-10-10 00:00:00+03:00,out,False,910532,False,12,1363,1434,71
167031,2019-10-10 00:00:00+03:00,out,False,910520,False,4,1151,1186,35
167031,2019-10-10 00:00:00+03:00,out,False,910530,True,28,0,738,738
167031,2019-10-10 00:00:00+03:00,in,False,910516,False,1,71,95,24
167031,2019-10-11 00:00:00+03:00,out,False,910530,False,31,1951,2277,326
167031,2019-10-11 00:00:00+03:00,in,False,910516,False,1,43,52,9
167031,2019-10-11 00:00:00+03:00,in,False,-1,True,1,0,42,42
167031,2019-10-11 00:00:00+03:00,out,False,910530,True,16,0,420,420
167031,2019-10-11 00:00:00+03:00,out,False,910530,True,16,0,420,420
167031,2019-10-14 00:00:00+03:00,out,False,910530,False,80,4896,5703,807
167031,2019-10-14 00:00:00+03:00,in,False,910516,False,1,30,56,26
167031,2019-10-14 00:00:00+03:00,out,False,910520,True,5,0,107,107
167031,2019-10-14 00:00:00+03:00,out,False,910530,True,49,0,1342,1342
167031,2019-10-14 00:00:00+03:00,out,False,910520,False,13,508,599,91
167031,2019-10-14 00:00:00+03:00,out,False,910520,False,13,508,599,91
167031,2019-10-15 00:00:00+03:00,out,False,910520,False,17,1511,1747,236
167031,2019-10-15 00:00:00+03:00,in,False,910516,False,1,203,222,19
167031,2019-10-15 00:00:00+03:00,out,False,910520,True,8,0,180,180
167031,2019-10-16 00:00:00+03:00,out,False,910520,True,3,0,90,90
167031,2019-10-16 00:00:00+03:00,out,False,910530,True,54,0,1728,1728
167031,2019-10-16 00:00:00+03:00,out,False,910520,False,7,358,414,56
167031,2019-10-16 00:00:00+03:00,out,False,910530,False,94,7587,8529,942
167031,2019-10-16 00:00:00+03:00,in,False,910516,False,1,21,60,39
167031,2019-10-17 00:00:00+03:00,out,False,910530,True,41,0,1264,1264
167031,2019-10-17 00:00:00+03:00,in,False,910516,False,3,79,126,47
167031,2019-10-17 00:00:00+03:00,in,False,-1,True,1,0,9,9
167031,2019-10-17 00:00:00+03:00,out,False,910530,False,71,3731,4437,706
167031,2019-10-17 00:00:00+03:00,out,False,-1,True,1,0,0,0
167031,2019-10-17 00:00:00+03:00,out,False,910520,True,2,0,53,53
167031,2019-10-17 00:00:00+03:00,out,False,910520,False,4,181,216,35
167031,2019-10-18 00:00:00+03:00,in,False,910516,False,1,31,110,79
167031,2019-10-18 00:00:00+03:00,out,False,910520,False,1,94,105,11
167031,2019-10-18 00:00:00+03:00,out,False,910520,True,1,0,41,41
167031,2019-10-21 00:00:00+03:00,out,False,910520,True,8,0,10,10
167031,2019-10-21 00:00:00+03:00,out,False,910520,False,3,274,307,33
167031,2019-10-22 00:00:00+03:00,out,False,910520,False,8,1716,1770,54
167031,2019-10-22 00:00:00+03:00,out,False,910532,False,43,2706,3032,326
167031,2019-10-22 00:00:00+03:00,out,False,910530,True,24,0,441,441
167031,2019-10-22 00:00:00+03:00,out,False,910532,True,17,0,292,292
167031,2019-10-22 00:00:00+03:00,out,False,910530,False,59,3674,4159,485
167031,2019-10-22 00:00:00+03:00,out,False,910532,False,43,2706,3032,326
167031,2019-10-23 00:00:00+03:00,in,False,910516,False,1,41,69,28
167031,2019-10-23 00:00:00+03:00,out,False,910532,False,4,638,656,18
167031,2019-10-23 00:00:00+03:00,out,False,910530,False,61,3023,3611,588
167031,2019-10-23 00:00:00+03:00,out,False,910530,True,49,0,1476,1476
167031,2019-10-23 00:00:00+03:00,out,False,910520,False,1,581,591,10
167031,2019-10-24 00:00:00+03:00,out,False,910530,True,25,0,739,739
167031,2019-10-24 00:00:00+03:00,in,False,910516,False,1,23,64,41
167031,2019-10-24 00:00:00+03:00,out,False,910520,False,1,464,470,6
167031,2019-10-24 00:00:00+03:00,out,False,910530,False,64,4711,5229,518
167031,2019-10-24 00:00:00+03:00,in,False,910516,False,1,23,64,41
167031,2019-10-25 00:00:00+03:00,out,False,910530,False,56,3920,4444,524
167031,2019-10-25 00:00:00+03:00,in,False,910516,False,1,23,39,16
167031,2019-10-25 00:00:00+03:00,out,False,910530,True,26,0,927,927
167031,2019-10-25 00:00:00+03:00,out,False,910520,False,2,77,87,10
167031,2019-10-25 00:00:00+03:00,out,False,910520,False,2,77,87,10
167031,2019-10-28 00:00:00+03:00,out,False,910520,False,2,475,486,11
167031,2019-10-29 00:00:00+03:00,in,False,910516,False,1,24,37,13
167031,2019-10-30 00:00:00+03:00,out,False,910520,True,1,0,5,5
167031,2019-10-30 00:00:00+03:00,out,False,910520,False,5,682,712,30
167031,2019-10-31 00:00:00+03:00,out,False,910520,True,1,0,60,60
167031,2019-10-31 00:00:00+03:00,out,False,910520,False,1,304,309,5
167031,2019-11-05 00:00:00+03:00,out,False,910520,False,4,268,305,37
167031,2019-11-05 00:00:00+03:00,in,False,-1,True,1,0,29,29
167031,2019-11-06 00:00:00+03:00,out,False,910520,True,2,0,15,15
167031,2019-11-06 00:00:00+03:00,out,False,910520,False,2,864,873,9
167031,2019-11-07 00:00:00+03:00,out,False,910520,False,2,1189,1193,4
167031,2019-11-08 00:00:00+03:00,out,False,910520,True,1,0,46,46
167031,2019-11-08 00:00:00+03:00,out,False,910520,False,2,303,316,13
167031,2019-11-11 00:00:00+03:00,out,False,910520,True,2,0,101,101
167031,2019-11-11 00:00:00+03:00,out,False,910520,False,2,167,177,10
167031,2019-11-12 00:00:00+03:00,out,False,910520,False,1,431,433,2
167031,2019-11-13 00:00:00+03:00,out,False,910520,False,4,459,472,13
167031,2019-11-13 00:00:00+03:00,out,False,910520,True,1,0,53,53
167031,2019-11-13 00:00:00+03:00,out,False,910532,False,1,11,20,9
167031,2019-11-13 00:00:00+03:00,out,False,910520,True,1,0,53,53
167031,2019-11-14 00:00:00+03:00,in,False,-1,True,1,0,22,22
167031,2019-11-15 00:00:00+03:00,in,False,910516,False,1,6,17,11
167031,2019-11-18 00:00:00+03:00,out,False,910520,True,1,0,8,8
167031,2019-11-18 00:00:00+03:00,out,False,910520,False,1,207,215,8
167031,2019-11-19 00:00:00+03:00,out,False,910520,False,1,40,42,2
167031,2019-11-20 00:00:00+03:00,out,False,910520,False,1,64,66,2
167031,2019-11-20 00:00:00+03:00,in,False,910516,False,1,247,266,19
167031,2019-11-20 00:00:00+03:00,out,False,910520,False,1,64,66,2
167031,2019-11-27 00:00:00+03:00,in,False,910516,False,1,2,12,10
167035,2019-09-30 00:00:00+03:00,out,False,923528,False,17,343,599,256
167035,2019-09-30 00:00:00+03:00,out,False,923526,False,13,2131,2309,178
167035,2019-09-30 00:00:00+03:00,in,False,-1,True,3,0,83,83
167035,2019-09-30 00:00:00+03:00,in,False,923528,False,4,272,360,88
167035,2019-09-30 00:00:00+03:00,out,False,923528,True,9,0,181,181
167035,2019-09-30 00:00:00+03:00,in,False,923526,False,8,486,535,49
167035,2019-09-30 00:00:00+03:00,out,False,923526,True,6,0,160,160
167035,2019-09-30 00:00:00+03:00,out,False,923528,True,9,0,181,181
167035,2019-10-01 00:00:00+03:00,in,False,923526,False,9,1070,1153,83
167035,2019-10-01 00:00:00+03:00,in,False,923528,False,3,227,311,84
167035,2019-10-01 00:00:00+03:00,out,False,923528,False,2,62,96,34
167035,2019-10-01 00:00:00+03:00,out,False,923526,False,28,866,1297,431
167035,2019-10-01 00:00:00+03:00,out,False,923526,True,5,0,169,169
167035,2019-10-01 00:00:00+03:00,in,False,-1,True,2,0,16,16
167035,2019-10-01 00:00:00+03:00,out,False,923528,True,2,0,79,79
167035,2019-10-02 00:00:00+03:00,out,False,923526,True,5,0,129,129
167035,2019-10-02 00:00:00+03:00,in,False,923528,False,1,73,97,24
167035,2019-10-02 00:00:00+03:00,in,False,923526,False,16,1190,1356,166
167035,2019-10-02 00:00:00+03:00,out,False,923526,False,23,1016,1374,358
167035,2019-10-02 00:00:00+03:00,in,False,-1,True,3,0,39,39
167035,2019-10-02 00:00:00+03:00,out,False,923526,True,5,0,129,129
167035,2019-10-02 00:00:00+03:00,in,False,923526,False,16,1190,1356,166
167035,2019-10-03 00:00:00+03:00,out,False,923528,False,6,267,331,64
167035,2019-10-03 00:00:00+03:00,out,False,923526,True,11,0,372,372
167035,2019-10-03 00:00:00+03:00,in,False,923528,False,2,127,173,46
167035,2019-10-03 00:00:00+03:00,in,False,923526,False,9,423,495,72
167035,2019-10-03 00:00:00+03:00,out,False,923528,True,2,0,54,54
167035,2019-10-03 00:00:00+03:00,in,False,-1,True,1,0,15,15
167035,2019-10-03 00:00:00+03:00,out,False,923526,False,18,427,735,308
167035,2019-10-04 00:00:00+03:00,in,False,923528,False,2,285,339,54
167035,2019-10-04 00:00:00+03:00,in,False,-1,True,1,0,33,33
167035,2019-10-04 00:00:00+03:00,out,False,923526,False,23,1257,1560,303
167035,2019-10-04 00:00:00+03:00,in,False,923526,False,9,1101,1202,101
167035,2019-10-04 00:00:00+03:00,out,False,923526,True,5,0,148,148
167035,2019-10-04 00:00:00+03:00,out,False,923526,False,23,1257,1560,303
167035,2019-10-05 00:00:00+03:00,in,False,923526,False,7,453,516,63
167035,2019-10-05 00:00:00+03:00,out,False,923526,True,8,0,254,254
167035,2019-10-05 00:00:00+03:00,in,False,-1,True,1,0,12,12
167035,2019-10-05 00:00:00+03:00,in,False,923528,False,1,112,135,23
167035,2019-10-05 00:00:00+03:00,out,False,923526,False,30,972,1414,442
167035,2019-10-06 00:00:00+03:00,in,False,923528,False,1,138,161,23
167035,2019-10-06 00:00:00+03:00,out,False,923528,True,2,0,78,78
167035,2019-10-06 00:00:00+03:00,out,False,923526,True,12,0,243,243
167035,2019-10-06 00:00:00+03:00,in,False,-1,True,1,0,5,5
167035,2019-10-06 00:00:00+03:00,in,False,923526,False,12,610,695,85
167035,2019-10-06 00:00:00+03:00,out,False,923526,False,24,636,1021,385
167035,2019-10-06 00:00:00+03:00,out,False,923528,False,5,88,154,66
167035,2019-10-07 00:00:00+03:00,out,False,923526,False,33,1147,1642,495
167035,2019-10-07 00:00:00+03:00,in,False,923528,False,1,91,118,27
167035,2019-10-07 00:00:00+03:00,out,False,923526,True,12,0,263,263
167035,2019-10-07 00:00:00+03:00,in,False,923526,False,18,1019,1129,110
167035,2019-10-07 00:00:00+03:00,out,False,923528,False,1,17,34,17
167035,2019-10-08 00:00:00+03:00,in,False,923526,False,9,379,461,82
167035,2019-10-08 00:00:00+03:00,in,False,923528,False,2,224,276,52
167035,2019-10-08 00:00:00+03:00,out,False,923526,False,25,862,1221,359
167035,2019-10-08 00:00:00+03:00,in,False,-1,True,3,0,37,37
167035,2019-10-08 00:00:00+03:00,out,False,923526,True,9,0,264,264
167035,2019-10-09 00:00:00+03:00,out,False,923526,True,14,0,345,345
167035,2019-10-09 00:00:00+03:00,in,False,923528,False,3,364,487,123
167035,2019-10-09 00:00:00+03:00,out,False,923526,False,35,1240,1793,553
167035,2019-10-09 00:00:00+03:00,in,False,923526,False,15,1704,1849,145
167035,2019-10-10 00:00:00+03:00,in,False,923528,False,2,287,343,56
167035,2019-10-10 00:00:00+03:00,in,False,-1,True,3,0,5,5
167035,2019-10-10 00:00:00+03:00,in,False,923526,False,19,2817,3046,229
167035,2019-10-10 00:00:00+03:00,out,False,923526,False,35,933,1448,515
167035,2019-10-10 00:00:00+03:00,out,False,923526,True,15,0,356,356
167035,2019-10-10 00:00:00+03:00,out,False,923528,False,11,656,803,147
167035,2019-10-10 00:00:00+03:00,out,False,923528,True,1,0,12,12
167035,2019-10-11 00:00:00+03:00,out,False,923528,False,2,81,92,11
167035,2019-10-11 00:00:00+03:00,in,False,923526,False,17,2151,2315,164
167035,2019-10-11 00:00:00+03:00,out,False,923526,True,7,0,98,98
167035,2019-10-11 00:00:00+03:00,in,False,-1,True,1,0,2,2
167035,2019-10-11 00:00:00+03:00,out,False,923526,False,26,638,1001,363
167035,2019-10-11 00:00:00+03:00,in,False,923528,False,5,203,316,113
167035,2019-10-11 00:00:00+03:00,out,False,923528,True,1,0,13,13
167035,2019-10-12 00:00:00+03:00,in,False,923528,False,1,143,164,21
167035,2019-10-12 00:00:00+03:00,out,False,923526,True,4,0,133,133
167035,2019-10-12 00:00:00+03:00,in,False,-1,True,1,0,11,11
167035,2019-10-12 00:00:00+03:00,out,False,923526,False,18,658,941,283
167035,2019-10-12 00:00:00+03:00,in,False,923526,False,9,637,720,83
167035,2019-10-13 00:00:00+03:00,out,False,923526,False,27,1011,1427,416
167035,2019-10-13 00:00:00+03:00,out,False,923526,True,7,0,169,169
167035,2019-10-13 00:00:00+03:00,in,False,923526,False,5,258,285,27
167035,2019-10-13 00:00:00+03:00,in,False,-1,True,1,0,2,2
167035,2019-10-13 00:00:00+03:00,out,False,923526,True,7,0,169,169
167035,2019-10-14 00:00:00+03:00,out,False,923526,True,5,0,118,118
167035,2019-10-14 00:00:00+03:00,in,False,-1,True,3,0,176,176
167035,2019-10-14 00:00:00+03:00,out,False,923528,True,1,0,7,7
167035,2019-10-14 00:00:00+03:00,in,False,923528,False,1,59,82,23
167035,2019-10-14 00:00:00+03:00,in,False,923526,False,14,984,1093,109
167035,2019-10-14 00:00:00+03:00,out,False,923526,False,26,679,1019,340
167035,2019-10-14 00:00:00+03:00,out,False,923528,False,4,241,295,54
167035,2019-10-15 00:00:00+03:00,in,False,923526,False,15,1316,1453,137
167035,2019-10-15 00:00:00+03:00,out,False,923526,False,27,901,1290,389
167035,2019-10-15 00:00:00+03:00,in,False,-1,True,1,0,19,19
167035,2019-10-15 00:00:00+03:00,out,False,923526,True,5,0,90,90
167035,2019-10-16 00:00:00+03:00,in,False,923526,False,7,616,686,70
167035,2019-10-16 00:00:00+03:00,in,False,923528,False,3,99,153,54
167035,2019-10-16 00:00:00+03:00,in,False,-1,True,2,0,15,15
167035,2019-10-16 00:00:00+03:00,out,False,923526,True,5,0,156,156
167035,2019-10-16 00:00:00+03:00,out,False,923526,False,26,1161,1569,408
167035,2019-10-16 00:00:00+03:00,out,False,923526,True,5,0,156,156
167035,2019-10-17 00:00:00+03:00,in,False,923526,False,15,1026,1140,114
167035,2019-10-17 00:00:00+03:00,out,False,923526,True,11,0,379,379
167035,2019-10-17 00:00:00+03:00,out,False,923528,True,5,0,191,191
167035,2019-10-17 00:00:00+03:00,out,False,923528,False,10,181,304,123
167035,2019-10-17 00:00:00+03:00,out,False,923526,False,17,672,907,235
167035,2019-10-17 00:00:00+03:00,in,False,923528,False,2,244,287,43
167035,2019-10-17 00:00:00+03:00,in,False,923528,False,2,244,287,43
167035,2019-10-18 00:00:00+03:00,in,False,-1,True,3,0,17,17
167035,2019-10-18 00:00:00+03:00,in,False,923528,False,2,103,130,27
167035,2019-10-18 00:00:00+03:00,out,False,923526,False,33,1242,1682,440
167035,2019-10-18 00:00:00+03:00,in,False,923526,False,15,1563,1704,141
167035,2019-10-18 00:00:00+03:00,out,False,923526,True,4,0,105,105
167035,2019-10-19 00:00:00+03:00,out,False,923526,False,12,601,787,186
167035,2019-10-19 00:00:00+03:00,in,False,923526,False,3,72,93,21
167035,2019-10-19 00:00:00+03:00,out,False,923526,True,8,0,249,249
167035,2019-10-19 00:00:00+03:00,out,False,923526,True,8,0,249,249
167035,2019-10-20 00:00:00+03:00,out,False,923526,False,27,891,1284,393
167035,2019-10-20 00:00:00+03:00,in,False,923526,False,9,588,635,47
167035,2019-10-20 00:00:00+03:00,in,False,-1,True,1,0,1,1
167035,2019-10-20 00:00:00+03:00,out,False,923526,True,12,0,315,315
167035,2019-10-20 00:00:00+03:00,in,False,923528,False,1,21,31,10
167035,2019-10-21 00:00:00+03:00,in,False,923528,False,1,47,69,22
167035,2019-10-21 00:00:00+03:00,out,False,923526,False,38,946,1453,507
167035,2019-10-21 00:00:00+03:00,out,False,923528,True,2,0,44,44
167035,2019-10-21 00:00:00+03:00,in,False,923526,False,18,1226,1348,122
167035,2019-10-21 00:00:00+03:00,out,False,923526,True,8,0,200,200
167035,2019-10-21 00:00:00+03:00,in,False,-1,True,3,0,89,89
167035,2019-10-21 00:00:00+03:00,out,False,923528,False,11,245,408,163
167035,2019-10-22 00:00:00+03:00,in,False,923528,False,7,591,770,179
167035,2019-10-22 00:00:00+03:00,out,False,923526,False,40,1307,1910,603
167035,2019-10-22 00:00:00+03:00,out,False,923526,True,9,0,188,188
167035,2019-10-22 00:00:00+03:00,in,False,923526,False,12,1004,1093,89
167035,2019-10-22 00:00:00+03:00,out,False,923528,True,2,0,12,12
167035,2019-10-22 00:00:00+03:00,out,False,923528,False,3,216,269,53
167035,2019-10-22 00:00:00+03:00,in,False,-1,True,2,0,55,55
167035,2019-10-23 00:00:00+03:00,out,False,923526,False,33,1428,1860,432
167035,2019-10-23 00:00:00+03:00,in,False,923526,False,18,1288,1452,164
167035,2019-10-23 00:00:00+03:00,in,False,923528,False,3,177,235,58
167035,2019-10-23 00:00:00+03:00,in,False,-1,True,2,0,63,63
167035,2019-10-23 00:00:00+03:00,out,False,923526,True,7,0,133,133
167035,2019-10-24 00:00:00+03:00,in,False,-1,True,1,0,31,31
167035,2019-10-24 00:00:00+03:00,out,False,923528,False,25,1268,1684,416
167035,2019-10-24 00:00:00+03:00,out,False,923526,True,6,0,143,143
167035,2019-10-24 00:00:00+03:00,in,False,923526,False,9,525,581,56
167035,2019-10-24 00:00:00+03:00,out,False,923526,False,13,560,794,234
167035,2019-10-24 00:00:00+03:00,out,False,923528,True,5,0,202,202
167035,2019-10-24 00:00:00+03:00,in,False,923528,False,1,56,96,40
167035,2019-10-24 00:00:00+03:00,out,False,923526,False,13,560,794,234
167035,2019-10-24 00:00:00+03:00,out,False,923526,True,6,0,143,143
167035,2019-10-24 00:00:00+03:00,in,False,923526,False,9,525,581,56
167035,2019-10-25 00:00:00+03:00,out,False,923528,True,2,0,41,41
167035,2019-10-25 00:00:00+03:00,out,False,923526,False,15,796,1045,249
167035,2019-10-25 00:00:00+03:00,out,False,923528,False,1,0,9,9
167035,2019-10-25 00:00:00+03:00,in,False,923526,False,10,1204,1292,88
167035,2019-10-25 00:00:00+03:00,out,False,923526,True,8,0,297,297
167035,2019-10-25 00:00:00+03:00,in,False,-1,True,1,0,9,9
167035,2019-10-25 00:00:00+03:00,in,False,-1,True,1,0,9,9
167035,2019-10-26 00:00:00+03:00,out,False,923526,True,2,0,37,37
167035,2019-10-26 00:00:00+03:00,in,False,923526,False,8,635,713,78
167035,2019-10-26 00:00:00+03:00,out,False,923526,False,9,106,322,216
167035,2019-10-26 00:00:00+03:00,in,False,-1,True,18,0,3,3
167035,2019-10-27 00:00:00+03:00,out,False,923526,True,15,0,426,426
167035,2019-10-27 00:00:00+03:00,out,False,923528,True,3,0,118,118
167035,2019-10-27 00:00:00+03:00,in,False,923526,False,12,468,547,79
167035,2019-10-27 00:00:00+03:00,out,False,923528,False,3,259,319,60
167035,2019-10-27 00:00:00+03:00,in,False,-1,True,2,0,98,98
167035,2019-10-27 00:00:00+03:00,out,False,923526,False,21,528,831,303
167035,2019-10-27 00:00:00+03:00,out,False,923526,False,21,528,831,303
167035,2019-10-27 00:00:00+03:00,out,False,923526,True,15,0,426,426
167035,2019-10-28 00:00:00+03:00,out,False,923526,False,32,1170,1651,481
167035,2019-10-28 00:00:00+03:00,in,False,923526,False,13,857,947,90
167035,2019-10-28 00:00:00+03:00,out,False,923528,False,4,472,519,47
167035,2019-10-28 00:00:00+03:00,out,False,923526,True,13,0,163,163
167035,2019-10-28 00:00:00+03:00,in,False,-1,True,3,0,145,145
167035,2019-10-28 00:00:00+03:00,out,True,923528,True,1,0,0,0
167035,2019-10-29 00:00:00+03:00,out,False,923528,False,1,14,32,18
167035,2019-10-29 00:00:00+03:00,in,False,923528,False,10,579,697,118
167035,2019-10-29 00:00:00+03:00,in,False,923526,False,15,1266,1397,131
167035,2019-10-29 00:00:00+03:00,out,False,923526,True,10,0,170,170
167035,2019-10-29 00:00:00+03:00,in,False,-1,True,5,0,47,47
167035,2019-10-29 00:00:00+03:00,out,False,923526,False,28,1206,1625,419
167035,2019-10-29 00:00:00+03:00,in,False,-1,True,5,0,47,47
167035,2019-10-30 00:00:00+03:00,out,False,923526,True,11,0,293,293
167035,2019-10-30 00:00:00+03:00,out,False,923526,False,30,1134,1571,437
167035,2019-10-30 00:00:00+03:00,in,False,-1,True,1,0,20,20
167035,2019-10-30 00:00:00+03:00,in,False,923526,False,12,1201,1294,93
167035,2019-10-30 00:00:00+03:00,in,False,923526,False,12,1201,1294,93
167035,2019-10-31 00:00:00+03:00,out,False,923528,True,4,0,147,147
167035,2019-10-31 00:00:00+03:00,in,False,923526,False,9,629,699,70
167035,2019-10-31 00:00:00+03:00,in,False,923528,False,2,167,208,41
167035,2019-10-31 00:00:00+03:00,out,False,923526,True,9,0,262,262
167035,2019-10-31 00:00:00+03:00,out,False,923528,False,18,518,806,288
167035,2019-10-31 00:00:00+03:00,out,False,923526,False,21,675,954,279
167035,2019-10-31 00:00:00+03:00,out,False,923526,False,21,675,954,279
167035,2019-11-01 00:00:00+03:00,out,False,923528,False,8,446,572,126
167035,2019-11-01 00:00:00+03:00,out,False,923526,False,16,477,705,228
167035,2019-11-01 00:00:00+03:00,in,False,923526,False,8,922,981,59
167035,2019-11-01 00:00:00+03:00,out,False,923528,True,2,0,48,48
167035,2019-11-01 00:00:00+03:00,in,False,-1,True,1,0,2,2
167035,2019-11-01 00:00:00+03:00,out,False,923526,True,10,0,185,185
167035,2019-11-01 00:00:00+03:00,in,False,923528,False,4,212,331,119
167035,2019-11-01 00:00:00+03:00,in,False,-1,True,1,0,2,2
167035,2019-11-02 00:00:00+03:00,out,False,923528,True,1,0,39,39
167035,2019-11-02 00:00:00+03:00,out,False,923526,False,24,977,1352,375
167035,2019-11-02 00:00:00+03:00,out,False,923526,True,13,0,323,323
167035,2019-11-02 00:00:00+03:00,in,False,923528,False,1,25,47,22
167035,2019-11-02 00:00:00+03:00,in,False,923526,False,10,888,976,88
167035,2019-11-03 00:00:00+03:00,out,False,923528,True,1,0,26,26
167035,2019-11-03 00:00:00+03:00,out,False,923528,False,10,313,491,178
167035,2019-11-03 00:00:00+03:00,in,False,923528,False,1,42,72,30
167035,2019-11-03 00:00:00+03:00,in,False,923526,False,5,488,515,27
167035,2019-11-03 00:00:00+03:00,in,False,-1,True,1,0,0,0
167035,2019-11-03 00:00:00+03:00,out,False,923526,False,13,337,533,196
167035,2019-11-03 00:00:00+03:00,out,False,923526,True,5,0,179,179
167035,2019-11-03 00:00:00+03:00,out,False,923526,False,13,337,533,196
167035,2019-11-04 00:00:00+03:00,out,False,923528,True,8,0,207,207
167035,2019-11-04 00:00:00+03:00,out,False,923528,False,25,651,1009,358
167035,2019-11-04 00:00:00+03:00,in,False,-1,True,1,0,2,2
167035,2019-11-04 00:00:00+03:00,in,False,923528,False,2,99,138,39
167035,2019-11-04 00:00:00+03:00,in,False,923526,False,4,185,210,25
167035,2019-11-04 00:00:00+03:00,out,False,923526,True,20,0,467,467
167035,2019-11-04 00:00:00+03:00,out,False,923526,False,21,985,1322,337
167035,2019-11-04 00:00:00+03:00,out,False,923528,False,25,651,1009,358
167035,2019-11-05 00:00:00+03:00,in,False,-1,True,1,0,18,18
167035,2019-11-05 00:00:00+03:00,out,False,923526,True,10,0,154,154
167035,2019-11-05 00:00:00+03:00,in,False,923526,False,9,1238,1313,75
167035,2019-11-05 00:00:00+03:00,in,False,923528,False,2,139,183,44
167035,2019-11-05 00:00:00+03:00,out,False,923526,False,17,568,780,212
167035,2019-11-05 00:00:00+03:00,out,False,923528,True,8,0,195,195
167035,2019-11-05 00:00:00+03:00,out,False,923528,False,16,864,1091,227
167035,2019-11-05 00:00:00+03:00,out,False,923526,True,10,0,154,154
167035,2019-11-05 00:00:00+03:00,in,False,923526,False,9,1238,1313,75
167035,2019-11-06 00:00:00+03:00,out,False,923528,False,17,558,819,261
167035,2019-11-06 00:00:00+03:00,in,False,923528,False,3,80,161,81
167035,2019-11-06 00:00:00+03:00,out,False,923526,False,20,975,1333,358
167035,2019-11-06 00:00:00+03:00,out,False,923528,True,2,0,38,38
167035,2019-11-06 00:00:00+03:00,in,False,923526,False,13,786,875,89
167035,2019-11-06 00:00:00+03:00,out,False,923526,True,1,0,37,37
167035,2019-11-07 00:00:00+03:00,out,False,923526,True,14,0,240,240
167035,2019-11-07 00:00:00+03:00,in,False,923528,False,1,26,49,23
167035,2019-11-07 00:00:00+03:00,out,False,923528,False,17,570,820,250
167035,2019-11-07 00:00:00+03:00,out,False,923528,True,3,0,100,100
167035,2019-11-07 00:00:00+03:00,out,False,923526,False,14,343,586,243
167035,2019-11-07 00:00:00+03:00,in,False,923526,False,22,1124,1282,158
167035,2019-11-07 00:00:00+03:00,in,False,-1,True,1,0,23,23
167035,2019-11-07 00:00:00+03:00,in,False,-1,True,1,0,23,23
167035,2019-11-08 00:00:00+03:00,out,False,923526,False,9,403,515,112
167035,2019-11-08 00:00:00+03:00,out,False,923526,True,2,0,113,113
167035,2019-11-08 00:00:00+03:00,in,False,923526,False,2,348,363,15
167035,2019-11-08 00:00:00+03:00,out,False,923528,False,40,1616,2277,661
167035,2019-11-08 00:00:00+03:00,out,False,923528,True,7,0,212,212
167035,2019-11-08 00:00:00+03:00,in,False,923526,False,2,348,363,15
167035,2019-11-09 00:00:00+03:00,out,False,923526,False,19,893,1239,346
167035,2019-11-09 00:00:00+03:00,out,False,923526,True,6,0,173,173
167035,2019-11-09 00:00:00+03:00,out,False,923528,False,3,495,510,15
167035,2019-11-09 00:00:00+03:00,in,False,-1,True,3,0,52,52
167035,2019-11-09 00:00:00+03:00,in,False,923526,False,4,196,233,37
167035,2019-11-09 00:00:00+03:00,out,False,923528,True,2,0,50,50
167035,2019-11-10 00:00:00+03:00,in,False,-1,True,3,0,32,32
167035,2019-11-10 00:00:00+03:00,in,False,923528,False,2,123,156,33
167035,2019-11-10 00:00:00+03:00,out,False,923526,True,9,0,232,232
167035,2019-11-10 00:00:00+03:00,out,False,923528,False,2,77,91,14
167035,2019-11-10 00:00:00+03:00,in,False,923526,False,7,1055,1104,49
167035,2019-11-10 00:00:00+03:00,out,False,923526,False,28,968,1370,402
167035,2019-11-10 00:00:00+03:00,out,False,923526,False,28,968,1370,402
167035,2019-11-11 00:00:00+03:00,in,False,923528,False,2,211,254,43
167035,2019-11-11 00:00:00+03:00,in,False,923526,False,14,1474,1563,89
167035,2019-11-11 00:00:00+03:00,out,False,923526,True,5,0,108,108
167035,2019-11-11 00:00:00+03:00,out,False,923528,True,9,0,252,252
167035,2019-11-11 00:00:00+03:00,out,False,923528,False,27,1056,1450,394
167035,2019-11-11 00:00:00+03:00,out,False,923526,False,15,320,556,236
167035,2019-11-12 00:00:00+03:00,in,False,923526,False,16,1224,1327,103
167035,2019-11-12 00:00:00+03:00,in,False,923528,False,3,123,212,89
167035,2019-11-12 00:00:00+03:00,out,False,923528,False,30,976,1522,546
167035,2019-11-12 00:00:00+03:00,out,False,923528,True,10,0,318,318
167035,2019-11-12 00:00:00+03:00,in,False,-1,True,2,0,71,71
167035,2019-11-12 00:00:00+03:00,out,False,923526,True,2,0,64,64
167035,2019-11-12 00:00:00+03:00,out,False,923526,False,5,141,252,111
167035,2019-11-12 00:00:00+03:00,out,False,923526,False,5,141,252,111
167035,2019-11-13 00:00:00+03:00,out,False,923526,True,11,0,318,318
167035,2019-11-13 00:00:00+03:00,in,False,923526,False,5,385,436,51
167035,2019-11-13 00:00:00+03:00,out,False,923528,False,14,608,821,213
167035,2019-11-13 00:00:00+03:00,in,False,923528,False,4,135,233,98
167035,2019-11-13 00:00:00+03:00,out,False,923526,False,16,862,1090,228
167035,2019-11-13 00:00:00+03:00,in,False,-1,True,1,0,3,3
167035,2019-11-13 00:00:00+03:00,out,False,923528,True,3,0,68,68
167035,2019-11-14 00:00:00+03:00,out,False,923526,True,5,0,134,134
167035,2019-11-14 00:00:00+03:00,out,False,923526,False,22,1985,2228,243
167035,2019-11-14 00:00:00+03:00,out,False,923528,True,2,0,3,3
167035,2019-11-14 00:00:00+03:00,in,False,923526,False,45,1078,1435,357
167035,2019-11-14 00:00:00+03:00,out,False,923528,False,5,53,130,77
167035,2019-11-14 00:00:00+03:00,in,False,-1,True,8,0,105,105
167035,2019-11-14 00:00:00+03:00,in,False,923528,False,4,120,214,94
167035,2019-11-14 00:00:00+03:00,out,False,923528,True,2,0,3,3
167035,2019-11-15 00:00:00+03:00,in,False,923526,False,19,908,1033,125
167035,2019-11-15 00:00:00+03:00,out,False,923526,True,4,0,173,173
167035,2019-11-15 00:00:00+03:00,in,False,923528,False,3,114,191,77
167035,2019-11-15 00:00:00+03:00,in,False,-1,True,2,0,12,12
167035,2019-11-15 00:00:00+03:00,out,False,923526,False,14,386,583,197
167035,2019-11-15 00:00:00+03:00,out,False,923528,True,2,0,52,52
167035,2019-11-15 00:00:00+03:00,out,False,923528,False,4,186,224,38
167035,2019-11-15 00:00:00+03:00,out,False,923528,True,2,0,52,52
167035,2019-11-16 00:00:00+03:00,out,False,923526,False,10,279,409,130
167035,2019-11-16 00:00:00+03:00,out,False,923528,False,31,882,1391,509
167035,2019-11-16 00:00:00+03:00,in,False,-1,True,4,0,71,71
167035,2019-11-16 00:00:00+03:00,out,False,923528,True,9,0,216,216
167035,2019-11-16 00:00:00+03:00,out,False,923526,True,9,0,217,217
167035,2019-11-16 00:00:00+03:00,in,False,923526,False,8,536,584,48
167035,2019-11-17 00:00:00+03:00,in,False,923528,False,1,34,58,24
167035,2019-11-17 00:00:00+03:00,in,False,923526,False,11,1155,1252,97
167035,2019-11-17 00:00:00+03:00,out,False,923526,False,27,1325,1720,395
167035,2019-11-17 00:00:00+03:00,out,False,923526,True,7,0,137,137
167035,2019-11-18 00:00:00+03:00,out,False,923526,False,36,2075,2603,528
167035,2019-11-18 00:00:00+03:00,in,False,-1,True,3,0,38,38
167035,2019-11-18 00:00:00+03:00,in,False,923528,False,1,314,378,64
167035,2019-11-18 00:00:00+03:00,in,False,923526,False,33,2152,2398,246
167035,2019-11-18 00:00:00+03:00,in,False,923526,True,1,0,10,10
167035,2019-11-18 00:00:00+03:00,out,False,923526,True,13,0,319,319
167035,2019-11-18 00:00:00+03:00,in,False,923526,False,33,2152,2398,246
167035,2019-11-18 00:00:00+03:00,out,False,923526,True,13,0,319,319
167035,2019-11-18 00:00:00+03:00,in,False,-1,True,3,0,38,38
167035,2019-11-19 00:00:00+03:00,in,False,-1,True,1,0,52,52
167035,2019-11-19 00:00:00+03:00,out,False,923526,False,9,291,405,114
167035,2019-11-19 00:00:00+03:00,out,False,923526,True,7,0,175,175
167035,2019-11-19 00:00:00+03:00,in,False,923526,False,26,2074,2229,155
167035,2019-11-19 00:00:00+03:00,out,False,923528,True,9,0,267,267
167035,2019-11-19 00:00:00+03:00,in,False,923528,False,2,74,132,58
167035,2019-11-19 00:00:00+03:00,out,False,923528,False,32,1337,1796,459
167035,2019-11-19 00:00:00+03:00,in,False,923526,False,26,2074,2229,155
167035,2019-11-20 00:00:00+03:00,in,False,923528,False,6,352,517,165
167035,2019-11-20 00:00:00+03:00,out,False,923526,False,25,691,992,301
167035,2019-11-20 00:00:00+03:00,in,False,923526,False,45,1506,1782,276
167035,2019-11-20 00:00:00+03:00,out,False,923528,True,4,0,116,116
167035,2019-11-20 00:00:00+03:00,in,False,-1,True,6,0,124,124
167035,2019-11-20 00:00:00+03:00,out,False,923526,True,6,0,198,198
167035,2019-11-20 00:00:00+03:00,out,False,923528,False,26,1082,1480,398
167035,2019-11-21 00:00:00+03:00,in,False,923526,False,30,1063,1294,231
167035,2019-11-21 00:00:00+03:00,out,False,923526,True,7,0,243,243
167035,2019-11-21 00:00:00+03:00,in,False,-1,True,3,0,59,59
167035,2019-11-21 00:00:00+03:00,out,False,923528,False,2,41,58,17
167035,2019-11-21 00:00:00+03:00,out,False,923526,False,29,1812,2260,448
167035,2019-11-21 00:00:00+03:00,in,False,923528,False,3,134,208,74
167035,2019-11-22 00:00:00+03:00,in,False,923526,False,108,1436,2243,807
167035,2019-11-22 00:00:00+03:00,out,False,923526,False,21,1060,1317,257
167035,2019-11-22 00:00:00+03:00,out,False,923526,True,4,0,118,118
167035,2019-11-22 00:00:00+03:00,in,False,923528,True,1,0,24,24
167035,2019-11-22 00:00:00+03:00,out,False,923528,False,6,116,195,79
167035,2019-11-22 00:00:00+03:00,in,False,-1,True,18,0,268,268
167035,2019-11-22 00:00:00+03:00,in,False,923526,True,1,0,5,5
167035,2019-11-22 00:00:00+03:00,in,False,923528,False,5,11,114,103
167035,2019-11-22 00:00:00+03:00,in,False,923528,False,5,11,114,103
167035,2019-11-23 00:00:00+03:00,out,False,923526,False,9,244,358,114
167035,2019-11-23 00:00:00+03:00,out,False,923526,True,4,0,101,101
167035,2019-11-23 00:00:00+03:00,out,False,923528,True,9,0,233,233
167035,2019-11-23 00:00:00+03:00,out,False,923528,False,22,626,990,364
167035,2019-11-23 00:00:00+03:00,in,False,923526,False,8,633,680,47
167035,2019-11-24 00:00:00+03:00,in,False,923526,False,9,571,631,60
167035,2019-11-24 00:00:00+03:00,out,False,923528,True,4,0,132,132
167035,2019-11-24 00:00:00+03:00,out,False,923528,False,12,265,449,184
167035,2019-11-24 00:00:00+03:00,out,False,923526,False,12,1147,1311,164
167035,2019-11-24 00:00:00+03:00,out,False,923526,True,6,0,227,227
167035,2019-11-24 00:00:00+03:00,in,False,-1,True,2,0,6,6
167035,2019-11-24 00:00:00+03:00,in,False,-1,True,2,0,6,6
167035,2019-11-24 00:00:00+03:00,out,False,923526,False,12,1147,1311,164
167035,2019-11-24 00:00:00+03:00,in,False,923526,False,9,571,631,60
167035,2019-11-25 00:00:00+03:00,in,False,-1,True,1,0,2,2
167035,2019-11-25 00:00:00+03:00,in,False,923528,False,1,18,39,21
167035,2019-11-25 00:00:00+03:00,in,False,923526,False,23,2560,2761,201
167035,2019-11-25 00:00:00+03:00,out,False,923526,False,30,1445,1847,402
167035,2019-11-25 00:00:00+03:00,out,False,923526,True,14,0,474,474
167035,2019-11-26 00:00:00+03:00,in,False,923526,False,11,1347,1445,98
167035,2019-11-26 00:00:00+03:00,in,False,-1,True,1,0,3,3
167035,2019-11-26 00:00:00+03:00,out,False,923528,True,1,0,2,2
167035,2019-11-26 00:00:00+03:00,in,False,923528,False,3,177,235,58
167035,2019-11-26 00:00:00+03:00,out,False,923526,True,7,0,176,176
167035,2019-11-26 00:00:00+03:00,out,False,923528,False,1,57,72,15
167035,2019-11-26 00:00:00+03:00,in,False,923528,True,1,0,48,48
167035,2019-11-26 00:00:00+03:00,out,False,923526,False,32,1091,1566,475
167035,2019-11-27 00:00:00+03:00,in,False,-1,True,2,0,65,65
167035,2019-11-27 00:00:00+03:00,out,False,923528,True,1,0,21,21
167035,2019-11-27 00:00:00+03:00,in,False,923528,False,2,184,281,97
167035,2019-11-27 00:00:00+03:00,out,False,923526,False,27,1395,1830,435
167035,2019-11-27 00:00:00+03:00,out,False,923526,True,5,0,79,79
167035,2019-11-27 00:00:00+03:00,in,False,923526,False,19,2053,2198,145
167035,2019-11-27 00:00:00+03:00,out,False,923528,False,3,260,311,51
167035,2019-11-27 00:00:00+03:00,in,False,-1,True,2,0,65,65
167035,2019-11-28 00:00:00+03:00,out,False,923528,False,13,594,790,196
167035,2019-11-28 00:00:00+03:00,out,False,923526,True,11,0,314,314
167035,2019-11-28 00:00:00+03:00,out,False,923528,True,9,0,244,244
167035,2019-11-28 00:00:00+03:00,out,False,923526,False,21,1028,1359,331
167035,2019-11-28 00:00:00+03:00,in,False,923526,False,8,630,690,60
167035,2019-11-28 00:00:00+03:00,in,False,-1,True,2,0,117,117
167052,2019-09-04 00:00:00+03:00,in,False,-1,True,3,0,34,34
167052,2019-09-05 00:00:00+03:00,in,False,-1,True,1,0,7,7
167052,2019-09-08 00:00:00+03:00,out,True,904038,True,1,0,0,0
167052,2019-09-09 00:00:00+03:00,in,False,904038,False,1,324,337,13
167052,2019-09-10 00:00:00+03:00,in,False,904038,False,3,446,473,27
167052,2019-09-11 00:00:00+03:00,in,False,-1,True,1,0,30,30
167052,2019-09-11 00:00:00+03:00,out,False,904044,True,4,0,59,59
167052,2019-09-11 00:00:00+03:00,out,False,904038,True,3,0,65,65
167052,2019-09-11 00:00:00+03:00,in,False,904038,False,4,512,545,33
167052,2019-09-13 00:00:00+03:00,in,False,904038,False,3,1211,1236,25
167052,2019-09-13 00:00:00+03:00,out,False,904038,False,1,289,295,6
167052,2019-09-16 00:00:00+03:00,out,False,904044,True,1,0,6,6
167052,2019-09-16 00:00:00+03:00,in,False,904038,False,2,290,300,10
167052,2019-09-16 00:00:00+03:00,in,False,-1,True,5,0,3,3
167052,2019-09-16 00:00:00+03:00,in,False,904038,False,2,290,300,10
167052,2019-09-16 00:00:00+03:00,out,False,904044,True,1,0,6,6
167052,2019-09-17 00:00:00+03:00,in,False,-1,True,31,0,297,297
167052,2019-09-17 00:00:00+03:00,in,False,904044,False,2,539,555,16
167052,2019-09-17 00:00:00+03:00,out,False,904038,True,1,0,9,9
167052,2019-09-17 00:00:00+03:00,in,False,904038,False,6,1036,1204,168
167052,2019-09-17 00:00:00+03:00,out,False,904038,False,7,901,989,88
167052,2019-09-18 00:00:00+03:00,in,False,-1,True,2,0,0,0
167052,2019-09-18 00:00:00+03:00,in,False,904038,False,7,1862,1922,60
167052,2019-09-18 00:00:00+03:00,out,False,904038,True,1,0,29,29
167052,2019-09-18 00:00:00+03:00,in,False,-1,True,2,0,0,0
167052,2019-09-19 00:00:00+03:00,in,False,904038,False,6,692,727,35
167052,2019-09-19 00:00:00+03:00,in,False,904044,False,2,319,348,29
167052,2019-09-20 00:00:00+03:00,out,False,904038,True,2,0,20,20
167052,2019-09-20 00:00:00+03:00,out,False,904038,False,3,526,560,34
167052,2019-09-20 00:00:00+03:00,in,False,904038,False,8,2790,2841,51
167052,2019-09-20 00:00:00+03:00,out,False,904044,False,1,1213,1230,17
167052,2019-09-20 00:00:00+03:00,in,False,904044,False,2,837,881,44
167052,2019-09-20 00:00:00+03:00,out,False,904044,True,1,0,3,3
167052,2019-09-20 00:00:00+03:00,out,False,904044,True,1,0,3,3
167052,2019-09-21 00:00:00+03:00,in,False,904044,False,2,1134,1152,18
167052,2019-09-21 00:00:00+03:00,in,False,-1,True,1,0,26,26
167052,2019-09-21 00:00:00+03:00,in,False,904038,False,4,878,900,22
167052,2019-09-21 00:00:00+03:00,out,False,904038,True,2,0,62,62
167052,2019-09-21 00:00:00+03:00,in,False,904038,False,4,878,900,22
167052,2019-09-21 00:00:00+03:00,out,False,904038,True,2,0,62,62
167052,2019-09-22 00:00:00+03:00,in,False,904044,False,1,158,185,27
167052,2019-09-22 00:00:00+03:00,in,False,904038,False,2,711,728,17
167052,2019-09-23 00:00:00+03:00,in,False,904038,False,5,1395,1437,42
167052,2019-09-23 00:00:00+03:00,out,False,904038,False,1,120,129,9
167052,2019-09-23 00:00:00+03:00,in,False,904044,False,1,136,140,4
167052,2019-09-23 00:00:00+03:00,in,False,-1,True,1,0,47,47
167052,2019-09-24 00:00:00+03:00,in,False,-1,True,2,0,48,48
167052,2019-09-24 00:00:00+03:00,out,False,904044,True,1,0,2,2
167052,2019-09-24 00:00:00+03:00,in,False,904044,False,4,838,932,94
167052,2019-09-24 00:00:00+03:00,in,False,904038,False,14,3032,3123,91
167052,2019-09-24 00:00:00+03:00,in,False,904044,True,1,78,82,4
167052,2019-09-24 00:00:00+03:00,out,False,904038,True,1,0,3,3
167052,2019-09-24 00:00:00+03:00,out,False,904038,False,9,552,672,120
167052,2019-09-24 00:00:00+03:00,in,False,904044,False,4,838,932,94
167052,2019-09-25 00:00:00+03:00,out,False,904038,False,3,818,840,22
167052,2019-09-25 00:00:00+03:00,in,False,904038,False,8,2641,2688,47
167052,2019-09-25 00:00:00+03:00,in,False,-1,True,1,0,26,26
167052,2019-09-25 00:00:00+03:00,in,False,904044,False,3,861,968,107
167052,2019-09-26 00:00:00+03:00,in,False,-1,True,3,0,46,46
167052,2019-09-26 00:00:00+03:00,in,False,904038,False,8,1110,1173,63
167052,2019-09-26 00:00:00+03:00,in,False,904044,False,2,189,200,11
167052,2019-09-26 00:00:00+03:00,out,False,904038,False,1,150,163,13
167052,2019-09-27 00:00:00+03:00,out,False,904038,False,2,61,81,20
167052,2019-09-27 00:00:00+03:00,in,False,904044,False,4,1159,1203,44
167052,2019-09-27 00:00:00+03:00,out,False,904044,True,1,0,3,3
167052,2019-09-27 00:00:00+03:00,in,False,904038,False,9,1535,1609,74
167052,2019-09-28 00:00:00+03:00,in,False,-1,True,1,0,47,47
167052,2019-09-28 00:00:00+03:00,out,False,904044,False,1,81,101,20
167052,2019-09-28 00:00:00+03:00,in,False,904038,False,5,1757,1786,29
167052,2019-09-29 00:00:00+03:00,in,False,904044,False,2,353,373,20
167052,2019-09-29 00:00:00+03:00,in,False,904038,False,5,540,577,37
167052,2019-09-29 00:00:00+03:00,out,False,904038,False,1,60,68,8
167052,2019-09-29 00:00:00+03:00,in,False,-1,True,1,0,24,24
167052,2019-09-30 00:00:00+03:00,in,False,-1,True,1,0,61,61
167052,2019-09-30 00:00:00+03:00,out,False,904038,True,6,0,62,62
167052,2019-09-30 00:00:00+03:00,out,False,904038,False,3,122,188,66
167052,2019-09-30 00:00:00+03:00,out,False,904044,False,1,125,133,8
167052,2019-09-30 00:00:00+03:00,in,False,904038,False,10,3463,3530,67
167052,2019-09-30 00:00:00+03:00,in,False,904044,False,5,1741,1840,99
167052,2019-09-30 00:00:00+03:00,out,False,904044,False,1,125,133,8
167052,2019-09-30 00:00:00+03:00,in,False,-1,True,1,0,61,61
167052,2019-10-01 00:00:00+03:00,in,False,904044,False,1,507,517,10
167052,2019-10-01 00:00:00+03:00,in,False,904038,False,3,1241,1264,23
167052,2019-10-02 00:00:00+03:00,out,False,904038,False,3,221,270,49
167052,2019-10-02 00:00:00+03:00,in,False,-1,True,1,0,25,25
167052,2019-10-02 00:00:00+03:00,in,False,904038,True,1,0,95,95
167052,2019-10-02 00:00:00+03:00,in,False,904038,False,3,512,527,15
167052,2019-10-02 00:00:00+03:00,out,False,904044,True,1,0,7,7
167052,2019-10-02 00:00:00+03:00,out,False,904038,True,6,0,136,136
167052,2019-10-02 00:00:00+03:00,in,False,904044,False,2,2105,2148,43
167052,2019-10-02 00:00:00+03:00,in,False,-1,True,1,0,25,25
167052,2019-10-02 00:00:00+03:00,in,False,904038,False,3,512,527,15
167052,2019-10-03 00:00:00+03:00,in,False,904044,False,6,1592,1706,114
167052,2019-10-03 00:00:00+03:00,in,False,904038,False,3,418,451,33
167052,2019-10-03 00:00:00+03:00,in,False,-1,True,1,0,41,41
167052,2019-10-03 00:00:00+03:00,out,False,904038,False,1,374,389,15
167052,2019-10-03 00:00:00+03:00,out,False,904044,True,1,0,3,3
167052,2019-10-04 00:00:00+03:00,in,False,904044,False,1,278,286,8
167052,2019-10-04 00:00:00+03:00,in,False,-1,True,2,0,67,67
167052,2019-10-04 00:00:00+03:00,out,False,904038,False,1,17,23,6
167052,2019-10-04 00:00:00+03:00,in,False,904038,False,6,1242,1271,29
167052,2019-10-05 00:00:00+03:00,in,False,-1,True,14,0,147,147
167052,2019-10-05 00:00:00+03:00,out,False,904038,False,5,287,352,65
167052,2019-10-05 00:00:00+03:00,out,False,904038,True,1,0,8,8
167052,2019-10-05 00:00:00+03:00,out,False,904044,True,3,0,6,6
167052,2019-10-05 00:00:00+03:00,in,False,904044,False,3,1437,1485,48
167052,2019-10-05 00:00:00+03:00,in,False,904038,False,3,1250,1280,30
167052,2019-10-05 00:00:00+03:00,out,False,904038,False,5,287,352,65
167052,2019-10-06 00:00:00+03:00,in,False,904038,False,3,675,699,24
167052,2019-10-07 00:00:00+03:00,in,False,904038,False,9,2337,2396,59
167052,2019-10-07 00:00:00+03:00,in,False,904044,False,1,8,19,11
167052,2019-10-07 00:00:00+03:00,out,False,904038,False,2,241,275,34
167052,2019-10-07 00:00:00+03:00,in,False,-1,True,4,0,145,145
167052,2019-10-07 00:00:00+03:00,out,False,904038,True,1,0,31,31
167052,2019-10-08 00:00:00+03:00,in,False,904044,False,4,1571,1603,32
167052,2019-10-08 00:00:00+03:00,out,False,904038,False,1,51,61,10
167052,2019-10-08 00:00:00+03:00,in,False,-1,True,1,0,16,16
167052,2019-10-08 00:00:00+03:00,in,False,904038,False,11,1920,2015,95
167052,2019-10-09 00:00:00+03:00,in,False,904038,False,11,2810,2883,73
167052,2019-10-09 00:00:00+03:00,in,False,904044,False,5,1109,1184,75
167052,2019-10-09 00:00:00+03:00,out,False,904038,False,2,107,129,22
167052,2019-10-09 00:00:00+03:00,in,False,-1,True,1,0,43,43
167052,2019-10-10 00:00:00+03:00,in,False,-1,True,2,0,0,0
167052,2019-10-10 00:00:00+03:00,in,False,904044,False,2,215,226,11
167052,2019-10-10 00:00:00+03:00,in,False,904038,False,8,1620,1670,50
167052,2019-10-11 00:00:00+03:00,in,False,904044,False,1,1229,1274,45
167052,2019-10-11 00:00:00+03:00,out,False,904038,True,1,0,16,16
167052,2019-10-11 00:00:00+03:00,in,False,904038,False,5,734,817,83
167052,2019-10-11 00:00:00+03:00,out,False,904038,False,3,290,312,22
167052,2019-10-11 00:00:00+03:00,in,False,-1,True,2,0,24,24
167052,2019-10-11 00:00:00+03:00,in,False,904044,False,1,1229,1274,45
167052,2019-10-12 00:00:00+03:00,in,False,904038,False,9,1840,1987,147
167052,2019-10-12 00:00:00+03:00,out,False,904038,True,3,0,180,180
167052,2019-10-12 00:00:00+03:00,in,False,-1,True,1,0,0,0
167052,2019-10-12 00:00:00+03:00,out,False,904038,False,1,18,34,16
167052,2019-10-13 00:00:00+03:00,in,False,904038,False,2,906,922,16
167052,2019-10-13 00:00:00+03:00,in,False,904044,False,2,876,902,26
167052,2019-10-14 00:00:00+03:00,in,False,904038,True,1,0,20,20
167052,2019-10-14 00:00:00+03:00,in,False,904044,False,2,313,386,73
167052,2019-10-14 00:00:00+03:00,out,False,904038,False,2,295,314,19
167052,2019-10-14 00:00:00+03:00,in,False,904038,False,13,2859,2935,76
167052,2019-10-14 00:00:00+03:00,in,False,-1,True,1,0,34,34
167052,2019-10-15 00:00:00+03:00,in,False,-1,True,2,0,81,81
167052,2019-10-15 00:00:00+03:00,in,False,904038,False,6,1572,1629,57
167052,2019-10-15 00:00:00+03:00,out,False,904038,False,2,455,475,20
167052,2019-10-15 00:00:00+03:00,in,False,904044,False,4,570,665,95
167052,2019-10-16 00:00:00+03:00,in,False,904038,False,11,2034,2111,77
167052,2019-10-16 00:00:00+03:00,in,False,904044,False,2,658,703,45
167052,2019-10-16 00:00:00+03:00,in,False,-1,True,3,0,145,145
167052,2019-10-16 00:00:00+03:00,out,False,904038,False,4,1297,1353,56
167052,2019-10-16 00:00:00+03:00,in,False,-1,True,3,0,145,145
167052,2019-10-17 00:00:00+03:00,in,False,904038,False,19,3817,3980,163
167052,2019-10-17 00:00:00+03:00,out,False,904038,True,5,0,24,24
167052,2019-10-17 00:00:00+03:00,in,False,904044,False,7,1648,1740,92
167052,2019-10-17 00:00:00+03:00,in,False,-1,True,4,0,63,63
167052,2019-10-17 00:00:00+03:00,out,False,904038,False,2,208,234,26
167052,2019-10-18 00:00:00+03:00,out,False,904038,False,5,1106,1147,41
167052,2019-10-18 00:00:00+03:00,in,False,904038,False,18,3813,4004,191
167052,2019-10-18 00:00:00+03:00,in,False,904044,False,3,409,435,26
167052,2019-10-18 00:00:00+03:00,in,False,-1,True,5,0,98,98
167052,2019-10-19 00:00:00+03:00,in,False,-1,True,1,0,42,42
167052,2019-10-19 00:00:00+03:00,in,False,904038,False,6,651,687,36
167052,2019-10-19 00:00:00+03:00,out,False,904038,False,1,32,40,8
167052,2019-10-19 00:00:00+03:00,in,False,904044,False,1,630,638,8
167052,2019-10-19 00:00:00+03:00,out,False,904038,False,1,32,40,8
167052,2019-10-20 00:00:00+03:00,out,False,904038,True,1,0,32,32
167052,2019-10-20 00:00:00+03:00,out,False,904038,False,2,37,73,36
167052,2019-10-20 00:00:00+03:00,in,False,904038,False,6,1612,1678,66
167052,2019-10-21 00:00:00+03:00,out,False,904038,False,3,531,577,46
167052,2019-10-21 00:00:00+03:00,in,False,904038,False,11,3075,3203,128
167052,2019-10-21 00:00:00+03:00,in,False,-1,True,4,0,103,103
167052,2019-10-21 00:00:00+03:00,out,False,904038,True,4,0,36,36
167052,2019-10-22 00:00:00+03:00,out,False,904038,True,2,0,47,47
167052,2019-10-22 00:00:00+03:00,in,False,-1,True,1,0,29,29
167052,2019-10-22 00:00:00+03:00,in,False,904038,False,5,910,951,41
167052,2019-10-22 00:00:00+03:00,out,False,904038,False,2,457,489,32
167052,2019-10-23 00:00:00+03:00,in,False,904038,False,1,329,335,6
167052,2019-10-24 00:00:00+03:00,out,False,904038,False,1,110,131,21
167052,2019-10-24 00:00:00+03:00,out,False,904038,True,1,0,2,2
167052,2019-10-24 00:00:00+03:00,in,False,904038,False,5,746,777,31
167052,2019-10-25 00:00:00+03:00,out,False,904038,True,1,0,35,35
167052,2019-10-25 00:00:00+03:00,in,False,-1,True,1,0,107,107
167052,2019-10-27 00:00:00+03:00,in,False,904038,False,1,430,436,6
167052,2019-10-27 00:00:00+03:00,in,False,-1,True,1,0,2,2
167052,2019-10-28 00:00:00+03:00,in,False,-1,True,2,0,0,0
167052,2019-10-28 00:00:00+03:00,out,False,904038,False,1,1,9,8
167052,2019-10-28 00:00:00+03:00,in,False,904038,False,3,577,635,58
167052,2019-10-29 00:00:00+03:00,in,False,904038,False,1,171,182,11
167052,2019-10-29 00:00:00+03:00,out,False,904038,False,1,6,10,4
167052,2019-10-29 00:00:00+03:00,in,False,-1,True,1,0,30,30
167052,2019-10-30 00:00:00+03:00,in,False,904038,False,1,513,522,9
167052,2019-10-30 00:00:00+03:00,out,False,904038,False,1,89,99,10
167052,2019-10-31 00:00:00+03:00,in,False,-1,True,1,0,28,28
167052,2019-10-31 00:00:00+03:00,out,False,904038,False,3,272,294,22
167052,2019-10-31 00:00:00+03:00,in,False,904038,False,2,507,523,16
167052,2019-11-01 00:00:00+03:00,in,False,-1,True,2,0,60,60
167052,2019-11-01 00:00:00+03:00,in,False,904038,False,1,325,338,13
167052,2019-11-02 00:00:00+03:00,in,False,-1,True,3,0,15,15
167052,2019-11-02 00:00:00+03:00,in,False,904038,False,2,248,264,16
167052,2019-11-03 00:00:00+03:00,in,False,904038,False,1,107,116,9
167052,2019-11-04 00:00:00+03:00,in,False,-1,True,4,0,52,52
167052,2019-11-04 00:00:00+03:00,out,False,904038,False,2,213,237,24
167052,2019-11-04 00:00:00+03:00,out,False,904038,True,1,0,27,27
167052,2019-11-04 00:00:00+03:00,in,False,904038,False,5,1249,1286,37
167052,2019-11-04 00:00:00+03:00,out,False,904038,False,2,213,237,24
167052,2019-11-05 00:00:00+03:00,out,False,904038,False,4,755,804,49
167052,2019-11-05 00:00:00+03:00,in,False,904044,False,2,98,136,38
167052,2019-11-05 00:00:00+03:00,in,False,904038,False,9,2099,2166,67
167052,2019-11-05 00:00:00+03:00,out,False,904038,True,1,0,2,2
167052,2019-11-05 00:00:00+03:00,in,False,-1,True,1,0,48,48
167052,2019-11-05 00:00:00+03:00,in,False,904044,False,2,98,136,38
167052,2019-11-06 00:00:00+03:00,in,False,904038,False,5,1079,1122,43
167052,2019-11-06 00:00:00+03:00,out,False,904038,True,8,0,141,141
167052,2019-11-06 00:00:00+03:00,in,False,904044,False,2,66,132,66
167052,2019-11-06 00:00:00+03:00,out,False,904038,False,2,147,196,49
167052,2019-11-07 00:00:00+03:00,in,False,904044,False,1,109,147,38
167052,2019-11-07 00:00:00+03:00,in,False,-1,True,3,0,177,177
167052,2019-11-07 00:00:00+03:00,in,False,904038,False,4,368,402,34
167052,2019-11-07 00:00:00+03:00,out,False,904044,False,1,75,78,3
167052,2019-11-07 00:00:00+03:00,out,False,904044,True,1,0,2,2
167052,2019-11-07 00:00:00+03:00,out,False,904038,False,3,1170,1208,38
167052,2019-11-07 00:00:00+03:00,out,False,904038,True,2,0,68,68
167052,2019-11-08 00:00:00+03:00,out,False,904038,True,1,0,13,13
167052,2019-11-08 00:00:00+03:00,in,False,904038,False,12,2484,2573,89
167052,2019-11-08 00:00:00+03:00,out,False,904044,False,1,91,105,14
167052,2019-11-08 00:00:00+03:00,in,False,904044,False,4,497,611,114
167052,2019-11-08 00:00:00+03:00,out,False,904038,False,2,340,372,32
167052,2019-11-08 00:00:00+03:00,in,False,-1,True,2,0,79,79
167052,2019-11-09 00:00:00+03:00,in,False,904038,False,6,766,818,52
167052,2019-11-09 00:00:00+03:00,in,False,904044,False,1,103,120,17
167052,2019-11-09 00:00:00+03:00,out,False,904038,False,1,46,55,9
167052,2019-11-09 00:00:00+03:00,out,False,904044,False,1,11,25,14
167052,2019-11-09 00:00:00+03:00,in,False,-1,True,1,0,28,28
167052,2019-11-09 00:00:00+03:00,out,False,904044,False,1,11,25,14
167052,2019-11-10 00:00:00+03:00,in,False,904038,False,10,995,1066,71
167052,2019-11-10 00:00:00+03:00,in,False,-1,True,2,0,117,117
167052,2019-11-10 00:00:00+03:00,out,False,904038,False,5,884,945,61
167052,2019-11-10 00:00:00+03:00,in,False,-1,True,2,0,117,117
167052,2019-11-11 00:00:00+03:00,out,False,904044,False,1,54,75,21
167052,2019-11-11 00:00:00+03:00,out,False,904038,True,7,0,42,42
167052,2019-11-11 00:00:00+03:00,in,False,-1,True,5,0,261,261
167052,2019-11-11 00:00:00+03:00,in,False,904044,False,7,1085,1205,120
167052,2019-11-11 00:00:00+03:00,out,False,904038,False,2,60,96,36
167052,2019-11-11 00:00:00+03:00,in,False,904038,False,20,4556,4709,153
167052,2019-11-11 00:00:00+03:00,in,False,904038,False,20,4556,4709,153
167052,2019-11-12 00:00:00+03:00,in,False,-1,True,4,0,147,147
167052,2019-11-12 00:00:00+03:00,in,False,904038,False,8,2389,2454,65
167052,2019-11-12 00:00:00+03:00,out,False,904038,True,1,0,9,9
167052,2019-11-12 00:00:00+03:00,out,False,904044,False,1,105,113,8
167052,2019-11-12 00:00:00+03:00,out,False,904038,False,2,573,607,34
167052,2019-11-12 00:00:00+03:00,in,False,904044,False,2,351,401,50
167052,2019-11-13 00:00:00+03:00,out,False,904038,False,2,117,143,26
167052,2019-11-13 00:00:00+03:00,in,False,904038,False,8,1752,1815,63
167052,2019-11-13 00:00:00+03:00,in,False,-1,True,3,0,153,153
167052,2019-11-13 00:00:00+03:00,in,False,904044,False,2,704,749,45
167052,2019-11-13 00:00:00+03:00,out,False,904038,True,4,0,7,7
167052,2019-11-14 00:00:00+03:00,in,False,904038,False,8,3182,3251,69
167052,2019-11-14 00:00:00+03:00,out,False,904038,False,5,300,380,80
167052,2019-11-14 00:00:00+03:00,in,False,904044,False,3,1348,1416,68
167052,2019-11-14 00:00:00+03:00,in,False,-1,True,1,0,55,55
167052,2019-11-15 00:00:00+03:00,in,False,904044,False,1,337,357,20
167052,2019-11-15 00:00:00+03:00,out,False,904044,True,1,0,2,2
167052,2019-11-15 00:00:00+03:00,in,False,-1,True,2,0,192,192
167052,2019-11-15 00:00:00+03:00,in,False,904038,False,5,1437,1574,137
167052,2019-11-15 00:00:00+03:00,out,False,904038,False,5,713,825,112
167052,2019-11-15 00:00:00+03:00,out,False,904038,True,1,0,3,3
167052,2019-11-16 00:00:00+03:00,in,False,-1,True,2,0,68,68
167052,2019-11-16 00:00:00+03:00,in,False,904038,False,10,1567,1666,99
167052,2019-11-16 00:00:00+03:00,out,False,904038,False,2,129,154,25
167052,2019-11-17 00:00:00+03:00,in,False,-1,True,1,0,32,32
167052,2019-11-17 00:00:00+03:00,out,False,904038,False,4,297,358,61
167052,2019-11-17 00:00:00+03:00,in,False,904038,False,6,652,702,50
167052,2019-11-18 00:00:00+03:00,out,False,904038,False,1,31,46,15
167052,2019-11-18 00:00:00+03:00,out,False,904038,True,2,0,42,42
167052,2019-11-18 00:00:00+03:00,in,False,904038,False,7,1904,1951,47
167052,2019-11-18 00:00:00+03:00,in,False,904038,False,7,1904,1951,47
167052,2019-11-19 00:00:00+03:00,out,False,904038,True,4,0,12,12
167052,2019-11-19 00:00:00+03:00,in,False,-1,True,2,0,100,100
167052,2019-11-19 00:00:00+03:00,out,False,904038,False,2,320,348,28
167052,2019-11-19 00:00:00+03:00,in,False,904044,False,3,992,1085,93
167052,2019-11-19 00:00:00+03:00,in,False,904038,False,6,2506,2576,70
167052,2019-11-19 00:00:00+03:00,out,False,904038,False,2,320,348,28
167052,2019-11-20 00:00:00+03:00,in,False,904038,False,9,2456,2533,77
167052,2019-11-20 00:00:00+03:00,out,False,904038,False,1,232,247,15
167052,2019-11-20 00:00:00+03:00,in,False,-1,True,1,0,64,64
167052,2019-11-20 00:00:00+03:00,out,False,904038,True,3,0,6,6
167052,2019-11-21 00:00:00+03:00,in,False,904038,False,2,182,202,20
167052,2019-11-22 00:00:00+03:00,in,False,904044,False,2,489,509,20
167052,2019-11-22 00:00:00+03:00,in,False,-1,True,6,0,80,80
167052,2019-11-22 00:00:00+03:00,out,False,904038,True,2,0,37,37
167052,2019-11-22 00:00:00+03:00,in,False,904038,False,1,95,108,13
167052,2019-11-22 00:00:00+03:00,in,False,904044,False,2,489,509,20
167052,2019-11-22 00:00:00+03:00,out,False,904038,True,2,0,37,37
167052,2019-11-23 00:00:00+03:00,in,False,904038,False,4,810,840,30
167052,2019-11-24 00:00:00+03:00,in,False,-1,True,1,0,22,22
167052,2019-11-24 00:00:00+03:00,in,False,904038,False,1,30,35,5
167052,2019-11-24 00:00:00+03:00,out,False,904038,True,1,0,29,29
167052,2019-11-25 00:00:00+03:00,in,False,904038,False,7,1517,1575,58
167052,2019-11-25 00:00:00+03:00,in,False,-1,True,27,0,110,110
167052,2019-11-25 00:00:00+03:00,out,False,904038,False,3,140,176,36
167052,2019-11-25 00:00:00+03:00,out,False,904038,True,1,0,35,35
167052,2019-11-26 00:00:00+03:00,in,False,904038,False,4,764,790,26
167052,2019-11-26 00:00:00+03:00,in,False,-1,True,4,0,2,2
167052,2019-11-27 00:00:00+03:00,in,False,904038,False,2,1338,1348,10
167052,2019-11-27 00:00:00+03:00,out,False,904038,False,1,37,48,11
167052,2019-11-27 00:00:00+03:00,out,False,904038,True,1,0,28,28
167052,2019-11-28 00:00:00+03:00,in,False,904038,False,2,503,512,9
167052,2019-11-28 00:00:00+03:00,in,False,-1,True,4,0,46,46
167052,2019-11-28 00:00:00+03:00,out,False,904038,False,2,579,611,32
167052,2019-11-28 00:00:00+03:00,out,False,904038,True,1,0,2,2
167052,2019-11-28 00:00:00+03:00,out,False,904038,False,2,579,611,32
167053,2019-09-02 00:00:00+03:00,in,False,-1,True,1,0,2,2
167053,2019-09-04 00:00:00+03:00,in,False,-1,True,21,0,31,31
167053,2019-09-04 00:00:00+03:00,out,False,903292,False,24,1324,1445,121
167053,2019-09-04 00:00:00+03:00,in,False,903292,False,4,517,582,65
167053,2019-09-04 00:00:00+03:00,out,False,903292,True,18,0,562,562
167053,2019-09-05 00:00:00+03:00,in,False,903292,False,9,1668,1777,109
167053,2019-09-05 00:00:00+03:00,out,False,903292,False,44,4514,4816,302
167053,2019-09-05 00:00:00+03:00,in,False,-1,True,19,0,49,49
167053,2019-09-05 00:00:00+03:00,out,False,903292,True,31,0,943,943
167053,2019-09-06 00:00:00+03:00,out,False,903292,True,31,0,919,919
167053,2019-09-06 00:00:00+03:00,out,False,903292,False,38,4425,4698,273
167053,2019-09-06 00:00:00+03:00,out,False,-1,True,2,0,251,251
167053,2019-09-06 00:00:00+03:00,in,False,903292,False,11,1814,1972,158
167053,2019-09-06 00:00:00+03:00,in,False,-1,True,6,0,31,31
167053,2019-09-07 00:00:00+03:00,in,False,-1,True,2,0,30,30
167053,2019-09-09 00:00:00+03:00,in,False,-1,True,9,0,60,60
167053,2019-09-09 00:00:00+03:00,out,False,903292,False,71,6539,6993,454
167053,2019-09-09 00:00:00+03:00,in,False,903292,False,9,1295,1407,112
167053,2019-09-09 00:00:00+03:00,out,False,903292,True,35,0,1041,1041
167053,2019-09-10 00:00:00+03:00,in,False,903292,False,5,1371,1443,72
167053,2019-09-10 00:00:00+03:00,in,False,-1,True,2,0,58,58
167053,2019-09-10 00:00:00+03:00,in,False,-1,True,2,0,58,58
167053,2019-09-12 00:00:00+03:00,in,False,-1,True,2,0,30,30
167053,2019-09-13 00:00:00+03:00,in,False,-1,True,4,0,60,60
167053,2019-09-15 00:00:00+03:00,in,False,-1,True,2,0,0,0
167053,2019-09-16 00:00:00+03:00,in,False,903292,False,1,33,51,18
167053,2019-09-16 00:00:00+03:00,in,False,-1,True,2,0,39,39
167053,2019-09-16 00:00:00+03:00,out,False,903292,False,1,21,27,6
167053,2019-09-18 00:00:00+03:00,out,False,903292,False,6,190,213,23
167053,2019-09-18 00:00:00+03:00,in,False,-1,True,7,0,110,110
167053,2019-09-18 00:00:00+03:00,in,False,903292,False,2,17,55,38
167053,2019-09-19 00:00:00+03:00,out,False,903292,False,1,94,99,5
167053,2019-09-19 00:00:00+03:00,out,False,903292,False,1,94,99,5
167053,2019-09-20 00:00:00+03:00,out,False,903292,False,1,130,138,8
167053,2019-09-20 00:00:00+03:00,in,False,903292,False,1,181,198,17
167053,2019-09-20 00:00:00+03:00,in,False,903292,False,1,181,198,17
167053,2019-09-20 00:00:00+03:00,out,False,903292,False,1,130,138,8
167053,2019-10-01 00:00:00+03:00,in,False,-1,True,7,0,14,14
167053,2019-10-01 00:00:00+03:00,in,False,-1,True,7,0,14,14
167059,2019-09-13 00:00:00+03:00,in,False,-1,True,3,0,46,46
167059,2019-09-13 00:00:00+03:00,in,False,911136,False,2,490,536,46
167059,2019-09-13 00:00:00+03:00,in,False,911138,True,1,0,16,16
167059,2019-09-14 00:00:00+03:00,in,False,-1,True,1,0,13,13
167059,2019-09-14 00:00:00+03:00,in,False,911102,False,1,73,95,22
167059,2019-09-16 00:00:00+03:00,in,False,-1,True,1,0,12,12
167059,2019-09-16 00:00:00+03:00,in,False,911138,False,7,793,912,119
167059,2019-09-16 00:00:00+03:00,in,False,911136,False,6,714,820,106
167059,2019-09-16 00:00:00+03:00,in,False,911142,True,1,0,41,41
167059,2019-09-17 00:00:00+03:00,in,False,911140,False,1,290,329,39
167059,2019-09-17 00:00:00+03:00,in,False,911136,False,6,652,762,110
167059,2019-09-17 00:00:00+03:00,in,False,-1,True,3,0,26,26
167059,2019-09-17 00:00:00+03:00,in,False,911138,False,7,697,835,138
167059,2019-09-18 00:00:00+03:00,in,False,911136,False,8,1528,1670,142
167059,2019-09-18 00:00:00+03:00,in,False,911138,False,5,465,550,85
167059,2019-09-18 00:00:00+03:00,in,False,911142,False,2,64,144,80
167059,2019-09-18 00:00:00+03:00,in,False,-1,True,1,0,11,11
167059,2019-09-18 00:00:00+03:00,in,False,-1,True,1,0,11,11
167059,2019-09-19 00:00:00+03:00,in,False,-1,True,2,0,66,66
167059,2019-09-19 00:00:00+03:00,in,False,911136,False,4,495,564,69
167059,2019-09-19 00:00:00+03:00,in,False,911138,False,8,907,1053,146
167059,2019-09-19 00:00:00+03:00,in,False,911136,False,4,495,564,69
167059,2019-09-20 00:00:00+03:00,in,False,911142,True,1,0,29,29
167059,2019-09-20 00:00:00+03:00,in,False,-1,True,2,0,10,10
167059,2019-09-20 00:00:00+03:00,in,False,911138,False,12,1565,1771,206
167059,2019-09-20 00:00:00+03:00,in,False,911142,False,4,183,379,196
167059,2019-09-20 00:00:00+03:00,in,False,911136,False,3,499,555,56
167059,2019-09-20 00:00:00+03:00,in,False,911138,False,12,1565,1771,206
167059,2019-09-20 00:00:00+03:00,in,False,911142,True,1,0,29,29
167059,2019-09-21 00:00:00+03:00,in,False,-1,True,1,0,4,4
167059,2019-09-21 00:00:00+03:00,in,False,911102,False,1,27,65,38
167059,2019-09-21 00:00:00+03:00,in,False,911102,False,1,27,65,38
167059,2019-09-23 00:00:00+03:00,in,False,911102,True,1,0,28,28
167059,2019-09-23 00:00:00+03:00,in,False,911136,False,5,409,504,95
167059,2019-09-23 00:00:00+03:00,in,False,911138,False,7,861,986,125
167059,2019-09-23 00:00:00+03:00,in,False,-1,True,1,0,36,36
167059,2019-09-24 00:00:00+03:00,in,False,911138,True,1,1,19,18
167059,2019-09-24 00:00:00+03:00,in,False,911102,False,2,112,188,76
167059,2019-09-24 00:00:00+03:00,in,False,911136,False,5,641,746,105
167059,2019-09-24 00:00:00+03:00,in,False,911138,False,5,682,771,89
167059,2019-09-25 00:00:00+03:00,in,False,911152,False,2,59,102,43
167059,2019-09-25 00:00:00+03:00,in,False,911136,False,4,336,434,98
167059,2019-09-25 00:00:00+03:00,in,False,911140,False,1,72,159,87
167059,2019-09-25 00:00:00+03:00,in,False,911104,False,1,137,150,13
167059,2019-09-25 00:00:00+03:00,in,False,911138,False,8,1134,1276,142
167059,2019-09-25 00:00:00+03:00,in,False,-1,True,2,0,66,66
167059,2019-09-26 00:00:00+03:00,in,False,911102,False,1,18,54,36
167059,2019-09-26 00:00:00+03:00,in,False,911140,False,2,329,380,51
167059,2019-09-26 00:00:00+03:00,in,False,911136,False,8,1206,1427,221
167059,2019-09-26 00:00:00+03:00,in,False,911140,True,1,0,15,15
167059,2019-09-26 00:00:00+03:00,in,False,911138,False,9,2189,2345,156
167059,2019-09-27 00:00:00+03:00,in,False,-1,True,3,0,119,119
167059,2019-09-27 00:00:00+03:00,in,False,911142,False,1,32,82,50
167059,2019-09-27 00:00:00+03:00,in,False,911138,False,5,624,715,91
167059,2019-09-27 00:00:00+03:00,in,False,911136,False,4,344,412,68
167059,2019-09-30 00:00:00+03:00,in,False,-1,True,3,0,31,31
167059,2019-09-30 00:00:00+03:00,in,False,911136,True,1,0,20,20
167059,2019-09-30 00:00:00+03:00,in,False,911136,False,7,854,976,122
167059,2019-09-30 00:00:00+03:00,in,False,911138,False,5,375,460,85
167059,2019-10-01 00:00:00+03:00,in,False,911136,False,7,655,783,128
167059,2019-10-01 00:00:00+03:00,in,False,-1,True,2,0,13,13
167059,2019-10-01 00:00:00+03:00,in,False,911138,False,6,908,1010,102
167059,2019-10-02 00:00:00+03:00,in,False,911138,False,2,139,173,34
167059,2019-10-02 00:00:00+03:00,in,False,-1,True,1,0,11,11
167059,2019-10-02 00:00:00+03:00,in,False,911136,False,3,181,234,53
167059,2019-10-03 00:00:00+03:00,in,False,911138,False,2,604,638,34
167059,2019-10-04 00:00:00+03:00,in,False,911138,False,1,77,99,22
167059,2019-10-04 00:00:00+03:00,in,False,-1,True,1,0,10,10
167059,2019-10-04 00:00:00+03:00,in,False,911136,False,3,334,385,51
167059,2019-10-04 00:00:00+03:00,in,False,911102,False,1,24,50,26
167059,2019-10-04 00:00:00+03:00,in,False,911136,False,3,334,385,51
167059,2019-10-07 00:00:00+03:00,in,False,-1,True,2,0,32,32
167059,2019-10-07 00:00:00+03:00,in,False,911136,False,7,504,650,146
167059,2019-10-07 00:00:00+03:00,in,False,911138,False,1,38,60,22
167059,2019-10-08 00:00:00+03:00,in,False,911140,False,2,114,189,75
167059,2019-10-08 00:00:00+03:00,in,False,911138,False,2,119,156,37
167059,2019-10-08 00:00:00+03:00,in,False,911136,False,3,943,1003,60
167059,2019-10-09 00:00:00+03:00,in,False,-1,True,1,0,27,27
167059,2019-10-09 00:00:00+03:00,in,False,911140,False,1,72,96,24
167059,2019-10-09 00:00:00+03:00,in,False,911136,False,4,255,333,78
167059,2019-10-09 00:00:00+03:00,in,False,911142,False,1,20,46,26
167059,2019-10-09 00:00:00+03:00,in,False,911138,False,1,52,73,21
167059,2019-10-10 00:00:00+03:00,in,False,911138,False,3,233,293,60
167059,2019-10-10 00:00:00+03:00,in,False,911140,False,1,262,294,32
167059,2019-10-10 00:00:00+03:00,in,False,911142,False,1,71,127,56
167059,2019-10-11 00:00:00+03:00,in,False,-1,True,1,0,10,10
167059,2019-10-11 00:00:00+03:00,in,False,911138,False,3,473,537,64
167059,2019-10-11 00:00:00+03:00,in,False,911140,False,1,153,170,17
167059,2019-10-14 00:00:00+03:00,in,False,911138,False,5,688,788,100
167059,2019-10-14 00:00:00+03:00,in,False,-1,True,2,0,14,14
167059,2019-10-15 00:00:00+03:00,in,False,-1,True,1,0,144,144
167059,2019-10-15 00:00:00+03:00,in,False,911138,False,3,559,617,58
167059,2019-10-16 00:00:00+03:00,in,False,911140,False,3,441,516,75
167059,2019-10-16 00:00:00+03:00,in,False,911138,False,10,1816,2016,200
167059,2019-10-16 00:00:00+03:00,in,False,911136,False,1,388,419,31
167059,2019-10-16 00:00:00+03:00,in,False,-1,True,2,0,9,9
167059,2019-10-17 00:00:00+03:00,in,False,911138,False,6,1281,1401,120
167059,2019-10-18 00:00:00+03:00,in,False,911140,False,3,377,438,61
167059,2019-10-18 00:00:00+03:00,in,False,-1,True,1,0,9,9
167059,2019-10-18 00:00:00+03:00,in,False,911138,False,9,1391,1563,172
167059,2019-10-19 00:00:00+03:00,in,False,-1,True,1,0,60,60
167059,2019-10-21 00:00:00+03:00,in,False,911136,False,1,276,294,18
167059,2019-10-21 00:00:00+03:00,in,False,911138,False,6,644,772,128
167059,2019-10-21 00:00:00+03:00,in,False,911140,False,5,804,908,104
167059,2019-10-22 00:00:00+03:00,in,False,911138,True,1,0,18,18
167059,2019-10-22 00:00:00+03:00,in,False,911140,False,2,520,558,38
167059,2019-10-22 00:00:00+03:00,in,False,-1,True,2,0,148,148
167059,2019-10-22 00:00:00+03:00,in,False,911138,False,9,884,1052,168
167059,2019-10-22 00:00:00+03:00,in,False,911138,True,1,0,18,18
167059,2019-10-23 00:00:00+03:00,in,False,-1,True,1,0,11,11
167059,2019-10-23 00:00:00+03:00,in,False,911140,False,2,217,264,47
167059,2019-10-23 00:00:00+03:00,in,False,911138,False,6,631,745,114
167059,2019-10-23 00:00:00+03:00,in,False,911136,False,3,177,232,55
167059,2019-10-23 00:00:00+03:00,in,False,911140,False,2,217,264,47
167059,2019-10-24 00:00:00+03:00,in,False,911136,False,2,140,184,44
167059,2019-10-24 00:00:00+03:00,in,False,911140,False,2,396,445,49
167059,2019-10-24 00:00:00+03:00,in,False,-1,True,1,0,16,16
167059,2019-10-24 00:00:00+03:00,in,False,911138,False,6,974,1085,111
167059,2019-10-25 00:00:00+03:00,in,False,911102,False,1,23,44,21
167059,2019-10-25 00:00:00+03:00,in,False,911140,False,2,193,235,42
167059,2019-10-25 00:00:00+03:00,in,False,911136,False,5,389,519,130
167059,2019-10-25 00:00:00+03:00,in,False,911138,False,5,829,940,111
167059,2019-10-25 00:00:00+03:00,in,False,911102,True,1,0,20,20
167059,2019-10-25 00:00:00+03:00,in,False,-1,True,1,0,8,8
167059,2019-10-26 00:00:00+03:00,in,False,-1,True,2,0,125,125
167059,2019-10-27 00:00:00+03:00,in,False,-1,True,1,0,2,2
167059,2019-10-28 00:00:00+03:00,in,False,-1,True,1,0,128,128
167059,2019-10-28 00:00:00+03:00,in,False,911136,False,2,187,223,36
167059,2019-10-28 00:00:00+03:00,in,False,911140,False,1,59,77,18
167059,2019-10-28 00:00:00+03:00,in,False,911142,False,1,93,131,38
167059,2019-10-28 00:00:00+03:00,in,False,911138,False,5,687,787,100
167059,2019-10-28 00:00:00+03:00,in,False,911142,False,1,93,131,38
167059,2019-10-29 00:00:00+03:00,in,False,911136,False,1,96,113,17
167059,2019-10-29 00:00:00+03:00,in,False,-1,True,1,0,6,6
167059,2019-10-29 00:00:00+03:00,in,False,911138,False,4,305,381,76
167059,2019-10-30 00:00:00+03:00,in,False,911138,False,3,334,390,56
167059,2019-10-30 00:00:00+03:00,in,False,911140,False,2,271,327,56
167059,2019-10-30 00:00:00+03:00,in,False,911136,False,1,65,82,17
167059,2019-10-30 00:00:00+03:00,in,False,911140,False,2,271,327,56
167059,2019-10-31 00:00:00+03:00,in,False,911136,False,1,95,116,21
167059,2019-10-31 00:00:00+03:00,in,False,-1,True,1,0,10,10
167059,2019-10-31 00:00:00+03:00,in,False,911138,False,4,257,332,75
167059,2019-11-01 00:00:00+03:00,in,False,-1,True,1,0,225,225
167059,2019-11-01 00:00:00+03:00,in,False,911140,True,1,0,27,27
167059,2019-11-01 00:00:00+03:00,in,False,911138,False,5,873,964,91
167059,2019-11-02 00:00:00+03:00,in,False,911102,False,1,70,111,41
167059,2019-11-04 00:00:00+03:00,in,False,-1,True,1,0,34,34
167059,2019-11-05 00:00:00+03:00,in,False,911140,False,3,326,391,65
167059,2019-11-05 00:00:00+03:00,in,False,911136,False,1,69,86,17
167059,2019-11-05 00:00:00+03:00,in,False,911142,False,1,49,93,44
167059,2019-11-05 00:00:00+03:00,in,False,-1,True,1,0,11,11
167059,2019-11-05 00:00:00+03:00,in,False,911138,False,8,971,1130,159
167059,2019-11-06 00:00:00+03:00,in,False,911138,False,1,184,201,17
167059,2019-11-06 00:00:00+03:00,in,False,911140,False,1,115,136,21
167059,2019-11-06 00:00:00+03:00,in,False,-1,True,3,0,221,221
167059,2019-11-06 00:00:00+03:00,in,False,911136,False,3,538,593,55
167059,2019-11-07 00:00:00+03:00,in,False,911138,False,2,202,238,36
167059,2019-11-07 00:00:00+03:00,in,False,911136,False,3,479,546,67
167059,2019-11-07 00:00:00+03:00,in,False,911140,False,1,106,123,17
167059,2019-11-08 00:00:00+03:00,in,False,911140,False,1,42,75,33
167059,2019-11-08 00:00:00+03:00,in,False,911138,False,8,633,781,148
167059,2019-11-08 00:00:00+03:00,in,False,911136,False,3,186,256,70
167059,2019-11-08 00:00:00+03:00,in,False,-1,True,1,0,22,22
167059,2019-11-09 00:00:00+03:00,in,False,-1,True,1,0,5,5
167059,2019-11-09 00:00:00+03:00,in,False,911102,False,6,147,308,161
167059,2019-11-09 00:00:00+03:00,in,False,911102,True,1,0,29,29
167059,2019-11-09 00:00:00+03:00,in,False,911102,False,6,147,308,161
167059,2019-11-10 00:00:00+03:00,in,False,911102,False,1,24,59,35
167059,2019-11-10 00:00:00+03:00,in,False,911102,False,1,24,59,35
167059,2019-11-11 00:00:00+03:00,in,False,911140,False,1,115,167,52
167059,2019-11-11 00:00:00+03:00,in,False,-1,True,1,0,9,9
167059,2019-11-11 00:00:00+03:00,in,False,911138,False,13,1329,1618,289
167059,2019-11-11 00:00:00+03:00,in,False,911136,False,4,468,556,88
167059,2019-11-11 00:00:00+03:00,in,False,911142,False,1,44,109,65
167059,2019-11-12 00:00:00+03:00,in,False,-1,True,1,0,63,63
167059,2019-11-12 00:00:00+03:00,in,False,911138,False,8,1011,1157,146
167059,2019-11-12 00:00:00+03:00,in,False,911136,False,3,312,371,59
167059,2019-11-12 00:00:00+03:00,in,False,911140,False,5,575,684,109
167059,2019-11-12 00:00:00+03:00,in,False,911136,False,3,312,371,59
167059,2019-11-13 00:00:00+03:00,in,False,911136,False,3,463,520,57
167059,2019-11-13 00:00:00+03:00,in,False,911140,False,1,105,127,22
167059,2019-11-13 00:00:00+03:00,in,False,911142,False,1,15,61,46
167059,2019-11-13 00:00:00+03:00,in,False,911138,False,8,754,907,153
167059,2019-11-13 00:00:00+03:00,in,False,911102,False,1,33,54,21
167059,2019-11-13 00:00:00+03:00,in,False,-1,True,1,0,15,15
167059,2019-11-13 00:00:00+03:00,in,False,911140,False,1,105,127,22
167059,2019-11-13 00:00:00+03:00,in,False,-1,True,1,0,15,15
167059,2019-11-14 00:00:00+03:00,in,False,911136,False,3,694,752,58
167059,2019-11-14 00:00:00+03:00,in,False,911140,False,1,413,433,20
167059,2019-11-14 00:00:00+03:00,in,False,911138,False,5,537,638,101
167059,2019-11-14 00:00:00+03:00,in,False,911142,False,3,90,231,141
167059,2019-11-14 00:00:00+03:00,in,False,911142,False,3,90,231,141
167059,2019-11-14 00:00:00+03:00,in,False,911138,False,5,537,638,101
167059,2019-11-15 00:00:00+03:00,in,False,911102,False,1,195,214,19
167059,2019-11-15 00:00:00+03:00,in,False,-1,True,2,0,70,70
167059,2019-11-15 00:00:00+03:00,in,False,911136,False,7,1036,1161,125
167059,2019-11-15 00:00:00+03:00,in,False,911138,False,6,633,778,145
167059,2019-11-15 00:00:00+03:00,in,False,911140,False,2,369,431,62
167059,2019-11-15 00:00:00+03:00,in,False,911102,False,1,195,214,19
167059,2019-11-16 00:00:00+03:00,in,False,911102,False,1,38,63,25
167059,2019-11-17 00:00:00+03:00,in,False,911102,False,1,182,203,21
167059,2019-11-18 00:00:00+03:00,in,False,911140,False,3,354,447,93
167059,2019-11-18 00:00:00+03:00,in,False,911138,False,4,593,669,76
167059,2019-11-18 00:00:00+03:00,in,False,911136,False,9,1089,1311,222
167059,2019-11-18 00:00:00+03:00,in,False,-1,True,1,0,5,5
167059,2019-11-19 00:00:00+03:00,in,False,911138,False,9,1072,1258,186
167059,2019-11-19 00:00:00+03:00,in,False,911140,False,3,218,334,116
167059,2019-11-19 00:00:00+03:00,in,False,911136,False,10,1192,1377,185
167059,2019-11-20 00:00:00+03:00,in,False,911136,False,9,995,1203,208
167059,2019-11-20 00:00:00+03:00,in,False,911138,False,5,1002,1096,94
167059,2019-11-20 00:00:00+03:00,in,False,-1,True,3,0,48,48
167059,2019-11-20 00:00:00+03:00,in,False,911102,False,1,79,99,20
167059,2019-11-20 00:00:00+03:00,in,False,911140,False,5,634,742,108
167059,2019-11-20 00:00:00+03:00,in,False,911138,False,5,1002,1096,94
167059,2019-11-20 00:00:00+03:00,in,False,-1,True,3,0,48,48
167059,2019-11-21 00:00:00+03:00,in,False,911138,False,4,689,772,83
167059,2019-11-21 00:00:00+03:00,in,False,911142,False,1,40,96,56
167059,2019-11-21 00:00:00+03:00,in,False,911140,False,5,482,613,131
167059,2019-11-21 00:00:00+03:00,in,False,911136,False,5,535,634,99
167059,2019-11-21 00:00:00+03:00,in,False,-1,True,1,0,14,14
167059,2019-11-21 00:00:00+03:00,in,False,911138,False,4,689,772,83
167059,2019-11-22 00:00:00+03:00,in,False,911136,False,11,1355,1573,218
167059,2019-11-22 00:00:00+03:00,in,False,911138,False,5,483,618,135
167059,2019-11-23 00:00:00+03:00,in,False,911102,False,1,33,55,22
167059,2019-11-25 00:00:00+03:00,in,False,911136,False,11,1395,1597,202
167059,2019-11-25 00:00:00+03:00,in,False,911138,False,2,195,275,80
167059,2019-11-25 00:00:00+03:00,in,False,911102,False,1,50,74,24
167059,2019-11-26 00:00:00+03:00,in,False,-1,True,1,0,11,11
167059,2019-11-26 00:00:00+03:00,in,False,911136,False,9,1114,1287,173
167059,2019-11-26 00:00:00+03:00,in,False,911102,False,2,35,172,137
167059,2019-11-26 00:00:00+03:00,in,False,911138,False,5,893,1064,171
167059,2019-11-26 00:00:00+03:00,in,False,911136,False,9,1114,1287,173
167059,2019-11-27 00:00:00+03:00,in,False,-1,True,7,0,108,108
167059,2019-11-27 00:00:00+03:00,in,False,911136,False,4,386,459,73
167059,2019-11-27 00:00:00+03:00,in,False,911140,False,1,66,90,24
167059,2019-11-27 00:00:00+03:00,in,False,911138,False,6,867,992,125
167059,2019-11-27 00:00:00+03:00,in,False,911136,False,4,386,459,73
167059,2019-11-28 00:00:00+03:00,in,False,911138,False,2,215,251,36
167059,2019-11-28 00:00:00+03:00,in,False,-1,True,1,0,6,6
167059,2019-11-28 00:00:00+03:00,in,False,911142,False,1,20,75,55
167059,2019-11-28 00:00:00+03:00,in,False,911136,False,6,2317,2428,111
167059,2019-11-28 00:00:00+03:00,in,False,911140,False,4,306,416,110
167059,2019-11-28 00:00:00+03:00,in,False,911136,False,6,2317,2428,111
167059,2019-11-28 00:00:00+03:00,in,False,911142,False,1,20,75,55
167060,2019-10-04 00:00:00+03:00,in,False,-1,True,2,0,4,4
167060,2019-10-04 00:00:00+03:00,in,False,-1,True,2,0,4,4
167060,2019-10-07 00:00:00+03:00,in,False,-1,True,3,0,6,6
167060,2019-10-08 00:00:00+03:00,in,False,-1,True,5,0,6,6
167060,2019-10-08 00:00:00+03:00,in,False,-1,True,5,0,6,6
167060,2019-10-09 00:00:00+03:00,in,False,-1,True,1,0,0,0
167060,2019-10-09 00:00:00+03:00,out,False,930914,True,4,0,214,214
167060,2019-10-09 00:00:00+03:00,in,False,930908,False,1,449,453,4
167060,2019-10-09 00:00:00+03:00,out,True,930914,True,1,0,1,1
167060,2019-10-09 00:00:00+03:00,out,False,930914,False,4,182,229,47
167060,2019-10-10 00:00:00+03:00,out,False,930914,False,3,342,372,30
167060,2019-10-10 00:00:00+03:00,in,False,930908,False,1,41,44,3
167060,2019-10-10 00:00:00+03:00,out,False,930908,False,4,344,384,40
167060,2019-10-10 00:00:00+03:00,out,False,930914,True,8,0,241,241
167060,2019-10-10 00:00:00+03:00,in,False,-1,True,2,0,20,20
167060,2019-10-10 00:00:00+03:00,out,True,930908,True,1,0,0,0
167060,2019-10-10 00:00:00+03:00,in,False,-1,True,2,0,20,20
167060,2019-10-11 00:00:00+03:00,in,False,-1,True,1,0,10,10
167060,2019-10-14 00:00:00+03:00,out,False,930914,False,5,554,608,54
167060,2019-10-14 00:00:00+03:00,out,False,930914,True,2,0,88,88
167060,2019-10-15 00:00:00+03:00,out,False,930914,False,4,203,254,51
167060,2019-10-15 00:00:00+03:00,in,False,930908,False,1,35,40,5
167060,2019-10-16 00:00:00+03:00,out,True,930908,True,1,0,0,0
167060,2019-10-16 00:00:00+03:00,in,False,-1,True,1,0,10,10
167060,2019-10-16 00:00:00+03:00,out,False,930914,True,1,0,28,28
167060,2019-10-16 00:00:00+03:00,in,False,930908,False,2,492,504,12
167060,2019-10-16 00:00:00+03:00,out,False,930914,False,3,131,158,27
167060,2019-10-17 00:00:00+03:00,in,False,-1,True,10,0,100,100
167060,2019-10-17 00:00:00+03:00,out,False,930914,True,2,0,18,18
167060,2019-10-17 00:00:00+03:00,in,False,930908,False,1,70,75,5
167060,2019-10-17 00:00:00+03:00,out,False,930914,False,2,118,156,38
167060,2019-10-17 00:00:00+03:00,out,False,930910,False,2,182,193,11
167060,2019-10-17 00:00:00+03:00,out,False,930908,False,2,283,288,5
167060,2019-10-18 00:00:00+03:00,in,False,-1,True,5,0,50,50
167060,2019-10-21 00:00:00+03:00,out,False,930908,False,1,221,222,1
167060,2019-10-21 00:00:00+03:00,out,False,930908,True,1,0,6,6
167060,2019-10-21 00:00:00+03:00,in,False,930908,False,1,83,86,3
167060,2019-10-22 00:00:00+03:00,in,False,930908,False,1,41,50,9
167060,2019-10-23 00:00:00+03:00,in,False,930908,False,1,24,30,6
167060,2019-10-23 00:00:00+03:00,in,False,930908,False,1,24,30,6
167060,2019-10-24 00:00:00+03:00,in,False,-1,True,2,0,20,20
167060,2019-10-25 00:00:00+03:00,out,False,930910,False,1,149,163,14
167060,2019-10-25 00:00:00+03:00,in,False,-1,True,5,0,50,50
167060,2019-10-25 00:00:00+03:00,out,False,930914,True,1,0,12,12
167060,2019-10-25 00:00:00+03:00,out,False,930914,False,2,371,392,21
167060,2019-10-25 00:00:00+03:00,in,False,-1,True,5,0,50,50
167060,2019-10-28 00:00:00+03:00,in,False,-1,True,2,0,20,20
167060,2019-10-28 00:00:00+03:00,out,True,930914,True,1,0,0,0
167060,2019-10-28 00:00:00+03:00,out,False,930914,False,12,642,812,170
167060,2019-10-28 00:00:00+03:00,out,False,930914,True,3,0,44,44
167060,2019-10-28 00:00:00+03:00,out,False,930914,False,12,642,812,170
167060,2019-10-28 00:00:00+03:00,out,True,930914,True,1,0,0,0
167060,2019-10-29 00:00:00+03:00,in,False,-1,True,1,0,10,10
167060,2019-10-29 00:00:00+03:00,out,False,930914,True,12,0,363,363
167060,2019-10-29 00:00:00+03:00,out,False,930914,False,8,668,770,102
167060,2019-10-29 00:00:00+03:00,in,False,930908,False,1,50,57,7
167060,2019-10-29 00:00:00+03:00,out,True,930914,True,1,0,0,0
167060,2019-10-30 00:00:00+03:00,in,False,930908,False,3,267,288,21
167060,2019-10-30 00:00:00+03:00,out,False,930914,False,4,438,506,68
167060,2019-10-30 00:00:00+03:00,out,False,930908,False,2,103,118,15
167060,2019-10-30 00:00:00+03:00,out,True,930908,True,2,0,0,0
167060,2019-10-30 00:00:00+03:00,in,False,-1,True,3,0,30,30
167060,2019-10-30 00:00:00+03:00,out,False,930914,True,10,0,232,232
167060,2019-10-30 00:00:00+03:00,out,True,930908,True,2,0,0,0
167060,2019-10-31 00:00:00+03:00,out,False,930908,True,1,0,3,3
167060,2019-10-31 00:00:00+03:00,in,False,930908,False,3,135,149,14
167060,2019-10-31 00:00:00+03:00,out,False,930914,False,5,470,542,72
167060,2019-10-31 00:00:00+03:00,in,False,-1,True,1,0,10,10
167060,2019-10-31 00:00:00+03:00,out,False,930914,True,6,0,199,199
167060,2019-11-01 00:00:00+03:00,out,False,930914,True,3,0,124,124
167060,2019-11-01 00:00:00+03:00,out,False,930908,True,5,0,31,31
167060,2019-11-01 00:00:00+03:00,out,False,930914,False,6,180,261,81
167060,2019-11-01 00:00:00+03:00,out,False,930908,False,3,321,330,9
167060,2019-11-01 00:00:00+03:00,out,True,930914,True,1,0,0,0
167060,2019-11-05 00:00:00+03:00,out,False,930914,True,5,0,86,86
167060,2019-11-05 00:00:00+03:00,out,False,930908,False,1,56,69,13
167060,2019-11-05 00:00:00+03:00,out,False,930914,False,12,291,470,179
167060,2019-11-05 00:00:00+03:00,in,False,930908,False,1,248,255,7
167060,2019-11-06 00:00:00+03:00,out,False,930914,True,7,0,205,205
167060,2019-11-06 00:00:00+03:00,in,False,930908,False,1,179,183,4
167060,2019-11-06 00:00:00+03:00,out,False,930914,False,15,646,881,235
167060,2019-11-07 00:00:00+03:00,out,False,930914,False,7,204,345,141
167060,2019-11-07 00:00:00+03:00,out,False,930914,True,17,0,669,669
167060,2019-11-07 00:00:00+03:00,in,False,-1,True,1,0,10,10
167060,2019-11-07 00:00:00+03:00,in,False,930908,False,1,25,33,8
167060,2019-11-07 00:00:00+03:00,out,False,930908,False,5,414,437,23
167060,2019-11-07 00:00:00+03:00,out,False,930908,True,3,0,27,27
167060,2019-11-08 00:00:00+03:00,out,False,930914,False,13,813,929,116
167060,2019-11-08 00:00:00+03:00,out,False,930914,True,17,0,429,429
167060,2019-11-08 00:00:00+03:00,out,False,930910,False,1,32,45,13
167060,2019-11-08 00:00:00+03:00,in,False,-1,True,6,0,60,60
167060,2019-11-08 00:00:00+03:00,out,False,930908,False,1,1131,1135,4
167060,2019-11-11 00:00:00+03:00,out,False,930914,True,4,0,59,59
167060,2019-11-11 00:00:00+03:00,out,False,930914,False,10,528,610,82
167060,2019-11-11 00:00:00+03:00,out,True,930914,True,1,0,0,0
167060,2019-11-11 00:00:00+03:00,in,False,-1,True,2,0,20,20
167060,2019-11-12 00:00:00+03:00,out,False,930914,True,6,0,181,181
167060,2019-11-12 00:00:00+03:00,out,False,930912,False,3,46,91,45
167060,2019-11-12 00:00:00+03:00,out,True,930912,True,4,0,0,0
167060,2019-11-12 00:00:00+03:00,out,False,930914,False,15,970,1065,95
167060,2019-11-12 00:00:00+03:00,in,False,930908,False,3,402,418,16
167060,2019-11-12 00:00:00+03:00,in,False,-1,True,2,0,20,20
167060,2019-11-12 00:00:00+03:00,out,False,930908,False,1,144,149,5
167060,2019-11-12 00:00:00+03:00,out,False,930910,False,1,152,155,3
167060,2019-11-13 00:00:00+03:00,in,False,-1,True,2,0,20,20
167060,2019-11-13 00:00:00+03:00,out,False,930912,True,2,0,30,30
167060,2019-11-13 00:00:00+03:00,out,False,930910,False,1,284,286,2
167060,2019-11-13 00:00:00+03:00,out,False,930908,True,1,0,0,0
167060,2019-11-13 00:00:00+03:00,out,False,930912,False,11,249,402,153
167060,2019-11-13 00:00:00+03:00,out,False,930914,False,3,211,265,54
167060,2019-11-13 00:00:00+03:00,in,False,930908,False,1,15,24,9
167060,2019-11-14 00:00:00+03:00,out,False,930912,True,15,0,157,157
167060,2019-11-14 00:00:00+03:00,out,False,930914,False,7,439,531,92
167060,2019-11-14 00:00:00+03:00,out,False,930908,True,1,0,7,7
167060,2019-11-14 00:00:00+03:00,out,False,930910,False,1,564,568,4
167060,2019-11-14 00:00:00+03:00,out,True,930910,True,1,0,0,0
167060,2019-11-14 00:00:00+03:00,out,False,930912,False,20,686,1027,341
167060,2019-11-14 00:00:00+03:00,out,False,930908,False,2,231,243,12
167060,2019-11-14 00:00:00+03:00,in,False,930908,False,1,16,22,6
167060,2019-11-14 00:00:00+03:00,out,False,930914,True,2,0,32,32
167060,2019-11-15 00:00:00+03:00,out,False,930914,False,4,157,166,9
167060,2019-11-15 00:00:00+03:00,out,False,930912,True,9,0,134,134
167060,2019-11-15 00:00:00+03:00,out,False,930912,False,4,641,701,60
167060,2019-11-15 00:00:00+03:00,out,False,930914,True,1,0,59,59
167060,2019-11-17 00:00:00+03:00,in,False,-1,True,1,0,3,3
167060,2019-11-18 00:00:00+03:00,out,False,930912,False,17,1107,1321,214
167060,2019-11-18 00:00:00+03:00,in,False,-1,True,2,0,20,20
167060,2019-11-18 00:00:00+03:00,in,False,930908,False,3,227,242,15
167060,2019-11-18 00:00:00+03:00,out,False,930914,True,1,0,3,3
167060,2019-11-18 00:00:00+03:00,out,False,930912,True,19,0,246,246
167060,2019-11-18 00:00:00+03:00,out,False,930912,False,17,1107,1321,214
167060,2019-11-18 00:00:00+03:00,in,False,-1,True,2,0,20,20
167060,2019-11-18 00:00:00+03:00,in,False,930908,False,3,227,242,15
167060,2019-11-19 00:00:00+03:00,out,False,930914,True,2,0,26,26
167060,2019-11-19 00:00:00+03:00,out,False,930914,False,6,280,341,61
167060,2019-11-19 00:00:00+03:00,in,False,-1,True,3,0,29,29
167060,2019-11-19 00:00:00+03:00,out,True,930914,True,1,0,0,0
167060,2019-11-20 00:00:00+03:00,out,False,930910,False,3,329,337,8
167060,2019-11-20 00:00:00+03:00,in,False,930910,False,1,23,28,5
167060,2019-11-20 00:00:00+03:00,out,False,930914,False,2,82,90,8
167060,2019-11-20 00:00:00+03:00,out,False,930912,False,15,888,1015,127
167060,2019-11-20 00:00:00+03:00,in,False,930908,False,1,29,36,7
167060,2019-11-20 00:00:00+03:00,in,False,-1,True,1,0,10,10
167060,2019-11-20 00:00:00+03:00,out,False,930912,True,31,0,655,655
167060,2019-11-21 00:00:00+03:00,in,False,930908,False,1,6,12,6
167060,2019-11-21 00:00:00+03:00,out,False,930912,True,21,0,318,318
167060,2019-11-21 00:00:00+03:00,out,False,930908,False,1,73,74,1
167060,2019-11-21 00:00:00+03:00,out,False,930912,False,11,895,1007,112
167060,2019-11-22 00:00:00+03:00,out,False,930914,True,3,0,130,130
167060,2019-11-22 00:00:00+03:00,out,False,930912,False,3,480,509,29
167060,2019-11-22 00:00:00+03:00,out,False,930910,False,1,31,45,14
167060,2019-11-22 00:00:00+03:00,out,False,930914,False,5,162,241,79
167060,2019-11-22 00:00:00+03:00,out,False,930912,True,5,0,101,101
167060,2019-11-22 00:00:00+03:00,out,False,930910,False,1,31,45,14
167060,2019-11-25 00:00:00+03:00,out,False,930914,True,4,0,128,128
167060,2019-11-25 00:00:00+03:00,out,False,930914,False,5,260,321,61
167060,2019-11-25 00:00:00+03:00,in,False,930908,False,1,74,82,8
167060,2019-11-25 00:00:00+03:00,in,False,-1,True,2,0,20,20
167060,2019-11-26 00:00:00+03:00,out,False,930908,False,1,27,35,8
167060,2019-11-26 00:00:00+03:00,in,False,930908,False,4,225,244,19
167060,2019-11-26 00:00:00+03:00,in,False,-1,True,1,0,10,10
167060,2019-11-26 00:00:00+03:00,out,False,930914,True,3,0,112,112
167060,2019-11-26 00:00:00+03:00,out,False,930914,False,9,465,548,83
167060,2019-11-27 00:00:00+03:00,out,False,930914,True,2,0,72,72
167060,2019-11-27 00:00:00+03:00,out,False,930912,False,14,2439,2600,161
167060,2019-11-27 00:00:00+03:00,in,False,-1,True,4,0,39,39
167060,2019-11-27 00:00:00+03:00,out,False,930912,True,11,0,284,284
167060,2019-11-27 00:00:00+03:00,out,False,930914,False,9,362,455,93
167060,2019-11-27 00:00:00+03:00,out,False,930912,False,14,2439,2600,161
167060,2019-11-27 00:00:00+03:00,in,False,-1,True,4,0,39,39
167060,2019-11-28 00:00:00+03:00,in,False,-1,True,1,0,6,6
167060,2019-11-28 00:00:00+03:00,out,False,930914,False,2,294,337,43
167060,2019-11-28 00:00:00+03:00,out,False,930914,False,2,294,337,43
167061,2019-09-01 00:00:00+03:00,in,False,-1,True,1,0,2,2
167061,2019-09-01 00:00:00+03:00,out,False,901034,True,4,0,0,0
167061,2019-09-01 00:00:00+03:00,out,True,901038,False,1,0,7,7
167061,2019-09-02 00:00:00+03:00,out,True,901038,False,1,281,290,9
167061,2019-09-02 00:00:00+03:00,in,False,-1,True,7,0,14,14
167061,2019-09-02 00:00:00+03:00,in,False,901034,False,1,153,160,7
167061,2019-09-03 00:00:00+03:00,out,True,901034,True,1,0,0,0
167061,2019-09-03 00:00:00+03:00,out,True,901038,False,1,572,580,8
167061,2019-09-04 00:00:00+03:00,out,False,901038,False,2,902,906,4
167061,2019-09-04 00:00:00+03:00,in,False,901034,False,1,113,123,10
167061,2019-09-04 00:00:00+03:00,out,True,901038,False,2,661,680,19
167061,2019-09-05 00:00:00+03:00,out,True,901038,False,1,255,269,14
167061,2019-09-16 00:00:00+03:00,in,False,-1,True,1,0,1,1
167061,2019-09-17 00:00:00+03:00,in,False,-1,True,2,0,1,1
167061,2019-09-27 00:00:00+03:00,in,False,-1,True,3,0,1,1
167061,2019-10-03 00:00:00+03:00,in,False,-1,True,12,0,8,8
167061,2019-10-07 00:00:00+03:00,in,False,-1,True,1,0,0,0
167061,2019-10-08 00:00:00+03:00,in,False,-1,True,3,0,1,1
167061,2019-10-10 00:00:00+03:00,in,False,901038,False,1,13,32,19
167061,2019-10-17 00:00:00+03:00,in,False,-1,True,3,0,4,4
167061,2019-10-17 00:00:00+03:00,out,False,901038,True,1,0,56,56
167061,2019-10-17 00:00:00+03:00,out,True,901038,True,1,0,0,0
167061,2019-10-18 00:00:00+03:00,in,False,-1,True,1,0,5,5
167061,2019-10-18 00:00:00+03:00,out,False,901038,False,1,160,168,8
167061,2019-10-25 00:00:00+03:00,in,False,-1,True,1,0,0,0
167061,2019-10-27 00:00:00+03:00,in,False,-1,True,3,0,24,24
167061,2019-10-27 00:00:00+03:00,out,False,901034,True,1,0,11,11
167061,2019-10-28 00:00:00+03:00,out,True,901038,False,1,291,296,5
167061,2019-10-28 00:00:00+03:00,in,False,901034,False,2,85,100,15
167061,2019-10-29 00:00:00+03:00,out,False,901038,False,1,132,147,15
167061,2019-10-29 00:00:00+03:00,in,False,901034,False,1,194,209,15
167061,2019-10-30 00:00:00+03:00,in,False,-1,True,1,0,38,38
167061,2019-10-31 00:00:00+03:00,out,False,901034,False,1,25,35,10
167061,2019-11-01 00:00:00+03:00,out,False,901034,False,1,33,45,12
167061,2019-11-02 00:00:00+03:00,out,False,901038,False,1,30,48,18
167061,2019-11-07 00:00:00+03:00,in,False,-1,True,8,0,5,5
167061,2019-11-08 00:00:00+03:00,out,False,901038,False,3,497,520,23
167061,2019-11-08 00:00:00+03:00,in,False,-1,True,5,0,1,1
167061,2019-11-08 00:00:00+03:00,in,False,901038,False,2,136,163,27
167061,2019-11-09 00:00:00+03:00,out,False,901034,True,1,0,35,35
167061,2019-11-09 00:00:00+03:00,in,False,-1,True,5,0,81,81
167061,2019-11-11 00:00:00+03:00,in,False,901038,False,1,37,50,13
167061,2019-11-11 00:00:00+03:00,in,False,-1,True,4,0,3,3
167061,2019-11-11 00:00:00+03:00,out,False,901038,False,2,163,193,30
167061,2019-11-12 00:00:00+03:00,out,False,901038,True,1,0,4,4
167061,2019-11-12 00:00:00+03:00,in,False,901034,False,3,472,508,36
167061,2019-11-12 00:00:00+03:00,out,True,901038,False,1,90,102,12
167061,2019-11-12 00:00:00+03:00,in,False,-1,True,7,0,13,13
167061,2019-11-12 00:00:00+03:00,out,False,901034,False,3,317,344,27
167061,2019-11-12 00:00:00+03:00,out,True,901038,True,1,0,1,1
167061,2019-11-12 00:00:00+03:00,out,False,901038,False,6,780,858,78
167061,2019-11-14 00:00:00+03:00,out,False,901038,False,1,48,58,10
167061,2019-11-14 00:00:00+03:00,in,False,901034,False,1,16,27,11
167061,2019-11-19 00:00:00+03:00,in,False,901034,False,1,334,352,18
167061,2019-11-20 00:00:00+03:00,in,False,901034,False,1,20,37,17
167061,2019-11-21 00:00:00+03:00,in,False,901038,False,1,37,92,55
167061,2019-11-21 00:00:00+03:00,out,False,901038,False,2,9,25,16
167061,2019-11-21 00:00:00+03:00,out,False,901038,True,1,0,8,8
167061,2019-11-22 00:00:00+03:00,in,False,901034,False,1,79,98,19
167061,2019-11-25 00:00:00+03:00,in,False,-1,True,1,0,2,2
167061,2019-11-26 00:00:00+03:00,out,False,901038,True,1,0,0,0
167061,2019-11-28 00:00:00+03:00,in,False,901034,False,1,18,29,11
167071,2019-09-18 00:00:00+03:00,in,False,-1,True,2,0,10,10
167071,2019-09-18 00:00:00+03:00,out,False,913938,True,1,0,13,13
167071,2019-09-19 00:00:00+03:00,in,False,913942,False,3,42,66,24
167071,2019-09-19 00:00:00+03:00,in,False,913938,False,2,19,43,24
167071,2019-09-19 00:00:00+03:00,in,False,-1,True,10,0,116,116
167071,2019-09-19 00:00:00+03:00,out,False,913938,True,9,0,244,244
167071,2019-09-19 00:00:00+03:00,out,False,913942,True,1,0,12,12
167071,2019-09-20 00:00:00+03:00,in,False,-1,True,2,0,13,13
167071,2019-09-20 00:00:00+03:00,out,False,913938,True,5,0,168,168
167071,2019-09-20 00:00:00+03:00,in,False,913938,False,17,1150,1306,156
167071,2019-09-20 00:00:00+03:00,out,False,913938,False,2,21,71,50
167071,2019-09-20 00:00:00+03:00,in,False,913942,False,14,867,985,118
167071,2019-09-20 00:00:00+03:00,in,False,913942,False,14,867,985,118
167071,2019-09-21 00:00:00+03:00,in,False,913938,False,5,370,405,35
167071,2019-09-21 00:00:00+03:00,in,False,913942,False,17,940,1066,126
167071,2019-09-21 00:00:00+03:00,in,False,-1,True,1,0,7,7
167071,2019-09-22 00:00:00+03:00,in,False,-1,True,5,0,167,167
167071,2019-09-23 00:00:00+03:00,in,False,913938,False,7,545,636,91
167071,2019-09-23 00:00:00+03:00,in,False,-1,True,8,0,210,210
167071,2019-09-23 00:00:00+03:00,in,False,913942,False,14,840,992,152
167071,2019-09-23 00:00:00+03:00,out,False,913942,True,2,0,24,24
167071,2019-09-23 00:00:00+03:00,in,False,913938,False,7,545,636,91
167071,2019-09-23 00:00:00+03:00,in,False,-1,True,8,0,210,210
167071,2019-09-24 00:00:00+03:00,in,False,913942,False,23,1609,1855,246
167071,2019-09-24 00:00:00+03:00,out,False,913942,True,3,0,142,142
167071,2019-09-24 00:00:00+03:00,in,False,-1,True,10,0,145,145
167071,2019-09-24 00:00:00+03:00,out,True,913942,True,2,0,0,0
167071,2019-09-24 00:00:00+03:00,out,False,913942,False,1,0,23,23
167071,2019-09-24 00:00:00+03:00,in,False,913938,False,27,2202,2464,262
167071,2019-09-24 00:00:00+03:00,out,True,913942,True,2,0,0,0
167071,2019-09-25 00:00:00+03:00,out,False,913942,False,8,249,375,126
167071,2019-09-25 00:00:00+03:00,in,False,-1,True,143,0,3129,3129
167071,2019-09-25 00:00:00+03:00,in,False,913938,False,27,1611,1933,322
167071,2019-09-25 00:00:00+03:00,out,False,-1,True,1,0,0,0
167071,2019-09-25 00:00:00+03:00,in,False,913942,False,36,2474,2768,294
167071,2019-09-25 00:00:00+03:00,out,False,913942,True,8,0,210,210
167071,2019-09-25 00:00:00+03:00,in,False,-1,True,143,0,3129,3129
167071,2019-09-25 00:00:00+03:00,in,False,913942,False,36,2474,2768,294
167071,2019-09-26 00:00:00+03:00,out,False,913942,False,7,623,649,26
167071,2019-09-26 00:00:00+03:00,in,False,913938,False,82,7218,7895,677
167071,2019-09-26 00:00:00+03:00,out,False,913938,False,6,461,598,137
167071,2019-09-26 00:00:00+03:00,in,False,-1,True,19,0,420,420
167071,2019-09-26 00:00:00+03:00,out,False,913942,True,1,0,2,2
167071,2019-09-26 00:00:00+03:00,in,False,913942,False,35,3690,4022,332
167071,2019-09-26 00:00:00+03:00,out,False,913942,False,7,623,649,26
167071,2019-09-27 00:00:00+03:00,in,False,913938,False,49,4617,5048,431
167071,2019-09-27 00:00:00+03:00,in,False,-1,True,7,0,171,171
167071,2019-09-27 00:00:00+03:00,out,False,913942,True,1,0,10,10
167071,2019-09-27 00:00:00+03:00,out,False,913942,False,1,200,204,4
167071,2019-09-27 00:00:00+03:00,in,False,913942,False,48,4132,4722,590
167071,2019-09-28 00:00:00+03:00,out,False,913942,False,2,147,152,5
167071,2019-09-28 00:00:00+03:00,in,False,913938,False,22,2034,2189,155
167071,2019-09-28 00:00:00+03:00,in,False,913942,True,1,0,17,17
167071,2019-09-28 00:00:00+03:00,in,False,913942,False,28,2315,2638,323
167071,2019-09-28 00:00:00+03:00,in,False,-1,True,16,0,400,400
167071,2019-09-29 00:00:00+03:00,in,False,-1,True,4,0,164,164
167071,2019-09-30 00:00:00+03:00,out,False,913942,False,7,517,594,77
167071,2019-09-30 00:00:00+03:00,in,False,913942,True,2,1,75,74
167071,2019-09-30 00:00:00+03:00,in,False,913942,False,88,9794,10718,924
167071,2019-09-30 00:00:00+03:00,in,False,913938,False,67,7513,8217,704
167071,2019-09-30 00:00:00+03:00,out,False,913942,True,2,0,2,2
167071,2019-09-30 00:00:00+03:00,out,True,913942,True,2,0,3,3
167071,2019-09-30 00:00:00+03:00,in,False,-1,True,108,0,3116,3116
167071,2019-10-01 00:00:00+03:00,in,False,913938,False,51,4047,4659,612
167071,2019-10-01 00:00:00+03:00,out,True,913942,True,1,0,0,0
167071,2019-10-01 00:00:00+03:00,out,False,913942,False,11,893,1056,163
167071,2019-10-01 00:00:00+03:00,in,False,913942,False,83,7431,8311,880
167071,2019-10-01 00:00:00+03:00,in,False,-1,True,49,0,1443,1443
167071,2019-10-01 00:00:00+03:00,out,False,913942,True,11,0,197,197
167071,2019-10-01 00:00:00+03:00,in,False,913942,True,1,1,41,40
167071,2019-10-01 00:00:00+03:00,in,False,913938,False,51,4047,4659,612
167071,2019-10-02 00:00:00+03:00,out,False,913942,False,1,54,62,8
167071,2019-10-02 00:00:00+03:00,out,False,913938,True,8,0,382,382
167071,2019-10-02 00:00:00+03:00,out,False,913938,False,17,579,978,399
167071,2019-10-02 00:00:00+03:00,in,False,913942,False,43,2918,3550,632
167071,2019-10-02 00:00:00+03:00,in,False,-1,True,18,0,547,547
167071,2019-10-02 00:00:00+03:00,in,False,913938,False,95,8808,9726,918
167071,2019-10-03 00:00:00+03:00,in,False,-1,True,26,0,782,782
167071,2019-10-03 00:00:00+03:00,in,False,913942,True,1,0,4,4
167071,2019-10-03 00:00:00+03:00,in,False,913942,False,91,7359,8163,804
167071,2019-10-03 00:00:00+03:00,out,False,913942,False,1,24,36,12
167071,2019-10-03 00:00:00+03:00,in,False,913938,False,32,2883,3214,331
167071,2019-10-04 00:00:00+03:00,in,False,913938,False,88,6885,7806,921
167071,2019-10-04 00:00:00+03:00,in,False,-1,True,34,0,1133,1133
167071,2019-10-04 00:00:00+03:00,out,False,913938,True,1,0,44,44
167071,2019-10-04 00:00:00+03:00,out,False,913938,False,11,227,490,263
167071,2019-10-04 00:00:00+03:00,in,False,913942,False,30,2375,2698,323
167071,2019-10-04 00:00:00+03:00,in,False,913942,True,1,1,41,40
167071,2019-10-05 00:00:00+03:00,in,False,913942,False,16,746,952,206
167071,2019-10-05 00:00:00+03:00,out,False,913938,False,1,47,66,19
167071,2019-10-05 00:00:00+03:00,in,False,-1,True,20,0,712,712
167071,2019-10-05 00:00:00+03:00,in,False,913938,False,47,2630,3045,415
167071,2019-10-06 00:00:00+03:00,in,False,-1,True,2,0,82,82
167071,2019-10-07 00:00:00+03:00,in,False,913942,False,127,10649,11908,1259
167071,2019-10-07 00:00:00+03:00,in,False,-1,True,59,0,1572,1572
167071,2019-10-07 00:00:00+03:00,in,False,913938,False,41,3222,3716,494
167071,2019-10-07 00:00:00+03:00,in,False,913942,True,1,0,12,12
167071,2019-10-08 00:00:00+03:00,in,False,913942,True,2,0,17,17
167071,2019-10-08 00:00:00+03:00,in,False,913942,False,109,10082,11457,1375
167071,2019-10-08 00:00:00+03:00,in,False,-1,True,59,0,1854,1854
167071,2019-10-09 00:00:00+03:00,in,False,-1,True,29,0,921,921
167071,2019-10-09 00:00:00+03:00,in,False,913942,True,4,3,45,42
167071,2019-10-09 00:00:00+03:00,in,False,913938,False,29,2595,2910,315
167071,2019-10-09 00:00:00+03:00,in,False,913942,False,90,6781,7906,1125
167071,2019-10-10 00:00:00+03:00,in,False,-1,True,24,0,596,596
167071,2019-10-10 00:00:00+03:00,in,False,913938,False,90,7777,8631,854
167071,2019-10-10 00:00:00+03:00,out,False,913938,False,3,110,164,54
167071,2019-10-11 00:00:00+03:00,in,False,913938,False,118,9887,11445,1558
167071,2019-10-11 00:00:00+03:00,out,False,913938,True,4,0,92,92
167071,2019-10-11 00:00:00+03:00,in,False,913942,False,17,1499,1687,188
167071,2019-10-11 00:00:00+03:00,in,False,-1,True,79,0,1725,1725
167071,2019-10-11 00:00:00+03:00,out,False,913938,False,14,427,725,298
167071,2019-10-11 00:00:00+03:00,in,False,913938,False,118,9887,11445,1558
167071,2019-10-11 00:00:00+03:00,in,False,-1,True,79,0,1725,1725
167071,2019-10-12 00:00:00+03:00,out,False,913938,True,1,0,63,63
167071,2019-10-12 00:00:00+03:00,in,False,913938,False,61,3775,4428,653
167071,2019-10-12 00:00:00+03:00,in,False,-1,True,13,0,276,276
167071,2019-10-12 00:00:00+03:00,in,False,913942,True,1,0,19,19
167071,2019-10-12 00:00:00+03:00,in,False,913942,False,4,74,119,45
167071,2019-10-12 00:00:00+03:00,out,False,913938,False,3,70,120,50
167071,2019-10-13 00:00:00+03:00,in,False,-1,True,9,0,356,356
167071,2019-10-14 00:00:00+03:00,out,False,913942,False,22,816,1218,402
167071,2019-10-14 00:00:00+03:00,out,False,913942,True,16,0,339,339
167071,2019-10-14 00:00:00+03:00,in,False,913938,False,71,7765,8541,776
167071,2019-10-14 00:00:00+03:00,in,False,913942,False,59,5285,5956,671
167071,2019-10-14 00:00:00+03:00,in,False,-1,True,56,0,1811,1811
167071,2019-10-15 00:00:00+03:00,out,False,913942,True,5,0,67,67
167071,2019-10-15 00:00:00+03:00,in,False,-1,True,66,0,1894,1894
167071,2019-10-15 00:00:00+03:00,in,False,913938,False,82,6575,7502,927
167071,2019-10-15 00:00:00+03:00,in,False,913942,True,4,1,40,39
167071,2019-10-15 00:00:00+03:00,in,False,913942,False,75,6641,7637,996
167071,2019-10-15 00:00:00+03:00,out,False,913942,False,20,761,1077,316
167071,2019-10-15 00:00:00+03:00,out,True,913942,True,1,0,0,0
167071,2019-10-15 00:00:00+03:00,out,True,913942,True,1,0,0,0
167071,2019-10-16 00:00:00+03:00,out,False,913942,False,17,829,1116,287
167071,2019-10-16 00:00:00+03:00,out,False,913942,True,9,0,288,288
167071,2019-10-16 00:00:00+03:00,in,False,913942,False,57,5324,5985,661
167071,2019-10-16 00:00:00+03:00,in,False,-1,True,32,0,873,873
167071,2019-10-16 00:00:00+03:00,in,False,913938,False,73,6280,6925,645
167071,2019-10-16 00:00:00+03:00,out,False,913942,False,17,829,1116,287
167071,2019-10-17 00:00:00+03:00,in,False,-1,True,84,0,1547,1547
167071,2019-10-17 00:00:00+03:00,out,False,913938,True,2,0,120,120
167071,2019-10-17 00:00:00+03:00,in,False,913938,False,130,12003,13420,1417
167071,2019-10-17 00:00:00+03:00,in,False,913938,True,1,0,8,8
167071,2019-10-18 00:00:00+03:00,out,False,913938,False,5,89,197,108
167071,2019-10-18 00:00:00+03:00,in,False,913942,True,1,1,29,28
167071,2019-10-18 00:00:00+03:00,in,False,913938,False,90,6727,7754,1027
167071,2019-10-18 00:00:00+03:00,in,False,913942,False,28,2390,2719,329
167071,2019-10-18 00:00:00+03:00,out,False,913938,True,1,0,21,21
167071,2019-10-18 00:00:00+03:00,in,False,-1,True,52,0,1210,1210
167071,2019-10-18 00:00:00+03:00,out,False,913938,True,1,0,21,21
167071,2019-10-19 00:00:00+03:00,in,False,913938,False,37,2269,2578,309
167071,2019-10-19 00:00:00+03:00,out,False,913938,True,6,0,202,202
167071,2019-10-19 00:00:00+03:00,in,False,913938,True,1,0,16,16
167071,2019-10-19 00:00:00+03:00,in,False,-1,True,10,0,276,276
167071,2019-10-19 00:00:00+03:00,in,False,913942,False,20,1559,1786,227
167071,2019-10-19 00:00:00+03:00,out,False,913938,False,11,266,517,251
167071,2019-10-20 00:00:00+03:00,in,False,-1,True,8,0,252,252
167071,2019-10-21 00:00:00+03:00,in,False,913938,False,116,10863,12047,1184
167071,2019-10-21 00:00:00+03:00,in,False,-1,True,71,0,1865,1865
167071,2019-10-21 00:00:00+03:00,out,False,913938,True,1,0,33,33
167071,2019-10-21 00:00:00+03:00,in,False,913942,False,67,6363,7155,792
167071,2019-10-21 00:00:00+03:00,out,False,913942,True,6,0,145,145
167071,2019-10-21 00:00:00+03:00,in,False,913942,True,1,0,16,16
167071,2019-10-21 00:00:00+03:00,out,True,913942,True,1,0,0,0
167071,2019-10-21 00:00:00+03:00,out,False,913942,False,16,565,839,274
167071,2019-10-21 00:00:00+03:00,in,False,913942,False,67,6363,7155,792
167071,2019-10-22 00:00:00+03:00,out,False,913942,False,1,32,47,15
167071,2019-10-22 00:00:00+03:00,in,False,-1,True,36,0,1099,1099
167071,2019-10-22 00:00:00+03:00,in,False,913938,False,130,10862,11790,928
167071,2019-10-22 00:00:00+03:00,out,False,913942,True,1,0,12,12
167071,2019-10-22 00:00:00+03:00,in,False,913942,True,2,2,25,23
167071,2019-10-22 00:00:00+03:00,in,False,913942,False,54,4670,5439,769
167071,2019-10-22 00:00:00+03:00,in,False,913942,False,54,4670,5439,769
167071,2019-10-22 00:00:00+03:00,out,False,913942,True,1,0,12,12
167071,2019-10-23 00:00:00+03:00,in,False,913938,False,103,9046,9739,693
167071,2019-10-23 00:00:00+03:00,out,False,913938,True,1,0,18,18
167071,2019-10-23 00:00:00+03:00,in,False,913942,False,36,2835,3277,442
167071,2019-10-23 00:00:00+03:00,in,False,-1,True,31,0,938,938
167071,2019-10-23 00:00:00+03:00,out,False,913938,False,1,37,46,9
167071,2019-10-24 00:00:00+03:00,in,False,913938,False,98,6574,7318,744
167071,2019-10-24 00:00:00+03:00,out,True,913942,True,1,0,0,0
167071,2019-10-24 00:00:00+03:00,in,False,913942,False,107,8851,9746,895
167071,2019-10-24 00:00:00+03:00,out,False,913942,False,10,948,1121,173
167071,2019-10-24 00:00:00+03:00,in,False,-1,True,58,0,1632,1632
167071,2019-10-24 00:00:00+03:00,out,False,913938,False,22,2328,2601,273
167071,2019-10-24 00:00:00+03:00,out,False,913942,True,2,0,32,32
167071,2019-10-24 00:00:00+03:00,out,False,913938,True,4,0,204,204
167071,2019-10-24 00:00:00+03:00,in,False,913942,True,2,1,39,38
167071,2019-10-25 00:00:00+03:00,in,False,-1,True,22,0,571,571
167071,2019-10-25 00:00:00+03:00,out,False,913938,False,2,71,141,70
167071,2019-10-25 00:00:00+03:00,in,False,913938,False,102,8045,8720,675
167071,2019-10-25 00:00:00+03:00,out,False,913942,False,1,172,174,2
167071,2019-10-25 00:00:00+03:00,in,False,913942,True,2,1,64,63
167071,2019-10-25 00:00:00+03:00,in,False,913938,True,1,0,7,7
167071,2019-10-25 00:00:00+03:00,in,False,913942,False,31,2848,3204,356
167071,2019-10-26 00:00:00+03:00,out,False,913938,True,3,0,75,75
167071,2019-10-26 00:00:00+03:00,in,False,-1,True,7,0,264,264
167071,2019-10-26 00:00:00+03:00,out,False,913938,False,10,323,550,227
167071,2019-10-26 00:00:00+03:00,in,False,913938,False,51,3243,3593,350
167071,2019-10-26 00:00:00+03:00,in,False,913942,False,5,339,409,70
167071,2019-10-27 00:00:00+03:00,in,False,913938,False,7,224,274,50
167071,2019-10-28 00:00:00+03:00,in,False,913942,False,54,5364,6139,775
167071,2019-10-28 00:00:00+03:00,in,False,913942,True,1,0,25,25
167071,2019-10-28 00:00:00+03:00,out,False,913942,False,6,284,368,84
167071,2019-10-28 00:00:00+03:00,in,False,913938,False,175,12053,13512,1459
167071,2019-10-28 00:00:00+03:00,in,False,-1,True,92,0,2842,2842
167071,2019-10-28 00:00:00+03:00,out,False,913942,True,7,0,161,161
167071,2019-10-29 00:00:00+03:00,in,False,913938,True,1,0,6,6
167071,2019-10-29 00:00:00+03:00,in,False,913942,False,57,5378,6032,654
167071,2019-10-29 00:00:00+03:00,in,False,-1,True,59,0,1605,1605
167071,2019-10-29 00:00:00+03:00,in,False,913938,False,171,9467,10850,1383
167071,2019-10-29 00:00:00+03:00,out,False,913938,False,2,74,92,18
167071,2019-10-29 00:00:00+03:00,out,True,913938,False,1,14,14,0
167071,2019-10-30 00:00:00+03:00,in,False,913938,False,91,6886,7579,693
167071,2019-10-30 00:00:00+03:00,out,False,913942,True,21,0,581,581
167071,2019-10-30 00:00:00+03:00,in,False,-1,True,36,0,1040,1040
167071,2019-10-30 00:00:00+03:00,out,False,913938,True,2,0,45,45
167071,2019-10-30 00:00:00+03:00,out,False,913942,False,29,912,1512,600
167071,2019-10-30 00:00:00+03:00,out,False,913938,False,5,739,816,77
167071,2019-10-30 00:00:00+03:00,in,False,913942,False,44,4143,4613,470
167071,2019-10-30 00:00:00+03:00,in,False,913938,False,91,6886,7579,693
167071,2019-10-31 00:00:00+03:00,out,False,913938,False,4,276,339,63
167071,2019-10-31 00:00:00+03:00,out,False,913938,True,1,0,14,14
167071,2019-10-31 00:00:00+03:00,in,False,-1,True,16,0,385,385
167071,2019-10-31 00:00:00+03:00,in,False,913942,False,25,1896,2354,458
167071,2019-10-31 00:00:00+03:00,in,False,913938,True,1,0,4,4
167071,2019-10-31 00:00:00+03:00,in,False,913938,False,94,7719,8418,699
167071,2019-10-31 00:00:00+03:00,in,False,913938,True,1,0,4,4
167071,2019-11-01 00:00:00+03:00,in,False,913942,False,14,1435,1745,310
167071,2019-11-01 00:00:00+03:00,in,False,913938,True,1,1,8,7
167071,2019-11-01 00:00:00+03:00,out,False,913938,False,11,259,517,258
167071,2019-11-01 00:00:00+03:00,out,False,913938,True,6,0,172,172
167071,2019-11-01 00:00:00+03:00,in,False,-1,True,15,0,590,590
167071,2019-11-01 00:00:00+03:00,in,False,913938,False,98,6568,7240,672
167071,2019-11-02 00:00:00+03:00,out,False,913938,True,8,0,312,312
167071,2019-11-02 00:00:00+03:00,in,False,913942,False,2,162,189,27
167071,2019-11-02 00:00:00+03:00,in,False,913938,False,50,3377,3716,339
167071,2019-11-02 00:00:00+03:00,in,False,-1,True,4,0,139,139
167071,2019-11-02 00:00:00+03:00,out,False,913938,False,19,312,767,455
167071,2019-11-03 00:00:00+03:00,in,False,913938,False,10,311,381,70
167071,2019-11-04 00:00:00+03:00,in,False,913938,False,89,2336,3003,667
167071,2019-11-04 00:00:00+03:00,in,False,-1,True,4,0,141,141
167071,2019-11-05 00:00:00+03:00,in,False,913938,False,162,12282,13655,1373
167071,2019-11-05 00:00:00+03:00,in,False,913938,True,2,0,47,47
167071,2019-11-05 00:00:00+03:00,in,False,913942,False,27,2173,2627,454
167071,2019-11-05 00:00:00+03:00,in,False,-1,True,219,0,2159,2159
167071,2019-11-05 00:00:00+03:00,out,False,913938,True,6,0,210,210
167071,2019-11-05 00:00:00+03:00,out,False,913938,False,11,571,816,245
167071,2019-11-05 00:00:00+03:00,out,False,913938,False,11,571,816,245
167071,2019-11-06 00:00:00+03:00,in,False,913942,True,2,1,46,45
167071,2019-11-06 00:00:00+03:00,in,False,913942,False,60,5997,6832,835
167071,2019-11-06 00:00:00+03:00,out,False,913938,True,9,0,293,293
167071,2019-11-06 00:00:00+03:00,out,False,913938,False,19,474,948,474
167071,2019-11-06 00:00:00+03:00,in,False,913938,True,1,0,7,7
167071,2019-11-06 00:00:00+03:00,in,False,913938,False,57,4475,4878,403
167071,2019-11-06 00:00:00+03:00,in,False,-1,True,27,0,893,893
167071,2019-11-06 00:00:00+03:00,in,False,-1,True,27,0,893,893
167071,2019-11-07 00:00:00+03:00,in,False,913942,False,91,8106,9159,1053
167071,2019-11-07 00:00:00+03:00,in,False,913942,True,1,1,17,16
167071,2019-11-07 00:00:00+03:00,out,False,913942,True,21,0,616,616
167071,2019-11-07 00:00:00+03:00,out,False,913942,False,23,883,1325,442
167071,2019-11-07 00:00:00+03:00,in,False,-1,True,40,0,1120,1120
167071,2019-11-08 00:00:00+03:00,in,False,913942,False,62,4394,4948,554
167071,2019-11-08 00:00:00+03:00,in,False,913938,False,35,2429,2706,277
167071,2019-11-08 00:00:00+03:00,in,False,913942,True,1,0,13,13
167071,2019-11-08 00:00:00+03:00,in,False,-1,True,21,0,713,713
167071,2019-11-09 00:00:00+03:00,in,False,-1,True,3,0,70,70
167071,2019-11-09 00:00:00+03:00,in,False,913938,False,50,2969,3313,344
167071,2019-11-10 00:00:00+03:00,in,False,913938,False,11,302,380,78
167071,2019-11-11 00:00:00+03:00,in,False,913942,False,37,3709,4205,496
167071,2019-11-11 00:00:00+03:00,in,False,-1,True,58,0,1331,1331
167071,2019-11-11 00:00:00+03:00,out,False,913938,True,3,0,30,30
167071,2019-11-11 00:00:00+03:00,out,False,913938,False,11,765,953,188
167071,2019-11-11 00:00:00+03:00,in,False,913938,False,135,9416,10495,1079
167071,2019-11-12 00:00:00+03:00,out,True,913942,True,3,0,0,0
167071,2019-11-12 00:00:00+03:00,in,False,913942,False,47,3727,4324,597
167071,2019-11-12 00:00:00+03:00,in,False,-1,True,19,0,436,436
167071,2019-11-12 00:00:00+03:00,out,False,913938,False,15,537,889,352
167071,2019-11-12 00:00:00+03:00,out,False,913942,True,20,0,442,442
167071,2019-11-12 00:00:00+03:00,in,False,913942,True,4,1,22,21
167071,2019-11-12 00:00:00+03:00,out,False,913942,False,27,1362,1956,594
167071,2019-11-12 00:00:00+03:00,out,False,913938,True,1,0,60,60
167071,2019-11-12 00:00:00+03:00,in,False,913938,False,107,7929,8694,765
167071,2019-11-13 00:00:00+03:00,in,False,913942,False,24,2021,2299,278
167071,2019-11-13 00:00:00+03:00,in,False,-1,True,10,0,289,289
167071,2019-11-13 00:00:00+03:00,out,False,913938,True,5,0,268,268
167071,2019-11-13 00:00:00+03:00,out,False,913938,False,13,469,780,311
167071,2019-11-13 00:00:00+03:00,in,False,913938,False,87,6614,7282,668
167071,2019-11-14 00:00:00+03:00,out,False,913938,True,3,0,58,58
167071,2019-11-14 00:00:00+03:00,out,False,913938,False,5,173,297,124
167071,2019-11-14 00:00:00+03:00,in,False,-1,True,36,0,917,917
167071,2019-11-14 00:00:00+03:00,in,False,913942,False,25,2426,2831,405
167071,2019-11-14 00:00:00+03:00,in,False,913938,True,1,0,7,7
167071,2019-11-14 00:00:00+03:00,in,False,913938,False,108,7912,8771,859
167071,2019-11-14 00:00:00+03:00,out,False,913938,False,5,173,297,124
167071,2019-11-15 00:00:00+03:00,out,False,913938,False,5,435,498,63
167071,2019-11-15 00:00:00+03:00,in,False,913938,False,71,4051,4582,531
167071,2019-11-15 00:00:00+03:00,in,False,913942,False,66,4523,5068,545
167071,2019-11-15 00:00:00+03:00,in,False,-1,True,30,0,843,843
167071,2019-11-15 00:00:00+03:00,in,False,913942,True,1,1,4,3
167071,2019-11-16 00:00:00+03:00,in,False,913942,False,15,655,777,122
167071,2019-11-16 00:00:00+03:00,out,False,913942,False,10,250,384,134
167071,2019-11-16 00:00:00+03:00,out,False,913938,False,14,417,708,291
167071,2019-11-16 00:00:00+03:00,out,False,913938,True,1,0,60,60
167071,2019-11-16 00:00:00+03:00,in,False,913942,True,1,1,7,6
167071,2019-11-16 00:00:00+03:00,in,False,913938,False,72,4399,4954,555
167071,2019-11-16 00:00:00+03:00,in,False,-1,True,14,0,442,442
167071,2019-11-17 00:00:00+03:00,in,False,913938,False,7,150,199,49
167071,2019-11-17 00:00:00+03:00,in,False,-1,True,1,0,41,41
167071,2019-11-18 00:00:00+03:00,in,False,913942,True,1,1,29,28
167071,2019-11-18 00:00:00+03:00,out,False,913938,False,7,862,954,92
167071,2019-11-18 00:00:00+03:00,out,False,913938,True,2,0,24,24
167071,2019-11-18 00:00:00+03:00,in,False,913942,False,37,2983,3595,612
167071,2019-11-18 00:00:00+03:00,in,False,-1,True,31,0,1108,1108
167071,2019-11-18 00:00:00+03:00,in,False,913938,False,129,9798,10789,991
167071,2019-11-18 00:00:00+03:00,in,False,913938,False,129,9798,10789,991
167071,2019-11-19 00:00:00+03:00,in,False,913942,True,1,0,4,4
167071,2019-11-19 00:00:00+03:00,in,False,-1,True,26,0,788,788
167071,2019-11-19 00:00:00+03:00,in,False,913938,False,136,7440,8527,1087
167071,2019-11-19 00:00:00+03:00,in,False,913942,False,16,2295,2548,253
167071,2019-11-19 00:00:00+03:00,in,False,913938,True,1,0,7,7
167071,2019-11-19 00:00:00+03:00,out,False,913938,False,7,150,285,135
167071,2019-11-20 00:00:00+03:00,in,False,913938,False,76,6307,6864,557
167071,2019-11-20 00:00:00+03:00,in,False,913938,True,1,0,7,7
167071,2019-11-20 00:00:00+03:00,in,False,-1,True,18,0,530,530
167071,2019-11-20 00:00:00+03:00,out,False,913938,True,2,0,32,32
167071,2019-11-20 00:00:00+03:00,out,False,913938,False,15,2747,2981,234
167071,2019-11-20 00:00:00+03:00,in,False,913942,True,2,1,46,45
167071,2019-11-20 00:00:00+03:00,in,False,913942,False,27,2995,3339,344
167071,2019-11-21 00:00:00+03:00,out,False,913938,False,6,410,492,82
167071,2019-11-21 00:00:00+03:00,in,False,913942,False,26,2005,2390,385
167071,2019-11-21 00:00:00+03:00,out,False,913938,True,5,0,21,21
167071,2019-11-21 00:00:00+03:00,in,False,-1,True,10,0,249,249
167071,2019-11-21 00:00:00+03:00,in,False,913938,False,85,6508,7108,600
167071,2019-11-21 00:00:00+03:00,in,False,-1,True,10,0,249,249
167071,2019-11-22 00:00:00+03:00,out,False,913938,True,3,0,108,108
167071,2019-11-22 00:00:00+03:00,in,False,913942,False,19,1142,1373,231
167071,2019-11-22 00:00:00+03:00,in,False,913942,True,1,0,4,4
167071,2019-11-22 00:00:00+03:00,in,False,-1,True,8,0,320,320
167071,2019-11-22 00:00:00+03:00,in,False,913938,False,72,5634,6145,511
167071,2019-11-22 00:00:00+03:00,out,False,913938,False,2,227,256,29
167071,2019-11-23 00:00:00+03:00,out,False,913938,True,1,0,30,30
167071,2019-11-23 00:00:00+03:00,in,False,913938,False,79,4172,4713,541
167071,2019-11-23 00:00:00+03:00,in,False,913942,False,1,107,114,7
167071,2019-11-23 00:00:00+03:00,out,False,913938,False,1,5,21,16
167071,2019-11-23 00:00:00+03:00,in,False,-1,True,4,0,164,164
167071,2019-11-24 00:00:00+03:00,in,False,913938,False,12,288,372,84
167071,2019-11-25 00:00:00+03:00,in,False,-1,True,88,0,2041,2041
167071,2019-11-25 00:00:00+03:00,in,False,913938,False,179,11311,12838,1527
167071,2019-11-25 00:00:00+03:00,out,False,913938,True,1,0,38,38
167071,2019-11-25 00:00:00+03:00,out,False,913938,False,8,965,1107,142
167071,2019-11-25 00:00:00+03:00,in,False,913942,False,40,2935,3780,845
167071,2019-11-25 00:00:00+03:00,out,False,913938,True,1,0,38,38
167071,2019-11-26 00:00:00+03:00,in,False,913942,True,7,4,71,67
167071,2019-11-26 00:00:00+03:00,in,False,913938,True,1,0,34,34
167071,2019-11-26 00:00:00+03:00,out,True,913938,True,1,0,0,0
167071,2019-11-26 00:00:00+03:00,in,False,913942,False,66,5182,6094,912
167071,2019-11-26 00:00:00+03:00,out,False,913942,False,16,425,687,262
167071,2019-11-26 00:00:00+03:00,out,False,913938,True,1,0,60,60
167071,2019-11-26 00:00:00+03:00,in,False,-1,True,40,0,1076,1076
167071,2019-11-26 00:00:00+03:00,out,False,913942,True,6,0,205,205
167071,2019-11-26 00:00:00+03:00,in,False,913938,False,114,8120,8976,856
167071,2019-11-26 00:00:00+03:00,out,False,913938,False,3,101,153,52
167071,2019-11-26 00:00:00+03:00,out,False,913938,True,1,0,60,60
167071,2019-11-26 00:00:00+03:00,out,False,913938,False,3,101,153,52
167071,2019-11-27 00:00:00+03:00,out,False,913942,False,37,1142,1892,750
167071,2019-11-27 00:00:00+03:00,in,False,-1,True,27,0,1011,1011
167071,2019-11-27 00:00:00+03:00,in,False,913942,False,62,5936,6626,690
167071,2019-11-27 00:00:00+03:00,in,False,913938,False,58,5339,5757,418
167071,2019-11-27 00:00:00+03:00,out,False,913942,True,12,0,356,356
167071,2019-11-27 00:00:00+03:00,in,False,913942,True,3,2,33,31
167071,2019-11-27 00:00:00+03:00,in,False,913942,True,3,2,33,31
167071,2019-11-27 00:00:00+03:00,in,False,913938,False,58,5339,5757,418
167071,2019-11-28 00:00:00+03:00,in,False,-1,True,10,0,234,234
167071,2019-11-28 00:00:00+03:00,in,False,913938,False,85,6356,6981,625
167071,2019-11-28 00:00:00+03:00,out,False,913938,True,2,0,65,65
167071,2019-11-28 00:00:00+03:00,in,False,913938,True,1,0,7,7
167071,2019-11-28 00:00:00+03:00,out,False,913938,False,6,436,521,85
167071,2019-11-28 00:00:00+03:00,in,False,913942,False,16,1469,1776,307
167071,2019-11-28 00:00:00+03:00,out,False,913938,False,6,436,521,85
167077,2019-09-06 00:00:00+03:00,in,False,-1,True,1,0,2,2
167077,2019-09-07 00:00:00+03:00,in,False,-1,True,1,0,1,1
167077,2019-09-09 00:00:00+03:00,in,False,-1,True,1,0,2,2
167077,2019-09-11 00:00:00+03:00,in,False,-1,True,1,0,2,2
167077,2019-09-12 00:00:00+03:00,in,False,-1,True,1,0,2,2
167077,2019-09-13 00:00:00+03:00,in,False,-1,True,4,0,8,8
167077,2019-09-13 00:00:00+03:00,in,False,-1,True,4,0,8,8
167077,2019-09-14 00:00:00+03:00,in,False,-1,True,4,0,8,8
167077,2019-09-15 00:00:00+03:00,in,False,-1,True,2,0,4,4
167077,2019-09-16 00:00:00+03:00,in,False,-1,True,3,0,6,6
167077,2019-09-22 00:00:00+03:00,in,False,-1,True,1,0,2,2
167077,2019-09-24 00:00:00+03:00,in,False,-1,True,3,0,6,6
167077,2019-10-06 00:00:00+03:00,in,False,-1,True,1,0,2,2
167077,2019-10-09 00:00:00+03:00,in,False,-1,True,2,0,4,4
167077,2019-10-10 00:00:00+03:00,in,False,-1,True,1,0,2,2
167077,2019-10-11 00:00:00+03:00,in,False,-1,True,1,0,2,2
167077,2019-10-11 00:00:00+03:00,in,False,-1,True,1,0,2,2
167077,2019-10-16 00:00:00+03:00,in,False,-1,True,2,0,4,4
167077,2019-10-18 00:00:00+03:00,in,False,-1,True,2,0,4,4
167077,2019-10-20 00:00:00+03:00,in,False,-1,True,1,0,2,2
167077,2019-10-20 00:00:00+03:00,in,False,-1,True,1,0,2,2
167077,2019-10-22 00:00:00+03:00,in,False,-1,True,1,0,2,2
167077,2019-10-22 00:00:00+03:00,in,False,-1,True,1,0,2,2
167077,2019-10-27 00:00:00+03:00,in,False,-1,True,1,0,2,2
167077,2019-10-31 00:00:00+03:00,in,False,-1,True,1,0,2,2
167077,2019-11-07 00:00:00+03:00,in,False,-1,True,2,0,4,4
167077,2019-11-10 00:00:00+03:00,in,False,-1,True,2,0,4,4
167077,2019-11-11 00:00:00+03:00,in,False,-1,True,1,0,2,2
167077,2019-11-13 00:00:00+03:00,in,False,-1,True,1,0,2,2
167077,2019-11-16 00:00:00+03:00,in,False,-1,True,2,0,4,4
167077,2019-11-18 00:00:00+03:00,in,False,-1,True,1,0,2,2
167077,2019-11-19 00:00:00+03:00,in,False,-1,True,2,0,6,6
167077,2019-11-20 00:00:00+03:00,in,False,-1,True,1,0,2,2
167077,2019-11-27 00:00:00+03:00,in,False,-1,True,1,0,1,1
167077,2019-11-27 00:00:00+03:00,in,False,-1,True,1,0,1,1
167078,2019-08-30 00:00:00+03:00,in,False,-1,True,3,0,7,7
167078,2019-09-02 00:00:00+03:00,in,False,900592,False,3,34,46,12
167078,2019-09-02 00:00:00+03:00,out,False,900592,True,2,0,2,2
167078,2019-09-02 00:00:00+03:00,out,False,900592,False,1,21,34,13
167078,2019-09-02 00:00:00+03:00,in,False,-1,True,8,0,18,18
167078,2019-09-06 00:00:00+03:00,in,False,900592,False,2,285,296,11
167078,2019-09-07 00:00:00+03:00,in,False,900592,False,1,21,42,21
167078,2019-09-11 00:00:00+03:00,in,False,900592,False,1,145,152,7
167078,2019-09-11 00:00:00+03:00,in,False,-1,True,1,0,30,30
167078,2019-09-13 00:00:00+03:00,in,False,-1,True,2,0,2,2
167078,2019-09-13 00:00:00+03:00,in,False,900592,False,1,193,201,8
167078,2019-09-13 00:00:00+03:00,in,False,-1,True,2,0,2,2
167078,2019-09-14 00:00:00+03:00,in,False,900592,False,1,75,83,8
167078,2019-09-15 00:00:00+03:00,in,False,-1,True,2,0,0,0
167078,2019-09-16 00:00:00+03:00,in,False,-1,True,4,0,63,63
167078,2019-09-16 00:00:00+03:00,in,False,900592,False,1,76,81,5
167078,2019-09-22 00:00:00+03:00,in,False,-1,True,2,0,0,0
167078,2019-09-23 00:00:00+03:00,in,False,900592,False,1,15,19,4
167078,2019-09-27 00:00:00+03:00,in,False,-1,True,1,0,31,31
167078,2019-09-30 00:00:00+03:00,in,False,-1,True,1,0,5,5
167078,2019-10-04 00:00:00+03:00,in,False,-1,True,4,0,1,1
167078,2019-10-07 00:00:00+03:00,in,False,-1,True,1,0,1,1
167078,2019-10-12 00:00:00+03:00,in,False,900592,False,1,69,75,6
167078,2019-10-12 00:00:00+03:00,out,False,900592,False,1,31,42,11
167078,2019-10-14 00:00:00+03:00,out,False,935348,False,4,372,419,47
167078,2019-10-14 00:00:00+03:00,out,True,900592,True,1,0,6,6
167078,2019-10-14 00:00:00+03:00,in,False,-1,True,2,0,48,48
167078,2019-10-14 00:00:00+03:00,out,False,935348,True,10,0,179,179
167078,2019-10-14 00:00:00+03:00,in,False,900592,False,1,33,40,7
167078,2019-10-14 00:00:00+03:00,out,True,900592,False,1,6,19,13
167078,2019-10-14 00:00:00+03:00,out,True,935348,True,2,0,1,1
167078,2019-10-14 00:00:00+03:00,out,True,900592,True,1,0,6,6
167078,2019-10-15 00:00:00+03:00,out,False,935348,False,10,727,809,82
167078,2019-10-15 00:00:00+03:00,out,False,935348,True,2,0,51,51
167078,2019-10-15 00:00:00+03:00,in,False,-1,True,2,0,34,34
167078,2019-10-16 00:00:00+03:00,out,False,935348,True,3,0,44,44
167078,2019-10-16 00:00:00+03:00,out,False,935348,False,1,88,93,5
167078,2019-10-16 00:00:00+03:00,in,False,-1,True,1,0,31,31
167078,2019-10-17 00:00:00+03:00,out,False,935348,False,3,115,187,72
167078,2019-10-17 00:00:00+03:00,in,False,-1,True,3,0,56,56
167078,2019-10-17 00:00:00+03:00,in,False,900592,False,5,266,295,29
167078,2019-10-17 00:00:00+03:00,out,False,935348,True,2,0,54,54
167078,2019-10-18 00:00:00+03:00,in,False,900592,False,1,29,34,5
167078,2019-10-18 00:00:00+03:00,out,False,935348,False,1,388,398,10
167078,2019-10-18 00:00:00+03:00,in,False,-1,True,2,0,1,1
167078,2019-10-20 00:00:00+03:00,in,False,-1,True,2,0,0,0
167078,2019-10-21 00:00:00+03:00,in,False,-1,True,1,0,30,30
167078,2019-10-21 00:00:00+03:00,in,False,-1,True,1,0,30,30
167078,2019-10-22 00:00:00+03:00,out,False,935348,True,2,0,2,2
167078,2019-10-22 00:00:00+03:00,out,False,935348,False,1,550,580,30
167078,2019-10-22 00:00:00+03:00,in,False,900592,False,1,76,91,15
167078,2019-10-22 00:00:00+03:00,in,False,900592,False,1,76,91,15
167078,2019-10-23 00:00:00+03:00,out,True,935348,False,1,0,0,0
167078,2019-10-23 00:00:00+03:00,in,False,-1,True,2,0,1,1
167078,2019-10-23 00:00:00+03:00,out,False,935348,False,2,286,302,16
167078,2019-10-24 00:00:00+03:00,in,False,-1,True,2,0,19,19
167078,2019-10-24 00:00:00+03:00,out,False,935348,False,2,522,563,41
167078,2019-10-24 00:00:00+03:00,out,False,935348,True,4,0,67,67
167078,2019-10-24 00:00:00+03:00,out,False,-1,True,1,0,1,1
167078,2019-10-24 00:00:00+03:00,in,False,900592,False,3,397,429,32
167078,2019-10-24 00:00:00+03:00,in,False,-1,True,2,0,19,19
167078,2019-10-25 00:00:00+03:00,in,False,-1,True,2,0,46,46
167078,2019-10-25 00:00:00+03:00,out,False,935348,False,1,65,73,8
167078,2019-10-27 00:00:00+03:00,in,False,-1,True,3,0,0,0
167078,2019-10-28 00:00:00+03:00,out,False,935348,False,1,40,50,10
167078,2019-10-28 00:00:00+03:00,in,False,-1,True,1,0,30,30
167078,2019-10-29 00:00:00+03:00,in,False,900592,False,1,70,75,5
167078,2019-10-29 00:00:00+03:00,out,False,935348,True,1,0,0,0
167078,2019-10-29 00:00:00+03:00,out,False,935348,False,1,236,249,13
167078,2019-10-30 00:00:00+03:00,in,False,-1,True,3,0,60,60
167078,2019-10-30 00:00:00+03:00,in,False,900592,False,2,75,98,23
167078,2019-10-30 00:00:00+03:00,out,False,935348,False,1,85,102,17
167078,2019-10-31 00:00:00+03:00,out,False,935348,True,3,0,23,23
167078,2019-10-31 00:00:00+03:00,in,False,900592,False,9,867,960,93
167078,2019-10-31 00:00:00+03:00,out,False,935348,False,3,223,257,34
167078,2019-10-31 00:00:00+03:00,out,False,900592,False,1,284,295,11
167078,2019-11-01 00:00:00+03:00,out,False,935348,False,1,83,90,7
167078,2019-11-01 00:00:00+03:00,in,False,935348,False,7,1655,1721,66
167078,2019-11-01 00:00:00+03:00,out,False,900592,False,6,409,473,64
167078,2019-11-01 00:00:00+03:00,out,False,900592,True,2,0,33,33
167078,2019-11-01 00:00:00+03:00,in,False,-1,True,14,0,218,218
167078,2019-11-01 00:00:00+03:00,in,False,900592,False,5,313,419,106
167078,2019-11-02 00:00:00+03:00,in,False,-1,True,1,0,46,46
167078,2019-11-02 00:00:00+03:00,out,False,900592,False,1,114,126,12
167078,2019-11-02 00:00:00+03:00,in,False,900592,False,7,358,416,58
167078,2019-11-03 00:00:00+03:00,in,False,-1,True,13,0,1,1
167078,2019-11-04 00:00:00+03:00,in,False,-1,True,37,0,7,7
167078,2019-11-04 00:00:00+03:00,in,False,-1,True,37,0,7,7
167078,2019-11-05 00:00:00+03:00,out,False,935348,True,1,0,31,31
167078,2019-11-05 00:00:00+03:00,out,False,935348,False,2,431,447,16
167078,2019-11-05 00:00:00+03:00,in,False,935348,False,5,1009,1061,52
167078,2019-11-05 00:00:00+03:00,out,False,900592,False,3,159,193,34
167078,2019-11-05 00:00:00+03:00,in,False,900592,False,14,965,1058,93
167078,2019-11-05 00:00:00+03:00,in,False,-1,True,5,0,115,115
167078,2019-11-05 00:00:00+03:00,in,False,935348,True,1,0,11,11
167078,2019-11-06 00:00:00+03:00,in,False,900592,False,14,1316,1420,104
167078,2019-11-06 00:00:00+03:00,in,False,935348,False,4,716,751,35
167078,2019-11-06 00:00:00+03:00,out,False,900592,True,1,0,7,7
167078,2019-11-06 00:00:00+03:00,out,False,935348,False,3,210,235,25
167078,2019-11-07 00:00:00+03:00,out,False,900592,True,2,0,63,63
167078,2019-11-07 00:00:00+03:00,in,False,935348,False,10,801,1007,206
167078,2019-11-07 00:00:00+03:00,in,False,-1,True,6,0,197,197
167078,2019-11-07 00:00:00+03:00,out,False,935348,True,2,0,35,35
167078,2019-11-07 00:00:00+03:00,in,False,900592,False,14,1268,1342,74
167078,2019-11-07 00:00:00+03:00,out,False,935348,False,5,1037,1088,51
167078,2019-11-07 00:00:00+03:00,out,False,900592,False,2,47,72,25
167078,2019-11-07 00:00:00+03:00,out,False,900592,False,2,47,72,25
167078,2019-11-07 00:00:00+03:00,out,False,935348,False,5,1037,1088,51
167078,2019-11-08 00:00:00+03:00,in,False,935348,False,7,804,857,53
167078,2019-11-08 00:00:00+03:00,in,False,900592,False,3,171,188,17
167078,2019-11-08 00:00:00+03:00,out,False,935348,False,3,284,314,30
167078,2019-11-08 00:00:00+03:00,out,False,935348,True,1,0,37,37
167078,2019-11-08 00:00:00+03:00,out,False,900592,False,3,91,119,28
167078,2019-11-08 00:00:00+03:00,in,False,956480,False,7,963,1082,119
167078,2019-11-08 00:00:00+03:00,out,False,-1,True,1,0,0,0
167078,2019-11-08 00:00:00+03:00,in,False,900592,False,3,171,188,17
167078,2019-11-09 00:00:00+03:00,in,False,900592,False,2,232,247,15
167078,2019-11-09 00:00:00+03:00,in,False,956484,False,1,39,55,16
167078,2019-11-09 00:00:00+03:00,out,False,900592,False,3,141,180,39
167078,2019-11-09 00:00:00+03:00,in,False,-1,True,9,0,444,444
167078,2019-11-09 00:00:00+03:00,in,False,-1,True,9,0,444,444
167078,2019-11-10 00:00:00+03:00,in,False,-1,True,3,0,125,125
167078,2019-11-11 00:00:00+03:00,in,False,935348,False,8,558,613,55
167078,2019-11-11 00:00:00+03:00,in,False,900592,False,16,1553,1656,103
167078,2019-11-11 00:00:00+03:00,out,False,935348,True,5,0,121,121
167078,2019-11-11 00:00:00+03:00,out,False,935348,False,2,105,118,13
167078,2019-11-11 00:00:00+03:00,in,False,956484,False,1,46,100,54
167078,2019-11-11 00:00:00+03:00,in,False,956480,False,5,656,733,77
167078,2019-11-11 00:00:00+03:00,out,False,900592,False,8,395,502,107
167078,2019-11-11 00:00:00+03:00,out,False,935348,False,2,105,118,13
167078,2019-11-12 00:00:00+03:00,in,False,-1,True,2,0,68,68
167078,2019-11-12 00:00:00+03:00,in,False,935348,False,10,940,1003,63
167078,2019-11-12 00:00:00+03:00,in,False,900592,False,12,1128,1205,77
167078,2019-11-12 00:00:00+03:00,out,False,935348,False,3,217,253,36
167078,2019-11-12 00:00:00+03:00,in,False,956480,False,2,70,104,34
167078,2019-11-12 00:00:00+03:00,out,False,900592,True,1,0,46,46
167078,2019-11-12 00:00:00+03:00,out,False,900592,True,1,0,46,46
167078,2019-11-13 00:00:00+03:00,out,False,935348,True,2,0,53,53
167078,2019-11-13 00:00:00+03:00,in,False,956484,False,1,140,154,14
167078,2019-11-13 00:00:00+03:00,out,False,900592,False,3,102,130,28
167078,2019-11-13 00:00:00+03:00,in,False,956480,False,2,341,368,27
167078,2019-11-13 00:00:00+03:00,in,False,900592,False,19,1896,2031,135
167078,2019-11-13 00:00:00+03:00,in,False,935348,False,9,969,1022,53
167078,2019-11-13 00:00:00+03:00,in,False,-1,True,1,0,9,9
167078,2019-11-13 00:00:00+03:00,out,False,935348,False,5,342,400,58
167078,2019-11-13 00:00:00+03:00,in,False,935348,False,9,969,1022,53
167078,2019-11-13 00:00:00+03:00,in,False,956480,False,2,341,368,27
167078,2019-11-14 00:00:00+03:00,in,False,935348,False,7,1055,1094,39
167078,2019-11-14 00:00:00+03:00,out,False,935348,False,7,654,705,51
167078,2019-11-14 00:00:00+03:00,out,True,935348,True,1,0,0,0
167078,2019-11-14 00:00:00+03:00,in,False,956480,False,3,239,283,44
167078,2019-11-14 00:00:00+03:00,out,False,900592,False,7,224,314,90
167078,2019-11-14 00:00:00+03:00,in,False,900592,False,17,1497,1605,108
167078,2019-11-14 00:00:00+03:00,out,False,900592,True,1,0,38,38
167078,2019-11-14 00:00:00+03:00,out,False,935348,True,5,0,75,75
167078,2019-11-14 00:00:00+03:00,out,False,935348,False,7,654,705,51
167078,2019-11-15 00:00:00+03:00,out,False,935348,False,4,698,725,27
167078,2019-11-15 00:00:00+03:00,out,False,900592,True,1,0,3,3
167078,2019-11-15 00:00:00+03:00,out,False,935348,True,1,0,1,1
167078,2019-11-15 00:00:00+03:00,in,False,935348,False,11,851,923,72
167078,2019-11-15 00:00:00+03:00,out,False,900592,False,1,37,48,11
167078,2019-11-15 00:00:00+03:00,in,False,956484,False,2,75,122,47
167078,2019-11-15 00:00:00+03:00,in,False,900592,False,9,1081,1136,55
167078,2019-11-15 00:00:00+03:00,in,False,956480,False,7,890,1043,153
167078,2019-11-15 00:00:00+03:00,in,False,-1,True,2,0,3,3
167078,2019-11-15 00:00:00+03:00,out,False,900592,True,1,0,3,3
167078,2019-11-15 00:00:00+03:00,in,False,935348,False,11,851,923,72
167078,2019-11-16 00:00:00+03:00,out,False,900592,True,1,0,44,44
167078,2019-11-16 00:00:00+03:00,in,False,956480,False,12,829,945,116
167078,2019-11-16 00:00:00+03:00,out,False,900592,False,1,37,61,24
167078,2019-11-16 00:00:00+03:00,out,False,963716,False,1,25,39,14
167078,2019-11-16 00:00:00+03:00,in,False,-1,True,9,0,1075,1075
167078,2019-11-16 00:00:00+03:00,in,False,900592,False,1,16,22,6
167078,2019-11-17 00:00:00+03:00,in,False,-1,True,8,0,531,531
167078,2019-11-18 00:00:00+03:00,in,False,935348,False,4,502,525,23
167078,2019-11-18 00:00:00+03:00,out,False,900592,False,1,153,177,24
167078,2019-11-18 00:00:00+03:00,in,False,956480,False,8,1188,1293,105
167078,2019-11-18 00:00:00+03:00,in,False,900592,False,4,628,649,21
167078,2019-11-18 00:00:00+03:00,out,False,935348,True,3,0,16,16
167078,2019-11-18 00:00:00+03:00,out,False,935348,False,2,81,96,15
167078,2019-11-18 00:00:00+03:00,in,False,956484,False,1,87,110,23
167078,2019-11-18 00:00:00+03:00,in,False,-1,True,3,0,57,57
167078,2019-11-18 00:00:00+03:00,in,False,956484,False,1,87,110,23
167078,2019-11-19 00:00:00+03:00,out,False,935348,True,4,0,17,17
167078,2019-11-19 00:00:00+03:00,out,False,900592,True,1,0,5,5
167078,2019-11-19 00:00:00+03:00,in,False,935348,False,6,588,623,35
167078,2019-11-19 00:00:00+03:00,in,False,900592,False,16,1881,1977,96
167078,2019-11-19 00:00:00+03:00,out,False,935348,False,8,339,404,65
167078,2019-11-19 00:00:00+03:00,in,False,956484,False,1,188,205,17
167078,2019-11-19 00:00:00+03:00,in,False,-1,True,4,0,45,45
167078,2019-11-19 00:00:00+03:00,out,False,900592,False,4,227,289,62
167078,2019-11-19 00:00:00+03:00,in,False,956480,False,8,1683,1811,128
167078,2019-11-19 00:00:00+03:00,in,False,956484,False,1,188,205,17
167078,2019-11-19 00:00:00+03:00,in,False,900592,False,16,1881,1977,96
167078,2019-11-19 00:00:00+03:00,out,False,900592,True,1,0,5,5
167078,2019-11-20 00:00:00+03:00,out,False,900592,False,6,248,336,88
167078,2019-11-20 00:00:00+03:00,in,False,956484,False,1,44,68,24
167078,2019-11-20 00:00:00+03:00,in,False,900592,False,14,1184,1257,73
167078,2019-11-20 00:00:00+03:00,out,False,935348,False,3,161,204,43
167078,2019-11-20 00:00:00+03:00,in,False,935348,False,7,1338,1377,39
167078,2019-11-20 00:00:00+03:00,out,False,935348,True,2,0,22,22
167078,2019-11-20 00:00:00+03:00,in,False,956480,False,1,148,163,15
167078,2019-11-20 00:00:00+03:00,out,False,900592,False,6,248,336,88
167078,2019-11-20 00:00:00+03:00,out,False,935348,False,3,161,204,43
167078,2019-11-21 00:00:00+03:00,out,False,935348,False,1,42,48,6
167078,2019-11-21 00:00:00+03:00,out,False,900592,True,1,0,50,50
167078,2019-11-21 00:00:00+03:00,in,False,900592,False,10,641,700,59
167078,2019-11-21 00:00:00+03:00,in,False,956480,False,7,663,736,73
167078,2019-11-21 00:00:00+03:00,in,False,935348,False,11,1121,1190,69
167078,2019-11-21 00:00:00+03:00,out,False,900592,False,7,629,690,61
167078,2019-11-21 00:00:00+03:00,in,False,956484,False,4,949,1011,62
167078,2019-11-22 00:00:00+03:00,in,False,956480,False,4,240,298,58
167078,2019-11-22 00:00:00+03:00,out,False,900592,False,5,165,237,72
167078,2019-11-22 00:00:00+03:00,in,False,900592,False,8,813,864,51
167078,2019-11-22 00:00:00+03:00,out,True,900592,False,1,76,81,5
167078,2019-11-22 00:00:00+03:00,out,False,935348,False,3,59,99,40
167078,2019-11-22 00:00:00+03:00,out,False,935348,True,1,0,0,0
167078,2019-11-22 00:00:00+03:00,in,False,935348,False,4,376,405,29
167078,2019-11-22 00:00:00+03:00,in,False,935348,False,4,376,405,29
167078,2019-11-23 00:00:00+03:00,out,False,935348,True,1,0,16,16
167078,2019-11-23 00:00:00+03:00,in,False,900592,False,7,609,642,33
167078,2019-11-23 00:00:00+03:00,out,False,935348,False,2,81,94,13
167078,2019-11-23 00:00:00+03:00,in,False,956480,False,2,61,90,29
167078,2019-11-23 00:00:00+03:00,in,False,-1,True,6,0,307,307
167078,2019-11-23 00:00:00+03:00,in,False,935348,False,1,63,68,5
167078,2019-11-23 00:00:00+03:00,out,False,900592,False,3,121,155,34
167078,2019-11-23 00:00:00+03:00,in,False,956480,False,2,61,90,29
167078,2019-11-24 00:00:00+03:00,in,False,-1,True,10,0,689,689
167078,2019-11-25 00:00:00+03:00,in,False,-1,True,3,0,152,152
167078,2019-11-25 00:00:00+03:00,in,False,935348,False,8,717,767,50
167078,2019-11-25 00:00:00+03:00,out,False,900592,True,1,0,1,1
167078,2019-11-25 00:00:00+03:00,in,False,900592,False,13,1011,1077,66
167078,2019-11-25 00:00:00+03:00,out,False,935348,False,11,888,995,107
167078,2019-11-25 00:00:00+03:00,out,False,935348,True,1,0,20,20
167078,2019-11-25 00:00:00+03:00,out,False,900592,False,9,383,484,101
167078,2019-11-25 00:00:00+03:00,in,False,956480,False,6,865,952,87
167078,2019-11-25 00:00:00+03:00,out,False,935348,True,1,0,20,20
167078,2019-11-26 00:00:00+03:00,in,False,956480,False,3,471,504,33
167078,2019-11-26 00:00:00+03:00,out,False,935348,False,1,103,113,10
167078,2019-11-26 00:00:00+03:00,out,True,900592,True,1,0,5,5
167078,2019-11-26 00:00:00+03:00,in,False,900592,False,6,514,551,37
167078,2019-11-26 00:00:00+03:00,out,False,935348,True,2,0,38,38
167078,2019-11-26 00:00:00+03:00,in,False,935348,False,7,935,979,44
167078,2019-11-26 00:00:00+03:00,out,False,900592,False,1,130,132,2
167078,2019-11-27 00:00:00+03:00,in,False,900592,False,10,1215,1278,63
167078,2019-11-27 00:00:00+03:00,in,False,935348,False,5,673,712,39
167078,2019-11-27 00:00:00+03:00,out,True,900592,False,1,48,50,2
167078,2019-11-27 00:00:00+03:00,out,False,935348,False,1,140,144,4
167078,2019-11-27 00:00:00+03:00,in,False,956480,False,2,344,379,35
167078,2019-11-27 00:00:00+03:00,out,False,900592,True,5,0,127,127
167078,2019-11-27 00:00:00+03:00,in,False,956484,False,1,97,113,16
167078,2019-11-27 00:00:00+03:00,out,False,935348,True,2,0,0,0
167078,2019-11-27 00:00:00+03:00,out,False,900592,False,5,388,443,55
167078,2019-11-27 00:00:00+03:00,in,False,935348,False,5,673,712,39
167078,2019-11-28 00:00:00+03:00,in,False,935348,False,13,1653,1740,87
167078,2019-11-28 00:00:00+03:00,out,False,935348,True,4,0,67,67
167078,2019-11-28 00:00:00+03:00,out,False,900592,False,3,157,205,48
167078,2019-11-28 00:00:00+03:00,in,False,900592,False,9,670,723,53
167078,2019-11-28 00:00:00+03:00,in,False,-1,True,3,0,57,57
167078,2019-11-28 00:00:00+03:00,in,False,956480,False,7,500,603,103
167078,2019-11-28 00:00:00+03:00,out,False,935348,False,3,149,179,30
167079,2019-09-04 00:00:00+03:00,in,False,-1,True,1,0,30,30
167079,2019-09-04 00:00:00+03:00,in,False,904058,False,1,14,28,14
167079,2019-09-04 00:00:00+03:00,in,False,-1,True,1,0,30,30
167079,2019-09-05 00:00:00+03:00,in,False,-1,True,1,0,14,14
167079,2019-09-19 00:00:00+03:00,in,False,-1,True,4,0,170,170
167079,2019-09-20 00:00:00+03:00,in,False,-1,True,2,0,112,112
167079,2019-09-23 00:00:00+03:00,in,False,-1,True,2,0,103,103
167079,2019-09-23 00:00:00+03:00,in,False,904058,False,1,10,19,9
167079,2019-09-26 00:00:00+03:00,in,False,904058,False,1,26,44,18
167079,2019-09-26 00:00:00+03:00,in,False,-1,True,2,0,26,26
167079,2019-09-30 00:00:00+03:00,in,False,904058,False,1,77,95,18
167079,2019-10-01 00:00:00+03:00,in,False,-1,True,1,0,2,2
167079,2019-10-03 00:00:00+03:00,in,False,-1,True,2,0,2,2
167079,2019-10-03 00:00:00+03:00,in,False,904058,False,1,31,45,14
167079,2019-10-07 00:00:00+03:00,in,False,904058,False,1,25,42,17
167079,2019-10-21 00:00:00+03:00,in,False,904058,False,1,28,45,17
167079,2019-10-21 00:00:00+03:00,in,False,-1,True,1,0,25,25
167079,2019-10-28 00:00:00+03:00,in,False,-1,True,1,0,18,18
167079,2019-10-31 00:00:00+03:00,in,False,904058,False,1,51,66,15
167079,2019-10-31 00:00:00+03:00,in,False,-1,True,2,0,55,55
167079,2019-11-01 00:00:00+03:00,in,False,-1,True,1,0,27,27
167079,2019-11-01 00:00:00+03:00,in,False,904058,False,1,120,134,14
167079,2019-11-02 00:00:00+03:00,in,False,904058,False,1,101,124,23
167079,2019-11-04 00:00:00+03:00,in,False,904058,False,2,274,305,31
167079,2019-11-05 00:00:00+03:00,in,False,904058,False,2,52,87,35
167079,2019-11-06 00:00:00+03:00,in,False,904058,False,1,90,102,12
167079,2019-11-11 00:00:00+03:00,in,False,904058,False,1,159,187,28
167079,2019-11-13 00:00:00+03:00,in,False,904058,False,1,107,126,19
167079,2019-11-20 00:00:00+03:00,in,False,904058,False,1,38,52,14
167079,2019-11-27 00:00:00+03:00,in,False,904058,False,1,38,51,13
167082,2019-08-31 00:00:00+03:00,in,False,-1,True,4,0,8,8
167082,2019-08-31 00:00:00+03:00,in,False,-1,True,4,0,8,8
167082,2019-09-01 00:00:00+03:00,in,False,-1,True,2,0,4,4
167082,2019-09-02 00:00:00+03:00,in,False,-1,True,27,0,22,22
167082,2019-09-03 00:00:00+03:00,in,False,900790,False,9,923,986,63
167082,2019-09-03 00:00:00+03:00,in,False,-1,True,10,0,119,119
167082,2019-09-03 00:00:00+03:00,out,False,900792,False,3,59,99,40
167082,2019-09-03 00:00:00+03:00,out,False,900790,False,9,673,752,79
167082,2019-09-03 00:00:00+03:00,in,False,900792,False,1,55,89,34
167082,2019-09-03 00:00:00+03:00,out,True,900792,True,2,0,9,9
167082,2019-09-03 00:00:00+03:00,out,False,900790,True,4,0,51,51
167082,2019-09-04 00:00:00+03:00,out,False,900792,True,1,0,3,3
167082,2019-09-04 00:00:00+03:00,in,False,-1,True,15,0,362,362
167082,2019-09-04 00:00:00+03:00,out,False,900790,False,6,601,677,76
167082,2019-09-04 00:00:00+03:00,out,False,900790,True,6,0,42,42
167082,2019-09-04 00:00:00+03:00,in,False,900790,False,7,298,350,52
167082,2019-09-04 00:00:00+03:00,out,False,900790,False,6,601,677,76
167082,2019-09-05 00:00:00+03:00,out,False,900790,True,1,0,43,43
167082,2019-09-05 00:00:00+03:00,in,False,900790,False,6,320,375,55
167082,2019-09-05 00:00:00+03:00,in,False,-1,True,6,0,3,3
167082,2019-09-05 00:00:00+03:00,out,False,900790,False,4,132,184,52
167082,2019-09-05 00:00:00+03:00,out,False,900792,False,1,27,51,24
167082,2019-09-05 00:00:00+03:00,out,False,900792,False,1,27,51,24
167082,2019-09-06 00:00:00+03:00,in,False,-1,True,4,0,30,30
167082,2019-09-06 00:00:00+03:00,in,False,900790,False,4,227,256,29
167082,2019-09-06 00:00:00+03:00,out,False,900790,False,1,5,7,2
167082,2019-09-07 00:00:00+03:00,in,False,-1,True,4,0,1,1
167082,2019-09-08 00:00:00+03:00,in,False,-1,True,2,0,0,0
167082,2019-09-09 00:00:00+03:00,out,False,900790,False,7,247,304,57
167082,2019-09-09 00:00:00+03:00,out,False,900790,True,1,0,8,8
167082,2019-09-09 00:00:00+03:00,in,False,900790,False,9,1742,1837,95
167082,2019-09-10 00:00:00+03:00,in,False,900790,False,3,560,577,17
167082,2019-09-10 00:00:00+03:00,out,False,900790,False,2,229,275,46
167082,2019-09-11 00:00:00+03:00,in,False,-1,True,2,0,1,1
167082,2019-09-11 00:00:00+03:00,in,False,900790,False,5,433,478,45
167082,2019-09-11 00:00:00+03:00,out,False,900790,False,3,159,203,44
167082,2019-09-12 00:00:00+03:00,out,False,900788,False,1,36,46,10
167082,2019-09-12 00:00:00+03:00,in,False,900788,False,5,797,824,27
167082,2019-09-12 00:00:00+03:00,out,False,900788,True,1,0,9,9
167082,2019-09-12 00:00:00+03:00,out,False,900790,False,1,16,39,23
167082,2019-09-12 00:00:00+03:00,in,False,-1,True,1,0,14,14
167082,2019-09-13 00:00:00+03:00,in,False,-1,True,2,0,43,43
167082,2019-09-13 00:00:00+03:00,in,False,900788,False,5,895,928,33
167082,2019-09-13 00:00:00+03:00,out,False,900788,True,3,0,87,87
167082,2019-09-13 00:00:00+03:00,out,False,900788,False,1,47,61,14
167082,2019-09-13 00:00:00+03:00,out,False,900788,False,1,47,61,14
167082,2019-09-14 00:00:00+03:00,in,False,-1,True,4,0,395,395
167082,2019-09-15 00:00:00+03:00,in,False,-1,True,3,0,188,188
167082,2019-09-16 00:00:00+03:00,in,False,900788,False,3,596,614,18
167082,2019-09-16 00:00:00+03:00,out,False,900788,True,1,0,14,14
167082,2019-09-17 00:00:00+03:00,out,False,900790,True,1,0,37,37
167082,2019-09-17 00:00:00+03:00,out,False,900788,False,2,376,408,32
167082,2019-09-17 00:00:00+03:00,in,False,900788,False,2,512,524,12
167082,2019-09-17 00:00:00+03:00,out,False,900790,False,3,1017,1054,37
167082,2019-09-17 00:00:00+03:00,out,False,900788,True,1,0,41,41
167082,2019-09-18 00:00:00+03:00,in,False,900788,False,4,587,602,15
167082,2019-09-18 00:00:00+03:00,in,False,-1,True,1,0,3,3
167082,2019-09-18 00:00:00+03:00,out,False,900788,False,2,127,149,22
167082,2019-09-18 00:00:00+03:00,out,False,900790,False,4,624,667,43
167082,2019-09-18 00:00:00+03:00,out,False,900788,True,1,0,27,27
167082,2019-09-18 00:00:00+03:00,out,False,900790,True,1,0,6,6
167082,2019-09-19 00:00:00+03:00,in,False,900788,False,3,960,972,12
167082,2019-09-19 00:00:00+03:00,out,False,900788,False,3,504,518,14
167082,2019-09-19 00:00:00+03:00,out,False,900788,True,2,0,49,49
167082,2019-09-20 00:00:00+03:00,in,False,900788,False,3,103,119,16
167082,2019-09-20 00:00:00+03:00,in,False,-1,True,7,0,617,617
167082,2019-09-21 00:00:00+03:00,in,False,-1,True,1,0,64,64
167082,2019-09-23 00:00:00+03:00,out,False,900788,True,1,0,3,3
167082,2019-09-23 00:00:00+03:00,in,False,-1,True,3,0,23,23
167082,2019-09-23 00:00:00+03:00,in,False,900788,False,4,284,306,22
167082,2019-09-23 00:00:00+03:00,out,False,900788,False,5,208,253,45
167082,2019-09-23 00:00:00+03:00,in,False,900788,False,4,284,306,22
167082,2019-09-24 00:00:00+03:00,in,False,-1,True,1,0,42,42
167082,2019-09-24 00:00:00+03:00,in,False,900788,False,5,276,300,24
167082,2019-09-24 00:00:00+03:00,out,False,900788,False,5,594,666,72
167082,2019-09-25 00:00:00+03:00,in,False,-1,True,2,0,187,187
167082,2019-09-25 00:00:00+03:00,in,False,900788,False,8,1116,1168,52
167082,2019-09-25 00:00:00+03:00,out,False,900788,False,6,968,1023,55
167082,2019-09-25 00:00:00+03:00,out,False,900788,True,2,0,40,40
167082,2019-09-26 00:00:00+03:00,in,False,900788,False,5,506,535,29
167082,2019-09-26 00:00:00+03:00,out,False,900788,True,2,0,63,63
167082,2019-09-26 00:00:00+03:00,out,False,900788,False,5,457,520,63
167082,2019-09-27 00:00:00+03:00,in,False,-1,True,2,0,65,65
167082,2019-09-27 00:00:00+03:00,in,False,-1,True,3,0,77,77
167082,2019-09-27 00:00:00+03:00,in,False,900788,False,1,269,274,5
167082,2019-09-27 00:00:00+03:00,out,False,900788,True,1,0,11,11
167082,2019-09-27 00:00:00+03:00,out,False,900788,False,8,998,1091,93
167082,2019-09-28 00:00:00+03:00,in,False,922356,False,1,93,138,45
167082,2019-09-28 00:00:00+03:00,in,False,-1,True,1,0,40,40
167082,2019-09-30 00:00:00+03:00,in,False,900788,False,2,78,90,12
167082,2019-09-30 00:00:00+03:00,in,False,-1,True,1,0,45,45
167082,2019-09-30 00:00:00+03:00,out,False,900788,False,2,57,79,22
167082,2019-10-01 00:00:00+03:00,out,False,900788,False,3,309,347,38
167082,2019-10-01 00:00:00+03:00,in,False,922356,False,1,30,62,32
167082,2019-10-01 00:00:00+03:00,in,False,900788,False,6,684,710,26
167082,2019-10-02 00:00:00+03:00,in,False,-1,True,1,0,5,5
167082,2019-10-02 00:00:00+03:00,out,False,900788,False,4,237,278,41
167082,2019-10-02 00:00:00+03:00,out,False,900788,True,2,0,77,77
167082,2019-10-02 00:00:00+03:00,in,False,900788,False,1,31,37,6
167082,2019-10-03 00:00:00+03:00,in,False,-1,True,2,0,59,59
167082,2019-10-03 00:00:00+03:00,out,False,900788,True,4,0,25,25
167082,2019-10-03 00:00:00+03:00,out,False,900788,False,6,1009,1078,69
167082,2019-10-03 00:00:00+03:00,in,False,900790,False,1,1,16,15
167082,2019-10-03 00:00:00+03:00,in,False,900788,False,9,761,810,49
167082,2019-10-04 00:00:00+03:00,in,False,-1,True,3,0,62,62
167082,2019-10-04 00:00:00+03:00,in,False,920982,False,1,160,180,20
167082,2019-10-04 00:00:00+03:00,out,False,900788,True,2,0,23,23
167082,2019-10-04 00:00:00+03:00,in,False,922356,False,2,65,103,38
167082,2019-10-07 00:00:00+03:00,in,False,922356,False,3,762,827,65
167082,2019-10-07 00:00:00+03:00,in,False,900788,False,2,98,115,17
167082,2019-10-07 00:00:00+03:00,in,False,-1,True,1,0,4,4
167082,2019-10-07 00:00:00+03:00,out,False,900788,False,1,267,278,11
167082,2019-10-07 00:00:00+03:00,in,False,920982,False,3,449,512,63
167082,2019-10-07 00:00:00+03:00,in,False,920982,False,3,449,512,63
167082,2019-10-08 00:00:00+03:00,in,False,900788,False,1,159,167,8
167082,2019-10-08 00:00:00+03:00,in,False,920982,False,1,74,97,23
167082,2019-10-08 00:00:00+03:00,out,False,900788,False,1,197,228,31
167082,2019-10-08 00:00:00+03:00,in,False,920982,False,1,74,97,23
167082,2019-10-09 00:00:00+03:00,in,False,920982,False,5,738,872,134
167082,2019-10-09 00:00:00+03:00,in,False,922356,False,4,413,516,103
167082,2019-10-09 00:00:00+03:00,in,False,900788,False,2,272,284,12
167082,2019-10-09 00:00:00+03:00,in,False,922356,False,4,413,516,103
167082,2019-10-10 00:00:00+03:00,in,False,-1,True,1,0,10,10
167082,2019-10-10 00:00:00+03:00,in,False,920982,False,1,280,308,28
167082,2019-10-10 00:00:00+03:00,in,False,922356,False,2,80,146,66
167082,2019-10-10 00:00:00+03:00,in,False,-1,True,1,0,10,10
167082,2019-10-11 00:00:00+03:00,in,False,900788,False,3,250,279,29
167082,2019-10-12 00:00:00+03:00,in,False,922356,False,3,868,951,83
167082,2019-10-12 00:00:00+03:00,in,False,-1,True,5,0,196,196
167082,2019-10-13 00:00:00+03:00,in,False,920982,False,1,150,178,28
167082,2019-10-14 00:00:00+03:00,in,False,920982,False,3,171,252,81
167082,2019-10-15 00:00:00+03:00,in,False,920982,False,1,32,39,7
167082,2019-10-15 00:00:00+03:00,in,False,922356,False,1,664,676,12
167082,2019-10-15 00:00:00+03:00,in,False,-1,True,1,0,30,30
167082,2019-10-16 00:00:00+03:00,in,False,-1,True,2,0,91,91
167082,2019-10-16 00:00:00+03:00,out,False,900788,False,1,68,78,10
167082,2019-10-16 00:00:00+03:00,in,False,920982,False,1,208,232,24
167082,2019-10-17 00:00:00+03:00,in,False,920982,False,1,306,331,25
167082,2019-10-17 00:00:00+03:00,out,False,900788,False,3,584,607,23
167082,2019-10-17 00:00:00+03:00,in,False,922356,False,1,15,43,28
167082,2019-10-17 00:00:00+03:00,in,False,-1,True,2,0,62,62
167082,2019-10-17 00:00:00+03:00,out,False,900788,True,3,0,80,80
167082,2019-10-18 00:00:00+03:00,out,False,900788,False,1,74,82,8
167082,2019-10-18 00:00:00+03:00,in,False,900788,False,5,1218,1258,40
167082,2019-10-19 00:00:00+03:00,in,False,900788,False,1,54,59,5
167082,2019-10-21 00:00:00+03:00,out,False,900788,False,2,103,145,42
167082,2019-10-21 00:00:00+03:00,in,False,920982,False,2,325,385,60
167082,2019-10-21 00:00:00+03:00,in,False,900788,False,3,805,844,39
167082,2019-10-22 00:00:00+03:00,out,False,900790,True,1,0,9,9
167082,2019-10-22 00:00:00+03:00,in,False,900788,True,1,0,5,5
167082,2019-10-23 00:00:00+03:00,in,False,900788,False,1,8,16,8
167082,2019-10-23 00:00:00+03:00,in,False,-1,True,2,0,67,67
167082,2019-10-23 00:00:00+03:00,in,False,920982,False,2,122,164,42
167082,2019-10-23 00:00:00+03:00,in,False,920982,False,2,122,164,42
167082,2019-10-24 00:00:00+03:00,in,False,920982,False,2,40,96,56
167082,2019-10-24 00:00:00+03:00,in,False,-1,True,1,0,28,28
167082,2019-10-25 00:00:00+03:00,in,False,900788,False,3,554,580,26
167082,2019-10-27 00:00:00+03:00,in,False,-1,True,1,0,22,22
167082,2019-10-27 00:00:00+03:00,in,False,920982,False,1,438,467,29
167082,2019-10-28 00:00:00+03:00,in,False,900788,False,2,34,47,13
167082,2019-10-29 00:00:00+03:00,in,False,920982,False,1,445,469,24
167082,2019-10-30 00:00:00+03:00,in,False,920982,False,3,531,610,79
167082,2019-10-30 00:00:00+03:00,in,False,900788,False,4,891,918,27
167082,2019-10-30 00:00:00+03:00,out,False,900788,False,1,124,134,10
167082,2019-10-31 00:00:00+03:00,out,False,900788,False,1,645,647,2
167082,2019-10-31 00:00:00+03:00,in,False,920982,False,1,48,74,26
167082,2019-10-31 00:00:00+03:00,in,False,-1,True,1,0,46,46
167082,2019-11-01 00:00:00+03:00,in,False,900788,False,1,97,105,8
167082,2019-11-01 00:00:00+03:00,out,False,900788,True,1,0,9,9
167082,2019-11-04 00:00:00+03:00,in,False,-1,True,2,0,74,74
167082,2019-11-05 00:00:00+03:00,in,False,920982,False,5,496,645,149
167082,2019-11-06 00:00:00+03:00,in,False,900788,False,3,574,586,12
167082,2019-11-06 00:00:00+03:00,in,False,-1,True,2,0,65,65
167082,2019-11-07 00:00:00+03:00,in,False,900788,False,2,51,72,21
167082,2019-11-08 00:00:00+03:00,in,False,900788,False,2,146,154,8
167082,2019-11-09 00:00:00+03:00,in,False,920982,False,1,79,102,23
167082,2019-11-09 00:00:00+03:00,in,False,900788,False,1,43,54,11
167082,2019-11-11 00:00:00+03:00,in,False,900788,False,2,312,329,17
167082,2019-11-12 00:00:00+03:00,in,False,900788,False,4,467,488,21
167082,2019-11-14 00:00:00+03:00,in,False,900788,False,1,106,111,5
167082,2019-11-15 00:00:00+03:00,in,False,900788,False,3,447,477,30
167082,2019-11-16 00:00:00+03:00,in,False,920982,False,1,33,60,27
167082,2019-11-16 00:00:00+03:00,in,False,-1,True,1,0,14,14
167082,2019-11-17 00:00:00+03:00,in,False,920982,False,3,441,519,78
167082,2019-11-17 00:00:00+03:00,in,False,-1,True,2,0,64,64
167082,2019-11-18 00:00:00+03:00,in,False,900788,False,1,34,47,13
167082,2019-11-18 00:00:00+03:00,in,False,920982,False,3,205,277,72
167082,2019-11-18 00:00:00+03:00,in,False,900788,False,1,34,47,13
167082,2019-11-19 00:00:00+03:00,in,False,920982,False,3,294,368,74
167082,2019-11-19 00:00:00+03:00,in,False,920982,False,3,294,368,74
167082,2019-11-20 00:00:00+03:00,in,False,920982,False,1,432,444,12
167082,2019-11-20 00:00:00+03:00,in,False,900788,False,3,581,601,20
167082,2019-11-20 00:00:00+03:00,out,False,900788,False,1,161,169,8
167082,2019-11-20 00:00:00+03:00,in,False,920982,False,1,432,444,12
167082,2019-11-21 00:00:00+03:00,in,False,920982,False,1,83,110,27
167082,2019-11-22 00:00:00+03:00,in,False,-1,True,1,0,10,10
167082,2019-11-23 00:00:00+03:00,in,False,920982,False,2,304,372,68
167082,2019-11-23 00:00:00+03:00,in,False,900788,False,2,324,334,10
167082,2019-11-25 00:00:00+03:00,in,False,-1,True,2,0,10,10
167082,2019-11-26 00:00:00+03:00,in,False,920982,False,1,96,119,23
167082,2019-11-27 00:00:00+03:00,in,False,900788,False,3,117,136,19
167082,2019-11-28 00:00:00+03:00,in,False,900788,False,2,285,304,19
167082,2019-11-28 00:00:00+03:00,in,False,900788,False,2,285,304,19
167102,2019-09-02 00:00:00+03:00,in,False,-1,True,1,0,2,2
167102,2019-09-03 00:00:00+03:00,in,False,-1,True,8,0,46,46
167102,2019-09-04 00:00:00+03:00,in,False,-1,True,7,0,191,191
167102,2019-09-04 00:00:00+03:00,in,False,902906,False,1,16,34,18
167102,2019-09-05 00:00:00+03:00,in,False,902906,False,2,64,99,35
167102,2019-09-06 00:00:00+03:00,in,False,902910,False,1,61,98,37
167102,2019-09-06 00:00:00+03:00,in,False,-1,True,1,0,50,50
167102,2019-09-09 00:00:00+03:00,in,False,902906,False,1,234,252,18
167102,2019-09-09 00:00:00+03:00,in,False,902906,False,1,234,252,18
167102,2019-09-10 00:00:00+03:00,in,False,902910,False,2,137,192,55
167102,2019-09-10 00:00:00+03:00,in,False,902906,False,1,76,92,16
167102,2019-09-11 00:00:00+03:00,in,False,-1,True,2,0,15,15
167102,2019-09-11 00:00:00+03:00,in,False,902906,False,1,135,153,18
167102,2019-09-13 00:00:00+03:00,in,False,-1,True,1,0,9,9
167102,2019-09-16 00:00:00+03:00,in,False,902910,False,1,32,54,22
167102,2019-09-17 00:00:00+03:00,in,False,902906,False,1,183,201,18
167102,2019-09-17 00:00:00+03:00,in,False,-1,True,1,0,10,10
167102,2019-09-17 00:00:00+03:00,in,False,902910,False,1,62,84,22
167102,2019-09-17 00:00:00+03:00,in,False,-1,True,1,0,10,10
167102,2019-09-19 00:00:00+03:00,in,False,-1,True,1,0,9,9
167102,2019-09-19 00:00:00+03:00,in,False,902906,False,2,70,108,38
167102,2019-09-19 00:00:00+03:00,in,False,902910,False,2,143,178,35
167102,2019-09-19 00:00:00+03:00,in,False,-1,True,1,0,9,9
167102,2019-09-20 00:00:00+03:00,in,False,902906,False,1,82,101,19
167102,2019-09-21 00:00:00+03:00,in,False,-1,True,1,0,8,8
167102,2019-09-23 00:00:00+03:00,in,False,902910,False,1,79,105,26
167102,2019-09-24 00:00:00+03:00,in,False,902910,False,1,47,74,27
167102,2019-09-25 00:00:00+03:00,in,False,-1,True,2,0,50,50
167102,2019-09-25 00:00:00+03:00,in,False,902910,False,1,104,132,28
167102,2019-09-25 00:00:00+03:00,in,False,902906,False,3,597,648,51
167102,2019-09-26 00:00:00+03:00,in,False,902910,False,1,63,87,24
167102,2019-09-27 00:00:00+03:00,in,False,902906,False,1,55,74,19
167102,2019-09-28 00:00:00+03:00,in,False,-1,True,1,0,2,2
167102,2019-09-30 00:00:00+03:00,in,False,-1,True,1,0,21,21
167102,2019-10-02 00:00:00+03:00,in,False,902906,False,1,130,148,18
167102,2019-10-03 00:00:00+03:00,in,False,-1,True,1,0,25,25
167102,2019-10-07 00:00:00+03:00,in,False,902906,False,1,43,62,19
167102,2019-10-08 00:00:00+03:00,in,False,902906,False,1,106,122,16
167102,2019-10-08 00:00:00+03:00,in,False,-1,True,1,0,20,20
167102,2019-10-09 00:00:00+03:00,in,False,902906,False,1,13,30,17
167102,2019-10-10 00:00:00+03:00,in,False,902906,False,1,46,64,18
167102,2019-10-10 00:00:00+03:00,in,False,-1,True,1,0,43,43
167102,2019-10-14 00:00:00+03:00,in,False,902906,False,1,76,92,16
167102,2019-10-17 00:00:00+03:00,in,False,902910,False,2,53,106,53
167102,2019-10-17 00:00:00+03:00,in,False,-1,True,1,0,27,27
167102,2019-10-17 00:00:00+03:00,in,False,902906,False,1,123,137,14
167102,2019-10-17 00:00:00+03:00,in,False,902910,False,2,53,106,53
167102,2019-10-18 00:00:00+03:00,in,False,-1,True,1,0,2,2
167102,2019-10-18 00:00:00+03:00,in,False,902910,False,3,256,333,77
167102,2019-10-21 00:00:00+03:00,in,False,902910,False,2,70,130,60
167102,2019-10-21 00:00:00+03:00,in,False,902906,False,1,307,325,18
167102,2019-10-22 00:00:00+03:00,in,False,902906,False,2,29,64,35
167102,2019-10-23 00:00:00+03:00,in,False,902910,False,1,68,93,25
167102,2019-10-23 00:00:00+03:00,in,False,902906,False,1,37,54,17
167102,2019-10-24 00:00:00+03:00,in,False,902910,False,2,162,218,56
167102,2019-10-25 00:00:00+03:00,in,False,-1,True,1,0,5,5
167102,2019-10-25 00:00:00+03:00,in,False,902910,False,2,106,158,52
167102,2019-10-28 00:00:00+03:00,in,False,902910,False,1,30,55,25
167102,2019-10-29 00:00:00+03:00,in,False,902910,False,1,52,78,26
167102,2019-10-29 00:00:00+03:00,in,False,902906,False,1,147,164,17
167102,2019-10-30 00:00:00+03:00,in,False,902910,False,1,46,74,28
167102,2019-10-30 00:00:00+03:00,in,False,902906,False,1,65,82,17
167102,2019-10-31 00:00:00+03:00,in,False,902906,False,1,287,305,18
167102,2019-10-31 00:00:00+03:00,in,False,902910,True,1,0,29,29
167102,2019-11-01 00:00:00+03:00,in,False,902906,False,2,54,83,29
167102,2019-11-05 00:00:00+03:00,in,False,902906,False,1,23,41,18
167102,2019-11-07 00:00:00+03:00,in,False,902906,False,1,84,99,15
167102,2019-11-08 00:00:00+03:00,in,False,902906,False,1,105,118,13
167102,2019-11-08 00:00:00+03:00,in,False,902910,False,1,56,85,29
167102,2019-11-08 00:00:00+03:00,in,False,902910,False,1,56,85,29
167102,2019-11-11 00:00:00+03:00,in,False,902906,False,1,22,41,19
167102,2019-11-12 00:00:00+03:00,in,False,902906,False,1,36,53,17
167102,2019-11-13 00:00:00+03:00,in,False,902906,False,1,285,303,18
167102,2019-11-13 00:00:00+03:00,in,False,-1,True,1,0,35,35
167102,2019-11-14 00:00:00+03:00,in,False,902906,False,1,37,56,19
167102,2019-11-18 00:00:00+03:00,in,False,902906,False,1,247,264,17
167102,2019-11-19 00:00:00+03:00,in,False,902906,False,1,31,49,18
167102,2019-11-20 00:00:00+03:00,in,False,902906,False,2,560,594,34
167102,2019-11-20 00:00:00+03:00,in,False,-1,True,1,0,35,35
167102,2019-11-21 00:00:00+03:00,in,False,902906,False,2,84,122,38
167102,2019-11-21 00:00:00+03:00,in,False,-1,True,2,0,37,37
167102,2019-11-22 00:00:00+03:00,in,False,902906,False,1,339,357,18
167102,2019-11-25 00:00:00+03:00,in,False,902906,False,2,107,139,32
167102,2019-11-25 00:00:00+03:00,in,False,-1,True,1,0,9,9
167102,2019-11-27 00:00:00+03:00,in,False,902906,False,1,152,170,18
167102,2019-11-28 00:00:00+03:00,in,False,902906,False,1,273,288,15
167109,2019-09-10 00:00:00+03:00,out,True,907224,True,1,0,4,4
167109,2019-09-10 00:00:00+03:00,out,False,906296,True,3,0,40,40
167109,2019-09-10 00:00:00+03:00,in,False,906294,False,2,86,96,10
167109,2019-09-10 00:00:00+03:00,out,True,906294,True,1,0,39,39
167109,2019-09-10 00:00:00+03:00,in,False,906296,False,2,109,143,34
167109,2019-09-10 00:00:00+03:00,out,True,906296,True,2,0,0,0
167109,2019-09-10 00:00:00+03:00,out,False,907182,False,2,51,53,2
167109,2019-09-10 00:00:00+03:00,out,False,907224,False,7,2423,2508,85
167109,2019-09-10 00:00:00+03:00,in,False,907182,False,1,116,121,5
167109,2019-09-10 00:00:00+03:00,out,True,907178,True,1,0,4,4
167109,2019-09-10 00:00:00+03:00,in,False,907178,False,2,185,231,46
167109,2019-09-10 00:00:00+03:00,out,True,906296,False,4,212,229,17
167109,2019-09-10 00:00:00+03:00,out,False,907182,True,1,0,0,0
167109,2019-09-10 00:00:00+03:00,out,False,906296,False,2,36,60,24
167109,2019-09-10 00:00:00+03:00,in,False,-1,True,16,0,287,287
167109,2019-09-10 00:00:00+03:00,in,False,-1,True,1,0,7,7
167109,2019-09-10 00:00:00+03:00,out,False,907224,True,1,0,55,55
167109,2019-09-10 00:00:00+03:00,out,True,906294,False,1,16,27,11
167109,2019-09-10 00:00:00+03:00,out,True,907182,False,3,64,73,9
167109,2019-09-10 00:00:00+03:00,in,False,907178,False,2,185,231,46
167109,2019-09-10 00:00:00+03:00,out,True,907182,False,3,64,73,9
167109,2019-09-10 00:00:00+03:00,out,False,907182,False,2,51,53,2
167109,2019-09-10 00:00:00+03:00,out,False,907224,False,7,2423,2508,85
167109,2019-09-11 00:00:00+03:00,out,True,906294,False,1,45,54,9
167109,2019-09-11 00:00:00+03:00,out,True,907180,True,1,0,4,4
167109,2019-09-11 00:00:00+03:00,out,True,907224,True,1,0,0,0
167109,2019-09-11 00:00:00+03:00,in,False,906296,False,2,236,267,31
167109,2019-09-11 00:00:00+03:00,in,False,907178,False,1,164,190,26
167109,2019-09-11 00:00:00+03:00,out,False,907224,False,6,2243,2325,82
167109,2019-09-11 00:00:00+03:00,out,True,907182,True,4,0,74,74
167109,2019-09-11 00:00:00+03:00,out,False,907224,True,1,0,42,42
167109,2019-09-11 00:00:00+03:00,out,True,906296,False,1,83,88,5
167109,2019-09-11 00:00:00+03:00,in,False,907182,False,2,133,159,26
167109,2019-09-11 00:00:00+03:00,out,True,907178,True,1,0,1,1
167109,2019-09-11 00:00:00+03:00,out,False,907178,False,6,796,825,29
167109,2019-09-11 00:00:00+03:00,out,False,907180,False,5,1212,1236,24
167109,2019-09-11 00:00:00+03:00,out,False,906294,False,2,226,245,19
167109,2019-09-11 00:00:00+03:00,in,False,906294,False,6,455,488,33
167109,2019-09-11 00:00:00+03:00,out,True,907224,False,1,17,21,4
167109,2019-09-11 00:00:00+03:00,out,True,907182,False,9,460,500,40
167109,2019-09-11 00:00:00+03:00,out,False,906294,True,1,0,23,23
167109,2019-09-11 00:00:00+03:00,in,True,907182,False,2,84,95,11
167109,2019-09-11 00:00:00+03:00,in,False,906296,False,2,236,267,31
167109,2019-09-11 00:00:00+03:00,out,True,906294,False,1,45,54,9
167109,2019-09-12 00:00:00+03:00,out,False,907178,False,3,577,594,17
167109,2019-09-12 00:00:00+03:00,out,False,906294,False,2,215,239,24
167109,2019-09-12 00:00:00+03:00,in,False,907224,False,1,43,72,29
167109,2019-09-12 00:00:00+03:00,out,True,907180,False,4,145,173,28
167109,2019-09-12 00:00:00+03:00,out,False,909910,False,4,1005,1015,10
167109,2019-09-12 00:00:00+03:00,out,True,907182,False,5,387,410,23
167109,2019-09-12 00:00:00+03:00,out,False,907224,False,5,1136,1205,69
167109,2019-09-12 00:00:00+03:00,out,True,906294,True,2,0,0,0
167109,2019-09-12 00:00:00+03:00,out,True,907224,False,2,14,27,13
167109,2019-09-12 00:00:00+03:00,out,False,906294,True,1,0,7,7
167109,2019-09-12 00:00:00+03:00,out,True,907224,True,1,0,0,0
167109,2019-09-12 00:00:00+03:00,in,False,907182,False,1,341,347,6
167109,2019-09-12 00:00:00+03:00,in,False,-1,True,1,0,30,30
167109,2019-09-12 00:00:00+03:00,out,True,907182,True,2,0,60,60
167109,2019-09-12 00:00:00+03:00,out,True,907178,True,1,0,0,0
167109,2019-09-12 00:00:00+03:00,in,False,906294,False,11,851,910,59
167109,2019-09-12 00:00:00+03:00,out,True,906294,False,2,31,47,16
167109,2019-09-13 00:00:00+03:00,out,False,907178,True,3,0,118,118
167109,2019-09-13 00:00:00+03:00,out,True,907224,False,1,27,30,3
167109,2019-09-13 00:00:00+03:00,in,False,907182,False,1,101,119,18
167109,2019-09-13 00:00:00+03:00,in,False,-1,True,1,0,40,40
167109,2019-09-13 00:00:00+03:00,out,True,907182,False,7,262,308,46
167109,2019-09-13 00:00:00+03:00,out,False,906294,False,1,81,98,17
167109,2019-09-13 00:00:00+03:00,in,False,906294,False,7,367,412,45
167109,2019-09-13 00:00:00+03:00,out,False,907180,False,2,522,563,41
167109,2019-09-13 00:00:00+03:00,in,False,907224,False,2,138,158,20
167109,2019-09-13 00:00:00+03:00,out,False,907178,False,5,160,260,100
167109,2019-09-13 00:00:00+03:00,out,True,907182,True,9,0,55,55
167109,2019-09-13 00:00:00+03:00,out,True,906294,True,1,0,3,3
167109,2019-09-13 00:00:00+03:00,out,True,906294,False,7,321,361,40
167109,2019-09-13 00:00:00+03:00,out,True,907178,False,5,311,332,21
167109,2019-09-13 00:00:00+03:00,out,True,907178,True,5,0,13,13
167109,2019-09-13 00:00:00+03:00,out,True,907180,False,2,34,43,9
167109,2019-09-13 00:00:00+03:00,out,False,907224,False,2,88,126,38
167109,2019-09-13 00:00:00+03:00,out,True,909910,True,1,0,1,1
167109,2019-09-13 00:00:00+03:00,out,True,909910,False,1,6,9,3
167109,2019-09-13 00:00:00+03:00,in,False,907224,False,2,138,158,20
167109,2019-09-13 00:00:00+03:00,out,True,909910,False,1,6,9,3
167109,2019-09-16 00:00:00+03:00,out,True,907224,False,2,41,51,10
167109,2019-09-16 00:00:00+03:00,out,False,907224,False,11,1986,2102,116
167109,2019-09-16 00:00:00+03:00,out,False,909910,True,2,0,85,85
167109,2019-09-16 00:00:00+03:00,in,False,906294,False,6,356,392,36
167109,2019-09-16 00:00:00+03:00,out,True,906294,True,1,0,0,0
167109,2019-09-16 00:00:00+03:00,out,True,906296,False,3,71,108,37
167109,2019-09-16 00:00:00+03:00,out,True,909910,True,2,0,1,1
167109,2019-09-16 00:00:00+03:00,out,False,907224,True,9,0,148,148
167109,2019-09-16 00:00:00+03:00,out,True,906294,False,1,93,98,5
167109,2019-09-16 00:00:00+03:00,out,True,907178,True,2,0,12,12
167109,2019-09-16 00:00:00+03:00,out,False,907178,False,2,125,142,17
167109,2019-09-16 00:00:00+03:00,out,True,907182,False,1,11,28,17
167109,2019-09-16 00:00:00+03:00,in,False,-1,True,2,0,61,61
167109,2019-09-16 00:00:00+03:00,out,True,907224,True,8,0,48,48
167109,2019-09-16 00:00:00+03:00,out,False,909910,False,1,104,115,11
167109,2019-09-16 00:00:00+03:00,out,True,907178,False,1,12,15,3
167109,2019-09-16 00:00:00+03:00,out,True,907182,False,1,11,28,17
167109,2019-09-17 00:00:00+03:00,out,False,906294,False,1,81,93,12
167109,2019-09-17 00:00:00+03:00,out,True,907182,True,1,0,26,26
167109,2019-09-17 00:00:00+03:00,out,True,907180,False,4,74,94,20
167109,2019-09-17 00:00:00+03:00,out,False,909910,True,1,0,49,49
167109,2019-09-17 00:00:00+03:00,out,True,906294,False,7,670,704,34
167109,2019-09-17 00:00:00+03:00,out,True,909910,True,1,0,1,1
167109,2019-09-17 00:00:00+03:00,in,False,907224,False,1,21,38,17
167109,2019-09-17 00:00:00+03:00,in,False,906294,False,12,1195,1263,68
167109,2019-09-17 00:00:00+03:00,out,True,906294,True,5,0,22,22
167109,2019-09-17 00:00:00+03:00,out,False,906296,False,4,307,348,41
167109,2019-09-17 00:00:00+03:00,out,True,906296,True,1,0,1,1
167109,2019-09-17 00:00:00+03:00,out,True,907178,False,3,58,68,10
167109,2019-09-17 00:00:00+03:00,out,False,907182,False,4,506,518,12
167109,2019-09-17 00:00:00+03:00,in,False,907182,False,2,82,110,28
167109,2019-09-17 00:00:00+03:00,out,False,907178,False,4,122,147,25
167109,2019-09-17 00:00:00+03:00,out,False,909910,False,7,933,1010,77
167109,2019-09-17 00:00:00+03:00,out,False,-1,True,1,0,0,0
167109,2019-09-17 00:00:00+03:00,out,False,907224,False,4,186,217,31
167109,2019-09-17 00:00:00+03:00,out,False,907224,True,5,0,31,31
167109,2019-09-17 00:00:00+03:00,out,True,907182,False,2,52,62,10
167109,2019-09-18 00:00:00+03:00,out,True,906294,False,4,714,729,15
167109,2019-09-18 00:00:00+03:00,out,True,907224,False,2,65,77,12
167109,2019-09-18 00:00:00+03:00,out,False,907180,False,8,510,631,121
167109,2019-09-18 00:00:00+03:00,out,True,906296,False,1,168,171,3
167109,2019-09-18 00:00:00+03:00,out,True,907182,True,3,0,4,4
167109,2019-09-18 00:00:00+03:00,out,True,907180,False,1,9,13,4
167109,2019-09-18 00:00:00+03:00,out,False,907180,True,6,0,107,107
167109,2019-09-18 00:00:00+03:00,in,False,906294,False,3,712,737,25
167109,2019-09-18 00:00:00+03:00,in,False,907224,False,1,63,80,17
167109,2019-09-18 00:00:00+03:00,in,False,-1,True,2,0,81,81
167109,2019-09-18 00:00:00+03:00,out,False,907224,False,3,194,227,33
167109,2019-09-18 00:00:00+03:00,out,True,907224,True,1,0,19,19
167109,2019-09-18 00:00:00+03:00,out,True,906294,True,1,0,1,1
167109,2019-09-18 00:00:00+03:00,out,False,907178,False,3,156,194,38
167109,2019-09-18 00:00:00+03:00,out,True,907180,True,1,0,25,25
167109,2019-09-18 00:00:00+03:00,out,False,906294,False,1,318,329,11
167109,2019-09-18 00:00:00+03:00,out,True,907182,False,1,118,120,2
167109,2019-09-18 00:00:00+03:00,in,False,907182,False,3,212,253,41
167109,2019-09-18 00:00:00+03:00,out,False,907180,True,6,0,107,107
167109,2019-09-18 00:00:00+03:00,in,False,-1,True,2,0,81,81
167109,2019-09-19 00:00:00+03:00,out,False,907180,True,5,0,117,117
167109,2019-09-19 00:00:00+03:00,out,False,909910,False,3,643,654,11
167109,2019-09-19 00:00:00+03:00,out,True,907182,False,2,26,33,7
167109,2019-09-19 00:00:00+03:00,out,True,907180,True,6,0,5,5
167109,2019-09-19 00:00:00+03:00,out,False,906294,False,4,225,266,41
167109,2019-09-19 00:00:00+03:00,out,True,907224,True,1,0,6,6
167109,2019-09-19 00:00:00+03:00,out,False,906294,True,2,0,66,66
167109,2019-09-19 00:00:00+03:00,out,False,907224,True,4,0,50,50
167109,2019-09-19 00:00:00+03:00,out,True,906296,False,3,47,57,10
167109,2019-09-19 00:00:00+03:00,out,False,907224,False,4,733,802,69
167109,2019-09-19 00:00:00+03:00,out,False,907180,False,7,1911,1990,79
167109,2019-09-19 00:00:00+03:00,out,True,906294,False,2,84,103,19
167109,2019-09-19 00:00:00+03:00,out,True,907180,False,1,10,14,4
167109,2019-09-19 00:00:00+03:00,in,False,-1,True,1,0,15,15
167109,2019-09-19 00:00:00+03:00,out,True,907178,True,3,0,4,4
167109,2019-09-19 00:00:00+03:00,in,False,906294,False,4,233,249,16
167109,2019-09-19 00:00:00+03:00,out,True,907182,True,5,0,29,29
167109,2019-09-19 00:00:00+03:00,out,True,906294,True,5,0,4,4
167109,2019-09-19 00:00:00+03:00,out,False,907180,True,5,0,117,117
167109,2019-09-20 00:00:00+03:00,in,False,906294,False,12,977,1036,59
167109,2019-09-20 00:00:00+03:00,out,True,907180,True,4,0,11,11
167109,2019-09-20 00:00:00+03:00,in,False,-1,True,1,0,9,9
167109,2019-09-20 00:00:00+03:00,out,True,906294,False,6,460,532,72
167109,2019-09-20 00:00:00+03:00,out,True,907180,False,1,80,88,8
167109,2019-09-20 00:00:00+03:00,out,False,907224,False,1,24,41,17
167109,2019-09-20 00:00:00+03:00,out,True,906294,True,1,0,1,1
167109,2019-09-20 00:00:00+03:00,out,True,909910,False,1,11,15,4
167109,2019-09-20 00:00:00+03:00,out,True,907178,False,1,16,19,3
167109,2019-09-20 00:00:00+03:00,out,False,907224,True,1,0,8,8
167109,2019-09-20 00:00:00+03:00,out,True,907182,False,3,107,129,22
167109,2019-09-21 00:00:00+03:00,in,False,-1,True,2,0,21,21
167109,2019-09-23 00:00:00+03:00,out,False,907224,False,1,152,163,11
167109,2019-09-23 00:00:00+03:00,out,False,907224,True,2,0,15,15
167109,2019-09-23 00:00:00+03:00,out,True,907182,False,5,107,129,22
167109,2019-09-23 00:00:00+03:00,out,True,906296,False,2,146,156,10
167109,2019-09-23 00:00:00+03:00,out,False,909910,True,4,0,93,93
167109,2019-09-23 00:00:00+03:00,out,False,907178,True,2,0,8,8
167109,2019-09-23 00:00:00+03:00,in,False,-1,True,3,0,35,35
167109,2019-09-23 00:00:00+03:00,out,True,907178,False,1,18,29,11
167109,2019-09-23 00:00:00+03:00,out,False,906294,False,1,59,93,34
167109,2019-09-23 00:00:00+03:00,out,False,907182,True,1,0,20,20
167109,2019-09-23 00:00:00+03:00,out,False,907178,False,5,384,425,41
167109,2019-09-23 00:00:00+03:00,out,True,909910,True,1,0,0,0
167109,2019-09-23 00:00:00+03:00,out,True,906294,False,3,436,456,20
167109,2019-09-23 00:00:00+03:00,out,False,909910,False,8,1448,1497,49
167109,2019-09-23 00:00:00+03:00,in,False,906294,False,7,1593,1640,47
167109,2019-09-24 00:00:00+03:00,out,False,909910,False,3,481,491,10
167109,2019-09-24 00:00:00+03:00,out,True,907224,False,2,14,22,8
167109,2019-09-24 00:00:00+03:00,in,False,906294,False,4,53,65,12
167109,2019-09-24 00:00:00+03:00,out,True,907224,True,1,0,22,22
167109,2019-09-24 00:00:00+03:00,in,False,-1,True,2,0,41,41
167109,2019-09-24 00:00:00+03:00,out,True,906296,False,1,89,93,4
167109,2019-09-24 00:00:00+03:00,out,True,907182,False,3,233,249,16
167109,2019-09-24 00:00:00+03:00,out,False,906294,False,2,486,505,19
167109,2019-09-24 00:00:00+03:00,out,True,907180,False,2,23,29,6
167109,2019-09-24 00:00:00+03:00,out,False,907224,True,1,0,60,60
167109,2019-09-24 00:00:00+03:00,out,True,906296,False,1,89,93,4
167109,2019-09-24 00:00:00+03:00,out,False,906294,False,2,486,505,19
167109,2019-09-25 00:00:00+03:00,out,True,906294,False,8,1693,1736,43
167109,2019-09-25 00:00:00+03:00,out,True,906294,True,5,0,68,68
167109,2019-09-25 00:00:00+03:00,out,True,907182,False,2,274,305,31
167109,2019-09-25 00:00:00+03:00,in,False,906294,False,12,2317,2362,45
167109,2019-09-25 00:00:00+03:00,out,False,907224,False,2,62,87,25
167109,2019-09-25 00:00:00+03:00,out,True,906296,False,2,61,75,14
167109,2019-09-25 00:00:00+03:00,out,True,907180,False,1,23,26,3
167109,2019-09-25 00:00:00+03:00,in,False,907182,False,2,368,379,11
167109,2019-09-25 00:00:00+03:00,out,False,907178,False,2,202,218,16
167109,2019-09-25 00:00:00+03:00,out,False,909910,False,3,1371,1384,13
167109,2019-09-25 00:00:00+03:00,in,False,-1,True,2,0,71,71
167109,2019-09-26 00:00:00+03:00,out,True,907224,True,1,0,3,3
167109,2019-09-26 00:00:00+03:00,out,True,906294,False,4,142,212,70
167109,2019-09-26 00:00:00+03:00,out,True,907182,False,1,8,11,3
167109,2019-09-26 00:00:00+03:00,in,False,906294,False,8,445,485,40
167109,2019-09-26 00:00:00+03:00,out,True,906294,True,1,0,28,28
167109,2019-09-26 00:00:00+03:00,out,True,906296,True,1,0,15,15
167109,2019-09-26 00:00:00+03:00,in,False,-1,True,5,0,102,102
167109,2019-09-26 00:00:00+03:00,out,True,907178,True,1,0,5,5
167109,2019-09-26 00:00:00+03:00,out,True,906296,False,3,335,348,13
167109,2019-09-26 00:00:00+03:00,out,False,907224,True,1,0,0,0
167109,2019-09-26 00:00:00+03:00,out,False,907224,False,1,152,161,9
167109,2019-09-26 00:00:00+03:00,out,False,907182,False,1,117,119,2
167109,2019-09-26 00:00:00+03:00,out,True,906294,True,1,0,28,28
167109,2019-09-26 00:00:00+03:00,out,True,906296,False,3,335,348,13
167109,2019-09-27 00:00:00+03:00,out,True,907224,False,2,52,58,6
167109,2019-09-27 00:00:00+03:00,in,False,906294,False,11,1278,1318,40
167109,2019-09-27 00:00:00+03:00,in,False,907224,False,1,60,66,6
167109,2019-09-27 00:00:00+03:00,out,False,906294,False,5,2003,2067,64
167109,2019-09-27 00:00:00+03:00,out,True,906296,False,1,16,18,2
167109,2019-09-27 00:00:00+03:00,out,True,906294,False,4,694,730,36
167109,2019-09-27 00:00:00+03:00,out,False,907178,False,7,320,375,55
167109,2019-09-27 00:00:00+03:00,in,False,-1,True,1,0,15,15
167109,2019-09-27 00:00:00+03:00,out,True,907224,True,2,0,1,1
167109,2019-09-27 00:00:00+03:00,in,False,907182,False,3,786,836,50
167109,2019-09-27 00:00:00+03:00,out,True,907182,False,8,276,302,26
167109,2019-09-27 00:00:00+03:00,out,False,907224,False,4,291,335,44
167109,2019-09-27 00:00:00+03:00,out,False,907178,True,1,0,13,13
167109,2019-09-27 00:00:00+03:00,out,True,907178,True,1,0,45,45
167109,2019-09-27 00:00:00+03:00,out,False,907224,True,1,0,13,13
167109,2019-09-27 00:00:00+03:00,out,False,907178,False,7,320,375,55
167109,2019-09-27 00:00:00+03:00,in,False,907224,False,1,60,66,6
167109,2019-09-30 00:00:00+03:00,out,True,907182,False,3,29,45,16
167109,2019-09-30 00:00:00+03:00,out,False,907224,False,3,86,150,64
167109,2019-09-30 00:00:00+03:00,out,True,906296,False,1,6,10,4
167109,2019-09-30 00:00:00+03:00,in,False,-1,True,2,0,63,63
167109,2019-09-30 00:00:00+03:00,out,True,907180,True,1,0,1,1
167109,2019-09-30 00:00:00+03:00,out,False,906294,False,4,238,305,67
167109,2019-09-30 00:00:00+03:00,out,False,907224,True,1,0,9,9
167109,2019-09-30 00:00:00+03:00,in,False,906294,False,12,1291,1355,64
167109,2019-09-30 00:00:00+03:00,out,True,906294,False,3,408,425,17
167109,2019-09-30 00:00:00+03:00,out,False,909910,False,3,971,980,9
167109,2019-09-30 00:00:00+03:00,out,False,907224,False,3,86,150,64
167109,2019-09-30 00:00:00+03:00,out,True,907180,True,1,0,1,1
167109,2019-09-30 00:00:00+03:00,out,False,906294,False,4,238,305,67
167109,2019-09-30 00:00:00+03:00,out,False,907224,True,1,0,9,9
167109,2019-10-01 00:00:00+03:00,out,False,906294,False,2,109,134,25
167109,2019-10-01 00:00:00+03:00,in,False,907224,False,2,409,470,61
167109,2019-10-01 00:00:00+03:00,out,False,909910,False,1,98,101,3
167109,2019-10-01 00:00:00+03:00,out,True,907182,False,4,66,93,27
167109,2019-10-01 00:00:00+03:00,out,True,909910,True,1,0,28,28
167109,2019-10-01 00:00:00+03:00,in,False,906294,False,11,1277,1333,56
167109,2019-10-01 00:00:00+03:00,out,True,906294,True,2,0,69,69
167109,2019-10-01 00:00:00+03:00,out,True,906296,False,2,25,34,9
167109,2019-10-01 00:00:00+03:00,out,True,906294,False,3,637,666,29
167109,2019-10-01 00:00:00+03:00,out,False,907224,True,1,0,34,34
167109,2019-10-01 00:00:00+03:00,out,False,907224,False,5,162,227,65
167109,2019-10-01 00:00:00+03:00,out,True,907224,False,1,7,13,6
167109,2019-10-01 00:00:00+03:00,out,False,907224,False,5,162,227,65
167109,2019-10-01 00:00:00+03:00,out,True,907182,False,4,66,93,27
167109,2019-10-02 00:00:00+03:00,out,False,906294,False,4,196,272,76
167109,2019-10-02 00:00:00+03:00,out,True,907182,True,5,0,79,79
167109,2019-10-02 00:00:00+03:00,out,True,906294,True,3,0,91,91
167109,2019-10-02 00:00:00+03:00,out,True,906294,False,2,120,142,22
167109,2019-10-02 00:00:00+03:00,out,False,906294,True,1,0,7,7
167109,2019-10-02 00:00:00+03:00,out,False,907178,False,1,182,194,12
167109,2019-10-02 00:00:00+03:00,out,True,907224,False,2,16,24,8
167109,2019-10-02 00:00:00+03:00,out,True,907182,False,2,32,40,8
167109,2019-10-02 00:00:00+03:00,out,False,907224,False,3,283,338,55
167109,2019-10-02 00:00:00+03:00,out,True,907178,True,1,0,1,1
167109,2019-10-02 00:00:00+03:00,out,False,909910,False,10,1551,1595,44
167109,2019-10-02 00:00:00+03:00,out,False,907224,True,1,0,4,4
167109,2019-10-02 00:00:00+03:00,out,True,909910,False,2,40,45,5
167109,2019-10-02 00:00:00+03:00,in,False,907182,False,1,15,19,4
167109,2019-10-02 00:00:00+03:00,out,True,909910,True,2,0,2,2
167109,2019-10-02 00:00:00+03:00,out,True,906296,False,3,126,147,21
167109,2019-10-02 00:00:00+03:00,in,False,-1,True,3,0,71,71
167109,2019-10-02 00:00:00+03:00,in,False,906294,False,12,862,926,64
167109,2019-10-02 00:00:00+03:00,out,False,906294,False,4,196,272,76
167109,2019-10-02 00:00:00+03:00,out,True,906296,False,3,126,147,21
167109,2019-10-02 00:00:00+03:00,out,True,907182,True,5,0,79,79
167109,2019-10-02 00:00:00+03:00,out,True,909910,True,2,0,2,2
167109,2019-10-02 00:00:00+03:00,out,True,906294,False,2,120,142,22
167109,2019-10-03 00:00:00+03:00,out,True,906294,False,5,468,523,55
167109,2019-10-03 00:00:00+03:00,out,False,906294,False,2,106,124,18
167109,2019-10-03 00:00:00+03:00,out,True,909910,False,1,6,11,5
167109,2019-10-03 00:00:00+03:00,out,True,907224,True,1,0,0,0
167109,2019-10-03 00:00:00+03:00,in,False,-1,True,2,0,34,34
167109,2019-10-03 00:00:00+03:00,out,False,909910,False,1,34,48,14
167109,2019-10-03 00:00:00+03:00,out,True,907224,False,3,129,138,9
167109,2019-10-03 00:00:00+03:00,out,False,907224,False,1,76,116,40
167109,2019-10-03 00:00:00+03:00,in,False,906294,False,9,996,1036,40
167109,2019-10-03 00:00:00+03:00,out,True,906294,True,2,0,73,73
167109,2019-10-03 00:00:00+03:00,out,True,907178,False,2,84,89,5
167109,2019-10-03 00:00:00+03:00,out,False,906294,True,2,0,70,70
167109,2019-10-03 00:00:00+03:00,out,False,-1,True,1,0,0,0
167109,2019-10-03 00:00:00+03:00,in,False,906294,False,9,996,1036,40
167109,2019-10-03 00:00:00+03:00,out,True,907224,False,3,129,138,9
167109,2019-10-03 00:00:00+03:00,out,True,907178,False,2,84,89,5
167109,2019-10-04 00:00:00+03:00,in,False,907182,False,1,5,11,6
167109,2019-10-04 00:00:00+03:00,out,False,907182,False,2,446,497,51
167109,2019-10-04 00:00:00+03:00,out,True,906296,False,5,459,486,27
167109,2019-10-04 00:00:00+03:00,out,True,909910,False,1,6,10,4
167109,2019-10-04 00:00:00+03:00,out,True,906294,True,1,0,13,13
167109,2019-10-04 00:00:00+03:00,in,False,906294,True,1,0,5,5
167109,2019-10-04 00:00:00+03:00,out,False,906294,True,1,0,32,32
167109,2019-10-04 00:00:00+03:00,out,True,907180,False,1,46,49,3
167109,2019-10-04 00:00:00+03:00,out,False,906294,False,1,38,42,4
167109,2019-10-04 00:00:00+03:00,out,True,907182,False,4,287,301,14
167109,2019-10-04 00:00:00+03:00,out,True,907178,False,1,2,13,11
167109,2019-10-04 00:00:00+03:00,out,False,909910,False,4,696,717,21
167109,2019-10-04 00:00:00+03:00,out,False,907224,False,5,888,950,62
167109,2019-10-04 00:00:00+03:00,in,False,906294,False,3,121,137,16
167109,2019-10-04 00:00:00+03:00,out,True,907224,False,1,10,14,4
167109,2019-10-04 00:00:00+03:00,out,False,907224,True,2,0,5,5
167109,2019-10-04 00:00:00+03:00,out,False,909910,False,4,696,717,21
167109,2019-10-04 00:00:00+03:00,in,False,906294,True,1,0,5,5
167109,2019-10-07 00:00:00+03:00,out,True,907224,True,1,0,5,5
167109,2019-10-07 00:00:00+03:00,out,True,907180,False,1,36,39,3
167109,2019-10-07 00:00:00+03:00,out,True,909910,False,1,7,18,11
167109,2019-10-07 00:00:00+03:00,in,False,907224,False,2,34,86,52
167109,2019-10-07 00:00:00+03:00,out,False,-1,True,1,0,0,0
167109,2019-10-07 00:00:00+03:00,out,True,909910,True,2,0,13,13
167109,2019-10-07 00:00:00+03:00,out,True,907182,False,2,51,57,6
167109,2019-10-07 00:00:00+03:00,out,False,907224,False,2,157,181,24
167109,2019-10-07 00:00:00+03:00,in,False,-1,True,3,0,64,64
167109,2019-10-07 00:00:00+03:00,out,True,907182,True,1,0,13,13
167109,2019-10-07 00:00:00+03:00,out,False,909910,False,5,1196,1250,54
167109,2019-10-07 00:00:00+03:00,in,False,907182,False,4,522,567,45
167109,2019-10-07 00:00:00+03:00,out,True,907182,True,1,0,13,13
167109,2019-10-08 00:00:00+03:00,in,False,-1,True,3,0,55,55
167109,2019-10-08 00:00:00+03:00,out,True,907182,True,1,0,48,48
167109,2019-10-08 00:00:00+03:00,out,True,907182,False,5,76,94,18
167109,2019-10-08 00:00:00+03:00,in,False,907224,False,3,201,250,49
167109,2019-10-08 00:00:00+03:00,in,False,907182,False,1,81,93,12
167109,2019-10-08 00:00:00+03:00,out,False,909910,False,2,93,108,15
167109,2019-10-08 00:00:00+03:00,out,False,907224,True,1,0,0,0
167109,2019-10-08 00:00:00+03:00,out,False,906296,False,2,67,73,6
167109,2019-10-08 00:00:00+03:00,out,False,907182,False,2,182,194,12
167109,2019-10-08 00:00:00+03:00,out,True,909910,False,1,7,14,7
167109,2019-10-08 00:00:00+03:00,out,False,907224,False,4,846,891,45
167109,2019-10-08 00:00:00+03:00,out,True,909910,False,1,7,14,7
167109,2019-10-09 00:00:00+03:00,in,False,907182,False,2,153,165,12
167109,2019-10-09 00:00:00+03:00,in,False,-1,True,1,0,15,15
167109,2019-10-09 00:00:00+03:00,out,True,906296,True,1,0,19,19
167109,2019-10-09 00:00:00+03:00,out,False,907224,True,3,0,16,16
167109,2019-10-09 00:00:00+03:00,out,False,907224,False,4,1106,1152,46
167109,2019-10-09 00:00:00+03:00,out,True,907224,False,1,10,14,4
167109,2019-10-09 00:00:00+03:00,out,True,906296,False,1,8,12,4
167109,2019-10-09 00:00:00+03:00,in,False,907224,False,4,135,202,67
167109,2019-10-09 00:00:00+03:00,out,True,909910,False,2,49,64,15
167109,2019-10-09 00:00:00+03:00,out,True,909910,True,1,0,18,18
167109,2019-10-09 00:00:00+03:00,out,False,909910,False,14,1070,1134,64
167109,2019-10-09 00:00:00+03:00,out,True,907224,True,1,0,1,1
167109,2019-10-09 00:00:00+03:00,out,False,909910,True,12,0,195,195
167109,2019-10-09 00:00:00+03:00,out,True,907182,False,2,94,101,7
167109,2019-10-09 00:00:00+03:00,out,True,909910,True,1,0,18,18
167109,2019-10-09 00:00:00+03:00,out,True,906296,False,1,8,12,4
167109,2019-10-10 00:00:00+03:00,out,True,907180,False,1,2,16,14
167109,2019-10-10 00:00:00+03:00,out,True,907182,False,3,43,59,16
167109,2019-10-10 00:00:00+03:00,in,False,907182,False,3,140,164,24
167109,2019-10-10 00:00:00+03:00,out,True,907224,False,1,12,17,5
167109,2019-10-10 00:00:00+03:00,out,False,909910,False,10,1637,1691,54
167109,2019-10-10 00:00:00+03:00,out,False,907178,True,1,0,11,11
167109,2019-10-10 00:00:00+03:00,out,True,909910,False,1,7,19,12
167109,2019-10-10 00:00:00+03:00,out,False,907224,True,1,0,60,60
167109,2019-10-10 00:00:00+03:00,out,True,907182,True,2,0,26,26
167109,2019-10-10 00:00:00+03:00,out,False,906296,False,1,44,55,11
167109,2019-10-10 00:00:00+03:00,in,False,907224,False,1,64,67,3
167109,2019-10-10 00:00:00+03:00,out,False,907224,False,2,174,217,43
167109,2019-10-10 00:00:00+03:00,out,True,907182,False,3,43,59,16
167109,2019-10-10 00:00:00+03:00,in,False,907182,False,3,140,164,24
167109,2019-10-11 00:00:00+03:00,out,True,907180,False,2,18,24,6
167109,2019-10-11 00:00:00+03:00,out,True,909910,True,1,0,1,1
167109,2019-10-11 00:00:00+03:00,out,True,907182,False,4,270,286,16
167109,2019-10-11 00:00:00+03:00,out,False,907224,False,4,825,874,49
167109,2019-10-11 00:00:00+03:00,out,True,909910,False,3,18,37,19
167109,2019-10-11 00:00:00+03:00,in,False,907182,False,2,324,334,10
167109,2019-10-11 00:00:00+03:00,out,True,907224,False,1,5,11,6
167109,2019-10-11 00:00:00+03:00,out,False,906296,False,3,274,359,85
167109,2019-10-11 00:00:00+03:00,out,True,906296,True,1,0,0,0
167109,2019-10-11 00:00:00+03:00,out,True,907178,False,1,20,31,11
167109,2019-10-11 00:00:00+03:00,out,True,906296,False,4,81,100,19
167109,2019-10-11 00:00:00+03:00,out,False,909910,True,2,0,27,27
167109,2019-10-11 00:00:00+03:00,out,False,909910,False,6,627,661,34
167109,2019-10-11 00:00:00+03:00,in,False,907182,False,2,324,334,10
167109,2019-10-12 00:00:00+03:00,in,False,-1,True,1,0,26,26
167109,2019-10-14 00:00:00+03:00,out,True,906296,False,1,4,10,6
167109,2019-10-14 00:00:00+03:00,out,True,907182,False,2,19,26,7
167109,2019-10-14 00:00:00+03:00,in,False,-1,True,2,0,53,53
167109,2019-10-14 00:00:00+03:00,out,False,907224,False,2,105,128,23
167109,2019-10-14 00:00:00+03:00,out,True,907178,True,1,0,26,26
167109,2019-10-14 00:00:00+03:00,out,False,906296,False,1,48,66,18
167109,2019-10-14 00:00:00+03:00,out,True,906296,True,4,0,23,23
167109,2019-10-14 00:00:00+03:00,in,False,907224,False,4,194,260,66
167109,2019-10-14 00:00:00+03:00,out,False,909910,True,4,0,5,5
167109,2019-10-14 00:00:00+03:00,out,False,909910,False,12,1418,1484,66
167109,2019-10-14 00:00:00+03:00,out,True,909910,True,1,0,28,28
167109,2019-10-14 00:00:00+03:00,out,True,907178,True,1,0,26,26
167109,2019-10-15 00:00:00+03:00,out,True,906296,True,1,0,21,21
167109,2019-10-15 00:00:00+03:00,out,True,906294,False,2,145,154,9
167109,2019-10-15 00:00:00+03:00,out,False,907178,False,3,680,696,16
167109,2019-10-15 00:00:00+03:00,out,False,906294,False,3,827,854,27
167109,2019-10-15 00:00:00+03:00,out,True,906296,False,4,157,172,15
167109,2019-10-15 00:00:00+03:00,out,False,907178,True,2,0,18,18
167109,2019-10-15 00:00:00+03:00,in,False,-1,True,1,0,39,39
167109,2019-10-15 00:00:00+03:00,out,True,909910,False,1,6,13,7
167109,2019-10-15 00:00:00+03:00,out,True,906294,True,1,0,44,44
167109,2019-10-15 00:00:00+03:00,in,False,907224,False,1,70,100,30
167109,2019-10-15 00:00:00+03:00,out,False,909910,True,1,0,42,42
167109,2019-10-15 00:00:00+03:00,out,False,907224,False,2,149,173,24
167109,2019-10-15 00:00:00+03:00,out,False,909910,False,4,204,244,40
167109,2019-10-15 00:00:00+03:00,out,True,907178,False,1,34,37,3
167109,2019-10-15 00:00:00+03:00,out,True,907182,False,4,104,116,12
167109,2019-10-15 00:00:00+03:00,in,False,906294,False,8,551,590,39
167109,2019-10-15 00:00:00+03:00,in,False,-1,True,1,0,39,39
167109,2019-10-16 00:00:00+03:00,out,True,907182,False,2,91,96,5
167109,2019-10-16 00:00:00+03:00,out,True,907224,False,1,7,9,2
167109,2019-10-16 00:00:00+03:00,out,True,906294,False,3,268,280,12
167109,2019-10-16 00:00:00+03:00,out,True,906294,True,1,0,28,28
167109,2019-10-16 00:00:00+03:00,in,False,-1,True,1,0,2,2
167109,2019-10-16 00:00:00+03:00,out,True,909910,True,1,0,19,19
167109,2019-10-16 00:00:00+03:00,out,False,906296,False,1,290,295,5
167109,2019-10-16 00:00:00+03:00,out,True,906296,False,7,200,223,23
167109,2019-10-16 00:00:00+03:00,out,False,907224,False,2,346,370,24
167109,2019-10-16 00:00:00+03:00,out,False,909910,True,1,0,11,11
167109,2019-10-16 00:00:00+03:00,in,False,906294,False,9,470,501,31
167109,2019-10-16 00:00:00+03:00,out,False,909910,False,3,1097,1139,42
167109,2019-10-16 00:00:00+03:00,out,True,909910,False,2,36,54,18
167109,2019-10-16 00:00:00+03:00,out,False,906294,False,4,444,480,36
167109,2019-10-16 00:00:00+03:00,out,False,907182,False,1,197,199,2
167109,2019-10-16 00:00:00+03:00,out,True,907182,True,2,0,15,15
167109,2019-10-16 00:00:00+03:00,out,True,909910,False,2,36,54,18
167109,2019-10-16 00:00:00+03:00,out,False,906296,False,1,290,295,5
167109,2019-10-16 00:00:00+03:00,out,True,907182,True,2,0,15,15
167109,2019-10-17 00:00:00+03:00,out,True,907178,False,1,75,79,4
167109,2019-10-17 00:00:00+03:00,in,False,-1,True,2,0,73,73
167109,2019-10-17 00:00:00+03:00,out,True,906296,True,3,0,68,68
167109,2019-10-17 00:00:00+03:00,out,True,907182,False,4,155,172,17
167109,2019-10-17 00:00:00+03:00,out,False,907178,True,25,0,515,515
167109,2019-10-17 00:00:00+03:00,out,False,909910,True,1,0,20,20
167109,2019-10-17 00:00:00+03:00,in,False,907182,False,2,124,151,27
167109,2019-10-17 00:00:00+03:00,out,False,906294,False,1,269,282,13
167109,2019-10-17 00:00:00+03:00,out,True,906294,False,3,432,454,22
167109,2019-10-17 00:00:00+03:00,in,False,907224,False,3,124,201,77
167109,2019-10-17 00:00:00+03:00,out,False,907224,False,1,120,142,22
167109,2019-10-17 00:00:00+03:00,out,False,907180,False,1,37,42,5
167109,2019-10-17 00:00:00+03:00,out,True,907178,True,1,0,1,1
167109,2019-10-17 00:00:00+03:00,out,True,906294,True,1,0,23,23
167109,2019-10-17 00:00:00+03:00,out,True,907180,True,1,0,30,30
167109,2019-10-17 00:00:00+03:00,in,False,906294,False,9,811,852,41
167109,2019-10-17 00:00:00+03:00,out,True,907224,False,1,60,65,5
167109,2019-10-17 00:00:00+03:00,out,True,906296,False,1,5,8,3
167109,2019-10-17 00:00:00+03:00,out,False,907178,True,25,0,515,515
167109,2019-10-18 00:00:00+03:00,out,True,909910,True,5,0,95,95
167109,2019-10-18 00:00:00+03:00,out,True,906294,True,2,0,80,80
167109,2019-10-18 00:00:00+03:00,out,True,906294,False,2,44,57,13
167109,2019-10-18 00:00:00+03:00,in,False,906294,False,3,149,163,14
167109,2019-10-18 00:00:00+03:00,out,False,906294,False,4,1760,1797,37
167109,2019-10-18 00:00:00+03:00,out,False,907178,False,5,1002,1063,61
167109,2019-10-18 00:00:00+03:00,out,False,907178,True,5,0,53,53
167109,2019-10-18 00:00:00+03:00,out,True,907224,False,1,18,21,3
167109,2019-10-18 00:00:00+03:00,in,False,907182,False,1,31,52,21
167109,2019-10-18 00:00:00+03:00,in,False,-1,True,3,0,75,75
167109,2019-10-18 00:00:00+03:00,out,True,907178,True,3,0,45,45
167109,2019-10-18 00:00:00+03:00,in,False,907224,False,2,135,202,67
167109,2019-10-18 00:00:00+03:00,out,True,907178,False,1,23,25,2
167109,2019-10-18 00:00:00+03:00,out,True,909910,False,2,17,24,7
167109,2019-10-18 00:00:00+03:00,out,True,906296,False,1,56,59,3
167109,2019-10-18 00:00:00+03:00,out,False,907224,False,2,79,116,37
167109,2019-10-18 00:00:00+03:00,out,False,906296,False,1,35,41,6
167109,2019-10-18 00:00:00+03:00,out,True,907182,False,3,160,168,8
167109,2019-10-21 00:00:00+03:00,out,True,907182,False,2,107,120,13
167109,2019-10-21 00:00:00+03:00,out,False,906294,False,2,253,273,20
167109,2019-10-21 00:00:00+03:00,in,False,-1,True,1,0,39,39
167109,2019-10-21 00:00:00+03:00,out,False,907224,True,10,0,32,32
167109,2019-10-21 00:00:00+03:00,out,True,906294,False,2,481,490,9
167109,2019-10-21 00:00:00+03:00,out,False,906296,False,1,85,90,5
167109,2019-10-21 00:00:00+03:00,out,True,906296,True,1,0,4,4
167109,2019-10-21 00:00:00+03:00,out,False,907178,False,1,74,92,18
167109,2019-10-21 00:00:00+03:00,out,False,907224,False,5,1332,1370,38
167109,2019-10-21 00:00:00+03:00,out,False,909910,False,1,554,568,14
167109,2019-10-21 00:00:00+03:00,out,True,907224,False,2,29,35,6
167109,2019-10-21 00:00:00+03:00,out,True,906296,False,3,187,204,17
167109,2019-10-21 00:00:00+03:00,in,False,906294,False,3,595,605,10
167109,2019-10-21 00:00:00+03:00,out,True,907224,True,1,0,17,17
167109,2019-10-21 00:00:00+03:00,out,False,907224,True,10,0,32,32
167109,2019-10-22 00:00:00+03:00,out,False,907224,False,4,1005,1037,32
167109,2019-10-22 00:00:00+03:00,out,True,907182,False,2,30,37,7
167109,2019-10-22 00:00:00+03:00,in,False,907182,False,2,74,108,34
167109,2019-10-22 00:00:00+03:00,out,False,906294,False,1,65,88,23
167109,2019-10-22 00:00:00+03:00,out,False,907178,False,5,751,805,54
167109,2019-10-22 00:00:00+03:00,in,False,907224,False,2,108,168,60
167109,2019-10-22 00:00:00+03:00,out,False,907224,True,2,0,5,5
167109,2019-10-22 00:00:00+03:00,out,False,909910,True,1,0,10,10
167109,2019-10-22 00:00:00+03:00,out,False,907178,True,9,0,73,73
167109,2019-10-22 00:00:00+03:00,out,False,909910,False,2,271,294,23
167109,2019-10-22 00:00:00+03:00,in,False,906294,False,1,45,50,5
167109,2019-10-22 00:00:00+03:00,out,True,907182,True,1,0,22,22
167109,2019-10-23 00:00:00+03:00,out,True,907224,True,1,0,0,0
167109,2019-10-23 00:00:00+03:00,out,True,906294,True,2,0,46,46
167109,2019-10-23 00:00:00+03:00,out,True,907182,False,11,137,174,37
167109,2019-10-23 00:00:00+03:00,out,True,906296,True,1,0,19,19
167109,2019-10-23 00:00:00+03:00,out,True,906296,False,4,123,137,14
167109,2019-10-23 00:00:00+03:00,out,True,907182,True,1,0,0,0
167109,2019-10-23 00:00:00+03:00,out,False,906294,False,1,255,269,14
167109,2019-10-23 00:00:00+03:00,out,True,906294,False,3,200,219,19
167109,2019-10-23 00:00:00+03:00,in,False,906294,False,5,671,690,19
167109,2019-10-23 00:00:00+03:00,out,False,907224,False,2,345,368,23
167109,2019-10-23 00:00:00+03:00,out,False,909910,False,2,169,182,13
167109,2019-10-23 00:00:00+03:00,in,False,907182,False,1,39,44,5
167109,2019-10-24 00:00:00+03:00,out,False,907178,True,1,0,7,7
167109,2019-10-24 00:00:00+03:00,out,False,909910,False,3,390,404,14
167109,2019-10-24 00:00:00+03:00,out,False,907224,False,3,495,535,40
167109,2019-10-24 00:00:00+03:00,out,False,906294,True,2,0,83,83
167109,2019-10-24 00:00:00+03:00,out,True,906294,False,1,62,66,4
167109,2019-10-24 00:00:00+03:00,out,True,906296,False,2,146,151,5
167109,2019-10-24 00:00:00+03:00,out,False,907178,False,1,24,26,2
167109,2019-10-24 00:00:00+03:00,out,True,906294,True,2,0,25,25
167109,2019-10-24 00:00:00+03:00,out,False,906294,False,3,386,426,40
167109,2019-10-24 00:00:00+03:00,in,False,906294,False,9,517,566,49
167109,2019-10-24 00:00:00+03:00,out,True,906296,True,1,0,13,13
167109,2019-10-24 00:00:00+03:00,out,True,907224,False,1,15,35,20
167109,2019-10-24 00:00:00+03:00,in,False,-1,True,4,0,85,85
167109,2019-10-24 00:00:00+03:00,out,True,909910,False,1,39,41,2
167109,2019-10-25 00:00:00+03:00,out,False,907178,True,1,0,19,19
167109,2019-10-25 00:00:00+03:00,out,False,907224,False,2,106,138,32
167109,2019-10-25 00:00:00+03:00,out,False,907178,False,1,152,173,21
167109,2019-10-25 00:00:00+03:00,out,True,906296,True,1,0,0,0
167109,2019-10-25 00:00:00+03:00,out,True,906296,False,1,13,23,10
167109,2019-10-25 00:00:00+03:00,in,False,906294,False,3,175,188,13
167109,2019-10-25 00:00:00+03:00,out,False,906294,True,1,0,43,43
167109,2019-10-25 00:00:00+03:00,in,False,907224,False,3,365,429,64
167109,2019-10-25 00:00:00+03:00,out,True,906294,True,1,0,0,0
167109,2019-10-25 00:00:00+03:00,out,False,906294,False,5,134,195,61
167109,2019-10-25 00:00:00+03:00,in,False,-1,True,7,0,174,174
167109,2019-10-25 00:00:00+03:00,out,True,906296,True,1,0,0,0
167109,2019-10-25 00:00:00+03:00,out,True,906296,False,1,13,23,10
167109,2019-10-28 00:00:00+03:00,out,True,906294,False,4,410,431,21
167109,2019-10-28 00:00:00+03:00,out,False,907224,True,1,0,1,1
167109,2019-10-28 00:00:00+03:00,out,False,906294,False,5,452,479,27
167109,2019-10-28 00:00:00+03:00,in,False,-1,True,1,0,17,17
167109,2019-10-28 00:00:00+03:00,out,True,907180,True,1,0,18,18
167109,2019-10-28 00:00:00+03:00,out,True,907224,True,1,0,60,60
167109,2019-10-28 00:00:00+03:00,in,False,906294,False,6,744,763,19
167109,2019-10-28 00:00:00+03:00,out,True,906296,True,1,0,21,21
167109,2019-10-28 00:00:00+03:00,out,False,907224,False,1,46,65,19
167109,2019-10-28 00:00:00+03:00,out,True,907224,False,1,46,50,4
167109,2019-10-29 00:00:00+03:00,out,False,906294,False,1,81,97,16
167109,2019-10-29 00:00:00+03:00,out,True,909910,True,2,0,23,23
167109,2019-10-29 00:00:00+03:00,in,False,906294,False,7,533,558,25
167109,2019-10-29 00:00:00+03:00,out,False,909910,False,3,381,410,29
167109,2019-10-29 00:00:00+03:00,in,False,-1,True,3,0,77,77
167109,2019-10-29 00:00:00+03:00,out,True,909910,False,1,8,13,5
167109,2019-10-29 00:00:00+03:00,in,False,907224,False,1,25,60,35
167109,2019-10-29 00:00:00+03:00,out,True,906294,True,2,0,26,26
167109,2019-10-29 00:00:00+03:00,out,False,909910,False,3,381,410,29
167109,2019-10-30 00:00:00+03:00,out,False,906296,False,1,42,45,3
167109,2019-10-30 00:00:00+03:00,out,True,907224,False,2,14,30,16
167109,2019-10-30 00:00:00+03:00,out,True,906296,False,4,150,163,13
167109,2019-10-30 00:00:00+03:00,in,False,906294,False,13,1306,1352,46
167109,2019-10-30 00:00:00+03:00,out,False,907224,False,2,401,419,18
167109,2019-10-30 00:00:00+03:00,out,True,909910,True,2,0,0,0
167109,2019-10-30 00:00:00+03:00,out,False,909910,True,13,0,311,311
167109,2019-10-30 00:00:00+03:00,out,True,907182,False,4,152,163,11
167109,2019-10-30 00:00:00+03:00,out,True,906294,True,3,0,146,146
167109,2019-10-30 00:00:00+03:00,out,False,906294,True,1,0,40,40
167109,2019-10-30 00:00:00+03:00,out,True,909910,False,1,36,41,5
167109,2019-10-30 00:00:00+03:00,in,False,907182,False,1,110,116,6
167109,2019-10-30 00:00:00+03:00,out,True,906294,False,6,289,331,42
167109,2019-10-30 00:00:00+03:00,out,False,906294,False,4,331,363,32
167109,2019-10-30 00:00:00+03:00,out,True,906296,True,1,0,22,22
167109,2019-10-30 00:00:00+03:00,out,False,909910,False,3,419,433,14
167109,2019-10-31 00:00:00+03:00,out,True,907182,True,2,0,0,0
167109,2019-10-31 00:00:00+03:00,out,True,906296,True,1,0,60,60
167109,2019-10-31 00:00:00+03:00,out,True,909910,False,1,28,37,9
167109,2019-10-31 00:00:00+03:00,in,False,906294,False,3,428,444,16
167109,2019-10-31 00:00:00+03:00,out,True,906294,False,2,314,328,14
167109,2019-10-31 00:00:00+03:00,out,False,909910,False,2,790,809,19
167109,2019-10-31 00:00:00+03:00,out,False,906294,False,2,201,236,35
167109,2019-10-31 00:00:00+03:00,out,False,907224,False,3,528,560,32
167109,2019-10-31 00:00:00+03:00,out,True,909910,True,3,0,17,17
167109,2019-10-31 00:00:00+03:00,out,True,906296,False,4,69,80,11
167109,2019-10-31 00:00:00+03:00,out,True,906294,True,1,0,25,25
167109,2019-10-31 00:00:00+03:00,out,True,907182,False,1,6,8,2
167109,2019-11-01 00:00:00+03:00,out,True,906294,True,1,0,43,43
167109,2019-11-01 00:00:00+03:00,out,False,909910,False,2,171,193,22
167109,2019-11-01 00:00:00+03:00,out,True,909910,True,3,0,16,16
167109,2019-11-01 00:00:00+03:00,out,True,906296,False,4,527,542,15
167109,2019-11-01 00:00:00+03:00,out,True,907180,True,1,0,17,17
167109,2019-11-01 00:00:00+03:00,out,False,907224,False,2,111,132,21
167109,2019-11-01 00:00:00+03:00,in,False,907182,False,1,316,321,5
167109,2019-11-01 00:00:00+03:00,out,True,907178,True,2,0,30,30
167109,2019-11-01 00:00:00+03:00,out,True,909910,False,1,13,15,2
167109,2019-11-01 00:00:00+03:00,out,True,907182,False,1,22,26,4
167109,2019-11-01 00:00:00+03:00,out,False,909910,True,1,0,30,30
167109,2019-11-01 00:00:00+03:00,out,True,906294,False,5,192,210,18
167109,2019-11-01 00:00:00+03:00,in,False,906294,False,4,243,264,21
167109,2019-11-01 00:00:00+03:00,out,False,906294,False,5,884,968,84
167109,2019-11-01 00:00:00+03:00,in,False,907224,False,1,16,20,4
167109,2019-11-01 00:00:00+03:00,out,True,907180,True,1,0,17,17
167109,2019-11-05 00:00:00+03:00,out,True,907182,False,7,312,331,19
167109,2019-11-05 00:00:00+03:00,out,False,907224,False,2,57,78,21
167109,2019-11-05 00:00:00+03:00,out,False,907224,True,1,0,17,17
167109,2019-11-05 00:00:00+03:00,in,False,907182,False,2,182,194,12
167109,2019-11-05 00:00:00+03:00,in,False,906294,False,5,201,217,16
167109,2019-11-05 00:00:00+03:00,out,True,909910,True,3,0,0,0
167109,2019-11-05 00:00:00+03:00,out,False,906294,False,2,44,77,33
167109,2019-11-05 00:00:00+03:00,out,False,909910,False,4,770,779,9
167109,2019-11-05 00:00:00+03:00,out,True,906296,True,1,0,22,22
167109,2019-11-05 00:00:00+03:00,out,True,906294,False,1,48,53,5
167109,2019-11-05 00:00:00+03:00,out,True,906296,False,1,5,9,4
167109,2019-11-05 00:00:00+03:00,out,False,907178,False,1,103,108,5
167109,2019-11-05 00:00:00+03:00,out,False,906294,True,4,0,53,53
167109,2019-11-06 00:00:00+03:00,out,True,906296,False,4,82,95,13
167109,2019-11-06 00:00:00+03:00,out,True,907224,False,1,4,10,6
167109,2019-11-06 00:00:00+03:00,in,False,-1,True,2,0,31,31
167109,2019-11-06 00:00:00+03:00,out,False,909910,True,6,0,33,33
167109,2019-11-06 00:00:00+03:00,out,False,906294,False,2,310,345,35
167109,2019-11-06 00:00:00+03:00,out,False,909910,False,2,127,136,9
167109,2019-11-06 00:00:00+03:00,out,False,906296,False,2,49,93,44
167109,2019-11-06 00:00:00+03:00,out,True,909910,False,3,20,36,16
167109,2019-11-06 00:00:00+03:00,out,False,907224,False,5,926,1020,94
167109,2019-11-06 00:00:00+03:00,out,True,907182,False,5,63,94,31
167109,2019-11-06 00:00:00+03:00,out,True,909910,True,1,0,0,0
167109,2019-11-06 00:00:00+03:00,out,False,906296,True,3,0,161,161
167109,2019-11-06 00:00:00+03:00,out,False,909910,False,2,127,136,9
167109,2019-11-06 00:00:00+03:00,out,True,906296,False,4,82,95,13
167109,2019-11-07 00:00:00+03:00,out,True,907178,False,3,136,154,18
167109,2019-11-07 00:00:00+03:00,out,True,906296,True,1,0,17,17
167109,2019-11-07 00:00:00+03:00,out,False,909910,True,3,0,69,69
167109,2019-11-07 00:00:00+03:00,out,True,907182,True,1,0,0,0
167109,2019-11-07 00:00:00+03:00,in,False,906294,False,1,35,44,9
167109,2019-11-07 00:00:00+03:00,in,False,-1,True,3,0,79,79
167109,2019-11-07 00:00:00+03:00,out,True,906296,False,4,418,438,20
167109,2019-11-07 00:00:00+03:00,out,False,906294,False,3,163,200,37
167109,2019-11-07 00:00:00+03:00,out,False,909910,False,5,532,610,78
167109,2019-11-07 00:00:00+03:00,out,False,907224,False,4,796,848,52
167109,2019-11-07 00:00:00+03:00,in,False,907182,False,4,885,970,85
167109,2019-11-07 00:00:00+03:00,out,True,909910,False,1,7,11,4
167109,2019-11-07 00:00:00+03:00,out,True,907182,False,3,803,818,15
167109,2019-11-07 00:00:00+03:00,out,False,909910,False,5,532,610,78
167109,2019-11-07 00:00:00+03:00,out,True,907182,True,1,0,0,0
167109,2019-11-07 00:00:00+03:00,out,True,906296,False,4,418,438,20
167109,2019-11-08 00:00:00+03:00,out,False,906294,False,2,111,131,20
167109,2019-11-08 00:00:00+03:00,out,False,907180,False,1,51,60,9
167109,2019-11-08 00:00:00+03:00,out,True,906296,False,2,27,38,11
167109,2019-11-08 00:00:00+03:00,out,False,907224,False,2,149,170,21
167109,2019-11-08 00:00:00+03:00,out,True,906294,False,1,40,42,2
167109,2019-11-08 00:00:00+03:00,out,False,909910,False,1,81,84,3
167109,2019-11-08 00:00:00+03:00,out,True,909910,True,1,0,16,16
167109,2019-11-08 00:00:00+03:00,out,True,909910,False,1,56,58,2
167109,2019-11-08 00:00:00+03:00,in,False,-1,True,1,0,15,15
167109,2019-11-08 00:00:00+03:00,out,False,906296,False,1,115,156,41
167109,2019-11-08 00:00:00+03:00,in,False,907182,False,1,25,50,25
167109,2019-11-08 00:00:00+03:00,in,False,906294,False,3,221,237,16
167109,2019-11-08 00:00:00+03:00,out,True,909910,True,1,0,16,16
167109,2019-11-08 00:00:00+03:00,out,False,907224,False,2,149,170,21
167109,2019-11-08 00:00:00+03:00,out,False,909910,False,1,81,84,3
167109,2019-11-08 00:00:00+03:00,in,False,906294,False,3,221,237,16
167109,2019-11-11 00:00:00+03:00,out,True,909910,True,2,0,30,30
167109,2019-11-11 00:00:00+03:00,out,False,909910,True,1,0,10,10
167109,2019-11-11 00:00:00+03:00,out,True,907182,True,2,0,0,0
167109,2019-11-11 00:00:00+03:00,out,True,906294,False,6,1619,1641,22
167109,2019-11-11 00:00:00+03:00,out,False,907224,True,4,0,37,37
167109,2019-11-11 00:00:00+03:00,out,True,907224,True,1,0,0,0
167109,2019-11-11 00:00:00+03:00,out,True,907182,False,5,142,179,37
167109,2019-11-11 00:00:00+03:00,out,False,909910,False,9,629,716,87
167109,2019-11-11 00:00:00+03:00,in,False,907182,False,3,680,702,22
167109,2019-11-11 00:00:00+03:00,out,True,909910,False,2,14,24,10
167109,2019-11-11 00:00:00+03:00,out,False,907224,False,8,456,520,64
167109,2019-11-11 00:00:00+03:00,in,False,906294,False,5,1524,1543,19
167109,2019-11-11 00:00:00+03:00,out,True,906296,False,4,300,309,9
167109,2019-11-11 00:00:00+03:00,out,True,906296,False,4,300,309,9
167109,2019-11-12 00:00:00+03:00,in,False,-1,True,2,0,78,78
167109,2019-11-12 00:00:00+03:00,out,False,907178,True,2,0,40,40
167109,2019-11-12 00:00:00+03:00,out,True,909910,False,1,7,14,7
167109,2019-11-12 00:00:00+03:00,out,True,907182,False,5,202,228,26
167109,2019-11-12 00:00:00+03:00,out,True,906294,False,2,233,242,9
167109,2019-11-12 00:00:00+03:00,out,True,907182,True,1,0,0,0
167109,2019-11-12 00:00:00+03:00,in,False,906294,False,3,313,329,16
167109,2019-11-12 00:00:00+03:00,out,True,907224,False,1,30,34,4
167109,2019-11-12 00:00:00+03:00,out,False,907224,False,4,636,680,44
167109,2019-11-12 00:00:00+03:00,in,False,907182,False,3,752,769,17
167109,2019-11-12 00:00:00+03:00,out,True,907178,False,1,33,40,7
167109,2019-11-12 00:00:00+03:00,out,True,906296,False,2,75,79,4
167109,2019-11-13 00:00:00+03:00,out,True,907224,False,1,27,29,2
167109,2019-11-13 00:00:00+03:00,out,True,909910,True,3,0,3,3
167109,2019-11-13 00:00:00+03:00,out,True,909910,False,4,103,114,11
167109,2019-11-13 00:00:00+03:00,in,False,907224,False,5,397,561,164
167109,2019-11-13 00:00:00+03:00,in,False,-1,True,3,0,107,107
167109,2019-11-13 00:00:00+03:00,out,True,906296,False,1,88,90,2
167109,2019-11-13 00:00:00+03:00,out,False,907224,False,1,102,113,11
167109,2019-11-13 00:00:00+03:00,out,False,907178,False,1,29,37,8
167109,2019-11-14 00:00:00+03:00,in,False,907224,False,6,486,680,194
167109,2019-11-14 00:00:00+03:00,out,False,907224,True,2,0,10,10
167109,2019-11-14 00:00:00+03:00,out,False,907224,False,5,1115,1168,53
167109,2019-11-14 00:00:00+03:00,in,False,-1,True,5,0,166,166
167109,2019-11-14 00:00:00+03:00,out,False,906296,True,7,0,130,130
167109,2019-11-14 00:00:00+03:00,out,False,906296,True,7,0,130,130
167109,2019-11-15 00:00:00+03:00,in,False,-1,True,2,0,47,47
167109,2019-11-15 00:00:00+03:00,out,True,907182,True,1,0,19,19
167109,2019-11-15 00:00:00+03:00,out,False,909910,False,4,558,577,19
167109,2019-11-15 00:00:00+03:00,out,True,906296,False,1,7,10,3
167109,2019-11-15 00:00:00+03:00,out,False,906296,False,1,46,51,5
167109,2019-11-15 00:00:00+03:00,out,False,906294,False,1,97,110,13
167109,2019-11-15 00:00:00+03:00,in,False,-1,True,1,0,39,39
167109,2019-11-15 00:00:00+03:00,in,False,906294,False,2,14,23,9
167109,2019-11-15 00:00:00+03:00,in,False,907224,False,1,55,91,36
167109,2019-11-15 00:00:00+03:00,out,False,909910,True,1,0,35,35
167109,2019-11-15 00:00:00+03:00,out,True,909910,False,4,54,77,23
167109,2019-11-15 00:00:00+03:00,in,False,906294,False,2,14,23,9
167109,2019-11-18 00:00:00+03:00,out,True,907178,False,1,37,39,2
167109,2019-11-18 00:00:00+03:00,in,False,907182,False,5,655,747,92
167109,2019-11-18 00:00:00+03:00,out,True,907182,False,5,117,151,34
167109,2019-11-18 00:00:00+03:00,out,True,907178,True,1,0,13,13
167109,2019-11-18 00:00:00+03:00,out,True,909910,False,2,25,37,12
167109,2019-11-18 00:00:00+03:00,in,False,906294,False,2,97,110,13
167109,2019-11-18 00:00:00+03:00,out,True,906296,False,2,57,77,20
167109,2019-11-18 00:00:00+03:00,out,True,907182,True,1,0,18,18
167109,2019-11-18 00:00:00+03:00,out,False,907224,False,2,84,106,22
167109,2019-11-19 00:00:00+03:00,out,False,909910,True,1,0,8,8
167109,2019-11-19 00:00:00+03:00,in,False,-1,True,1,0,40,40
167109,2019-11-19 00:00:00+03:00,out,True,909910,False,2,14,25,11
167109,2019-11-19 00:00:00+03:00,out,True,906296,True,1,0,17,17
167109,2019-11-19 00:00:00+03:00,out,True,906294,True,3,0,55,55
167109,2019-11-19 00:00:00+03:00,out,False,909910,False,3,1235,1281,46
167109,2019-11-19 00:00:00+03:00,out,False,907224,False,3,283,312,29
167109,2019-11-19 00:00:00+03:00,out,True,906294,False,1,88,101,13
167109,2019-11-19 00:00:00+03:00,out,False,906294,False,1,184,199,15
167109,2019-11-19 00:00:00+03:00,out,True,906296,False,11,377,425,48
167109,2019-11-19 00:00:00+03:00,in,False,906294,False,6,666,692,26
167109,2019-11-19 00:00:00+03:00,out,True,907182,False,3,50,63,13
167109,2019-11-19 00:00:00+03:00,out,True,907182,False,3,50,63,13
167109,2019-11-20 00:00:00+03:00,out,True,907224,False,1,16,21,5
167109,2019-11-20 00:00:00+03:00,out,True,907224,True,1,0,0,0
167109,2019-11-20 00:00:00+03:00,out,True,909910,False,2,19,28,9
167109,2019-11-20 00:00:00+03:00,out,False,906294,False,1,50,56,6
167109,2019-11-20 00:00:00+03:00,out,True,906296,False,8,348,383,35
167109,2019-11-20 00:00:00+03:00,out,False,907224,False,2,213,237,24
167109,2019-11-20 00:00:00+03:00,out,True,906294,True,2,0,13,13
167109,2019-11-20 00:00:00+03:00,in,False,907182,False,1,37,42,5
167109,2019-11-20 00:00:00+03:00,out,False,907224,True,1,0,11,11
167109,2019-11-20 00:00:00+03:00,out,False,907178,False,1,76,88,12
167109,2019-11-20 00:00:00+03:00,out,False,909910,False,1,448,461,13
167109,2019-11-20 00:00:00+03:00,out,True,907182,False,3,237,246,9
167109,2019-11-20 00:00:00+03:00,out,True,907178,False,3,81,91,10
167109,2019-11-20 00:00:00+03:00,out,True,906294,False,4,132,170,38
167109,2019-11-20 00:00:00+03:00,in,False,906294,False,12,761,819,58
167109,2019-11-20 00:00:00+03:00,out,True,906296,True,2,0,37,37
167109,2019-11-20 00:00:00+03:00,out,True,907224,True,1,0,0,0
167109,2019-11-20 00:00:00+03:00,out,True,906294,True,2,0,13,13
167109,2019-11-20 00:00:00+03:00,out,True,907182,False,3,237,246,9
167109,2019-11-21 00:00:00+03:00,out,True,906296,True,2,0,56,56
167109,2019-11-21 00:00:00+03:00,out,False,906294,False,1,100,119,19
167109,2019-11-21 00:00:00+03:00,in,False,907224,False,1,37,69,32
167109,2019-11-21 00:00:00+03:00,out,False,907224,False,4,514,553,39
167109,2019-11-21 00:00:00+03:00,in,False,-1,True,1,0,34,34
167109,2019-11-21 00:00:00+03:00,in,False,906294,False,5,459,480,21
167109,2019-11-21 00:00:00+03:00,in,False,907182,False,1,2192,2196,4
167109,2019-11-21 00:00:00+03:00,out,True,907182,False,4,109,127,18
167109,2019-11-21 00:00:00+03:00,out,True,906296,False,6,218,246,28
167109,2019-11-21 00:00:00+03:00,out,True,909910,False,1,10,16,6
167109,2019-11-21 00:00:00+03:00,out,True,907182,False,4,109,127,18
167109,2019-11-21 00:00:00+03:00,out,False,906294,False,1,100,119,19
167109,2019-11-22 00:00:00+03:00,out,False,906296,False,1,32,47,15
167109,2019-11-22 00:00:00+03:00,in,False,906294,False,5,446,467,21
167109,2019-11-22 00:00:00+03:00,out,False,907224,False,2,312,337,25
167109,2019-11-22 00:00:00+03:00,out,True,907178,False,1,28,37,9
167109,2019-11-22 00:00:00+03:00,out,False,906294,False,1,13,26,13
167109,2019-11-22 00:00:00+03:00,in,False,-1,True,1,0,27,27
167109,2019-11-22 00:00:00+03:00,out,True,909910,True,1,0,13,13
167109,2019-11-22 00:00:00+03:00,out,False,909910,False,3,250,296,46
167109,2019-11-22 00:00:00+03:00,out,True,907182,True,1,0,44,44
167109,2019-11-22 00:00:00+03:00,out,True,907182,False,2,31,45,14
167109,2019-11-22 00:00:00+03:00,in,False,907182,False,2,1859,1871,12
167109,2019-11-22 00:00:00+03:00,out,True,906294,False,1,96,102,6
167109,2019-11-22 00:00:00+03:00,out,False,907180,False,1,81,85,4
167109,2019-11-22 00:00:00+03:00,out,True,906296,False,3,476,486,10
167109,2019-11-22 00:00:00+03:00,out,True,909910,True,1,0,13,13
167109,2019-11-22 00:00:00+03:00,out,False,906296,False,1,32,47,15
167109,2019-11-25 00:00:00+03:00,out,False,907224,True,1,0,1,1
167109,2019-11-25 00:00:00+03:00,out,True,909910,False,1,2,8,6
167109,2019-11-25 00:00:00+03:00,in,False,906294,False,2,113,127,14
167109,2019-11-25 00:00:00+03:00,out,False,907224,False,5,407,440,33
167109,2019-11-25 00:00:00+03:00,out,True,909910,True,1,0,16,16
167109,2019-11-25 00:00:00+03:00,out,True,906296,False,1,5,8,3
167109,2019-11-25 00:00:00+03:00,out,False,906294,False,1,1016,1032,16
167109,2019-11-25 00:00:00+03:00,out,True,906294,False,1,95,99,4
167109,2019-11-25 00:00:00+03:00,out,False,909910,False,1,253,261,8
167109,2019-11-25 00:00:00+03:00,out,True,907182,False,5,69,88,19
167109,2019-11-25 00:00:00+03:00,out,True,906296,False,1,5,8,3
167109,2019-11-25 00:00:00+03:00,out,True,907182,False,5,69,88,19
167109,2019-11-25 00:00:00+03:00,out,False,907224,False,5,407,440,33
167109,2019-11-25 00:00:00+03:00,out,False,909910,False,1,253,261,8
167109,2019-11-26 00:00:00+03:00,out,False,909910,False,2,198,209,11
167109,2019-11-26 00:00:00+03:00,in,False,-1,True,3,0,117,117
167109,2019-11-26 00:00:00+03:00,out,True,907224,False,2,45,49,4
167109,2019-11-26 00:00:00+03:00,out,True,907182,False,3,95,104,9
167109,2019-11-26 00:00:00+03:00,in,False,907182,False,2,154,168,14
167109,2019-11-26 00:00:00+03:00,out,True,906294,False,5,466,489,23
167109,2019-11-26 00:00:00+03:00,in,False,906294,False,6,652,671,19
167109,2019-11-26 00:00:00+03:00,out,True,906296,True,1,0,6,6
167109,2019-11-26 00:00:00+03:00,out,False,906294,True,2,0,52,52
167109,2019-11-26 00:00:00+03:00,out,False,907224,False,4,94,176,82
167109,2019-11-26 00:00:00+03:00,out,False,906294,False,1,106,113,7
167109,2019-11-26 00:00:00+03:00,out,False,907224,True,4,0,28,28
167109,2019-11-26 00:00:00+03:00,out,True,906296,True,1,0,6,6
167109,2019-11-26 00:00:00+03:00,out,False,906294,True,2,0,52,52
167109,2019-11-27 00:00:00+03:00,out,False,907224,False,2,454,478,24
167109,2019-11-27 00:00:00+03:00,out,True,906294,True,3,0,0,0
167109,2019-11-27 00:00:00+03:00,out,True,909910,False,2,26,34,8
167109,2019-11-27 00:00:00+03:00,out,False,909910,False,6,1327,1371,44
167109,2019-11-27 00:00:00+03:00,in,False,-1,True,1,0,15,15
167109,2019-11-27 00:00:00+03:00,out,True,906294,False,1,288,294,6
167109,2019-11-27 00:00:00+03:00,in,False,907182,False,1,125,135,10
167109,2019-11-27 00:00:00+03:00,out,False,907178,True,11,0,139,139
167109,2019-11-27 00:00:00+03:00,in,False,906294,False,7,926,957,31
167109,2019-11-27 00:00:00+03:00,out,False,906296,False,1,68,77,9
167109,2019-11-27 00:00:00+03:00,out,False,906294,False,3,147,191,44
167109,2019-11-27 00:00:00+03:00,out,False,907178,False,3,89,141,52
167109,2019-11-27 00:00:00+03:00,out,True,909910,True,1,0,17,17
167109,2019-11-27 00:00:00+03:00,out,True,906296,False,3,94,110,16
167109,2019-11-27 00:00:00+03:00,out,True,907182,False,3,69,83,14
167109,2019-11-27 00:00:00+03:00,in,False,907182,False,1,125,135,10
167109,2019-11-27 00:00:00+03:00,out,True,909910,True,1,0,17,17
167109,2019-11-28 00:00:00+03:00,in,False,907182,False,1,998,1007,9
167109,2019-11-28 00:00:00+03:00,out,True,906294,False,3,808,818,10
167109,2019-11-28 00:00:00+03:00,out,True,907224,False,1,12,16,4
167109,2019-11-28 00:00:00+03:00,in,False,906294,False,7,986,1021,35
167109,2019-11-28 00:00:00+03:00,out,True,906296,True,1,0,23,23
167109,2019-11-28 00:00:00+03:00,out,True,909910,False,1,8,14,6
167109,2019-11-28 00:00:00+03:00,out,True,906296,False,5,232,255,23
167109,2019-11-28 00:00:00+03:00,out,True,906294,True,1,0,34,34
167109,2019-11-28 00:00:00+03:00,out,False,909910,False,4,2995,3058,63
167109,2019-11-28 00:00:00+03:00,out,False,909910,True,1,0,5,5
167109,2019-11-28 00:00:00+03:00,out,False,907224,False,2,953,974,21
167109,2019-11-28 00:00:00+03:00,out,True,909910,True,2,0,30,30
167109,2019-11-28 00:00:00+03:00,out,False,907180,False,1,41,56,15
167109,2019-11-28 00:00:00+03:00,out,False,906294,False,1,119,132,13
167109,2019-11-28 00:00:00+03:00,in,False,907182,False,1,998,1007,9
167110,2019-09-10 00:00:00+03:00,in,False,-1,True,3,0,6,6
167110,2019-09-10 00:00:00+03:00,out,False,907998,False,2,23,49,26
167110,2019-09-10 00:00:00+03:00,out,False,908002,False,1,8,23,15
167110,2019-09-11 00:00:00+03:00,in,False,-1,True,1,0,4,4
167110,2019-09-11 00:00:00+03:00,in,False,-1,True,1,0,1,1
167110,2019-09-12 00:00:00+03:00,out,False,908002,True,1,0,12,12
167110,2019-09-12 00:00:00+03:00,in,False,908002,False,2,27,68,41
167110,2019-09-12 00:00:00+03:00,in,False,-1,True,1,0,27,27
167110,2019-09-12 00:00:00+03:00,out,False,908002,False,1,22,35,13
167110,2019-09-12 00:00:00+03:00,in,False,908002,False,2,27,68,41
167110,2019-09-16 00:00:00+03:00,out,False,908002,False,1,14,25,11
167110,2019-09-16 00:00:00+03:00,out,False,908002,True,4,0,89,89
167110,2019-09-18 00:00:00+03:00,out,False,908002,True,2,0,53,53
167110,2019-09-18 00:00:00+03:00,out,False,908002,False,2,186,213,27
167110,2019-09-19 00:00:00+03:00,in,False,908002,False,2,18,48,30
167110,2019-09-19 00:00:00+03:00,in,False,-1,True,1,0,5,5
167110,2019-09-19 00:00:00+03:00,out,False,908002,False,2,12,14,2
167110,2019-09-19 00:00:00+03:00,in,False,-1,True,3,0,56,56
167110,2019-09-20 00:00:00+03:00,in,False,-1,True,2,0,29,29
167110,2019-09-20 00:00:00+03:00,in,False,-1,True,1,0,4,4
167110,2019-09-23 00:00:00+03:00,in,False,-1,True,1,0,12,12
167110,2019-09-23 00:00:00+03:00,in,False,908002,False,1,8,26,18
167110,2019-09-23 00:00:00+03:00,in,False,-1,True,4,0,96,96
167110,2019-09-23 00:00:00+03:00,in,False,-1,True,1,0,12,12
167110,2019-09-30 00:00:00+03:00,in,False,-1,True,1,0,3,3
167110,2019-10-04 00:00:00+03:00,out,False,908002,True,1,0,60,60
167110,2019-10-11 00:00:00+03:00,in,False,-1,True,2,0,8,8
167110,2019-10-11 00:00:00+03:00,in,False,-1,True,3,0,31,31
167110,2019-10-15 00:00:00+03:00,in,False,-1,True,2,0,54,54
167110,2019-10-15 00:00:00+03:00,in,False,908002,False,1,11,21,10
167110,2019-10-15 00:00:00+03:00,out,False,908002,False,1,2,3,1
167110,2019-10-16 00:00:00+03:00,in,False,-1,True,1,0,4,4
167110,2019-10-16 00:00:00+03:00,in,False,-1,True,1,0,1,1
167110,2019-11-07 00:00:00+03:00,in,False,-1,True,2,0,4,4
167110,2019-11-07 00:00:00+03:00,in,False,-1,True,2,0,10,10
167110,2019-11-08 00:00:00+03:00,in,False,-1,True,2,0,9,9
167110,2019-11-08 00:00:00+03:00,in,False,-1,True,2,0,2,2
167110,2019-11-08 00:00:00+03:00,in,False,-1,True,2,0,2,2
167110,2019-11-12 00:00:00+03:00,in,False,-1,True,1,0,1,1
167110,2019-11-12 00:00:00+03:00,in,False,-1,True,1,0,4,4
167110,2019-11-12 00:00:00+03:00,in,False,-1,True,1,0,1,1
167110,2019-11-14 00:00:00+03:00,in,False,-1,True,6,0,8,8
167112,2019-09-04 00:00:00+03:00,out,False,904016,False,2,261,280,19
167112,2019-09-04 00:00:00+03:00,in,False,904016,False,1,19,24,5
167112,2019-09-04 00:00:00+03:00,out,False,904016,True,3,0,87,87
167112,2019-09-05 00:00:00+03:00,out,False,904016,False,24,1128,1547,419
167112,2019-09-05 00:00:00+03:00,in,False,904016,False,3,115,130,15
167112,2019-09-05 00:00:00+03:00,out,False,904016,True,27,0,1006,1006
167112,2019-09-05 00:00:00+03:00,in,False,-1,True,5,0,67,67
167112,2019-09-06 00:00:00+03:00,out,False,904014,False,3,80,177,97
167112,2019-09-06 00:00:00+03:00,out,False,904016,False,36,1886,2490,604
167112,2019-09-06 00:00:00+03:00,out,False,904016,True,25,0,552,552
167112,2019-09-06 00:00:00+03:00,in,False,-1,True,3,0,70,70
167112,2019-09-06 00:00:00+03:00,in,False,904014,False,1,25,38,13
167112,2019-09-10 00:00:00+03:00,out,False,904014,True,36,0,837,837
167112,2019-09-10 00:00:00+03:00,in,False,-1,True,5,0,90,90
167112,2019-09-10 00:00:00+03:00,in,False,904014,False,2,20,28,8
167112,2019-09-10 00:00:00+03:00,out,False,904014,False,73,3856,4839,983
167112,2019-09-10 00:00:00+03:00,out,False,904016,False,90,3570,5013,1443
167112,2019-09-10 00:00:00+03:00,in,False,904016,True,1,0,21,21
167112,2019-09-10 00:00:00+03:00,in,False,904016,False,1,2,27,25
167112,2019-09-10 00:00:00+03:00,out,False,904016,True,65,0,1432,1432
167112,2019-09-11 00:00:00+03:00,out,False,904016,False,52,1579,2384,805
167112,2019-09-11 00:00:00+03:00,out,False,904016,True,35,0,936,936
167112,2019-09-11 00:00:00+03:00,in,False,-1,True,6,0,118,118
167112,2019-09-12 00:00:00+03:00,in,False,-1,True,9,0,110,110
167112,2019-09-12 00:00:00+03:00,in,False,904014,False,5,168,247,79
167112,2019-09-12 00:00:00+03:00,out,False,904014,False,57,2657,3540,883
167112,2019-09-12 00:00:00+03:00,in,False,904016,False,1,81,96,15
167112,2019-09-12 00:00:00+03:00,out,False,904014,True,37,0,781,781
167112,2019-09-12 00:00:00+03:00,out,False,904016,False,106,4540,6221,1681
167112,2019-09-12 00:00:00+03:00,out,False,904016,True,87,0,2049,2049
167112,2019-09-12 00:00:00+03:00,in,False,904014,False,5,168,247,79
167112,2019-09-12 00:00:00+03:00,out,False,904014,False,57,2657,3540,883
167112,2019-09-12 00:00:00+03:00,out,False,904016,False,106,4540,6221,1681
167112,2019-09-13 00:00:00+03:00,out,False,904016,False,120,5186,7266,2080
167112,2019-09-13 00:00:00+03:00,in,False,904014,False,3,47,90,43
167112,2019-09-13 00:00:00+03:00,out,False,904016,True,93,0,2504,2504
167112,2019-09-13 00:00:00+03:00,out,False,904014,False,47,2403,3138,735
167112,2019-09-13 00:00:00+03:00,out,False,904014,True,29,0,692,692
167112,2019-09-13 00:00:00+03:00,in,False,-1,True,18,0,226,226
167112,2019-09-13 00:00:00+03:00,in,False,904016,False,4,69,126,57
167112,2019-09-14 00:00:00+03:00,out,False,904016,True,1,0,10,10
167112,2019-09-16 00:00:00+03:00,out,False,904016,False,58,2306,3120,814
167112,2019-09-16 00:00:00+03:00,out,False,904016,True,35,0,1087,1087
167112,2019-09-16 00:00:00+03:00,out,False,904014,True,10,0,184,184
167112,2019-09-16 00:00:00+03:00,in,False,904014,False,3,150,180,30
167112,2019-09-16 00:00:00+03:00,out,False,904014,False,27,2845,3245,400
167112,2019-09-16 00:00:00+03:00,in,False,904016,False,2,47,76,29
167112,2019-09-16 00:00:00+03:00,in,False,-1,True,17,0,539,539
167112,2019-09-16 00:00:00+03:00,in,False,-1,True,17,0,539,539
167112,2019-09-17 00:00:00+03:00,in,False,904014,False,6,206,278,72
167112,2019-09-17 00:00:00+03:00,in,False,-1,True,12,0,122,122
167112,2019-09-17 00:00:00+03:00,in,False,904016,False,5,206,325,119
167112,2019-09-17 00:00:00+03:00,out,False,904016,True,76,0,1977,1977
167112,2019-09-17 00:00:00+03:00,out,False,904016,False,112,5151,6769,1618
167112,2019-09-17 00:00:00+03:00,out,False,904014,False,73,3944,4944,1000
167112,2019-09-17 00:00:00+03:00,out,False,904014,True,37,0,667,667
167112,2019-09-17 00:00:00+03:00,out,False,904014,False,73,3944,4944,1000
167112,2019-09-17 00:00:00+03:00,in,False,904016,False,5,206,325,119
167112,2019-09-18 00:00:00+03:00,out,False,904016,False,106,4850,6451,1601
167112,2019-09-18 00:00:00+03:00,in,False,-1,True,12,0,88,88
167112,2019-09-18 00:00:00+03:00,out,False,904014,True,44,0,1054,1054
167112,2019-09-18 00:00:00+03:00,in,False,904014,False,7,379,468,89
167112,2019-09-18 00:00:00+03:00,out,False,904014,False,64,3837,4705,868
167112,2019-09-18 00:00:00+03:00,out,False,904016,True,74,0,2024,2024
167112,2019-09-18 00:00:00+03:00,in,False,904016,False,3,113,178,65
167112,2019-09-18 00:00:00+03:00,out,False,904016,True,74,0,2024,2024
167112,2019-09-18 00:00:00+03:00,out,False,904014,True,44,0,1054,1054
167112,2019-09-18 00:00:00+03:00,out,False,904016,False,106,4850,6451,1601
167112,2019-09-19 00:00:00+03:00,out,False,904016,True,67,0,1942,1942
167112,2019-09-19 00:00:00+03:00,in,False,904014,False,4,98,146,48
167112,2019-09-19 00:00:00+03:00,in,False,904016,False,1,15,24,9
167112,2019-09-19 00:00:00+03:00,out,False,904016,False,87,4683,6131,1448
167112,2019-09-19 00:00:00+03:00,out,False,904014,False,49,2502,3145,643
167112,2019-09-19 00:00:00+03:00,out,False,904014,True,30,0,563,563
167112,2019-09-19 00:00:00+03:00,in,False,-1,True,10,0,139,139
167112,2019-09-20 00:00:00+03:00,out,False,904014,True,1,0,16,16
167112,2019-09-20 00:00:00+03:00,out,False,904014,False,2,97,123,26
167112,2019-09-20 00:00:00+03:00,out,False,904016,False,26,708,1107,399
167112,2019-09-20 00:00:00+03:00,out,False,904016,True,27,0,413,413
167112,2019-09-20 00:00:00+03:00,in,False,-1,True,1,0,17,17
167112,2019-09-20 00:00:00+03:00,out,False,904014,True,1,0,16,16
167112,2019-09-20 00:00:00+03:00,out,False,904014,False,2,97,123,26
167112,2019-09-21 00:00:00+03:00,in,False,-1,True,1,0,14,14
167112,2019-09-23 00:00:00+03:00,in,False,904014,False,3,195,226,31
167112,2019-09-23 00:00:00+03:00,out,False,904016,False,73,4910,6112,1202
167112,2019-09-23 00:00:00+03:00,in,False,-1,True,9,0,174,174
167112,2019-09-23 00:00:00+03:00,out,False,904014,False,32,2641,3090,449
167112,2019-09-23 00:00:00+03:00,out,False,904016,True,63,0,1197,1197
167112,2019-09-23 00:00:00+03:00,out,False,904014,True,35,0,722,722
167112,2019-09-24 00:00:00+03:00,out,False,904016,False,65,3628,4712,1084
167112,2019-09-24 00:00:00+03:00,in,False,-1,True,5,0,120,120
167112,2019-09-24 00:00:00+03:00,out,False,904014,True,28,0,634,634
167112,2019-09-24 00:00:00+03:00,in,False,904014,False,2,443,476,33
167112,2019-09-24 00:00:00+03:00,out,False,904016,True,68,0,1406,1406
167112,2019-09-24 00:00:00+03:00,out,False,904014,False,26,2696,3100,404
167112,2019-09-24 00:00:00+03:00,out,False,904016,False,65,3628,4712,1084
167112,2019-09-24 00:00:00+03:00,in,False,-1,True,5,0,120,120
167112,2019-09-25 00:00:00+03:00,in,False,-1,True,10,0,163,163
167112,2019-09-25 00:00:00+03:00,out,False,904016,False,69,3895,5058,1163
167112,2019-09-25 00:00:00+03:00,out,False,904014,False,20,835,1127,292
167112,2019-09-25 00:00:00+03:00,out,False,904016,True,54,0,932,932
167112,2019-09-25 00:00:00+03:00,out,False,904014,True,6,0,82,82
167112,2019-09-25 00:00:00+03:00,in,False,904016,False,1,27,42,15
167112,2019-09-26 00:00:00+03:00,out,False,904014,False,12,1387,1592,205
167112,2019-09-26 00:00:00+03:00,out,True,904016,True,1,0,0,0
167112,2019-09-26 00:00:00+03:00,out,False,904014,True,17,0,206,206
167112,2019-09-26 00:00:00+03:00,out,False,904016,True,57,0,1399,1399
167112,2019-09-26 00:00:00+03:00,in,False,-1,True,3,0,52,52
167112,2019-09-26 00:00:00+03:00,out,False,904016,False,39,3739,4384,645
167112,2019-09-26 00:00:00+03:00,out,False,904016,True,57,0,1399,1399
167112,2019-09-26 00:00:00+03:00,in,False,-1,True,3,0,52,52
167112,2019-09-27 00:00:00+03:00,out,False,904016,True,15,0,444,444
167112,2019-09-27 00:00:00+03:00,in,False,-1,True,2,0,44,44
167112,2019-09-27 00:00:00+03:00,out,False,904016,False,6,378,496,118
167112,2019-09-30 00:00:00+03:00,in,False,-1,True,4,0,25,25
167112,2019-09-30 00:00:00+03:00,out,False,904016,True,80,0,1420,1420
167112,2019-09-30 00:00:00+03:00,in,False,904014,False,3,274,304,30
167112,2019-09-30 00:00:00+03:00,out,False,904014,True,21,0,237,237
167112,2019-09-30 00:00:00+03:00,in,False,904016,False,1,163,182,19
167112,2019-09-30 00:00:00+03:00,out,False,904014,False,24,1401,1740,339
167112,2019-09-30 00:00:00+03:00,out,False,904016,False,61,3073,3997,924
167112,2019-10-01 00:00:00+03:00,out,False,904016,True,73,0,1511,1511
167112,2019-10-01 00:00:00+03:00,out,False,904016,False,66,3672,4646,974
167112,2019-10-01 00:00:00+03:00,out,False,904014,True,49,0,828,828
167112,2019-10-01 00:00:00+03:00,out,False,904014,False,32,1639,2117,478
167112,2019-10-01 00:00:00+03:00,in,False,-1,True,2,0,3,3
167112,2019-10-02 00:00:00+03:00,out,False,904016,True,127,0,2032,2032
167112,2019-10-02 00:00:00+03:00,in,False,904014,False,1,229,244,15
167112,2019-10-02 00:00:00+03:00,out,False,904016,False,79,3467,4663,1196
167112,2019-10-02 00:00:00+03:00,out,False,904014,False,41,6602,7392,790
167112,2019-10-02 00:00:00+03:00,in,False,-1,True,10,0,140,140
167112,2019-10-02 00:00:00+03:00,in,False,904016,False,2,43,90,47
167112,2019-10-02 00:00:00+03:00,out,False,904014,True,27,0,588,588
167112,2019-10-02 00:00:00+03:00,out,True,904016,True,2,0,5,5
167112,2019-10-03 00:00:00+03:00,out,False,904014,True,4,0,120,120
167112,2019-10-03 00:00:00+03:00,out,False,904014,False,9,4304,4478,174
167112,2019-10-04 00:00:00+03:00,out,False,904014,False,16,2432,2730,298
167112,2019-10-04 00:00:00+03:00,out,False,904014,True,17,0,489,489
167112,2019-10-04 00:00:00+03:00,out,False,904016,False,1,33,40,7
167112,2019-10-04 00:00:00+03:00,out,False,904016,True,1,0,9,9
167112,2019-10-07 00:00:00+03:00,in,False,904014,False,1,48,63,15
167112,2019-10-07 00:00:00+03:00,out,False,904014,False,5,806,908,102
167112,2019-10-07 00:00:00+03:00,out,False,904016,True,46,0,1198,1198
167112,2019-10-07 00:00:00+03:00,out,False,904016,False,69,4532,5659,1127
167112,2019-10-07 00:00:00+03:00,out,False,904014,True,1,0,7,7
167112,2019-10-07 00:00:00+03:00,in,False,-1,True,10,0,212,212
167112,2019-10-08 00:00:00+03:00,out,False,904014,True,8,0,171,171
167112,2019-10-08 00:00:00+03:00,in,False,-1,True,9,0,139,139
167112,2019-10-08 00:00:00+03:00,out,False,904014,False,14,3953,4166,213
167112,2019-10-08 00:00:00+03:00,out,False,904016,True,85,0,1938,1938
167112,2019-10-08 00:00:00+03:00,out,False,904016,False,78,5017,6089,1072
167112,2019-10-09 00:00:00+03:00,out,False,904014,False,14,968,1254,286
167112,2019-10-09 00:00:00+03:00,out,False,904016,False,60,2992,3855,863
167112,2019-10-09 00:00:00+03:00,out,False,904016,True,96,0,1824,1824
167112,2019-10-09 00:00:00+03:00,in,False,904016,True,1,0,30,30
167112,2019-10-09 00:00:00+03:00,in,False,904016,False,2,95,109,14
167112,2019-10-09 00:00:00+03:00,in,False,-1,True,10,0,138,138
167112,2019-10-09 00:00:00+03:00,out,False,904014,True,28,0,335,335
167112,2019-10-10 00:00:00+03:00,in,False,-1,True,7,0,67,67
167112,2019-10-10 00:00:00+03:00,out,False,904016,True,107,0,1813,1813
167112,2019-10-10 00:00:00+03:00,out,False,933452,False,1,17,25,8
167112,2019-10-10 00:00:00+03:00,out,False,904016,False,74,2682,3779,1097
167112,2019-10-10 00:00:00+03:00,in,False,904016,False,2,36,75,39
167112,2019-10-10 00:00:00+03:00,out,False,904014,False,3,542,603,61
167112,2019-10-10 00:00:00+03:00,out,False,933452,True,1,0,8,8
167112,2019-10-10 00:00:00+03:00,out,False,904014,False,3,542,603,61
167112,2019-10-11 00:00:00+03:00,out,False,904016,True,60,0,1168,1168
167112,2019-10-11 00:00:00+03:00,out,False,904016,False,44,1708,2353,645
167112,2019-10-11 00:00:00+03:00,in,False,-1,True,6,0,103,103
167112,2019-10-11 00:00:00+03:00,in,False,904016,False,1,10,43,33
167112,2019-10-11 00:00:00+03:00,out,False,904014,True,6,0,22,22
167112,2019-10-11 00:00:00+03:00,out,False,904014,False,1,31,39,8
167112,2019-10-12 00:00:00+03:00,out,False,933452,True,1,0,9,9
167112,2019-10-14 00:00:00+03:00,in,False,-1,True,2,0,47,47
167112,2019-10-14 00:00:00+03:00,out,False,904014,False,7,655,762,107
167112,2019-10-14 00:00:00+03:00,in,False,904016,False,2,188,228,40
167112,2019-10-14 00:00:00+03:00,out,False,904016,True,67,0,1010,1010
167112,2019-10-14 00:00:00+03:00,out,False,904016,False,35,1028,1599,571
167112,2019-10-14 00:00:00+03:00,out,False,904014,True,3,0,68,68
167112,2019-10-15 00:00:00+03:00,in,False,-1,True,3,0,101,101
167112,2019-10-15 00:00:00+03:00,out,False,904016,True,38,0,993,993
167112,2019-10-15 00:00:00+03:00,out,False,904016,False,53,2869,3663,794
167112,2019-10-16 00:00:00+03:00,out,False,904016,False,27,3932,4366,434
167112,2019-10-16 00:00:00+03:00,in,False,-1,True,6,0,109,109
167112,2019-10-16 00:00:00+03:00,out,False,904016,True,19,0,423,423
167112,2019-10-17 00:00:00+03:00,in,False,-1,True,4,0,56,56
167112,2019-10-17 00:00:00+03:00,out,False,904016,False,4,431,492,61
167112,2019-10-17 00:00:00+03:00,out,False,904016,True,13,0,282,282
167112,2019-10-18 00:00:00+03:00,out,False,904016,False,35,3711,4342,631
167112,2019-10-18 00:00:00+03:00,in,False,-1,True,4,0,90,90
167112,2019-10-18 00:00:00+03:00,out,False,904016,True,38,0,696,696
167112,2019-10-19 00:00:00+03:00,in,False,-1,True,1,0,0,0
167112,2019-10-20 00:00:00+03:00,out,False,933452,True,1,0,9,9
167112,2019-10-21 00:00:00+03:00,out,False,904014,True,9,0,128,128
167112,2019-10-21 00:00:00+03:00,out,False,904014,False,4,313,404,91
167112,2019-10-21 00:00:00+03:00,in,False,-1,True,2,0,32,32
167112,2019-10-21 00:00:00+03:00,out,False,904016,False,29,2224,2668,444
167112,2019-10-21 00:00:00+03:00,out,True,904014,True,1,0,0,0
167112,2019-10-21 00:00:00+03:00,out,False,904016,True,31,0,654,654
167112,2019-10-22 00:00:00+03:00,in,False,-1,True,13,0,163,163
167112,2019-10-22 00:00:00+03:00,in,False,904016,False,4,968,1079,111
167112,2019-10-22 00:00:00+03:00,out,False,942174,False,2,456,474,18
167112,2019-10-22 00:00:00+03:00,out,False,904016,True,87,0,1581,1581
167112,2019-10-22 00:00:00+03:00,out,False,942174,True,3,0,44,44
167112,2019-10-22 00:00:00+03:00,out,True,904016,True,1,0,0,0
167112,2019-10-22 00:00:00+03:00,out,False,904016,False,96,4294,5533,1239
167112,2019-10-23 00:00:00+03:00,out,False,904016,False,80,4998,6242,1244
167112,2019-10-23 00:00:00+03:00,out,False,904016,True,102,0,2583,2583
167112,2019-10-23 00:00:00+03:00,out,False,942174,False,1,8,27,19
167112,2019-10-23 00:00:00+03:00,in,False,904016,False,4,100,171,71
167112,2019-10-23 00:00:00+03:00,out,False,-1,True,1,0,36,36
167112,2019-10-23 00:00:00+03:00,in,False,-1,True,9,0,89,89
167112,2019-10-24 00:00:00+03:00,in,False,904016,False,1,127,152,25
167112,2019-10-24 00:00:00+03:00,out,False,904016,False,54,4583,5399,816
167112,2019-10-24 00:00:00+03:00,out,False,904016,True,54,0,1646,1646
167112,2019-10-24 00:00:00+03:00,in,False,-1,True,6,0,130,130
167112,2019-10-25 00:00:00+03:00,out,False,904016,False,20,2565,2973,408
167112,2019-10-25 00:00:00+03:00,in,False,-1,True,3,0,23,23
167112,2019-10-25 00:00:00+03:00,out,False,904016,True,38,0,1179,1179
167112,2019-10-28 00:00:00+03:00,in,False,904016,False,1,458,488,30
167112,2019-10-28 00:00:00+03:00,in,False,-1,True,4,0,22,22
167112,2019-10-28 00:00:00+03:00,out,False,904016,True,101,0,3210,3210
167112,2019-10-28 00:00:00+03:00,out,False,904016,False,82,7096,8389,1293
167112,2019-10-29 00:00:00+03:00,out,False,904016,False,53,4669,5585,916
167112,2019-10-29 00:00:00+03:00,out,False,904016,True,61,0,1334,1334
167112,2019-10-29 00:00:00+03:00,in,False,-1,True,4,0,10,10
167112,2019-10-29 00:00:00+03:00,in,False,-1,True,4,0,10,10
167112,2019-10-30 00:00:00+03:00,out,False,904016,True,19,0,569,569
167112,2019-10-30 00:00:00+03:00,in,False,904016,False,2,482,528,46
167112,2019-10-30 00:00:00+03:00,out,False,904016,False,11,1695,1943,248
167112,2019-10-30 00:00:00+03:00,in,False,-1,True,4,0,42,42
167112,2019-10-30 00:00:00+03:00,in,False,-1,True,4,0,42,42
167112,2019-10-31 00:00:00+03:00,in,False,-1,True,2,0,44,44
167112,2019-10-31 00:00:00+03:00,out,False,951648,False,25,1842,2255,413
167112,2019-10-31 00:00:00+03:00,out,False,904016,True,30,0,769,769
167112,2019-10-31 00:00:00+03:00,out,False,904016,False,25,2028,2527,499
167112,2019-10-31 00:00:00+03:00,out,False,951648,True,42,0,626,626
167112,2019-10-31 00:00:00+03:00,out,False,904014,False,18,991,1361,370
167112,2019-10-31 00:00:00+03:00,out,False,904014,True,14,0,380,380
167112,2019-10-31 00:00:00+03:00,in,False,-1,True,2,0,44,44
167112,2019-10-31 00:00:00+03:00,out,False,904016,True,30,0,769,769
167112,2019-11-01 00:00:00+03:00,out,False,951648,False,52,2884,3835,951
167112,2019-11-01 00:00:00+03:00,out,False,904016,False,37,1275,1852,577
167112,2019-11-01 00:00:00+03:00,out,False,904016,True,49,0,797,797
167112,2019-11-01 00:00:00+03:00,in,False,-1,True,4,0,95,95
167112,2019-11-01 00:00:00+03:00,in,False,904016,False,1,53,57,4
167112,2019-11-01 00:00:00+03:00,out,False,951648,True,42,0,925,925
167112,2019-11-01 00:00:00+03:00,out,True,904016,True,1,0,0,0
167112,2019-11-02 00:00:00+03:00,out,False,904016,True,1,0,7,7
167112,2019-11-02 00:00:00+03:00,out,False,904016,True,1,0,7,7
167112,2019-11-04 00:00:00+03:00,in,False,-1,True,4,0,6,6
167112,2019-11-05 00:00:00+03:00,in,False,-1,True,8,0,141,141
167112,2019-11-05 00:00:00+03:00,out,False,951650,False,5,113,164,51
167112,2019-11-05 00:00:00+03:00,out,False,904014,False,45,1899,2519,620
167112,2019-11-05 00:00:00+03:00,out,True,904014,True,1,0,0,0
167112,2019-11-05 00:00:00+03:00,in,False,904016,False,2,52,86,34
167112,2019-11-05 00:00:00+03:00,out,False,904014,True,31,0,551,551
167112,2019-11-05 00:00:00+03:00,out,False,951650,True,4,0,100,100
167112,2019-11-05 00:00:00+03:00,out,False,904016,True,47,0,847,847
167112,2019-11-05 00:00:00+03:00,out,False,904016,False,64,3139,4100,961
167112,2019-11-06 00:00:00+03:00,in,False,904016,False,1,832,840,8
167112,2019-11-06 00:00:00+03:00,in,False,-1,True,5,0,151,151
167112,2019-11-06 00:00:00+03:00,out,False,904016,True,2,0,29,29
167112,2019-11-06 00:00:00+03:00,out,False,904016,False,2,18,36,18
167112,2019-11-07 00:00:00+03:00,in,False,951650,False,1,57,102,45
167112,2019-11-07 00:00:00+03:00,in,False,951650,False,1,57,102,45
167112,2019-11-08 00:00:00+03:00,out,False,904016,True,8,0,235,235
167112,2019-11-08 00:00:00+03:00,out,False,904016,False,14,2668,2892,224
167112,2019-11-13 00:00:00+03:00,in,False,-1,True,1,0,36,36
167112,2019-11-14 00:00:00+03:00,out,False,951650,True,1,0,11,11
167112,2019-11-18 00:00:00+03:00,out,False,904014,False,1,227,241,14
167112,2019-11-18 00:00:00+03:00,in,False,-1,True,1,0,40,40
167112,2019-11-20 00:00:00+03:00,in,False,-1,True,1,0,41,41
167112,2019-11-26 00:00:00+03:00,in,False,-1,True,3,0,6,6
167112,2019-11-26 00:00:00+03:00,in,False,-1,True,3,0,6,6
167112,2019-11-27 00:00:00+03:00,in,False,-1,True,1,0,2,2
167113,2019-09-03 00:00:00+03:00,in,False,-1,True,2,0,16,16
167113,2019-09-03 00:00:00+03:00,out,False,902238,True,1,0,5,5
167113,2019-09-03 00:00:00+03:00,in,False,902238,False,1,21,29,8
167114,2019-10-21 00:00:00+03:00,in,False,-1,True,4,0,4,4
167114,2019-11-19 00:00:00+03:00,in,False,-1,True,1,0,1,1
167122,2019-09-11 00:00:00+03:00,in,False,-1,True,10,0,20,20
167122,2019-09-19 00:00:00+03:00,out,False,909308,True,4,0,80,80
167122,2019-09-19 00:00:00+03:00,in,False,-1,True,8,0,2,2
167122,2019-09-20 00:00:00+03:00,out,False,909308,True,9,0,230,230
167122,2019-09-20 00:00:00+03:00,in,False,-1,True,93,0,8,8
167122,2019-09-21 00:00:00+03:00,in,False,-1,True,68,0,1,1
167122,2019-09-22 00:00:00+03:00,in,False,-1,True,55,0,1,1
167122,2019-09-23 00:00:00+03:00,out,False,909308,True,2,0,39,39
167122,2019-09-23 00:00:00+03:00,in,False,-1,True,118,0,6,6
167122,2019-09-24 00:00:00+03:00,in,False,-1,True,98,0,190,190
167124,2019-09-12 00:00:00+03:00,out,False,901992,False,17,2068,2394,326
167124,2019-09-12 00:00:00+03:00,in,False,-1,True,4,0,56,56
167124,2019-09-12 00:00:00+03:00,out,False,901992,True,17,0,431,431
167124,2019-09-12 00:00:00+03:00,in,False,901992,False,3,49,65,16
167124,2019-09-13 00:00:00+03:00,out,False,901992,True,41,0,816,816
167124,2019-09-13 00:00:00+03:00,in,False,901992,False,1,49,58,9
167124,2019-09-13 00:00:00+03:00,out,False,901992,False,37,2127,2879,752
167124,2019-09-13 00:00:00+03:00,out,False,901992,False,37,2127,2879,752
167124,2019-09-14 00:00:00+03:00,out,False,901992,True,2,0,139,139
167124,2019-09-16 00:00:00+03:00,out,False,901992,True,34,0,964,964
167124,2019-09-16 00:00:00+03:00,out,False,901996,True,1,0,0,0
167124,2019-09-16 00:00:00+03:00,out,False,901992,False,40,5664,6379,715
167124,2019-09-17 00:00:00+03:00,in,False,901992,False,2,57,72,15
167124,2019-09-17 00:00:00+03:00,in,False,-1,True,4,0,78,78
167124,2019-09-17 00:00:00+03:00,out,False,901992,True,48,0,1201,1201
167124,2019-09-17 00:00:00+03:00,out,False,901992,False,58,5210,6280,1070
167124,2019-09-17 00:00:00+03:00,out,False,901992,False,58,5210,6280,1070
167124,2019-09-18 00:00:00+03:00,in,False,901992,False,2,27,40,13
167124,2019-09-18 00:00:00+03:00,out,False,901992,False,40,7619,8402,783
167124,2019-09-18 00:00:00+03:00,out,False,901992,True,37,0,960,960
167124,2019-09-18 00:00:00+03:00,in,False,-1,True,3,0,42,42
167124,2019-09-18 00:00:00+03:00,in,False,901992,False,2,27,40,13
167124,2019-09-18 00:00:00+03:00,out,False,901992,False,40,7619,8402,783
167124,2019-09-19 00:00:00+03:00,out,False,901992,True,5,0,181,181
167124,2019-09-19 00:00:00+03:00,out,False,901992,False,6,525,667,142
167124,2019-09-20 00:00:00+03:00,out,False,901992,True,18,0,525,525
167124,2019-09-20 00:00:00+03:00,in,False,901992,False,1,66,77,11
167124,2019-09-20 00:00:00+03:00,out,False,901992,False,23,2267,2682,415
167124,2019-09-23 00:00:00+03:00,out,False,901992,False,20,1916,2286,370
167124,2019-09-23 00:00:00+03:00,out,False,901992,True,10,0,115,115
167124,2019-09-24 00:00:00+03:00,out,False,901992,False,20,3432,3814,382
167124,2019-09-24 00:00:00+03:00,out,False,901992,True,9,0,341,341
167124,2019-09-25 00:00:00+03:00,in,False,-1,True,3,0,33,33
167124,2019-09-25 00:00:00+03:00,out,False,901992,False,11,1235,1402,167
167124,2019-09-25 00:00:00+03:00,out,False,901992,True,1,0,45,45
167124,2019-09-25 00:00:00+03:00,out,False,901992,False,11,1235,1402,167
167124,2019-09-26 00:00:00+03:00,out,False,901992,False,1,92,111,19
167124,2019-10-04 00:00:00+03:00,out,False,901992,False,26,2124,2531,407
167124,2019-10-04 00:00:00+03:00,out,False,901992,True,24,0,359,359
167124,2019-10-05 00:00:00+03:00,in,False,901992,False,1,19,32,13
167124,2019-10-05 00:00:00+03:00,out,False,901992,False,24,935,1403,468
167124,2019-10-05 00:00:00+03:00,out,False,901992,True,10,0,191,191
167124,2019-10-07 00:00:00+03:00,out,False,901992,True,21,0,514,514
167124,2019-10-07 00:00:00+03:00,out,False,901992,False,28,3230,3952,722
167124,2019-10-09 00:00:00+03:00,out,False,901992,True,2,0,90,90
167124,2019-10-09 00:00:00+03:00,out,False,901992,False,9,874,1189,315
167124,2019-10-10 00:00:00+03:00,out,False,901992,False,2,307,365,58
167124,2019-10-14 00:00:00+03:00,in,False,-1,True,1,0,2,2
167124,2019-10-17 00:00:00+03:00,out,False,901992,True,4,0,111,111
167124,2019-10-17 00:00:00+03:00,out,False,901992,False,26,2198,2817,619
167124,2019-10-17 00:00:00+03:00,in,False,901992,False,1,36,50,14
167124,2019-10-21 00:00:00+03:00,in,False,-1,True,4,0,25,25
167124,2019-10-21 00:00:00+03:00,in,False,901996,False,3,226,269,43
167124,2019-10-21 00:00:00+03:00,out,False,901996,False,14,702,981,279
167124,2019-10-21 00:00:00+03:00,out,False,901996,True,9,0,271,271
167124,2019-10-21 00:00:00+03:00,out,True,901996,True,2,0,28,28
167125,2019-09-03 00:00:00+03:00,out,False,902746,True,1,0,7,7
167125,2019-09-04 00:00:00+03:00,out,False,902746,False,34,4534,5034,500
167125,2019-09-04 00:00:00+03:00,out,False,902782,False,22,6013,6433,420
167125,2019-09-04 00:00:00+03:00,out,True,902746,True,1,0,0,0
167125,2019-09-04 00:00:00+03:00,out,False,902742,False,13,2703,2963,260
167125,2019-09-04 00:00:00+03:00,out,False,902782,True,73,0,1359,1359
167125,2019-09-04 00:00:00+03:00,out,True,902782,True,1,0,2,2
167125,2019-09-04 00:00:00+03:00,out,False,902742,True,17,0,259,259
167125,2019-09-04 00:00:00+03:00,out,False,902746,True,61,0,1202,1202
167125,2019-09-04 00:00:00+03:00,out,True,902742,True,1,0,5,5
167125,2019-09-04 00:00:00+03:00,out,False,902744,True,63,0,1032,1032
167125,2019-09-04 00:00:00+03:00,out,False,902744,False,37,3204,3847,643
167125,2019-09-04 00:00:00+03:00,in,False,-1,True,14,0,766,766
167125,2019-09-05 00:00:00+03:00,in,False,-1,True,27,0,1353,1353
167125,2019-09-05 00:00:00+03:00,out,True,902744,True,4,0,36,36
167125,2019-09-05 00:00:00+03:00,out,False,902744,True,51,0,895,895
167125,2019-09-05 00:00:00+03:00,out,False,902742,True,5,0,84,84
167125,2019-09-05 00:00:00+03:00,out,False,902746,True,17,0,310,310
167125,2019-09-05 00:00:00+03:00,out,False,902746,False,12,2569,2702,133
167125,2019-09-05 00:00:00+03:00,out,False,902742,False,10,2368,2540,172
167125,2019-09-05 00:00:00+03:00,out,False,902782,False,22,6204,6478,274
167125,2019-09-05 00:00:00+03:00,out,False,902744,False,24,4771,5158,387
167125,2019-09-05 00:00:00+03:00,out,False,902782,True,39,0,1057,1057
167125,2019-09-06 00:00:00+03:00,out,False,902742,False,12,2178,2442,264
167125,2019-09-06 00:00:00+03:00,out,False,902746,True,24,0,312,312
167125,2019-09-06 00:00:00+03:00,out,False,902746,False,22,3398,3820,422
167125,2019-09-06 00:00:00+03:00,out,False,-1,True,1,0,0,0
167125,2019-09-06 00:00:00+03:00,out,False,902782,False,16,4582,4888,306
167125,2019-09-06 00:00:00+03:00,out,False,902744,False,17,5340,5623,283
167125,2019-09-06 00:00:00+03:00,out,False,902744,True,20,0,490,490
167125,2019-09-06 00:00:00+03:00,in,False,-1,True,16,0,607,607
167125,2019-09-06 00:00:00+03:00,out,False,902742,True,9,0,197,197
167125,2019-09-06 00:00:00+03:00,out,False,902782,True,22,0,487,487
167125,2019-09-06 00:00:00+03:00,out,False,-1,True,1,0,0,0
167125,2019-09-06 00:00:00+03:00,out,False,902746,True,24,0,312,312
167125,2019-09-07 00:00:00+03:00,in,False,-1,True,1,0,65,65
167125,2019-09-07 00:00:00+03:00,out,False,902744,False,7,1923,1991,68
167125,2019-09-07 00:00:00+03:00,out,False,902744,True,3,0,42,42
167125,2019-09-07 00:00:00+03:00,out,False,902744,True,3,0,42,42
167125,2019-09-09 00:00:00+03:00,out,False,902746,True,39,0,653,653
167125,2019-09-09 00:00:00+03:00,out,False,902782,True,23,0,695,695
167125,2019-09-09 00:00:00+03:00,out,False,902742,True,22,0,848,848
167125,2019-09-09 00:00:00+03:00,out,False,902748,False,30,2180,2665,485
167125,2019-09-09 00:00:00+03:00,out,False,902742,False,29,7634,8221,587
167125,2019-09-09 00:00:00+03:00,in,False,-1,True,9,0,299,299
167125,2019-09-09 00:00:00+03:00,out,False,902748,True,34,0,889,889
167125,2019-09-09 00:00:00+03:00,out,True,902748,True,1,0,1,1
167125,2019-09-09 00:00:00+03:00,out,False,902782,False,18,6948,7300,352
167125,2019-09-09 00:00:00+03:00,out,True,902746,True,2,0,6,6
167125,2019-09-09 00:00:00+03:00,out,False,902744,True,39,0,741,741
167125,2019-09-09 00:00:00+03:00,out,False,902744,False,24,2999,3341,342
167125,2019-09-09 00:00:00+03:00,out,False,902746,False,22,6579,6958,379
167125,2019-09-09 00:00:00+03:00,out,False,902748,False,30,2180,2665,485
167125,2019-09-10 00:00:00+03:00,out,False,902742,False,20,4375,4750,375
167125,2019-09-10 00:00:00+03:00,out,False,902746,False,21,3251,3561,310
167125,2019-09-10 00:00:00+03:00,out,False,902782,False,9,3287,3452,165
167125,2019-09-10 00:00:00+03:00,out,True,902744,True,2,0,10,10
167125,2019-09-10 00:00:00+03:00,out,False,902748,False,24,1820,2202,382
167125,2019-09-10 00:00:00+03:00,out,False,902782,True,16,0,543,543
167125,2019-09-10 00:00:00+03:00,out,False,902742,True,26,0,540,540
167125,2019-09-10 00:00:00+03:00,out,False,902746,True,29,0,618,618
167125,2019-09-10 00:00:00+03:00,out,False,902744,True,21,0,369,369
167125,2019-09-10 00:00:00+03:00,out,True,902746,True,2,0,2,2
167125,2019-09-10 00:00:00+03:00,in,False,-1,True,8,0,337,337
167125,2019-09-10 00:00:00+03:00,out,False,902748,True,37,0,1259,1259
167125,2019-09-10 00:00:00+03:00,out,False,902744,False,7,612,714,102
167125,2019-09-10 00:00:00+03:00,in,False,-1,True,8,0,337,337
167125,2019-09-11 00:00:00+03:00,out,False,902778,False,1,48,60,12
167125,2019-09-11 00:00:00+03:00,out,False,902744,False,17,559,914,355
167125,2019-09-11 00:00:00+03:00,out,False,902782,True,13,0,391,391
167125,2019-09-11 00:00:00+03:00,out,False,902742,False,25,5982,6451,469
167125,2019-09-11 00:00:00+03:00,out,False,902742,True,13,0,299,299
167125,2019-09-11 00:00:00+03:00,out,False,902782,False,16,5563,5850,287
167125,2019-09-11 00:00:00+03:00,out,False,902748,True,49,0,1213,1213
167125,2019-09-11 00:00:00+03:00,out,False,902746,False,24,4280,4686,406
167125,2019-09-11 00:00:00+03:00,in,False,-1,True,12,0,382,382
167125,2019-09-11 00:00:00+03:00,out,False,902746,True,14,0,246,246
167125,2019-09-11 00:00:00+03:00,out,False,902748,False,40,2995,3829,834
167125,2019-09-11 00:00:00+03:00,out,True,902746,True,1,0,7,7
167125,2019-09-11 00:00:00+03:00,out,True,902782,True,1,0,0,0
167125,2019-09-11 00:00:00+03:00,out,False,902744,True,43,0,674,674
167125,2019-09-11 00:00:00+03:00,out,False,902778,True,2,0,56,56
167125,2019-09-11 00:00:00+03:00,out,False,902746,False,24,4280,4686,406
167125,2019-09-11 00:00:00+03:00,out,False,902742,True,13,0,299,299
167125,2019-09-12 00:00:00+03:00,out,False,902746,False,9,1503,1616,113
167125,2019-09-12 00:00:00+03:00,in,False,-1,True,5,0,99,99
167125,2019-09-12 00:00:00+03:00,out,False,902782,True,31,0,671,671
167125,2019-09-12 00:00:00+03:00,out,False,902744,True,16,0,198,198
167125,2019-09-12 00:00:00+03:00,out,False,902748,True,7,0,151,151
167125,2019-09-12 00:00:00+03:00,out,False,902742,True,11,0,213,213
167125,2019-09-12 00:00:00+03:00,out,False,902742,False,12,5164,5369,205
167125,2019-09-12 00:00:00+03:00,out,False,902748,False,4,81,126,45
167125,2019-09-12 00:00:00+03:00,out,False,902746,True,5,0,90,90
167125,2019-09-12 00:00:00+03:00,out,False,902782,False,18,6070,6384,314
167125,2019-09-12 00:00:00+03:00,out,False,902744,False,5,1076,1145,69
167125,2019-09-13 00:00:00+03:00,out,False,902742,True,14,0,341,341
167125,2019-09-13 00:00:00+03:00,out,False,902748,True,44,0,1099,1099
167125,2019-09-13 00:00:00+03:00,out,True,902782,True,1,0,0,0
167125,2019-09-13 00:00:00+03:00,out,False,902782,False,10,4251,4450,199
167125,2019-09-13 00:00:00+03:00,out,False,902748,False,28,2023,2490,467
167125,2019-09-13 00:00:00+03:00,out,False,902746,False,36,6961,7559,598
167125,2019-09-13 00:00:00+03:00,out,False,902744,True,62,0,950,950
167125,2019-09-13 00:00:00+03:00,out,False,902782,True,9,0,230,230
167125,2019-09-13 00:00:00+03:00,in,False,-1,True,13,0,536,536
167125,2019-09-13 00:00:00+03:00,out,False,902742,False,23,6860,7308,448
167125,2019-09-13 00:00:00+03:00,out,True,902746,True,1,0,0,0
167125,2019-09-13 00:00:00+03:00,out,False,902744,False,27,1452,1888,436
167125,2019-09-13 00:00:00+03:00,out,False,902746,True,45,0,1309,1309
167125,2019-09-16 00:00:00+03:00,out,False,902744,False,24,1970,2319,349
167125,2019-09-16 00:00:00+03:00,out,False,902748,True,43,0,885,885
167125,2019-09-16 00:00:00+03:00,in,False,-1,True,13,0,421,421
167125,2019-09-16 00:00:00+03:00,out,False,902746,True,82,0,1848,1848
167125,2019-09-16 00:00:00+03:00,out,False,902778,False,2,465,501,36
167125,2019-09-16 00:00:00+03:00,out,False,-1,True,1,0,1,1
167125,2019-09-16 00:00:00+03:00,out,True,902774,True,1,0,5,5
167125,2019-09-16 00:00:00+03:00,out,False,902742,True,28,0,347,347
167125,2019-09-16 00:00:00+03:00,out,False,902744,True,39,0,661,661
167125,2019-09-16 00:00:00+03:00,out,False,902746,False,28,3139,3583,444
167125,2019-09-16 00:00:00+03:00,out,False,902748,False,35,3263,3891,628
167125,2019-09-16 00:00:00+03:00,out,False,902774,True,16,0,585,585
167125,2019-09-16 00:00:00+03:00,out,False,902742,False,21,6094,6449,355
167125,2019-09-16 00:00:00+03:00,out,False,902774,False,14,1073,1324,251
167125,2019-09-16 00:00:00+03:00,out,True,902746,True,2,0,2,2
167125,2019-09-16 00:00:00+03:00,out,True,902746,True,2,0,2,2
167125,2019-09-16 00:00:00+03:00,out,False,902774,True,16,0,585,585
167125,2019-09-16 00:00:00+03:00,out,False,902744,True,39,0,661,661
167125,2019-09-17 00:00:00+03:00,out,False,902746,True,47,0,715,715
167125,2019-09-17 00:00:00+03:00,out,True,902744,True,3,0,17,17
167125,2019-09-17 00:00:00+03:00,out,False,902748,True,24,0,556,556
167125,2019-09-17 00:00:00+03:00,out,True,902748,True,1,0,1,1
167125,2019-09-17 00:00:00+03:00,out,False,902748,False,25,2426,2893,467
167125,2019-09-17 00:00:00+03:00,out,False,902746,False,18,4190,4567,377
167125,2019-09-17 00:00:00+03:00,out,False,902742,True,25,0,448,448
167125,2019-09-17 00:00:00+03:00,out,False,902744,False,35,2617,3103,486
167125,2019-09-17 00:00:00+03:00,out,False,902774,False,32,2212,2897,685
167125,2019-09-17 00:00:00+03:00,out,False,902744,True,62,0,987,987
167125,2019-09-17 00:00:00+03:00,in,False,-1,True,23,0,828,828
167125,2019-09-17 00:00:00+03:00,out,False,902742,False,17,6299,6739,440
167125,2019-09-17 00:00:00+03:00,out,False,902774,True,19,0,343,343
167125,2019-09-17 00:00:00+03:00,out,False,902742,False,17,6299,6739,440
167125,2019-09-17 00:00:00+03:00,in,False,-1,True,23,0,828,828
167125,2019-09-17 00:00:00+03:00,out,False,902748,True,24,0,556,556
167125,2019-09-17 00:00:00+03:00,out,False,902744,False,35,2617,3103,486
167125,2019-09-17 00:00:00+03:00,out,False,902744,True,62,0,987,987
167125,2019-09-18 00:00:00+03:00,out,False,902744,True,41,0,689,689
167125,2019-09-18 00:00:00+03:00,out,False,902742,False,18,5599,5938,339
167125,2019-09-18 00:00:00+03:00,out,False,902748,False,36,1980,2701,721
167125,2019-09-18 00:00:00+03:00,out,False,902774,True,22,0,403,403
167125,2019-09-18 00:00:00+03:00,out,False,902748,True,44,0,1163,1163
167125,2019-09-18 00:00:00+03:00,out,False,902744,False,38,1933,2611,678
167125,2019-09-18 00:00:00+03:00,out,False,902746,True,67,0,1285,1285
167125,2019-09-18 00:00:00+03:00,in,False,-1,True,16,0,609,609
167125,2019-09-18 00:00:00+03:00,out,False,902742,True,10,0,333,333
167125,2019-09-18 00:00:00+03:00,out,False,902746,False,38,6546,7224,678
167125,2019-09-18 00:00:00+03:00,out,False,902774,False,17,3673,4001,328
167125,2019-09-18 00:00:00+03:00,out,False,902746,False,38,6546,7224,678
167125,2019-09-19 00:00:00+03:00,out,False,902746,False,34,2055,2798,743
167125,2019-09-19 00:00:00+03:00,out,True,902744,True,2,0,4,4
167125,2019-09-19 00:00:00+03:00,out,True,902746,True,1,0,0,0
167125,2019-09-19 00:00:00+03:00,out,False,902774,True,19,0,291,291
167125,2019-09-19 00:00:00+03:00,out,False,902744,False,36,2920,3582,662
167125,2019-09-19 00:00:00+03:00,out,False,902744,True,83,0,1139,1139
167125,2019-09-19 00:00:00+03:00,out,False,902774,False,35,1909,2857,948
167125,2019-09-19 00:00:00+03:00,out,False,902742,True,8,0,140,140
167125,2019-09-19 00:00:00+03:00,out,False,902748,False,43,3041,3942,901
167125,2019-09-19 00:00:00+03:00,out,True,902774,True,1,0,3,3
167125,2019-09-19 00:00:00+03:00,out,False,902746,True,62,0,1564,1564
167125,2019-09-19 00:00:00+03:00,out,False,902742,False,25,6128,6590,462
167125,2019-09-19 00:00:00+03:00,out,False,902748,True,67,0,1422,1422
167125,2019-09-19 00:00:00+03:00,in,False,-1,True,20,0,885,885
167125,2019-09-19 00:00:00+03:00,out,False,902778,True,1,0,61,61
167125,2019-09-20 00:00:00+03:00,out,False,902748,True,40,0,1024,1024
167125,2019-09-20 00:00:00+03:00,out,False,902774,True,20,0,529,529
167125,2019-09-20 00:00:00+03:00,out,False,902748,False,36,2977,3605,628
167125,2019-09-20 00:00:00+03:00,out,False,902746,False,54,5075,6048,973
167125,2019-09-20 00:00:00+03:00,out,False,902744,True,89,0,1389,1389
167125,2019-09-20 00:00:00+03:00,out,False,902742,True,22,0,315,315
167125,2019-09-20 00:00:00+03:00,in,False,-1,True,33,0,1560,1560
167125,2019-09-20 00:00:00+03:00,out,False,902746,True,78,0,1508,1508
167125,2019-09-20 00:00:00+03:00,out,False,902744,False,45,3337,4077,740
167125,2019-09-20 00:00:00+03:00,out,False,902742,False,20,3984,4300,316
167125,2019-09-20 00:00:00+03:00,out,False,902778,False,2,278,308,30
167125,2019-09-20 00:00:00+03:00,out,True,902744,True,1,0,0,0
167125,2019-09-20 00:00:00+03:00,out,False,902774,False,29,3233,3810,577
167125,2019-09-20 00:00:00+03:00,out,False,902748,False,36,2977,3605,628
167125,2019-09-20 00:00:00+03:00,out,False,902742,False,20,3984,4300,316
167125,2019-09-21 00:00:00+03:00,out,False,902742,True,2,0,73,73
167125,2019-09-21 00:00:00+03:00,out,False,902742,False,6,1887,2065,178
167125,2019-09-21 00:00:00+03:00,out,False,902774,False,1,109,125,16
167125,2019-09-21 00:00:00+03:00,out,False,902774,True,3,0,57,57
167125,2019-09-21 00:00:00+03:00,out,False,902778,False,2,434,452,18
167125,2019-09-21 00:00:00+03:00,in,False,-1,True,6,0,230,230
167125,2019-09-21 00:00:00+03:00,out,False,902778,False,2,434,452,18
167125,2019-09-21 00:00:00+03:00,out,False,902742,False,6,1887,2065,178
167125,2019-09-21 00:00:00+03:00,out,False,902774,False,1,109,125,16
167125,2019-09-23 00:00:00+03:00,out,False,902746,True,54,0,1498,1498
167125,2019-09-23 00:00:00+03:00,in,False,-1,True,19,0,639,639
167125,2019-09-23 00:00:00+03:00,out,False,902744,True,95,0,1660,1660
167125,2019-09-23 00:00:00+03:00,out,False,902748,False,46,3073,3923,850
167125,2019-09-23 00:00:00+03:00,out,False,902782,True,41,0,1048,1048
167125,2019-09-23 00:00:00+03:00,out,False,902774,True,27,0,535,535
167125,2019-09-23 00:00:00+03:00,out,True,902744,True,2,0,6,6
167125,2019-09-23 00:00:00+03:00,out,False,902742,True,19,0,314,314
167125,2019-09-23 00:00:00+03:00,out,False,902774,False,22,5319,5686,367
167125,2019-09-23 00:00:00+03:00,out,False,902744,False,42,5470,6210,740
167125,2019-09-23 00:00:00+03:00,out,False,902778,False,2,473,497,24
167125,2019-09-23 00:00:00+03:00,out,False,902742,False,21,5128,5534,406
167125,2019-09-23 00:00:00+03:00,out,False,902746,False,38,6876,7653,777
167125,2019-09-23 00:00:00+03:00,out,False,902782,False,33,9080,9687,607
167125,2019-09-23 00:00:00+03:00,out,False,902748,True,103,0,2852,2852
167125,2019-09-23 00:00:00+03:00,out,False,-1,True,1,0,0,0
167125,2019-09-23 00:00:00+03:00,out,False,902778,True,1,0,50,50
167125,2019-09-23 00:00:00+03:00,out,True,902746,True,2,0,1,1
167125,2019-09-23 00:00:00+03:00,out,False,902782,True,41,0,1048,1048
167125,2019-09-24 00:00:00+03:00,out,False,902748,False,49,3867,4876,1009
167125,2019-09-24 00:00:00+03:00,out,False,902778,True,1,0,7,7
167125,2019-09-24 00:00:00+03:00,out,False,902742,True,12,0,212,212
167125,2019-09-24 00:00:00+03:00,out,True,902746,True,2,0,11,11
167125,2019-09-24 00:00:00+03:00,out,False,902776,False,19,1794,2212,418
167125,2019-09-24 00:00:00+03:00,out,False,902776,True,51,0,951,951
167125,2019-09-24 00:00:00+03:00,out,False,902746,False,36,4966,5618,652
167125,2019-09-24 00:00:00+03:00,out,False,902782,False,29,8988,9559,571
167125,2019-09-24 00:00:00+03:00,out,False,902744,False,29,3776,4286,510
167125,2019-09-24 00:00:00+03:00,out,False,902748,True,80,0,1863,1863
167125,2019-09-24 00:00:00+03:00,out,True,902776,True,2,0,0,0
167125,2019-09-24 00:00:00+03:00,out,True,902748,True,1,0,0,0
167125,2019-09-24 00:00:00+03:00,out,False,902742,False,16,4386,4655,269
167125,2019-09-24 00:00:00+03:00,out,False,902744,True,35,0,486,486
167125,2019-09-24 00:00:00+03:00,out,False,902782,True,19,0,776,776
167125,2019-09-24 00:00:00+03:00,out,False,902774,False,22,3801,4238,437
167125,2019-09-24 00:00:00+03:00,out,False,902774,True,12,0,294,294
167125,2019-09-24 00:00:00+03:00,out,False,902746,True,45,0,1261,1261
167125,2019-09-24 00:00:00+03:00,out,True,902774,True,1,0,2,2
167125,2019-09-24 00:00:00+03:00,in,False,-1,True,17,0,690,690
167125,2019-09-24 00:00:00+03:00,out,False,902776,False,19,1794,2212,418
167125,2019-09-24 00:00:00+03:00,out,False,902778,True,1,0,7,7
167125,2019-09-25 00:00:00+03:00,out,False,902746,True,54,0,1086,1086
167125,2019-09-25 00:00:00+03:00,out,False,902742,False,18,5991,6293,302
167125,2019-09-25 00:00:00+03:00,out,True,902782,True,1,0,0,0
167125,2019-09-25 00:00:00+03:00,out,False,902782,True,49,0,1295,1295
167125,2019-09-25 00:00:00+03:00,out,False,902782,False,25,7417,7908,491
167125,2019-09-25 00:00:00+03:00,out,False,902744,True,43,0,897,897
167125,2019-09-25 00:00:00+03:00,out,False,902748,False,50,3459,4429,970
167125,2019-09-25 00:00:00+03:00,out,False,902778,False,2,250,307,57
167125,2019-09-25 00:00:00+03:00,out,True,902746,True,3,0,7,7
167125,2019-09-25 00:00:00+03:00,out,False,902746,False,34,5662,6316,654
167125,2019-09-25 00:00:00+03:00,in,False,-1,True,29,0,940,940
167125,2019-09-25 00:00:00+03:00,out,False,902774,True,16,0,609,609
167125,2019-09-25 00:00:00+03:00,out,False,902744,False,28,3579,4051,472
167125,2019-09-25 00:00:00+03:00,out,False,902774,False,10,1821,1987,166
167125,2019-09-25 00:00:00+03:00,out,False,902742,True,11,0,157,157
167125,2019-09-25 00:00:00+03:00,out,False,902748,True,56,0,1422,1422
167125,2019-09-25 00:00:00+03:00,out,False,902776,False,18,3038,3356,318
167125,2019-09-25 00:00:00+03:00,out,True,902776,True,1,0,0,0
167125,2019-09-25 00:00:00+03:00,out,False,902776,True,44,0,1060,1060
167125,2019-09-25 00:00:00+03:00,out,True,902742,True,1,0,4,4
167125,2019-09-25 00:00:00+03:00,out,False,902746,True,54,0,1086,1086
167125,2019-09-25 00:00:00+03:00,out,False,902744,True,43,0,897,897
167125,2019-09-25 00:00:00+03:00,out,False,902748,True,56,0,1422,1422
167125,2019-09-26 00:00:00+03:00,out,False,902742,False,17,4237,4540,303
167125,2019-09-26 00:00:00+03:00,in,False,-1,True,19,0,865,865
167125,2019-09-26 00:00:00+03:00,out,False,-1,True,1,0,0,0
167125,2019-09-26 00:00:00+03:00,out,False,902744,True,48,0,989,989
167125,2019-09-26 00:00:00+03:00,out,False,902782,True,41,0,1447,1447
167125,2019-09-26 00:00:00+03:00,out,False,902776,True,15,0,200,200
167125,2019-09-26 00:00:00+03:00,out,False,902776,False,24,3814,4298,484
167125,2019-09-26 00:00:00+03:00,out,False,902774,True,4,0,13,13
167125,2019-09-26 00:00:00+03:00,out,False,902778,True,3,0,100,100
167125,2019-09-26 00:00:00+03:00,out,False,902742,True,14,0,255,255
167125,2019-09-26 00:00:00+03:00,out,True,902746,True,1,0,3,3
167125,2019-09-26 00:00:00+03:00,out,False,902744,False,33,5728,6188,460
167125,2019-09-26 00:00:00+03:00,out,False,902746,False,43,5478,6216,738
167125,2019-09-26 00:00:00+03:00,out,False,902748,False,69,2245,3644,1399
167125,2019-09-26 00:00:00+03:00,out,False,902746,True,62,0,1391,1391
167125,2019-09-26 00:00:00+03:00,out,False,902778,False,1,728,747,19
167125,2019-09-26 00:00:00+03:00,out,False,902748,True,101,0,2115,2115
167125,2019-09-26 00:00:00+03:00,in,False,-1,True,1,0,22,22
167125,2019-09-26 00:00:00+03:00,out,True,902744,True,1,0,5,5
167125,2019-09-26 00:00:00+03:00,out,False,902774,False,6,536,666,130
167125,2019-09-26 00:00:00+03:00,out,False,-1,True,1,0,0,0
167125,2019-09-26 00:00:00+03:00,out,False,902782,False,37,6488,7095,607
167125,2019-09-26 00:00:00+03:00,out,False,902776,False,24,3814,4298,484
167125,2019-09-26 00:00:00+03:00,out,False,902778,False,1,728,747,19
167125,2019-09-27 00:00:00+03:00,out,True,902748,True,1,0,2,2
167125,2019-09-27 00:00:00+03:00,out,True,902782,True,1,0,4,4
167125,2019-09-27 00:00:00+03:00,out,False,902782,False,27,8535,9074,539
167125,2019-09-27 00:00:00+03:00,out,True,902744,True,1,0,4,4
167125,2019-09-27 00:00:00+03:00,out,False,902748,False,46,3968,4818,850
167125,2019-09-27 00:00:00+03:00,out,False,902774,True,39,0,982,982
167125,2019-09-27 00:00:00+03:00,out,False,902748,True,64,0,1630,1630
167125,2019-09-27 00:00:00+03:00,out,False,902744,True,31,0,733,733
167125,2019-09-27 00:00:00+03:00,out,False,902774,False,32,4016,4805,789
167125,2019-09-27 00:00:00+03:00,out,False,902776,True,64,0,1196,1196
167125,2019-09-27 00:00:00+03:00,out,True,902746,True,1,0,1,1
167125,2019-09-27 00:00:00+03:00,out,True,902776,True,3,0,5,5
167125,2019-09-27 00:00:00+03:00,out,False,902746,False,57,4196,5246,1050
167125,2019-09-27 00:00:00+03:00,out,False,902778,True,10,0,312,312
167125,2019-09-27 00:00:00+03:00,out,False,902746,True,106,0,2405,2405
167125,2019-09-27 00:00:00+03:00,out,False,902744,False,14,2284,2556,272
167125,2019-09-27 00:00:00+03:00,out,False,902778,False,3,826,870,44
167125,2019-09-27 00:00:00+03:00,out,False,902782,True,53,0,1656,1656
167125,2019-09-27 00:00:00+03:00,out,True,902774,True,1,0,3,3
167125,2019-09-27 00:00:00+03:00,out,False,902776,False,35,7404,8139,735
167125,2019-09-27 00:00:00+03:00,in,False,-1,True,11,0,275,275
167125,2019-09-27 00:00:00+03:00,out,False,902746,True,106,0,2405,2405
167125,2019-09-27 00:00:00+03:00,out,False,902782,True,53,0,1656,1656
167125,2019-09-28 00:00:00+03:00,out,False,902746,False,25,2129,2663,534
167125,2019-09-28 00:00:00+03:00,out,False,902778,False,2,706,745,39
167125,2019-09-28 00:00:00+03:00,out,True,902746,True,1,0,5,5
167125,2019-09-28 00:00:00+03:00,out,False,902742,True,10,0,254,254
167125,2019-09-28 00:00:00+03:00,out,False,902744,False,32,2349,2843,494
167125,2019-09-28 00:00:00+03:00,out,False,902746,True,55,0,1383,1383
167125,2019-09-28 00:00:00+03:00,out,False,902748,True,45,0,1444,1444
167125,2019-09-28 00:00:00+03:00,out,False,902776,True,54,0,1814,1814
167125,2019-09-28 00:00:00+03:00,out,False,902748,False,33,2475,3256,781
167125,2019-09-28 00:00:00+03:00,out,False,902742,False,15,2676,2983,307
167125,2019-09-28 00:00:00+03:00,out,True,902774,True,1,0,4,4
167125,2019-09-28 00:00:00+03:00,out,True,902782,True,1,0,0,0
167125,2019-09-28 00:00:00+03:00,out,False,902778,True,1,0,20,20
167125,2019-09-28 00:00:00+03:00,out,False,902782,False,17,6028,6400,372
167125,2019-09-28 00:00:00+03:00,out,False,902744,True,55,0,1033,1033
167125,2019-09-28 00:00:00+03:00,out,False,902782,True,10,0,325,325
167125,2019-09-28 00:00:00+03:00,out,False,902774,True,13,0,447,447
167125,2019-09-28 00:00:00+03:00,out,True,902744,True,2,0,13,13
167125,2019-09-28 00:00:00+03:00,out,False,902776,False,22,2820,3299,479
167125,2019-09-28 00:00:00+03:00,in,False,-1,True,10,0,323,323
167125,2019-09-28 00:00:00+03:00,out,False,902774,False,18,2808,3220,412
167125,2019-09-29 00:00:00+03:00,in,False,-1,True,3,0,19,19
167125,2019-09-30 00:00:00+03:00,out,False,902774,False,31,3277,3953,676
167125,2019-09-30 00:00:00+03:00,out,False,902778,True,51,0,1356,1356
167125,2019-09-30 00:00:00+03:00,out,False,902746,False,43,7097,7790,693
167125,2019-09-30 00:00:00+03:00,out,True,902748,True,1,0,1,1
167125,2019-09-30 00:00:00+03:00,out,False,902744,True,105,0,2066,2066
167125,2019-09-30 00:00:00+03:00,out,True,902744,True,1,0,0,0
167125,2019-09-30 00:00:00+03:00,out,False,902748,True,81,0,1913,1913
167125,2019-09-30 00:00:00+03:00,out,False,-1,True,1,0,0,0
167125,2019-09-30 00:00:00+03:00,out,False,902744,False,40,3736,4424,688
167125,2019-09-30 00:00:00+03:00,in,False,-1,True,32,0,1258,1258
167125,2019-09-30 00:00:00+03:00,out,False,902742,True,14,0,341,341
167125,2019-09-30 00:00:00+03:00,out,False,902742,False,27,5888,6391,503
167125,2019-09-30 00:00:00+03:00,out,True,902778,True,1,0,1,1
167125,2019-09-30 00:00:00+03:00,out,False,902748,False,32,4408,4953,545
167125,2019-09-30 00:00:00+03:00,out,False,902782,False,18,6385,6718,333
167125,2019-09-30 00:00:00+03:00,out,False,902782,True,26,0,712,712
167125,2019-09-30 00:00:00+03:00,out,False,902774,True,46,0,1223,1223
167125,2019-09-30 00:00:00+03:00,out,False,902778,False,29,10977,11534,557
167125,2019-09-30 00:00:00+03:00,out,False,902746,True,48,0,1054,1054
167125,2019-10-01 00:00:00+03:00,out,False,902778,True,21,0,452,452
167125,2019-10-01 00:00:00+03:00,out,False,902744,True,24,0,434,434
167125,2019-10-01 00:00:00+03:00,out,False,902776,True,39,0,843,843
167125,2019-10-01 00:00:00+03:00,out,True,902778,True,2,0,8,8
167125,2019-10-01 00:00:00+03:00,out,False,902782,True,6,0,164,164
167125,2019-10-01 00:00:00+03:00,out,False,902742,True,28,0,593,593
167125,2019-10-01 00:00:00+03:00,out,False,902748,False,39,2578,3368,790
167125,2019-10-01 00:00:00+03:00,out,False,902776,False,17,2193,2496,303
167125,2019-10-01 00:00:00+03:00,out,False,902782,False,7,4151,4338,187
167125,2019-10-01 00:00:00+03:00,out,False,902746,True,53,0,892,892
167125,2019-10-01 00:00:00+03:00,out,False,902774,False,15,2398,2658,260
167125,2019-10-01 00:00:00+03:00,out,False,902778,False,19,5485,5831,346
167125,2019-10-01 00:00:00+03:00,out,False,902774,True,15,0,242,242
167125,2019-10-01 00:00:00+03:00,out,False,902744,False,19,1711,2074,363
167125,2019-10-01 00:00:00+03:00,out,False,902748,True,51,0,822,822
167125,2019-10-01 00:00:00+03:00,out,False,902742,False,19,2954,3383,429
167125,2019-10-01 00:00:00+03:00,out,False,902746,False,29,2454,3072,618
167125,2019-10-01 00:00:00+03:00,out,True,902744,True,1,0,5,5
167125,2019-10-01 00:00:00+03:00,in,False,-1,True,25,0,988,988
167125,2019-10-01 00:00:00+03:00,out,True,902778,True,2,0,8,8
167125,2019-10-01 00:00:00+03:00,out,False,902778,True,21,0,452,452
167125,2019-10-02 00:00:00+03:00,out,False,902744,False,50,2444,3300,856
167125,2019-10-02 00:00:00+03:00,out,False,902748,True,141,0,2519,2519
167125,2019-10-02 00:00:00+03:00,out,True,902774,True,2,0,0,0
167125,2019-10-02 00:00:00+03:00,out,False,902778,False,38,7704,8402,698
167125,2019-10-02 00:00:00+03:00,out,False,902774,False,24,1578,2058,480
167125,2019-10-02 00:00:00+03:00,out,True,902782,True,1,0,1,1
167125,2019-10-02 00:00:00+03:00,out,True,902778,True,2,0,0,0
167125,2019-10-02 00:00:00+03:00,out,False,902776,False,44,2892,3851,959
167125,2019-10-02 00:00:00+03:00,out,False,902782,False,36,6239,6834,595
167125,2019-10-02 00:00:00+03:00,out,False,902774,True,47,0,1027,1027
167125,2019-10-02 00:00:00+03:00,out,False,902746,True,53,0,1169,1169
167125,2019-10-02 00:00:00+03:00,out,False,902778,True,85,0,1392,1392
167125,2019-10-02 00:00:00+03:00,out,False,902744,True,142,0,2206,2206
167125,2019-10-02 00:00:00+03:00,out,False,902748,False,73,2930,4467,1537
167125,2019-10-02 00:00:00+03:00,out,True,902776,True,2,0,0,0
167125,2019-10-02 00:00:00+03:00,in,False,-1,True,38,0,1023,1023
167125,2019-10-02 00:00:00+03:00,out,False,902776,True,66,0,1657,1657
167125,2019-10-02 00:00:00+03:00,out,False,902782,True,49,0,1129,1129
167125,2019-10-02 00:00:00+03:00,out,False,902746,False,45,7490,8272,782
167125,2019-10-02 00:00:00+03:00,out,True,902748,True,1,0,1,1
167125,2019-10-02 00:00:00+03:00,out,False,902776,False,44,2892,3851,959
167125,2019-10-02 00:00:00+03:00,out,False,902748,True,141,0,2519,2519
167125,2019-10-03 00:00:00+03:00,out,False,902746,True,47,0,865,865
167125,2019-10-03 00:00:00+03:00,out,False,902778,False,60,7845,8937,1092
167125,2019-10-03 00:00:00+03:00,out,False,902776,True,78,0,1985,1985
167125,2019-10-03 00:00:00+03:00,out,False,902746,False,36,6385,7062,677
167125,2019-10-03 00:00:00+03:00,out,False,902748,True,120,0,2275,2275
167125,2019-10-03 00:00:00+03:00,in,False,-1,True,35,0,1307,1307
167125,2019-10-03 00:00:00+03:00,out,False,902742,True,30,0,636,636
167125,2019-10-03 00:00:00+03:00,out,False,902782,False,23,6797,7194,397
167125,2019-10-03 00:00:00+03:00,out,False,902776,False,40,4737,5552,815
167125,2019-10-03 00:00:00+03:00,out,False,902748,False,60,1757,3208,1451
167125,2019-10-03 00:00:00+03:00,out,True,902778,True,1,0,0,0
167125,2019-10-03 00:00:00+03:00,out,False,902778,True,104,0,1339,1339
167125,2019-10-03 00:00:00+03:00,out,False,902742,False,24,4529,5029,500
167125,2019-10-03 00:00:00+03:00,out,False,902774,False,26,4490,5045,555
167125,2019-10-03 00:00:00+03:00,out,False,902744,False,76,3577,4777,1200
167125,2019-10-03 00:00:00+03:00,out,False,902782,True,25,0,924,924
167125,2019-10-03 00:00:00+03:00,out,True,902782,True,2,0,3,3
167125,2019-10-03 00:00:00+03:00,out,False,902744,True,159,0,2717,2717
167125,2019-10-03 00:00:00+03:00,out,False,902774,True,18,0,443,443
167125,2019-10-03 00:00:00+03:00,out,True,902776,True,1,0,2,2
167125,2019-10-03 00:00:00+03:00,out,True,902744,True,2,0,4,4
167125,2019-10-03 00:00:00+03:00,out,False,902776,True,78,0,1985,1985
167125,2019-10-03 00:00:00+03:00,out,False,902746,True,47,0,865,865
167125,2019-10-04 00:00:00+03:00,out,False,902744,True,122,0,1951,1951
167125,2019-10-04 00:00:00+03:00,out,False,902746,False,1,57,67,10
167125,2019-10-04 00:00:00+03:00,out,True,902778,True,1,0,5,5
167125,2019-10-04 00:00:00+03:00,out,True,902744,True,7,0,26,26
167125,2019-10-04 00:00:00+03:00,out,True,902742,True,1,0,7,7
167125,2019-10-04 00:00:00+03:00,out,False,902742,True,29,0,383,383
167125,2019-10-04 00:00:00+03:00,out,False,902776,False,44,5351,6236,885
167125,2019-10-04 00:00:00+03:00,out,False,902778,False,36,8018,8652,634
167125,2019-10-04 00:00:00+03:00,out,False,902774,False,18,2188,2564,376
167125,2019-10-04 00:00:00+03:00,out,False,902782,True,23,0,646,646
167125,2019-10-04 00:00:00+03:00,out,False,902782,False,18,5550,5922,372
167125,2019-10-04 00:00:00+03:00,out,False,902778,True,122,0,2090,2090
167125,2019-10-04 00:00:00+03:00,out,True,902776,True,3,0,3,3
167125,2019-10-04 00:00:00+03:00,in,False,-1,True,13,0,340,340
167125,2019-10-04 00:00:00+03:00,out,False,902774,True,22,0,1119,1119
167125,2019-10-04 00:00:00+03:00,out,True,902774,True,1,0,0,0
167125,2019-10-04 00:00:00+03:00,out,False,902744,False,63,5955,6937,982
167125,2019-10-04 00:00:00+03:00,out,False,902742,False,27,4985,5517,532
167125,2019-10-04 00:00:00+03:00,out,False,902776,True,93,0,2085,2085
167125,2019-10-05 00:00:00+03:00,out,False,902778,False,1,58,77,19
167125,2019-10-05 00:00:00+03:00,out,False,902744,False,23,1718,2076,358
167125,2019-10-05 00:00:00+03:00,out,False,902774,False,13,577,946,369
167125,2019-10-05 00:00:00+03:00,out,True,902776,True,2,0,0,0
167125,2019-10-05 00:00:00+03:00,out,False,902782,True,11,0,284,284
167125,2019-10-05 00:00:00+03:00,out,False,902782,False,10,2425,2692,267
167125,2019-10-05 00:00:00+03:00,out,False,902776,True,73,0,1588,1588
167125,2019-10-05 00:00:00+03:00,out,False,902742,True,13,0,235,235
167125,2019-10-05 00:00:00+03:00,out,False,902776,False,34,2991,3737,746
167125,2019-10-05 00:00:00+03:00,out,False,902774,True,22,0,948,948
167125,2019-10-05 00:00:00+03:00,out,False,902742,False,9,1335,1572,237
167125,2019-10-05 00:00:00+03:00,out,False,902744,True,66,0,1137,1137
167125,2019-10-05 00:00:00+03:00,out,False,902748,True,29,0,559,559
167125,2019-10-05 00:00:00+03:00,out,False,902748,False,12,483,755,272
167125,2019-10-05 00:00:00+03:00,in,False,-1,True,11,0,246,246
167125,2019-10-05 00:00:00+03:00,out,False,902782,True,11,0,284,284
167125,2019-10-05 00:00:00+03:00,out,True,902776,True,2,0,0,0
167125,2019-10-05 00:00:00+03:00,out,False,902782,False,10,2425,2692,267
167125,2019-10-05 00:00:00+03:00,out,False,902776,False,34,2991,3737,746
167125,2019-10-06 00:00:00+03:00,in,False,-1,True,4,0,66,66
167125,2019-10-07 00:00:00+03:00,out,False,902748,True,111,0,3128,3128
167125,2019-10-07 00:00:00+03:00,out,False,902776,True,97,0,2121,2121
167125,2019-10-07 00:00:00+03:00,out,False,902748,False,52,2339,3152,813
167125,2019-10-07 00:00:00+03:00,out,False,902774,False,39,4136,4904,768
167125,2019-10-07 00:00:00+03:00,out,False,902774,True,49,0,1396,1396
167125,2019-10-07 00:00:00+03:00,out,False,902744,False,52,4241,5119,878
167125,2019-10-07 00:00:00+03:00,out,True,902746,True,1,0,0,0
167125,2019-10-07 00:00:00+03:00,out,False,902746,True,91,0,1753,1753
167125,2019-10-07 00:00:00+03:00,out,False,902782,True,19,0,616,616
167125,2019-10-07 00:00:00+03:00,out,False,902778,False,41,8560,9287,727
167125,2019-10-07 00:00:00+03:00,out,True,902776,True,1,0,13,13
167125,2019-10-07 00:00:00+03:00,out,True,902744,True,2,0,5,5
167125,2019-10-07 00:00:00+03:00,out,False,902742,True,37,0,1138,1138
167125,2019-10-07 00:00:00+03:00,out,False,902778,True,133,0,1997,1997
167125,2019-10-07 00:00:00+03:00,out,True,902778,True,1,0,1,1
167125,2019-10-07 00:00:00+03:00,out,False,902746,False,55,4075,5015,940
167125,2019-10-07 00:00:00+03:00,out,False,902776,False,53,6811,7694,883
167125,2019-10-07 00:00:00+03:00,out,True,902748,True,1,0,0,0
167125,2019-10-07 00:00:00+03:00,out,False,902742,False,28,5510,5960,450
167125,2019-10-07 00:00:00+03:00,out,False,902782,False,44,7774,8428,654
167125,2019-10-07 00:00:00+03:00,out,False,902744,True,112,0,1963,1963
167125,2019-10-07 00:00:00+03:00,in,False,-1,True,37,0,1441,1441
167125,2019-10-07 00:00:00+03:00,out,True,902748,True,1,0,0,0
167125,2019-10-08 00:00:00+03:00,out,False,902748,True,54,0,1381,1381
167125,2019-10-08 00:00:00+03:00,out,False,902744,False,24,1588,1948,360
167125,2019-10-08 00:00:00+03:00,out,False,902776,False,42,5492,6165,673
167125,2019-10-08 00:00:00+03:00,out,False,902778,True,45,0,774,774
167125,2019-10-08 00:00:00+03:00,out,False,902744,True,55,0,1161,1161
167125,2019-10-08 00:00:00+03:00,out,False,902778,False,27,3773,4266,493
167125,2019-10-08 00:00:00+03:00,out,True,902748,True,1,0,3,3
167125,2019-10-08 00:00:00+03:00,out,True,902746,True,1,0,5,5
167125,2019-10-08 00:00:00+03:00,in,False,-1,True,23,0,435,435
167125,2019-10-08 00:00:00+03:00,out,False,902742,False,14,3557,3854,297
167125,2019-10-08 00:00:00+03:00,out,True,902774,True,1,0,2,2
167125,2019-10-08 00:00:00+03:00,out,False,902776,True,76,0,1890,1890
167125,2019-10-08 00:00:00+03:00,out,False,902742,True,27,0,1103,1103
167125,2019-10-08 00:00:00+03:00,out,False,902746,True,63,0,1462,1462
167125,2019-10-08 00:00:00+03:00,out,False,902746,False,30,3305,3773,468
167125,2019-10-08 00:00:00+03:00,out,False,902782,False,41,7967,8754,787
167125,2019-10-08 00:00:00+03:00,out,True,902776,True,1,0,13,13
167125,2019-10-08 00:00:00+03:00,out,False,902748,False,25,1365,1787,422
167125,2019-10-08 00:00:00+03:00,out,False,902782,True,45,0,1180,1180
167125,2019-10-08 00:00:00+03:00,out,False,902774,False,13,1294,1456,162
167125,2019-10-08 00:00:00+03:00,out,False,902774,True,24,0,952,952
167125,2019-10-08 00:00:00+03:00,out,False,902776,False,42,5492,6165,673
167125,2019-10-08 00:00:00+03:00,out,True,902746,True,1,0,5,5
167125,2019-10-08 00:00:00+03:00,out,True,902748,True,1,0,3,3
167125,2019-10-09 00:00:00+03:00,out,True,902778,True,1,0,2,2
167125,2019-10-09 00:00:00+03:00,out,False,902744,False,54,4417,5244,827
167125,2019-10-09 00:00:00+03:00,out,False,902778,False,52,9283,10261,978
167125,2019-10-09 00:00:00+03:00,in,False,-1,True,31,0,999,999
167125,2019-10-09 00:00:00+03:00,out,False,902776,True,107,0,2151,2151
167125,2019-10-09 00:00:00+03:00,out,False,902774,True,64,0,2115,2115
167125,2019-10-09 00:00:00+03:00,out,False,902746,True,40,0,742,742
167125,2019-10-09 00:00:00+03:00,out,False,902742,True,51,0,939,939
167125,2019-10-09 00:00:00+03:00,out,True,902742,True,1,0,0,0
167125,2019-10-09 00:00:00+03:00,out,True,902744,True,1,0,5,5
167125,2019-10-09 00:00:00+03:00,out,False,902782,False,21,6183,6548,365
167125,2019-10-09 00:00:00+03:00,out,False,902748,False,48,4077,4812,735
167125,2019-10-09 00:00:00+03:00,out,False,902776,False,48,4562,5347,785
167125,2019-10-09 00:00:00+03:00,out,False,902782,True,22,0,681,681
167125,2019-10-09 00:00:00+03:00,out,False,902774,False,33,3160,3813,653
167125,2019-10-09 00:00:00+03:00,out,False,902744,True,126,0,2031,2031
167125,2019-10-09 00:00:00+03:00,out,False,902778,True,105,0,1626,1626
167125,2019-10-09 00:00:00+03:00,out,False,902742,False,37,5278,5915,637
167125,2019-10-09 00:00:00+03:00,out,False,902748,True,93,0,2292,2292
167125,2019-10-09 00:00:00+03:00,out,False,902746,False,36,6640,7299,659
167125,2019-10-09 00:00:00+03:00,out,False,902782,False,21,6183,6548,365
167125,2019-10-09 00:00:00+03:00,out,False,902744,True,126,0,2031,2031
167125,2019-10-10 00:00:00+03:00,out,False,902744,False,61,4918,5676,758
167125,2019-10-10 00:00:00+03:00,out,True,902744,True,1,0,5,5
167125,2019-10-10 00:00:00+03:00,out,True,902778,True,1,0,0,0
167125,2019-10-10 00:00:00+03:00,out,False,902774,False,32,4942,5615,673
167125,2019-10-10 00:00:00+03:00,out,False,902782,False,23,8620,9034,414
167125,2019-10-10 00:00:00+03:00,out,False,902776,False,39,8522,9271,749
167125,2019-10-10 00:00:00+03:00,out,False,902744,True,110,0,1686,1686
167125,2019-10-10 00:00:00+03:00,out,False,902782,True,14,0,438,438
167125,2019-10-10 00:00:00+03:00,out,False,902742,True,50,0,890,890
167125,2019-10-10 00:00:00+03:00,out,False,902774,True,43,0,1493,1493
167125,2019-10-10 00:00:00+03:00,out,False,902778,False,35,7860,8470,610
167125,2019-10-10 00:00:00+03:00,out,False,902746,True,86,0,1897,1897
167125,2019-10-10 00:00:00+03:00,out,False,902746,False,40,8935,9698,763
167125,2019-10-10 00:00:00+03:00,in,False,-1,True,22,0,901,901
167125,2019-10-10 00:00:00+03:00,out,False,902742,False,36,3804,4407,603
167125,2019-10-10 00:00:00+03:00,out,False,902776,True,95,0,2445,2445
167125,2019-10-10 00:00:00+03:00,out,False,902778,True,97,0,1869,1869
167125,2019-10-11 00:00:00+03:00,out,False,902742,False,29,4612,5256,644
167125,2019-10-11 00:00:00+03:00,out,False,902778,False,35,9334,9782,448
167125,2019-10-11 00:00:00+03:00,out,True,902774,True,1,0,0,0
167125,2019-10-11 00:00:00+03:00,out,True,902776,True,1,0,4,4
167125,2019-10-11 00:00:00+03:00,out,False,902776,True,66,0,1679,1679
167125,2019-10-11 00:00:00+03:00,out,False,902782,True,35,0,1054,1054
167125,2019-10-11 00:00:00+03:00,out,True,902742,True,1,0,1,1
167125,2019-10-11 00:00:00+03:00,in,False,-1,True,16,0,664,664
167125,2019-10-11 00:00:00+03:00,out,False,902744,False,44,4004,4621,617
167125,2019-10-11 00:00:00+03:00,out,False,902748,False,43,4634,5389,755
167125,2019-10-11 00:00:00+03:00,out,False,902774,True,25,0,564,564
167125,2019-10-11 00:00:00+03:00,out,False,902776,False,54,8175,9080,905
167125,2019-10-11 00:00:00+03:00,out,False,902744,True,106,0,2029,2029
167125,2019-10-11 00:00:00+03:00,out,True,902778,True,4,0,14,14
167125,2019-10-11 00:00:00+03:00,out,True,902782,True,2,0,1,1
167125,2019-10-11 00:00:00+03:00,out,False,902748,True,38,0,982,982
167125,2019-10-11 00:00:00+03:00,out,False,902778,True,94,0,1613,1613
167125,2019-10-11 00:00:00+03:00,out,False,902774,False,28,4513,4970,457
167125,2019-10-11 00:00:00+03:00,out,False,902746,False,32,4530,5114,584
167125,2019-10-11 00:00:00+03:00,out,True,902744,True,2,0,10,10
167125,2019-10-11 00:00:00+03:00,out,False,902746,True,68,0,1280,1280
167125,2019-10-11 00:00:00+03:00,out,False,902782,False,35,8131,8869,738
167125,2019-10-11 00:00:00+03:00,out,False,902742,True,18,0,381,381
167125,2019-10-11 00:00:00+03:00,out,False,902782,True,35,0,1054,1054
167125,2019-10-12 00:00:00+03:00,out,False,902778,True,16,0,137,137
167125,2019-10-12 00:00:00+03:00,out,False,902782,False,1,1668,1680,12
167125,2019-10-12 00:00:00+03:00,out,False,902746,False,2,283,312,29
167125,2019-10-12 00:00:00+03:00,out,False,902776,True,10,0,307,307
167125,2019-10-12 00:00:00+03:00,in,False,-1,True,7,0,335,335
167125,2019-10-12 00:00:00+03:00,out,False,902778,False,4,1378,1446,68
167125,2019-10-12 00:00:00+03:00,out,False,902744,True,16,0,206,206
167125,2019-10-12 00:00:00+03:00,out,False,902782,True,1,0,0,0
167125,2019-10-12 00:00:00+03:00,out,False,902744,False,5,87,140,53
167125,2019-10-12 00:00:00+03:00,out,False,902742,False,3,1228,1297,69
167125,2019-10-12 00:00:00+03:00,out,False,902742,True,2,0,102,102
167125,2019-10-12 00:00:00+03:00,out,False,902776,False,3,494,552,58
167125,2019-10-12 00:00:00+03:00,out,False,902774,True,4,0,232,232
167125,2019-10-12 00:00:00+03:00,in,False,-1,True,7,0,335,335
167125,2019-10-12 00:00:00+03:00,out,False,902742,False,3,1228,1297,69
167125,2019-10-13 00:00:00+03:00,in,False,-1,True,1,0,2,2
167125,2019-10-14 00:00:00+03:00,in,False,-1,True,6,0,12,12
167125,2019-10-15 00:00:00+03:00,in,False,-1,True,11,0,24,24
167125,2019-10-16 00:00:00+03:00,in,False,-1,True,10,0,20,20
167125,2019-10-17 00:00:00+03:00,in,False,-1,True,1,0,2,2
167125,2019-10-18 00:00:00+03:00,in,False,-1,True,3,0,6,6
167125,2019-10-23 00:00:00+03:00,in,False,-1,True,1,0,2,2
167125,2019-10-26 00:00:00+03:00,in,False,-1,True,1,0,2,2
167125,2019-10-27 00:00:00+03:00,in,False,-1,True,4,0,7,7
167125,2019-10-28 00:00:00+03:00,in,False,-1,True,1,0,2,2
167125,2019-10-29 00:00:00+03:00,in,False,-1,True,4,0,11,11
167125,2019-10-30 00:00:00+03:00,in,False,-1,True,9,0,21,21
167125,2019-10-31 00:00:00+03:00,in,False,-1,True,1,0,2,2
167130,2019-09-03 00:00:00+03:00,in,False,902608,False,5,272,358,86
167130,2019-09-03 00:00:00+03:00,in,False,-1,True,11,0,101,101
167130,2019-09-03 00:00:00+03:00,in,True,902608,False,5,276,314,38
167130,2019-09-03 00:00:00+03:00,in,False,-1,True,1,0,12,12
167130,2019-09-03 00:00:00+03:00,out,False,902608,False,7,362,502,140
167130,2019-09-03 00:00:00+03:00,out,True,902608,False,1,109,126,17
167130,2019-09-03 00:00:00+03:00,out,False,902608,True,3,0,55,55
167130,2019-09-04 00:00:00+03:00,in,False,902608,False,1,106,110,4
167130,2019-09-04 00:00:00+03:00,out,False,902608,True,7,0,99,99
167130,2019-09-04 00:00:00+03:00,out,False,902608,False,6,627,726,99
167130,2019-09-04 00:00:00+03:00,in,False,-1,True,2,0,19,19
167130,2019-09-04 00:00:00+03:00,in,False,902608,False,1,106,110,4
167130,2019-09-05 00:00:00+03:00,out,False,902608,False,17,650,933,283
167130,2019-09-05 00:00:00+03:00,out,False,902608,True,8,0,154,154
167130,2019-09-06 00:00:00+03:00,out,False,902608,True,1,0,14,14
167130,2019-09-07 00:00:00+03:00,in,False,-1,True,3,0,6,6
167130,2019-09-07 00:00:00+03:00,out,True,902608,True,4,0,8,8
167130,2019-09-07 00:00:00+03:00,out,False,902608,True,1,0,0,0
167130,2019-09-07 00:00:00+03:00,in,True,902608,False,1,27,31,4
167130,2019-09-08 00:00:00+03:00,in,False,-1,True,11,0,359,359
167130,2019-09-09 00:00:00+03:00,out,False,902608,False,15,1530,1823,293
167130,2019-09-09 00:00:00+03:00,out,False,902608,True,12,0,364,364
167130,2019-09-10 00:00:00+03:00,out,False,902608,False,42,2830,3744,914
167130,2019-09-10 00:00:00+03:00,in,False,902608,False,1,307,312,5
167130,2019-09-10 00:00:00+03:00,out,False,902608,True,33,0,865,865
167130,2019-09-11 00:00:00+03:00,out,False,902608,False,38,1578,2274,696
167130,2019-09-11 00:00:00+03:00,out,False,902608,True,22,0,667,667
167130,2019-09-11 00:00:00+03:00,in,False,-1,True,2,0,16,16
167130,2019-09-11 00:00:00+03:00,in,False,-1,True,3,0,81,81
167130,2019-09-12 00:00:00+03:00,out,True,902608,True,2,0,9,9
167139,2019-11-08 00:00:00+03:00,in,False,-1,True,1,0,26,26
167139,2019-11-08 00:00:00+03:00,in,False,950640,False,1,184,193,9
167141,2019-09-06 00:00:00+03:00,in,False,905870,False,8,764,823,59
167141,2019-09-06 00:00:00+03:00,in,False,-1,True,19,0,139,139
167141,2019-09-06 00:00:00+03:00,out,False,905870,True,12,0,563,563
167141,2019-09-06 00:00:00+03:00,out,False,905870,False,11,1013,1156,143
167141,2019-09-06 00:00:00+03:00,in,False,905870,False,8,764,823,59
167141,2019-09-07 00:00:00+03:00,in,False,-1,True,3,0,34,34
167141,2019-09-07 00:00:00+03:00,out,False,905870,True,6,0,257,257
167141,2019-09-07 00:00:00+03:00,in,False,905870,False,2,102,108,6
167141,2019-09-07 00:00:00+03:00,out,False,905870,False,23,1720,2098,378
167141,2019-09-08 00:00:00+03:00,in,False,-1,True,11,0,0,0
167141,2019-09-09 00:00:00+03:00,out,False,905870,True,11,0,217,217
167141,2019-09-09 00:00:00+03:00,in,False,-1,True,10,0,63,63
167141,2019-09-09 00:00:00+03:00,out,False,905870,False,9,531,675,144
167141,2019-09-10 00:00:00+03:00,out,False,905870,True,7,0,232,232
167141,2019-09-10 00:00:00+03:00,out,False,905870,False,10,911,1062,151
167141,2019-09-10 00:00:00+03:00,in,False,-1,True,11,0,83,83
167141,2019-09-10 00:00:00+03:00,out,False,905870,True,7,0,232,232
167141,2019-09-10 00:00:00+03:00,in,False,-1,True,11,0,83,83
167141,2019-09-11 00:00:00+03:00,out,False,905870,False,13,1655,1860,205
167141,2019-09-11 00:00:00+03:00,in,False,905870,False,3,224,264,40
167141,2019-09-11 00:00:00+03:00,out,False,905870,True,9,0,241,241
167141,2019-09-11 00:00:00+03:00,in,False,-1,True,2,0,42,42
167141,2019-09-12 00:00:00+03:00,in,False,-1,True,13,0,292,292
167141,2019-09-12 00:00:00+03:00,in,False,905870,False,6,1537,1614,77
167141,2019-09-12 00:00:00+03:00,out,False,905870,False,32,2034,2616,582
167141,2019-09-12 00:00:00+03:00,out,False,905870,True,6,0,227,227
167141,2019-09-13 00:00:00+03:00,out,False,905870,True,2,0,68,68
167141,2019-09-13 00:00:00+03:00,out,False,905870,False,5,261,326,65
167141,2019-09-13 00:00:00+03:00,in,False,905870,False,3,427,483,56
167141,2019-09-13 00:00:00+03:00,in,False,-1,True,2,0,6,6
167141,2019-09-14 00:00:00+03:00,out,False,905870,True,25,0,806,806
167141,2019-09-14 00:00:00+03:00,out,False,905870,False,52,3704,4601,897
167141,2019-09-14 00:00:00+03:00,in,False,-1,True,12,0,31,31
167141,2019-09-14 00:00:00+03:00,in,False,905870,False,8,1119,1218,99
167141,2019-09-15 00:00:00+03:00,out,False,905870,False,45,3691,4530,839
167141,2019-09-15 00:00:00+03:00,out,False,905870,True,28,0,881,881
167141,2019-09-15 00:00:00+03:00,in,False,905870,False,5,621,675,54
167141,2019-09-15 00:00:00+03:00,in,False,-1,True,1,0,0,0
167141,2019-09-16 00:00:00+03:00,in,False,905870,False,8,897,996,99
167141,2019-09-16 00:00:00+03:00,in,False,-1,True,17,0,269,269
167141,2019-09-16 00:00:00+03:00,out,False,905870,False,22,1347,1765,418
167141,2019-09-16 00:00:00+03:00,out,False,905870,True,6,0,214,214
167141,2019-09-16 00:00:00+03:00,out,False,905870,True,6,0,214,214
167141,2019-09-17 00:00:00+03:00,out,False,905870,True,8,0,265,265
167141,2019-09-17 00:00:00+03:00,in,False,905870,False,7,549,646,97
167141,2019-09-17 00:00:00+03:00,in,False,-1,True,3,0,80,80
167141,2019-09-17 00:00:00+03:00,out,False,905870,False,35,3041,3495,454
167141,2019-09-17 00:00:00+03:00,out,False,905870,False,35,3041,3495,454
167141,2019-09-18 00:00:00+03:00,in,False,-1,True,10,0,97,97
167141,2019-09-18 00:00:00+03:00,out,False,905870,False,35,2917,3455,538
167141,2019-09-18 00:00:00+03:00,in,False,905870,False,5,529,595,66
167141,2019-09-18 00:00:00+03:00,out,False,905870,True,6,0,226,226
167141,2019-09-19 00:00:00+03:00,out,False,905870,True,13,0,358,358
167141,2019-09-19 00:00:00+03:00,in,False,905870,False,6,915,992,77
167141,2019-09-19 00:00:00+03:00,out,False,905870,False,43,3864,4582,718
167141,2019-09-19 00:00:00+03:00,in,False,-1,True,2,0,31,31
167141,2019-09-20 00:00:00+03:00,in,False,905870,False,1,90,113,23
167141,2019-09-20 00:00:00+03:00,out,False,905870,False,8,481,615,134
167141,2019-09-20 00:00:00+03:00,in,False,-1,True,8,0,194,194
167141,2019-09-20 00:00:00+03:00,out,False,905870,True,3,0,110,110
167141,2019-09-20 00:00:00+03:00,out,False,905870,True,3,0,110,110
167141,2019-09-21 00:00:00+03:00,in,False,-1,True,11,0,124,124
167141,2019-09-22 00:00:00+03:00,out,False,905870,True,5,0,179,179
167141,2019-09-22 00:00:00+03:00,in,False,-1,True,2,0,1,1
167141,2019-09-22 00:00:00+03:00,out,False,905870,False,13,1538,1719,181
167141,2019-09-22 00:00:00+03:00,in,False,905870,False,4,567,602,35
167141,2019-09-23 00:00:00+03:00,in,False,905870,False,3,244,272,28
167141,2019-09-23 00:00:00+03:00,in,False,-1,True,8,0,158,158
167141,2019-09-24 00:00:00+03:00,in,False,-1,True,13,0,28,28
167141,2019-09-24 00:00:00+03:00,in,False,905870,False,1,48,58,10
167141,2019-09-25 00:00:00+03:00,in,False,905870,False,1,63,70,7
167141,2019-09-25 00:00:00+03:00,in,False,-1,True,4,0,142,142
167141,2019-09-26 00:00:00+03:00,in,False,-1,True,1,0,44,44
167141,2019-09-26 00:00:00+03:00,in,False,905870,False,4,714,769,55
167141,2019-09-27 00:00:00+03:00,in,False,-1,True,1,0,17,17
167141,2019-09-27 00:00:00+03:00,in,False,905870,False,3,613,655,42
167141,2019-09-27 00:00:00+03:00,out,False,905870,False,1,140,145,5
167141,2019-09-28 00:00:00+03:00,in,False,905870,False,2,264,286,22
167141,2019-09-29 00:00:00+03:00,in,False,-1,True,3,0,119,119
167141,2019-09-29 00:00:00+03:00,in,False,905870,False,8,368,431,63
167141,2019-09-30 00:00:00+03:00,in,False,905870,False,12,1158,1314,156
167141,2019-09-30 00:00:00+03:00,in,False,-1,True,4,0,60,60
167141,2019-09-30 00:00:00+03:00,out,False,905870,True,1,0,2,2
167141,2019-09-30 00:00:00+03:00,out,False,905870,True,1,0,2,2
167141,2019-10-01 00:00:00+03:00,in,False,-1,True,9,0,211,211
167141,2019-10-01 00:00:00+03:00,in,False,905870,False,2,176,203,27
167141,2019-10-02 00:00:00+03:00,out,False,905870,False,5,599,669,70
167141,2019-10-02 00:00:00+03:00,out,False,905870,True,1,0,41,41
167141,2019-10-02 00:00:00+03:00,in,False,905870,False,2,325,352,27
167141,2019-10-02 00:00:00+03:00,in,False,-1,True,1,0,0,0
167141,2019-10-03 00:00:00+03:00,in,False,905870,False,5,424,499,75
167141,2019-10-03 00:00:00+03:00,out,False,905870,True,3,0,52,52
167141,2019-10-03 00:00:00+03:00,out,False,905870,False,4,509,591,82
167141,2019-10-03 00:00:00+03:00,in,False,-1,True,4,0,96,96
167141,2019-10-03 00:00:00+03:00,out,False,905870,True,3,0,52,52
167141,2019-10-04 00:00:00+03:00,out,False,905870,False,2,83,102,19
167141,2019-10-04 00:00:00+03:00,in,False,-1,True,14,0,485,485
167141,2019-10-05 00:00:00+03:00,out,False,905870,True,5,0,116,116
167141,2019-10-05 00:00:00+03:00,in,False,-1,True,1,0,5,5
167141,2019-10-05 00:00:00+03:00,out,False,905870,False,12,1954,2152,198
167141,2019-10-06 00:00:00+03:00,out,False,905870,False,14,1410,1651,241
167141,2019-10-06 00:00:00+03:00,in,False,-1,True,1,0,14,14
167141,2019-10-06 00:00:00+03:00,out,False,905870,True,6,0,186,186
167141,2019-10-07 00:00:00+03:00,in,False,-1,True,3,0,135,135
167141,2019-10-07 00:00:00+03:00,in,False,905870,False,2,137,153,16
167141,2019-10-08 00:00:00+03:00,in,False,905870,False,2,289,301,12
167141,2019-10-08 00:00:00+03:00,out,False,905870,True,1,0,18,18
167141,2019-10-08 00:00:00+03:00,in,False,-1,True,5,0,0,0
167141,2019-10-09 00:00:00+03:00,in,False,-1,True,9,0,108,108
167141,2019-10-09 00:00:00+03:00,in,False,905870,False,3,82,125,43
167141,2019-10-10 00:00:00+03:00,in,False,-1,True,7,0,175,175
167141,2019-10-10 00:00:00+03:00,in,False,905870,False,9,1626,1744,118
167141,2019-10-11 00:00:00+03:00,in,False,-1,True,5,0,175,175
167141,2019-10-11 00:00:00+03:00,in,False,905870,False,8,1272,1351,79
167141,2019-10-12 00:00:00+03:00,in,False,-1,True,7,0,244,244
167141,2019-10-12 00:00:00+03:00,out,False,905870,True,1,0,9,9
167141,2019-10-12 00:00:00+03:00,in,False,905870,False,7,560,637,77
167141,2019-10-12 00:00:00+03:00,in,False,-1,True,7,0,244,244
167141,2019-10-13 00:00:00+03:00,in,False,-1,True,2,0,0,0
167141,2019-10-13 00:00:00+03:00,in,False,905870,False,3,102,148,46
167144,2019-09-04 00:00:00+03:00,in,False,903974,False,1,4,22,18
167144,2019-09-04 00:00:00+03:00,in,False,903974,False,1,4,22,18
167144,2019-09-05 00:00:00+03:00,in,False,903976,False,4,132,169,37
167144,2019-09-05 00:00:00+03:00,in,False,903978,False,4,134,172,38
167144,2019-09-05 00:00:00+03:00,in,False,-1,True,3,0,51,51
167144,2019-09-05 00:00:00+03:00,in,False,905082,False,2,5,39,34
167144,2019-09-05 00:00:00+03:00,in,False,903974,False,9,89,238,149
167144,2019-09-05 00:00:00+03:00,in,False,903978,False,4,134,172,38
167144,2019-09-05 00:00:00+03:00,in,False,905082,False,2,5,39,34
167144,2019-09-06 00:00:00+03:00,in,False,903976,False,1,2,7,5
167144,2019-09-08 00:00:00+03:00,out,True,903978,True,1,0,0,0
167144,2019-09-08 00:00:00+03:00,out,False,903978,False,1,8,22,14
167144,2019-09-10 00:00:00+03:00,out,True,903978,True,4,0,0,0
167144,2019-09-10 00:00:00+03:00,in,False,-1,True,1,0,1,1
167144,2019-09-10 00:00:00+03:00,out,True,903978,True,4,0,0,0
167144,2019-09-11 00:00:00+03:00,in,False,-1,True,7,0,9,9
167144,2019-09-12 00:00:00+03:00,in,False,-1,True,2,0,1,1
167144,2019-09-13 00:00:00+03:00,in,False,-1,True,3,0,1,1
167144,2019-09-16 00:00:00+03:00,in,False,-1,True,7,0,7,7
167144,2019-09-17 00:00:00+03:00,in,False,-1,True,12,0,17,17
167144,2019-09-18 00:00:00+03:00,in,False,-1,True,1,0,1,1
167144,2019-09-19 00:00:00+03:00,in,False,-1,True,2,0,1,1
167144,2019-09-23 00:00:00+03:00,in,False,-1,True,1,0,2,2
167144,2019-10-07 00:00:00+03:00,in,False,-1,True,1,0,2,2
167144,2019-10-10 00:00:00+03:00,in,False,-1,True,1,0,2,2
167144,2019-10-10 00:00:00+03:00,in,False,-1,True,1,0,2,2
167144,2019-10-16 00:00:00+03:00,in,False,-1,True,1,0,2,2
167150,2019-09-06 00:00:00+03:00,out,False,905542,False,3,204,264,60
167150,2019-09-06 00:00:00+03:00,in,False,905538,False,1,45,57,12
167150,2019-09-06 00:00:00+03:00,in,False,-1,True,15,0,155,155
167150,2019-09-06 00:00:00+03:00,out,False,905574,False,2,34,46,12
167150,2019-09-06 00:00:00+03:00,out,False,905566,False,3,166,201,35
167150,2019-09-06 00:00:00+03:00,out,False,905542,True,7,0,48,48
167150,2019-09-06 00:00:00+03:00,out,False,905566,True,1,0,7,7
167150,2019-09-06 00:00:00+03:00,out,False,905538,False,5,364,467,103
167150,2019-09-06 00:00:00+03:00,out,False,905574,True,8,0,51,51
167150,2019-09-06 00:00:00+03:00,out,False,905538,True,2,0,19,19
167150,2019-09-06 00:00:00+03:00,in,False,905566,False,1,8,17,9
167150,2019-09-06 00:00:00+03:00,out,True,905574,False,1,26,45,19
167150,2019-09-06 00:00:00+03:00,in,False,905538,False,1,45,57,12
167150,2019-09-06 00:00:00+03:00,out,False,905574,False,2,34,46,12
167150,2019-09-08 00:00:00+03:00,in,False,-1,True,1,0,11,11
167150,2019-09-09 00:00:00+03:00,out,False,905566,False,7,437,546,109
167150,2019-09-09 00:00:00+03:00,out,False,905566,True,2,0,11,11
167150,2019-09-10 00:00:00+03:00,in,False,905542,True,1,43,47,4
167150,2019-09-10 00:00:00+03:00,out,True,905542,True,5,0,40,40
167150,2019-09-10 00:00:00+03:00,out,True,905542,False,3,41,58,17
167150,2019-09-10 00:00:00+03:00,out,True,905538,False,2,100,113,13
167150,2019-09-10 00:00:00+03:00,out,False,905574,False,1,27,35,8
167150,2019-09-10 00:00:00+03:00,out,True,905574,False,11,194,264,70
167150,2019-09-10 00:00:00+03:00,out,False,905564,True,1,0,5,5
167150,2019-09-10 00:00:00+03:00,out,True,905564,True,3,0,24,24
167150,2019-09-10 00:00:00+03:00,out,False,905574,True,4,0,131,131
167150,2019-09-10 00:00:00+03:00,in,False,-1,True,24,0,286,286
167150,2019-09-10 00:00:00+03:00,in,False,905538,False,5,144,182,38
167150,2019-09-10 00:00:00+03:00,in,False,905542,False,4,52,95,43
167150,2019-09-10 00:00:00+03:00,out,False,905538,True,5,0,47,47
167150,2019-09-10 00:00:00+03:00,out,True,905574,True,17,0,214,214
167150,2019-09-10 00:00:00+03:00,out,True,905566,False,9,253,314,61
167150,2019-09-10 00:00:00+03:00,out,True,905538,True,2,0,14,14
167150,2019-09-10 00:00:00+03:00,out,True,905564,False,4,107,120,13
167150,2019-09-10 00:00:00+03:00,out,False,905566,False,6,527,587,60
167150,2019-09-10 00:00:00+03:00,out,True,905566,True,7,0,100,100
167150,2019-09-10 00:00:00+03:00,out,False,905542,True,9,0,145,145
167150,2019-09-10 00:00:00+03:00,out,False,905566,True,4,0,35,35
167150,2019-09-10 00:00:00+03:00,in,False,905566,False,6,140,212,72
167150,2019-09-10 00:00:00+03:00,out,False,905542,False,21,1400,1653,253
167150,2019-09-10 00:00:00+03:00,out,False,905538,False,12,962,1122,160
167150,2019-09-10 00:00:00+03:00,in,False,905542,False,4,52,95,43
167150,2019-09-11 00:00:00+03:00,out,False,905542,False,21,1493,1687,194
167150,2019-09-11 00:00:00+03:00,out,True,905574,False,7,267,315,48
167150,2019-09-11 00:00:00+03:00,out,False,905538,True,7,0,40,40
167150,2019-09-11 00:00:00+03:00,out,False,905574,False,7,200,240,40
167150,2019-09-11 00:00:00+03:00,out,True,905566,False,7,116,186,70
167150,2019-09-11 00:00:00+03:00,out,False,905538,False,17,642,853,211
167150,2019-09-11 00:00:00+03:00,out,False,905542,True,8,0,132,132
167150,2019-09-11 00:00:00+03:00,out,True,905542,False,4,340,363,23
167150,2019-09-11 00:00:00+03:00,out,False,905566,False,7,507,573,66
167150,2019-09-11 00:00:00+03:00,out,True,905574,True,3,0,62,62
167150,2019-09-11 00:00:00+03:00,out,True,905542,True,1,0,4,4
167150,2019-09-11 00:00:00+03:00,in,False,905538,False,2,106,120,14
167150,2019-09-11 00:00:00+03:00,out,True,905570,False,1,8,19,11
167150,2019-09-11 00:00:00+03:00,out,False,905566,True,1,0,65,65
167150,2019-09-11 00:00:00+03:00,out,True,905566,True,3,0,15,15
167150,2019-09-11 00:00:00+03:00,in,False,905538,False,2,106,120,14
167150,2019-09-11 00:00:00+03:00,out,False,905538,True,7,0,40,40
167150,2019-09-11 00:00:00+03:00,out,True,905542,False,4,340,363,23
167150,2019-09-11 00:00:00+03:00,out,False,905542,False,21,1493,1687,194
167150,2019-09-12 00:00:00+03:00,out,True,905566,False,11,403,508,105
167150,2019-09-12 00:00:00+03:00,out,False,905574,True,2,0,78,78
167150,2019-09-12 00:00:00+03:00,out,True,905570,False,1,3,9,6
167150,2019-09-12 00:00:00+03:00,out,True,905574,False,8,191,227,36
167150,2019-09-12 00:00:00+03:00,out,False,905538,False,35,1730,2220,490
167150,2019-09-12 00:00:00+03:00,out,True,905574,True,13,0,169,169
167150,2019-09-12 00:00:00+03:00,out,False,905542,True,9,0,205,205
167150,2019-09-12 00:00:00+03:00,in,False,905574,False,1,7,17,10
167150,2019-09-12 00:00:00+03:00,in,False,-1,True,28,0,290,290
167150,2019-09-12 00:00:00+03:00,out,True,905542,False,6,301,357,56
167150,2019-09-12 00:00:00+03:00,out,False,905574,False,3,188,239,51
167150,2019-09-12 00:00:00+03:00,out,True,905542,True,4,0,14,14
167150,2019-09-12 00:00:00+03:00,out,True,905570,True,2,0,53,53
167150,2019-09-12 00:00:00+03:00,in,False,905566,False,1,17,22,5
167150,2019-09-12 00:00:00+03:00,in,False,905538,False,5,273,303,30
167150,2019-09-12 00:00:00+03:00,out,False,905566,True,28,0,685,685
167150,2019-09-12 00:00:00+03:00,in,False,905542,False,2,39,65,26
167150,2019-09-12 00:00:00+03:00,out,True,905538,True,5,0,43,43
167150,2019-09-12 00:00:00+03:00,out,True,905566,True,2,0,0,0
167150,2019-09-12 00:00:00+03:00,out,False,905542,False,23,1000,1244,244
167150,2019-09-12 00:00:00+03:00,out,False,905566,False,12,1803,1940,137
167150,2019-09-12 00:00:00+03:00,out,False,905538,True,13,0,290,290
167150,2019-09-12 00:00:00+03:00,out,True,905538,False,4,18,34,16
167150,2019-09-12 00:00:00+03:00,in,False,905574,False,1,7,17,10
167150,2019-09-12 00:00:00+03:00,out,False,905538,True,13,0,290,290
167150,2019-09-12 00:00:00+03:00,out,True,905570,False,1,3,9,6
167150,2019-09-12 00:00:00+03:00,out,True,905574,True,13,0,169,169
167150,2019-09-13 00:00:00+03:00,out,True,905570,False,3,290,309,19
167150,2019-09-13 00:00:00+03:00,out,False,905538,True,26,0,317,317
167150,2019-09-13 00:00:00+03:00,out,True,905574,False,1,21,29,8
167150,2019-09-13 00:00:00+03:00,out,False,905538,False,31,2043,2468,425
167150,2019-09-13 00:00:00+03:00,in,False,-1,True,3,0,28,28
167150,2019-09-13 00:00:00+03:00,out,False,905566,False,6,486,538,52
167150,2019-09-13 00:00:00+03:00,out,True,905538,True,1,0,16,16
167150,2019-09-13 00:00:00+03:00,out,True,905570,False,3,290,309,19
167150,2019-09-14 00:00:00+03:00,in,False,-1,True,1,0,13,13
167150,2019-09-16 00:00:00+03:00,out,True,905542,False,3,93,111,18
167150,2019-09-16 00:00:00+03:00,out,False,905542,False,20,2120,2323,203
167150,2019-09-16 00:00:00+03:00,in,False,-1,True,7,0,57,57
167150,2019-09-16 00:00:00+03:00,out,True,905574,True,2,0,35,35
167150,2019-09-16 00:00:00+03:00,out,False,905542,True,2,0,0,0
167150,2019-09-16 00:00:00+03:00,in,False,905542,False,7,466,500,34
167150,2019-09-16 00:00:00+03:00,out,True,905542,True,7,0,26,26
167150,2019-09-16 00:00:00+03:00,out,False,905566,False,9,714,806,92
167150,2019-09-16 00:00:00+03:00,out,True,905574,False,3,47,68,21
167150,2019-09-16 00:00:00+03:00,in,False,905566,False,7,298,345,47
167150,2019-09-16 00:00:00+03:00,out,False,905574,False,1,537,549,12
167150,2019-09-16 00:00:00+03:00,out,True,905566,False,5,133,172,39
167150,2019-09-16 00:00:00+03:00,out,True,905566,True,1,0,16,16
167150,2019-09-16 00:00:00+03:00,out,False,905566,True,2,0,35,35
167150,2019-09-16 00:00:00+03:00,out,False,905574,False,1,537,549,12
167150,2019-09-17 00:00:00+03:00,in,False,905542,False,1,31,39,8
167150,2019-09-17 00:00:00+03:00,in,False,-1,True,10,0,119,119
167150,2019-09-17 00:00:00+03:00,in,False,905566,False,1,74,89,15
167150,2019-09-17 00:00:00+03:00,out,True,905574,False,2,30,47,17
167150,2019-09-17 00:00:00+03:00,in,False,905542,True,1,16,24,8
167150,2019-09-17 00:00:00+03:00,out,True,905574,True,1,0,0,0
167150,2019-09-17 00:00:00+03:00,out,True,905566,False,7,271,359,88
167150,2019-09-17 00:00:00+03:00,out,False,905564,False,2,1251,1274,23
167150,2019-09-17 00:00:00+03:00,out,True,905542,False,3,445,472,27
167150,2019-09-17 00:00:00+03:00,out,True,905564,False,2,13,35,22
167150,2019-09-17 00:00:00+03:00,out,False,905542,False,29,2315,2593,278
167150,2019-09-17 00:00:00+03:00,out,False,905542,True,10,0,34,34
167150,2019-09-17 00:00:00+03:00,out,False,-1,True,1,0,0,0
167150,2019-09-17 00:00:00+03:00,out,False,905538,False,1,15,33,18
167150,2019-09-17 00:00:00+03:00,out,False,905574,False,1,13,27,14
167150,2019-09-17 00:00:00+03:00,out,True,905564,True,1,0,18,18
167150,2019-09-17 00:00:00+03:00,out,True,905566,True,3,0,87,87
167150,2019-09-17 00:00:00+03:00,out,False,905566,False,14,1066,1257,191
167150,2019-09-17 00:00:00+03:00,out,True,905570,False,1,32,38,6
167150,2019-09-17 00:00:00+03:00,out,True,905570,True,1,0,33,33
167150,2019-09-17 00:00:00+03:00,out,False,905566,True,5,0,41,41
167150,2019-09-17 00:00:00+03:00,out,False,905538,True,2,0,25,25
167150,2019-09-17 00:00:00+03:00,out,True,905574,True,1,0,0,0
167150,2019-09-18 00:00:00+03:00,in,False,905564,False,1,145,152,7
167150,2019-09-18 00:00:00+03:00,out,True,905574,False,3,737,755,18
167150,2019-09-18 00:00:00+03:00,out,True,905566,True,1,0,37,37
167150,2019-09-18 00:00:00+03:00,in,False,905542,False,1,54,64,10
167150,2019-09-18 00:00:00+03:00,out,True,905564,True,1,0,0,0
167150,2019-09-18 00:00:00+03:00,out,False,905538,True,14,0,385,385
167150,2019-09-18 00:00:00+03:00,out,True,905570,False,1,181,192,11
167150,2019-09-18 00:00:00+03:00,out,False,905564,False,3,213,255,42
167150,2019-09-18 00:00:00+03:00,out,False,905574,True,1,0,2,2
167150,2019-09-18 00:00:00+03:00,out,False,905542,True,11,0,221,221
167150,2019-09-18 00:00:00+03:00,in,False,905538,False,4,109,136,27
167150,2019-09-18 00:00:00+03:00,out,True,905542,True,1,0,16,16
167150,2019-09-18 00:00:00+03:00,out,False,905566,True,2,0,67,67
167150,2019-09-18 00:00:00+03:00,out,False,905566,False,4,194,252,58
167150,2019-09-18 00:00:00+03:00,out,True,905538,False,4,43,92,49
167150,2019-09-18 00:00:00+03:00,out,False,905542,False,17,1301,1505,204
167150,2019-09-18 00:00:00+03:00,out,True,905574,True,3,0,0,0
167150,2019-09-18 00:00:00+03:00,out,True,905566,False,1,59,78,19
167150,2019-09-18 00:00:00+03:00,out,False,905564,True,1,0,3,3
167150,2019-09-18 00:00:00+03:00,in,False,-1,True,1,0,36,36
167150,2019-09-18 00:00:00+03:00,out,False,905538,False,28,1724,2084,360
167150,2019-09-18 00:00:00+03:00,out,False,905538,False,28,1724,2084,360
167150,2019-09-19 00:00:00+03:00,out,False,905564,False,5,449,530,81
167150,2019-09-19 00:00:00+03:00,out,False,905566,False,1,32,39,7
167150,2019-09-19 00:00:00+03:00,out,False,905542,True,5,0,155,155
167150,2019-09-19 00:00:00+03:00,out,True,905574,False,1,24,34,10
167150,2019-09-19 00:00:00+03:00,out,False,905542,False,11,896,1008,112
167150,2019-09-19 00:00:00+03:00,out,True,905566,False,1,54,59,5
167150,2019-09-19 00:00:00+03:00,out,False,905538,False,26,1654,2087,433
167150,2019-09-19 00:00:00+03:00,in,False,-1,True,2,0,2,2
167150,2019-09-19 00:00:00+03:00,in,False,905538,False,1,42,50,8
167150,2019-09-19 00:00:00+03:00,out,True,905538,False,1,9,17,8
167150,2019-09-19 00:00:00+03:00,out,True,905564,False,2,6,34,28
167150,2019-09-19 00:00:00+03:00,out,False,905538,True,10,0,269,269
167150,2019-09-19 00:00:00+03:00,out,False,905566,False,1,32,39,7
167150,2019-09-19 00:00:00+03:00,out,False,905542,True,5,0,155,155
167150,2019-09-20 00:00:00+03:00,out,True,905566,False,2,49,83,34
167150,2019-09-20 00:00:00+03:00,out,False,905542,False,35,2823,3335,512
167150,2019-09-20 00:00:00+03:00,out,True,905538,False,3,221,259,38
167150,2019-09-20 00:00:00+03:00,out,True,905574,True,2,0,17,17
167150,2019-09-20 00:00:00+03:00,in,False,905538,False,4,510,550,40
167150,2019-09-20 00:00:00+03:00,out,True,905566,True,2,0,58,58
167150,2019-09-20 00:00:00+03:00,out,False,905564,False,5,960,1013,53
167150,2019-09-20 00:00:00+03:00,out,False,905566,True,1,0,10,10
167150,2019-09-20 00:00:00+03:00,out,False,905542,True,5,0,94,94
167150,2019-09-20 00:00:00+03:00,out,True,905542,False,1,52,68,16
167150,2019-09-20 00:00:00+03:00,out,False,905566,False,5,168,235,67
167150,2019-09-20 00:00:00+03:00,out,False,905538,False,56,4563,5365,802
167150,2019-09-20 00:00:00+03:00,out,False,905538,True,31,0,662,662
167150,2019-09-20 00:00:00+03:00,out,True,905538,True,3,0,43,43
167150,2019-09-20 00:00:00+03:00,out,True,905564,False,2,60,80,20
167150,2019-09-20 00:00:00+03:00,out,True,905574,False,7,172,222,50
167150,2019-09-20 00:00:00+03:00,in,False,-1,True,3,0,39,39
167150,2019-09-20 00:00:00+03:00,in,False,905538,False,4,510,550,40
167150,2019-09-20 00:00:00+03:00,out,True,905566,False,2,49,83,34
167150,2019-09-20 00:00:00+03:00,out,True,905538,False,3,221,259,38
167150,2019-09-20 00:00:00+03:00,out,False,905566,True,1,0,10,10
167150,2019-09-23 00:00:00+03:00,out,False,905538,True,18,0,395,395
167150,2019-09-23 00:00:00+03:00,out,True,905564,False,4,73,123,50
167150,2019-09-23 00:00:00+03:00,out,False,905542,False,24,2139,2378,239
167150,2019-09-23 00:00:00+03:00,out,True,905538,True,7,0,34,34
167150,2019-09-23 00:00:00+03:00,out,False,905574,False,1,39,40,1
167150,2019-09-23 00:00:00+03:00,out,True,905570,False,2,72,86,14
167150,2019-09-23 00:00:00+03:00,out,True,905566,False,4,98,129,31
167150,2019-09-23 00:00:00+03:00,in,False,905542,False,2,199,221,22
167150,2019-09-23 00:00:00+03:00,in,False,905564,False,1,339,358,19
167150,2019-09-23 00:00:00+03:00,out,False,905564,False,7,384,513,129
167150,2019-09-23 00:00:00+03:00,out,True,905570,True,1,0,21,21
167150,2019-09-23 00:00:00+03:00,out,False,905542,True,10,0,235,235
167150,2019-09-23 00:00:00+03:00,out,False,905570,True,1,0,8,8
167150,2019-09-23 00:00:00+03:00,out,True,905566,True,2,0,26,26
167150,2019-09-23 00:00:00+03:00,out,False,905538,False,37,3110,3628,518
167150,2019-09-23 00:00:00+03:00,out,False,905566,True,16,0,527,527
167150,2019-09-23 00:00:00+03:00,out,False,905564,True,2,0,37,37
167150,2019-09-23 00:00:00+03:00,out,False,905566,False,12,582,743,161
167150,2019-09-23 00:00:00+03:00,out,True,905538,False,3,82,114,32
167150,2019-09-23 00:00:00+03:00,out,True,905564,True,2,0,21,21
167150,2019-09-23 00:00:00+03:00,out,True,905574,False,2,67,86,19
167150,2019-09-23 00:00:00+03:00,in,False,905538,False,5,570,611,41
167150,2019-09-23 00:00:00+03:00,out,False,905566,True,16,0,527,527
167150,2019-09-23 00:00:00+03:00,out,False,905538,False,37,3110,3628,518
167150,2019-09-23 00:00:00+03:00,out,True,905538,False,3,82,114,32
167150,2019-09-23 00:00:00+03:00,out,True,905566,True,2,0,26,26
167150,2019-09-24 00:00:00+03:00,in,False,-1,True,5,0,34,34
167150,2019-09-24 00:00:00+03:00,out,True,905570,False,1,7,10,3
167150,2019-09-24 00:00:00+03:00,out,True,905574,False,2,35,46,11
167150,2019-09-24 00:00:00+03:00,out,True,905564,False,1,14,47,33
167150,2019-09-24 00:00:00+03:00,out,True,905566,False,3,56,78,22
167150,2019-09-24 00:00:00+03:00,in,False,905542,False,2,144,166,22
167150,2019-09-24 00:00:00+03:00,out,True,905564,True,4,0,85,85
167150,2019-09-24 00:00:00+03:00,out,False,905566,False,8,694,780,86
167150,2019-09-24 00:00:00+03:00,out,False,905564,False,10,938,1049,111
167150,2019-09-24 00:00:00+03:00,out,False,905564,True,10,0,159,159
167150,2019-09-24 00:00:00+03:00,out,True,905574,True,4,0,4,4
167150,2019-09-24 00:00:00+03:00,out,False,905538,False,46,4414,4968,554
167150,2019-09-24 00:00:00+03:00,out,True,905538,False,2,57,72,15
167150,2019-09-24 00:00:00+03:00,out,True,905566,True,1,0,16,16
167150,2019-09-24 00:00:00+03:00,out,False,905538,True,12,0,262,262
167150,2019-09-24 00:00:00+03:00,out,False,905542,False,33,2533,2934,401
167150,2019-09-24 00:00:00+03:00,in,False,905566,False,1,18,32,14
167150,2019-09-24 00:00:00+03:00,in,False,905538,False,9,1024,1099,75
167150,2019-09-24 00:00:00+03:00,out,False,905542,True,16,0,466,466
167150,2019-09-24 00:00:00+03:00,out,True,905538,True,4,0,73,73
167150,2019-09-24 00:00:00+03:00,out,False,905564,False,10,938,1049,111
167150,2019-09-24 00:00:00+03:00,out,True,905564,False,1,14,47,33
167150,2019-09-24 00:00:00+03:00,out,True,905574,True,4,0,4,4
167150,2019-09-24 00:00:00+03:00,out,False,905538,False,46,4414,4968,554
167150,2019-09-24 00:00:00+03:00,out,True,905566,True,1,0,16,16
167150,2019-09-25 00:00:00+03:00,out,False,905538,True,14,0,416,416
167150,2019-09-25 00:00:00+03:00,out,False,905566,False,7,423,479,56
167150,2019-09-25 00:00:00+03:00,in,False,905538,False,4,338,384,46
167150,2019-09-25 00:00:00+03:00,out,False,905542,False,15,868,1066,198
167150,2019-09-25 00:00:00+03:00,out,False,905538,False,38,2910,3368,458
167150,2019-09-25 00:00:00+03:00,out,False,905564,False,5,232,273,41
167150,2019-09-25 00:00:00+03:00,out,True,905574,True,1,0,4,4
167150,2019-09-25 00:00:00+03:00,out,True,905542,False,1,43,48,5
167150,2019-09-25 00:00:00+03:00,out,False,905566,True,1,0,10,10
167150,2019-09-25 00:00:00+03:00,out,True,905574,False,6,222,256,34
167150,2019-09-25 00:00:00+03:00,in,False,-1,True,5,0,81,81
167150,2019-09-25 00:00:00+03:00,in,False,905542,False,2,127,155,28
167150,2019-09-25 00:00:00+03:00,in,False,905566,False,3,21,59,38
167150,2019-09-25 00:00:00+03:00,out,True,905566,True,2,0,47,47
167150,2019-09-25 00:00:00+03:00,out,True,905570,True,1,0,2,2
167150,2019-09-25 00:00:00+03:00,out,False,905542,True,4,0,126,126
167150,2019-09-25 00:00:00+03:00,out,False,905564,True,1,0,5,5
167150,2019-09-25 00:00:00+03:00,out,True,905566,False,2,79,110,31
167150,2019-09-25 00:00:00+03:00,out,True,905538,False,4,129,162,33
167150,2019-09-25 00:00:00+03:00,out,True,905538,True,5,0,18,18
167150,2019-09-25 00:00:00+03:00,out,True,905564,False,1,8,23,15
167150,2019-09-26 00:00:00+03:00,out,True,905566,False,5,69,104,35
167150,2019-09-26 00:00:00+03:00,out,True,905566,True,2,0,17,17
167150,2019-09-26 00:00:00+03:00,out,True,905538,False,7,251,340,89
167150,2019-09-26 00:00:00+03:00,out,False,905542,True,9,0,139,139
167150,2019-09-26 00:00:00+03:00,out,True,905574,False,10,243,304,61
167150,2019-09-26 00:00:00+03:00,in,False,905566,False,3,37,85,48
167150,2019-09-26 00:00:00+03:00,out,False,905538,False,41,2198,2756,558
167150,2019-09-26 00:00:00+03:00,out,False,905566,False,13,863,990,127
167150,2019-09-26 00:00:00+03:00,out,False,905566,True,2,0,50,50
167150,2019-09-26 00:00:00+03:00,out,True,905574,True,1,0,12,12
167150,2019-09-26 00:00:00+03:00,in,False,905538,False,7,555,619,64
167150,2019-09-26 00:00:00+03:00,out,False,905564,False,2,90,115,25
167150,2019-09-26 00:00:00+03:00,out,False,905538,True,30,0,390,390
167150,2019-09-26 00:00:00+03:00,out,True,905564,True,1,0,1,1
167150,2019-09-26 00:00:00+03:00,in,False,905542,False,3,101,147,46
167150,2019-09-26 00:00:00+03:00,out,True,905538,True,1,0,48,48
167150,2019-09-26 00:00:00+03:00,out,True,905564,False,4,26,80,54
167150,2019-09-26 00:00:00+03:00,out,True,905570,True,1,0,26,26
167150,2019-09-26 00:00:00+03:00,out,False,905564,True,1,0,10,10
167150,2019-09-26 00:00:00+03:00,out,False,905542,False,23,2240,2512,272
167150,2019-09-27 00:00:00+03:00,out,True,905566,False,4,74,107,33
167150,2019-09-27 00:00:00+03:00,out,True,905538,False,4,192,223,31
167150,2019-09-27 00:00:00+03:00,out,True,905570,False,2,435,461,26
167150,2019-09-27 00:00:00+03:00,out,True,905564,True,2,0,33,33
167150,2019-09-27 00:00:00+03:00,out,True,905574,False,2,80,94,14
167150,2019-09-27 00:00:00+03:00,out,False,905538,False,51,3727,4413,686
167150,2019-09-27 00:00:00+03:00,out,False,905538,True,29,0,546,546
167150,2019-09-27 00:00:00+03:00,out,False,905574,True,1,0,7,7
167150,2019-09-27 00:00:00+03:00,out,False,905566,False,3,265,295,30
167150,2019-09-27 00:00:00+03:00,out,True,905538,True,9,0,217,217
167150,2019-09-27 00:00:00+03:00,out,False,905566,True,2,0,8,8
167150,2019-09-27 00:00:00+03:00,out,True,905564,False,1,6,20,14
167150,2019-09-27 00:00:00+03:00,out,True,905566,True,6,0,162,162
167150,2019-09-27 00:00:00+03:00,out,False,905542,True,14,0,240,240
167150,2019-09-27 00:00:00+03:00,in,False,-1,True,7,0,98,98
167150,2019-09-27 00:00:00+03:00,out,False,905542,False,16,931,1164,233
167150,2019-09-27 00:00:00+03:00,in,False,905538,False,11,570,690,120
167150,2019-09-27 00:00:00+03:00,out,False,905564,False,9,741,870,129
167150,2019-09-27 00:00:00+03:00,in,False,905542,False,4,211,262,51
167150,2019-09-27 00:00:00+03:00,out,True,905574,True,11,0,31,31
167150,2019-09-27 00:00:00+03:00,in,False,905566,False,2,193,214,21
167150,2019-09-27 00:00:00+03:00,out,False,905564,True,6,0,195,195
167150,2019-09-27 00:00:00+03:00,out,True,905574,True,11,0,31,31
167150,2019-09-27 00:00:00+03:00,out,True,905570,False,2,435,461,26
167150,2019-09-30 00:00:00+03:00,out,True,905538,False,2,12,21,9
167150,2019-09-30 00:00:00+03:00,out,False,905542,True,7,0,107,107
167150,2019-09-30 00:00:00+03:00,out,False,905566,False,4,172,228,56
167150,2019-09-30 00:00:00+03:00,out,True,905574,False,4,49,75,26
167150,2019-09-30 00:00:00+03:00,out,True,905570,False,2,366,381,15
167150,2019-09-30 00:00:00+03:00,out,True,905542,False,3,69,103,34
167150,2019-09-30 00:00:00+03:00,out,False,905538,False,34,2494,2880,386
167150,2019-09-30 00:00:00+03:00,out,True,905566,True,2,0,50,50
167150,2019-09-30 00:00:00+03:00,out,True,905538,True,2,0,50,50
167150,2019-09-30 00:00:00+03:00,in,False,-1,True,2,0,59,59
167150,2019-09-30 00:00:00+03:00,in,False,905542,False,2,122,143,21
167150,2019-09-30 00:00:00+03:00,out,False,905574,False,1,37,40,3
167150,2019-09-30 00:00:00+03:00,out,True,905564,False,4,48,83,35
167150,2019-09-30 00:00:00+03:00,out,False,905574,True,2,0,2,2
167150,2019-09-30 00:00:00+03:00,out,False,905564,False,5,107,198,91
167150,2019-09-30 00:00:00+03:00,out,False,905564,True,3,0,72,72
167150,2019-09-30 00:00:00+03:00,out,True,905566,False,8,312,386,74
167150,2019-09-30 00:00:00+03:00,in,False,905538,False,3,87,105,18
167150,2019-09-30 00:00:00+03:00,out,False,905566,True,4,0,57,57
167150,2019-09-30 00:00:00+03:00,out,False,905538,True,13,0,222,222
167150,2019-09-30 00:00:00+03:00,out,True,905564,True,1,0,1,1
167150,2019-09-30 00:00:00+03:00,out,False,905542,False,25,2009,2362,353
167150,2019-09-30 00:00:00+03:00,out,False,905564,False,5,107,198,91
167150,2019-09-30 00:00:00+03:00,out,False,905566,True,4,0,57,57
167150,2019-09-30 00:00:00+03:00,out,True,905574,False,4,49,75,26
167150,2019-10-01 00:00:00+03:00,out,True,905564,False,2,51,67,16
167150,2019-10-01 00:00:00+03:00,out,True,905566,True,1,0,30,30
167150,2019-10-01 00:00:00+03:00,out,True,905538,True,4,0,40,40
167150,2019-10-01 00:00:00+03:00,out,False,905538,False,40,2462,2981,519
167150,2019-10-01 00:00:00+03:00,out,False,905538,True,22,0,556,556
167150,2019-10-01 00:00:00+03:00,out,True,905538,False,2,246,255,9
167150,2019-10-01 00:00:00+03:00,in,False,-1,True,1,0,21,21
167150,2019-10-01 00:00:00+03:00,out,False,905566,False,9,456,552,96
167150,2019-10-01 00:00:00+03:00,out,False,905564,True,3,0,81,81
167150,2019-10-01 00:00:00+03:00,out,True,905574,False,4,179,213,34
167150,2019-10-01 00:00:00+03:00,in,False,905566,False,1,190,201,11
167150,2019-10-01 00:00:00+03:00,in,False,905538,False,3,281,305,24
167150,2019-10-01 00:00:00+03:00,out,False,905542,True,8,0,113,113
167150,2019-10-01 00:00:00+03:00,out,False,905542,False,14,735,893,158
167150,2019-10-01 00:00:00+03:00,out,False,905566,True,4,0,86,86
167150,2019-10-01 00:00:00+03:00,out,True,905566,False,7,199,234,35
167150,2019-10-01 00:00:00+03:00,out,False,905564,False,8,1003,1060,57
167150,2019-10-01 00:00:00+03:00,in,False,905564,False,1,111,122,11
167150,2019-10-01 00:00:00+03:00,out,False,905538,False,40,2462,2981,519
167150,2019-10-02 00:00:00+03:00,out,True,905570,False,10,395,461,66
167150,2019-10-02 00:00:00+03:00,out,False,905566,True,2,0,77,77
167150,2019-10-02 00:00:00+03:00,out,False,905542,False,26,2410,2677,267
167150,2019-10-02 00:00:00+03:00,in,False,905538,False,3,250,283,33
167150,2019-10-02 00:00:00+03:00,out,False,905566,False,5,358,412,54
167150,2019-10-02 00:00:00+03:00,out,False,905538,False,25,1792,2084,292
167150,2019-10-02 00:00:00+03:00,out,True,905566,True,1,0,0,0
167150,2019-10-02 00:00:00+03:00,in,False,-1,True,1,0,18,18
167150,2019-10-02 00:00:00+03:00,out,False,905542,True,4,0,54,54
167150,2019-10-02 00:00:00+03:00,out,False,905538,True,29,0,272,272
167150,2019-10-02 00:00:00+03:00,out,True,905564,True,1,0,1,1
167150,2019-10-02 00:00:00+03:00,in,False,905542,False,3,307,348,41
167150,2019-10-02 00:00:00+03:00,in,False,905566,False,3,35,79,44
167150,2019-10-02 00:00:00+03:00,out,True,905542,True,1,0,27,27
167150,2019-10-02 00:00:00+03:00,out,True,905566,True,1,0,0,0
167150,2019-10-03 00:00:00+03:00,out,True,905538,True,8,0,192,192
167150,2019-10-03 00:00:00+03:00,in,False,-1,True,1,0,6,6
167150,2019-10-03 00:00:00+03:00,out,False,905566,True,2,0,57,57
167150,2019-10-03 00:00:00+03:00,out,True,905538,False,3,78,97,19
167150,2019-10-03 00:00:00+03:00,out,True,905570,False,7,333,372,39
167150,2019-10-03 00:00:00+03:00,out,True,905542,True,1,0,28,28
167150,2019-10-03 00:00:00+03:00,out,True,905566,False,7,201,233,32
167150,2019-10-03 00:00:00+03:00,out,False,905566,False,5,820,881,61
167150,2019-10-03 00:00:00+03:00,out,False,905538,False,38,2575,3029,454
167150,2019-10-03 00:00:00+03:00,out,False,905538,True,18,0,538,538
167150,2019-10-03 00:00:00+03:00,out,False,905542,False,32,4603,4831,228
167150,2019-10-03 00:00:00+03:00,out,True,905566,True,1,0,26,26
167150,2019-10-03 00:00:00+03:00,in,False,905542,False,1,138,149,11
167150,2019-10-03 00:00:00+03:00,out,False,905574,False,2,378,381,3
167150,2019-10-03 00:00:00+03:00,out,False,905542,True,2,0,44,44
167150,2019-10-03 00:00:00+03:00,in,False,905538,False,2,17,33,16
167150,2019-10-03 00:00:00+03:00,out,True,905574,False,6,242,285,43
167150,2019-10-03 00:00:00+03:00,out,False,905542,True,2,0,44,44
167150,2019-10-04 00:00:00+03:00,out,True,905538,True,5,0,17,17
167150,2019-10-04 00:00:00+03:00,out,True,905566,True,3,0,64,64
167150,2019-10-04 00:00:00+03:00,out,False,905542,True,7,0,124,124
167150,2019-10-04 00:00:00+03:00,out,True,905574,True,1,0,10,10
167150,2019-10-04 00:00:00+03:00,in,False,905542,False,2,213,240,27
167150,2019-10-04 00:00:00+03:00,out,False,905574,False,2,79,105,26
167150,2019-10-04 00:00:00+03:00,out,False,905566,False,1,51,65,14
167150,2019-10-04 00:00:00+03:00,in,False,928092,False,2,151,188,37
167150,2019-10-04 00:00:00+03:00,out,False,905538,False,23,1250,1505,255
167150,2019-10-04 00:00:00+03:00,out,False,905538,True,7,0,147,147
167150,2019-10-04 00:00:00+03:00,out,True,905574,False,5,150,189,39
167150,2019-10-04 00:00:00+03:00,out,True,905570,True,2,0,0,0
167150,2019-10-04 00:00:00+03:00,out,True,905566,False,6,119,154,35
167150,2019-10-04 00:00:00+03:00,in,False,905538,False,1,12,22,10
167150,2019-10-04 00:00:00+03:00,out,False,905542,False,20,1934,2147,213
167150,2019-10-04 00:00:00+03:00,in,False,-1,True,1,0,18,18
167150,2019-10-04 00:00:00+03:00,out,True,905538,False,5,113,182,69
167150,2019-10-05 00:00:00+03:00,in,False,-1,True,1,0,9,9
167150,2019-10-07 00:00:00+03:00,in,False,905566,False,1,14,34,20
167150,2019-10-07 00:00:00+03:00,out,True,905538,False,3,136,161,25
167150,2019-10-07 00:00:00+03:00,out,True,905574,False,3,58,90,32
167150,2019-10-07 00:00:00+03:00,out,True,905538,True,3,0,56,56
167150,2019-10-07 00:00:00+03:00,out,False,905542,True,23,0,339,339
167150,2019-10-07 00:00:00+03:00,out,True,905566,True,1,0,0,0
167150,2019-10-07 00:00:00+03:00,out,False,905566,False,6,440,506,66
167150,2019-10-07 00:00:00+03:00,out,True,905570,False,1,1,31,30
167150,2019-10-07 00:00:00+03:00,out,False,905538,True,17,0,475,475
167150,2019-10-07 00:00:00+03:00,out,False,905538,False,30,1781,2178,397
167150,2019-10-07 00:00:00+03:00,out,False,905542,False,28,1918,2296,378
167150,2019-10-07 00:00:00+03:00,in,False,905542,False,2,45,74,29
167150,2019-10-07 00:00:00+03:00,out,True,905574,True,1,0,38,38
167150,2019-10-07 00:00:00+03:00,in,False,905538,False,4,210,240,30
167150,2019-10-07 00:00:00+03:00,out,True,905566,True,1,0,0,0
167150,2019-10-07 00:00:00+03:00,out,False,905542,False,28,1918,2296,378
167150,2019-10-07 00:00:00+03:00,in,False,905542,False,2,45,74,29
167150,2019-10-08 00:00:00+03:00,in,False,905538,True,1,34,42,8
167150,2019-10-08 00:00:00+03:00,in,False,905564,False,1,10,45,35
167150,2019-10-08 00:00:00+03:00,out,False,905574,False,5,91,119,28
167150,2019-10-08 00:00:00+03:00,out,True,905574,True,13,0,44,44
167150,2019-10-08 00:00:00+03:00,in,False,905538,False,10,612,748,136
167150,2019-10-08 00:00:00+03:00,in,False,-1,True,19,0,357,357
167150,2019-10-08 00:00:00+03:00,in,False,905574,False,2,165,183,18
167150,2019-10-08 00:00:00+03:00,out,False,905538,True,21,0,583,583
167150,2019-10-08 00:00:00+03:00,out,False,905542,True,9,0,221,221
167150,2019-10-08 00:00:00+03:00,out,True,905564,True,1,0,60,60
167150,2019-10-08 00:00:00+03:00,out,False,905566,False,10,281,387,106
167150,2019-10-08 00:00:00+03:00,out,False,905564,False,6,376,397,21
167150,2019-10-08 00:00:00+03:00,out,True,905566,False,10,194,283,89
167150,2019-10-08 00:00:00+03:00,out,False,905542,False,28,2293,2539,246
167150,2019-10-08 00:00:00+03:00,out,True,905570,False,1,17,35,18
167150,2019-10-08 00:00:00+03:00,out,True,905542,True,9,0,10,10
167150,2019-10-08 00:00:00+03:00,out,False,905574,True,10,0,149,149
167150,2019-10-08 00:00:00+03:00,out,True,905538,False,9,286,341,55
167150,2019-10-08 00:00:00+03:00,in,False,928092,False,2,17,154,137
167150,2019-10-08 00:00:00+03:00,out,False,905566,True,3,0,10,10
167150,2019-10-08 00:00:00+03:00,out,True,905542,False,2,12,21,9
167150,2019-10-08 00:00:00+03:00,in,False,905542,False,3,51,93,42
167150,2019-10-08 00:00:00+03:00,out,True,905566,True,1,0,1,1
167150,2019-10-08 00:00:00+03:00,out,True,905538,True,7,0,75,75
167150,2019-10-08 00:00:00+03:00,out,False,905564,True,1,0,5,5
167150,2019-10-08 00:00:00+03:00,out,False,905538,False,43,3302,3850,548
167150,2019-10-08 00:00:00+03:00,out,True,905574,False,24,522,665,143
167150,2019-10-08 00:00:00+03:00,out,True,905564,False,2,18,37,19
167150,2019-10-08 00:00:00+03:00,out,False,905542,False,28,2293,2539,246
167150,2019-10-09 00:00:00+03:00,out,True,905566,False,10,215,268,53
167150,2019-10-09 00:00:00+03:00,out,True,905570,True,2,0,56,56
167150,2019-10-09 00:00:00+03:00,in,False,-1,True,8,0,138,138
167150,2019-10-09 00:00:00+03:00,in,False,905542,False,1,23,38,15
167150,2019-10-09 00:00:00+03:00,out,True,905538,False,7,72,141,69
167150,2019-10-09 00:00:00+03:00,out,False,905538,False,46,2459,3044,585
167150,2019-10-09 00:00:00+03:00,out,True,905564,False,2,25,65,40
167150,2019-10-09 00:00:00+03:00,out,True,905574,False,10,193,272,79
167150,2019-10-09 00:00:00+03:00,out,True,905538,True,3,0,55,55
167150,2019-10-09 00:00:00+03:00,in,False,905538,False,2,103,135,32
167150,2019-10-09 00:00:00+03:00,in,False,905564,False,3,68,160,92
167150,2019-10-09 00:00:00+03:00,out,False,905566,True,1,0,8,8
167150,2019-10-09 00:00:00+03:00,out,True,905566,True,4,0,65,65
167150,2019-10-09 00:00:00+03:00,out,True,905570,False,8,566,640,74
167150,2019-10-09 00:00:00+03:00,out,False,905566,False,10,767,852,85
167150,2019-10-09 00:00:00+03:00,out,False,905574,True,2,0,5,5
167150,2019-10-09 00:00:00+03:00,out,False,905538,True,12,0,313,313
167150,2019-10-09 00:00:00+03:00,out,True,905542,True,1,0,6,6
167150,2019-10-09 00:00:00+03:00,out,False,905542,True,2,0,102,102
167150,2019-10-09 00:00:00+03:00,out,True,905564,True,2,0,50,50
167150,2019-10-09 00:00:00+03:00,out,False,905564,True,2,0,85,85
167150,2019-10-09 00:00:00+03:00,out,True,905574,True,3,0,22,22
167150,2019-10-09 00:00:00+03:00,out,False,905564,False,14,1354,1463,109
167150,2019-10-09 00:00:00+03:00,out,False,905542,False,18,1343,1611,268
167150,2019-10-09 00:00:00+03:00,out,False,905574,False,3,222,246,24
167150,2019-10-09 00:00:00+03:00,out,False,905564,False,14,1354,1463,109
167150,2019-10-10 00:00:00+03:00,in,False,-1,True,7,0,157,157
167150,2019-10-10 00:00:00+03:00,out,False,905538,False,43,3204,3716,512
167150,2019-10-10 00:00:00+03:00,out,False,905538,True,30,0,610,610
167150,2019-10-10 00:00:00+03:00,in,False,905564,False,1,22,50,28
167150,2019-10-10 00:00:00+03:00,out,True,905570,False,14,1195,1299,104
167150,2019-10-10 00:00:00+03:00,out,True,905564,False,2,9,29,20
167150,2019-10-10 00:00:00+03:00,out,False,905564,False,24,2066,2334,268
167150,2019-10-10 00:00:00+03:00,out,False,905566,True,1,0,1,1
167150,2019-10-10 00:00:00+03:00,out,False,905542,True,9,0,160,160
167150,2019-10-10 00:00:00+03:00,out,True,905566,True,1,0,27,27
167150,2019-10-10 00:00:00+03:00,out,False,905564,True,6,0,122,122
167150,2019-10-10 00:00:00+03:00,out,True,905538,False,5,201,268,67
167150,2019-10-10 00:00:00+03:00,in,False,905538,False,7,516,607,91
167150,2019-10-10 00:00:00+03:00,in,False,905542,False,1,17,34,17
167150,2019-10-10 00:00:00+03:00,out,True,905538,True,2,0,58,58
167150,2019-10-10 00:00:00+03:00,out,False,905542,False,26,2025,2341,316
167150,2019-10-10 00:00:00+03:00,out,False,905566,False,14,882,1080,198
167150,2019-10-10 00:00:00+03:00,in,False,905566,False,1,20,39,19
167150,2019-10-10 00:00:00+03:00,out,False,905538,True,30,0,610,610
167150,2019-10-11 00:00:00+03:00,out,False,905566,False,10,850,964,114
167150,2019-10-11 00:00:00+03:00,out,True,905566,False,5,131,182,51
167150,2019-10-11 00:00:00+03:00,out,True,905538,False,5,338,370,32
167150,2019-10-11 00:00:00+03:00,out,True,905574,True,2,0,29,29
167150,2019-10-11 00:00:00+03:00,out,False,905564,True,6,0,247,247
167150,2019-10-11 00:00:00+03:00,out,True,905570,False,4,189,211,22
167150,2019-10-11 00:00:00+03:00,out,True,905574,False,5,256,287,31
167150,2019-10-11 00:00:00+03:00,out,False,905538,True,17,0,539,539
167150,2019-10-11 00:00:00+03:00,in,False,905566,False,1,52,76,24
167150,2019-10-11 00:00:00+03:00,out,False,905574,False,1,66,78,12
167150,2019-10-11 00:00:00+03:00,out,False,905566,True,1,0,31,31
167150,2019-10-11 00:00:00+03:00,in,False,905538,False,4,976,1082,106
167150,2019-10-11 00:00:00+03:00,out,False,905542,False,18,1236,1395,159
167150,2019-10-11 00:00:00+03:00,in,False,905542,False,2,33,69,36
167150,2019-10-11 00:00:00+03:00,out,False,905542,True,1,0,15,15
167150,2019-10-11 00:00:00+03:00,in,False,-1,True,3,0,82,82
167150,2019-10-11 00:00:00+03:00,out,True,905564,False,2,8,32,24
167150,2019-10-11 00:00:00+03:00,out,True,905538,True,1,0,24,24
167150,2019-10-11 00:00:00+03:00,out,True,905564,True,17,0,1,1
167150,2019-10-11 00:00:00+03:00,out,True,905566,True,2,0,55,55
167150,2019-10-11 00:00:00+03:00,out,True,905542,False,2,10,15,5
167150,2019-10-11 00:00:00+03:00,out,True,905542,True,1,0,44,44
167150,2019-10-11 00:00:00+03:00,out,False,905564,False,12,830,946,116
167150,2019-10-11 00:00:00+03:00,out,False,905538,False,33,1655,2110,455
167150,2019-10-11 00:00:00+03:00,out,True,905566,True,2,0,55,55
167150,2019-10-11 00:00:00+03:00,in,False,905538,False,4,976,1082,106
167150,2019-10-11 00:00:00+03:00,out,False,905564,False,12,830,946,116
167150,2019-10-11 00:00:00+03:00,in,False,905566,False,1,52,76,24
167150,2019-10-14 00:00:00+03:00,out,True,905542,True,1,0,28,28
167150,2019-10-14 00:00:00+03:00,out,True,905570,True,1,0,14,14
167150,2019-10-14 00:00:00+03:00,out,True,905574,False,10,363,443,80
167150,2019-10-14 00:00:00+03:00,out,False,905538,True,15,0,369,369
167150,2019-10-14 00:00:00+03:00,in,False,905542,False,1,258,281,23
167150,2019-10-14 00:00:00+03:00,out,False,905566,False,4,125,185,60
167150,2019-10-14 00:00:00+03:00,in,False,905564,False,2,100,146,46
167150,2019-10-14 00:00:00+03:00,out,True,905564,False,1,5,25,20
167150,2019-10-14 00:00:00+03:00,out,False,905542,True,1,0,37,37
167150,2019-10-14 00:00:00+03:00,out,False,905564,False,10,634,734,100
167150,2019-10-14 00:00:00+03:00,out,True,905566,True,6,0,149,149
167150,2019-10-14 00:00:00+03:00,out,True,905538,False,6,210,265,55
167150,2019-10-14 00:00:00+03:00,out,True,905542,False,2,44,52,8
167150,2019-10-14 00:00:00+03:00,out,False,905542,False,25,2386,2644,258
167150,2019-10-14 00:00:00+03:00,out,True,905570,False,5,604,649,45
167150,2019-10-14 00:00:00+03:00,out,False,905566,True,2,0,96,96
167150,2019-10-14 00:00:00+03:00,out,False,905564,True,3,0,145,145
167150,2019-10-14 00:00:00+03:00,out,True,905574,True,4,0,33,33
167150,2019-10-14 00:00:00+03:00,in,False,905538,False,1,64,85,21
167150,2019-10-14 00:00:00+03:00,out,True,905566,False,10,131,211,80
167150,2019-10-14 00:00:00+03:00,in,False,-1,True,6,0,115,115
167150,2019-10-14 00:00:00+03:00,out,False,905574,False,1,23,30,7
167150,2019-10-14 00:00:00+03:00,out,True,905564,True,2,0,27,27
167150,2019-10-14 00:00:00+03:00,out,False,905574,True,1,0,6,6
167150,2019-10-14 00:00:00+03:00,out,True,905538,True,8,0,105,105
167150,2019-10-14 00:00:00+03:00,out,False,905538,False,23,1505,1754,249
167150,2019-10-15 00:00:00+03:00,in,False,905538,False,1,35,48,13
167150,2019-10-15 00:00:00+03:00,out,False,905564,True,3,0,72,72
167150,2019-10-15 00:00:00+03:00,out,True,905538,False,1,62,71,9
167150,2019-10-15 00:00:00+03:00,out,True,905564,False,2,26,44,18
167150,2019-10-15 00:00:00+03:00,out,True,905570,True,1,0,22,22
167150,2019-10-15 00:00:00+03:00,out,False,905542,False,26,2437,2759,322
167150,2019-10-15 00:00:00+03:00,in,False,905542,False,2,19,66,47
167150,2019-10-15 00:00:00+03:00,in,False,905564,False,4,104,225,121
167150,2019-10-15 00:00:00+03:00,out,False,905564,False,7,457,543,86
167150,2019-10-15 00:00:00+03:00,in,False,905566,False,3,305,391,86
167150,2019-10-15 00:00:00+03:00,out,False,905538,True,29,0,404,404
167150,2019-10-15 00:00:00+03:00,in,False,-1,True,4,0,59,59
167150,2019-10-15 00:00:00+03:00,out,True,905566,True,1,0,0,0
167150,2019-10-15 00:00:00+03:00,out,False,905538,False,30,2186,2506,320
167150,2019-10-15 00:00:00+03:00,out,True,905564,True,2,0,55,55
167150,2019-10-15 00:00:00+03:00,out,False,905566,False,7,546,634,88
167150,2019-10-15 00:00:00+03:00,out,False,905542,True,24,0,95,95
167150,2019-10-15 00:00:00+03:00,out,False,905542,True,24,0,95,95
167150,2019-10-15 00:00:00+03:00,in,False,905538,False,1,35,48,13
167150,2019-10-16 00:00:00+03:00,in,False,905564,False,2,91,143,52
167150,2019-10-16 00:00:00+03:00,out,True,905538,False,3,28,60,32
167150,2019-10-16 00:00:00+03:00,in,False,905542,False,2,50,89,39
167150,2019-10-16 00:00:00+03:00,out,False,905574,True,1,0,0,0
167150,2019-10-16 00:00:00+03:00,out,False,905538,True,26,0,266,266
167150,2019-10-16 00:00:00+03:00,out,True,905566,False,10,364,456,92
167150,2019-10-16 00:00:00+03:00,out,True,905574,False,8,206,270,64
167150,2019-10-16 00:00:00+03:00,out,True,905564,True,4,0,130,130
167150,2019-10-16 00:00:00+03:00,out,False,905542,False,24,2572,2891,319
167150,2019-10-16 00:00:00+03:00,out,False,905564,True,3,0,34,34
167150,2019-10-16 00:00:00+03:00,in,False,905538,False,2,114,174,60
167150,2019-10-16 00:00:00+03:00,in,False,905566,False,1,16,37,21
167150,2019-10-16 00:00:00+03:00,out,False,905566,False,5,296,404,108
167150,2019-10-16 00:00:00+03:00,out,True,905564,False,3,174,207,33
167150,2019-10-16 00:00:00+03:00,out,True,905566,True,6,0,88,88
167150,2019-10-16 00:00:00+03:00,out,False,905538,False,36,1765,2246,481
167150,2019-10-16 00:00:00+03:00,in,False,-1,True,12,0,438,438
167150,2019-10-16 00:00:00+03:00,out,True,905574,True,2,0,23,23
167150,2019-10-16 00:00:00+03:00,out,False,905542,True,5,0,61,61
167150,2019-10-16 00:00:00+03:00,out,False,905564,False,11,950,1084,134
167150,2019-10-16 00:00:00+03:00,out,False,905564,False,11,950,1084,134
167150,2019-10-16 00:00:00+03:00,out,False,905574,True,1,0,0,0
167150,2019-10-16 00:00:00+03:00,in,False,-1,True,12,0,438,438
167150,2019-10-17 00:00:00+03:00,out,True,905574,True,1,0,2,2
167150,2019-10-17 00:00:00+03:00,out,False,905566,False,5,244,313,69
167150,2019-10-17 00:00:00+03:00,in,False,905564,False,3,161,225,64
167150,2019-10-17 00:00:00+03:00,out,True,905566,False,1,66,73,7
167150,2019-10-17 00:00:00+03:00,out,True,905574,False,4,1742,1761,19
167150,2019-10-17 00:00:00+03:00,in,False,905542,False,3,71,123,52
167150,2019-10-17 00:00:00+03:00,out,True,905542,True,4,0,20,20
167150,2019-10-17 00:00:00+03:00,out,True,905564,True,1,0,0,0
167150,2019-10-17 00:00:00+03:00,out,False,905538,False,51,2818,3461,643
167150,2019-10-17 00:00:00+03:00,out,False,905538,True,38,0,614,614
167150,2019-10-17 00:00:00+03:00,out,False,905564,False,8,773,863,90
167150,2019-10-17 00:00:00+03:00,out,False,905542,False,31,3245,3484,239
167150,2019-10-17 00:00:00+03:00,out,True,905564,False,3,140,222,82
167150,2019-10-17 00:00:00+03:00,in,False,905538,False,4,51,106,55
167150,2019-10-17 00:00:00+03:00,out,False,905542,True,9,0,96,96
167150,2019-10-17 00:00:00+03:00,out,False,905564,True,2,0,120,120
167150,2019-10-17 00:00:00+03:00,in,False,-1,True,3,0,99,99
167150,2019-10-17 00:00:00+03:00,out,True,905574,True,1,0,2,2
167150,2019-10-17 00:00:00+03:00,out,False,905566,False,5,244,313,69
167150,2019-10-17 00:00:00+03:00,in,False,905542,False,3,71,123,52
167150,2019-10-18 00:00:00+03:00,out,False,905542,False,24,1366,1568,202
167150,2019-10-18 00:00:00+03:00,in,False,905564,False,3,194,277,83
167150,2019-10-18 00:00:00+03:00,out,False,905538,False,20,1577,1827,250
167150,2019-10-18 00:00:00+03:00,out,False,905574,False,1,491,516,25
167150,2019-10-18 00:00:00+03:00,out,True,905538,True,2,0,21,21
167150,2019-10-18 00:00:00+03:00,out,False,905538,True,9,0,327,327
167150,2019-10-18 00:00:00+03:00,out,True,905574,True,1,0,37,37
167150,2019-10-18 00:00:00+03:00,out,True,905574,False,5,180,209,29
167150,2019-10-18 00:00:00+03:00,out,True,905570,False,1,38,43,5
167150,2019-10-18 00:00:00+03:00,out,True,905566,True,7,0,92,92
167150,2019-10-18 00:00:00+03:00,out,False,905542,True,3,0,91,91
167150,2019-10-18 00:00:00+03:00,in,False,905538,False,3,230,287,57
167150,2019-10-18 00:00:00+03:00,out,True,905566,False,7,205,244,39
167150,2019-10-18 00:00:00+03:00,out,True,905564,False,4,91,133,42
167150,2019-10-18 00:00:00+03:00,out,True,905538,False,2,59,105,46
167150,2019-10-18 00:00:00+03:00,in,False,-1,True,5,0,30,30
167150,2019-10-18 00:00:00+03:00,out,True,905542,False,1,30,48,18
167150,2019-10-18 00:00:00+03:00,out,True,905564,True,4,0,45,45
167150,2019-10-18 00:00:00+03:00,out,False,905564,False,15,1465,1622,157
167150,2019-10-18 00:00:00+03:00,out,False,905566,False,13,1315,1500,185
167150,2019-10-18 00:00:00+03:00,out,False,905566,True,9,0,213,213
167150,2019-10-18 00:00:00+03:00,out,False,905564,True,4,0,129,129
167150,2019-10-18 00:00:00+03:00,out,False,905542,False,24,1366,1568,202
167150,2019-10-18 00:00:00+03:00,out,True,905538,False,2,59,105,46
167150,2019-10-19 00:00:00+03:00,in,False,-1,True,1,0,48,48
167150,2019-10-21 00:00:00+03:00,in,False,-1,True,4,0,134,134
167150,2019-10-21 00:00:00+03:00,out,True,905564,True,3,0,0,0
167150,2019-10-21 00:00:00+03:00,out,False,905564,True,3,0,127,127
167150,2019-10-21 00:00:00+03:00,out,True,905570,False,1,201,206,5
167150,2019-10-21 00:00:00+03:00,out,True,905574,True,1,0,28,28
167150,2019-10-21 00:00:00+03:00,out,True,905566,False,4,548,571,23
167150,2019-10-21 00:00:00+03:00,out,False,905564,False,10,887,1022,135
167150,2019-10-21 00:00:00+03:00,out,True,905566,True,2,0,3,3
167150,2019-10-21 00:00:00+03:00,out,False,905538,True,8,0,217,217
167150,2019-10-21 00:00:00+03:00,in,False,905564,False,4,399,488,89
167150,2019-10-21 00:00:00+03:00,out,True,905564,False,1,40,52,12
167150,2019-10-21 00:00:00+03:00,out,True,905574,False,4,306,338,32
167150,2019-10-21 00:00:00+03:00,out,False,905542,False,14,933,1097,164
167150,2019-10-21 00:00:00+03:00,out,False,905538,False,20,1236,1475,239
167150,2019-10-21 00:00:00+03:00,out,False,905566,False,15,3104,3275,171
167150,2019-10-21 00:00:00+03:00,in,False,905538,False,4,269,363,94
167150,2019-10-21 00:00:00+03:00,out,True,905538,False,2,11,19,8
167150,2019-10-21 00:00:00+03:00,out,False,905566,True,9,0,86,86
167150,2019-10-22 00:00:00+03:00,out,True,905538,False,4,70,92,22
167150,2019-10-22 00:00:00+03:00,out,True,905542,False,3,31,61,30
167150,2019-10-22 00:00:00+03:00,out,True,905566,False,13,474,560,86
167150,2019-10-22 00:00:00+03:00,out,False,905574,False,1,190,200,10
167150,2019-10-22 00:00:00+03:00,out,False,905538,True,24,0,330,330
167150,2019-10-22 00:00:00+03:00,out,True,905564,True,1,0,24,24
167150,2019-10-22 00:00:00+03:00,out,False,905542,True,9,0,167,167
167150,2019-10-22 00:00:00+03:00,in,False,-1,True,4,0,144,144
167150,2019-10-22 00:00:00+03:00,out,True,905538,True,1,0,24,24
167150,2019-10-22 00:00:00+03:00,in,False,905542,False,1,20,42,22
167150,2019-10-22 00:00:00+03:00,out,False,905566,False,7,501,549,48
167150,2019-10-22 00:00:00+03:00,out,False,905564,True,5,0,136,136
167150,2019-10-22 00:00:00+03:00,out,False,905564,False,7,756,832,76
167150,2019-10-22 00:00:00+03:00,out,True,905564,False,3,66,111,45
167150,2019-10-22 00:00:00+03:00,out,True,905566,True,5,0,103,103
167150,2019-10-22 00:00:00+03:00,out,True,905574,False,22,563,713,150
167150,2019-10-22 00:00:00+03:00,out,True,905574,True,4,0,47,47
167150,2019-10-22 00:00:00+03:00,out,False,905566,True,4,0,12,12
167150,2019-10-22 00:00:00+03:00,out,False,905542,False,31,3082,3362,280
167150,2019-10-22 00:00:00+03:00,in,False,905564,False,1,9,28,19
167150,2019-10-22 00:00:00+03:00,out,False,905538,False,38,3206,3706,500
167150,2019-10-22 00:00:00+03:00,out,True,905542,False,3,31,61,30
167150,2019-10-23 00:00:00+03:00,in,False,905542,False,1,2,22,20
167150,2019-10-23 00:00:00+03:00,out,True,905564,True,3,0,33,33
167150,2019-10-23 00:00:00+03:00,out,False,905542,False,17,1503,1668,165
167150,2019-10-23 00:00:00+03:00,in,False,905564,False,1,100,128,28
167150,2019-10-23 00:00:00+03:00,out,False,905538,True,7,0,173,173
167150,2019-10-23 00:00:00+03:00,out,True,905542,False,4,222,248,26
167150,2019-10-23 00:00:00+03:00,in,False,-1,True,5,0,78,78
167150,2019-10-23 00:00:00+03:00,out,True,905574,False,14,749,857,108
167150,2019-10-23 00:00:00+03:00,out,True,905538,False,1,9,20,11
167150,2019-10-23 00:00:00+03:00,out,True,905570,False,1,11,33,22
167150,2019-10-23 00:00:00+03:00,out,False,905566,True,2,0,62,62
167150,2019-10-23 00:00:00+03:00,out,False,905542,True,11,0,103,103
167150,2019-10-23 00:00:00+03:00,out,False,905564,False,9,633,728,95
167150,2019-10-23 00:00:00+03:00,out,True,905538,True,1,0,1,1
167150,2019-10-23 00:00:00+03:00,out,False,905566,False,10,291,455,164
167150,2019-10-23 00:00:00+03:00,out,True,905566,False,16,513,588,75
167150,2019-10-23 00:00:00+03:00,out,False,905564,True,6,0,85,85
167150,2019-10-23 00:00:00+03:00,out,False,905538,False,16,916,1138,222
167150,2019-10-23 00:00:00+03:00,in,False,905538,False,4,249,330,81
167150,2019-10-23 00:00:00+03:00,out,True,905566,True,4,0,82,82
167150,2019-10-23 00:00:00+03:00,out,False,905538,False,16,916,1138,222
167150,2019-10-24 00:00:00+03:00,in,False,905538,False,5,308,416,108
167150,2019-10-24 00:00:00+03:00,out,True,905574,True,2,0,48,48
167150,2019-10-24 00:00:00+03:00,in,False,905564,False,1,14,45,31
167150,2019-10-24 00:00:00+03:00,out,False,905542,False,17,2292,2446,154
167150,2019-10-24 00:00:00+03:00,out,True,905566,False,13,753,878,125
167150,2019-10-24 00:00:00+03:00,out,True,905566,True,1,0,1,1
167150,2019-10-24 00:00:00+03:00,out,False,905566,True,4,0,155,155
167150,2019-10-24 00:00:00+03:00,out,True,905564,True,1,0,1,1
167150,2019-10-24 00:00:00+03:00,out,True,905538,False,3,83,109,26
167150,2019-10-24 00:00:00+03:00,out,False,905564,False,3,145,199,54
167150,2019-10-24 00:00:00+03:00,out,False,905538,True,21,0,584,584
167150,2019-10-24 00:00:00+03:00,out,True,905564,False,1,43,47,4
167150,2019-10-24 00:00:00+03:00,out,True,905538,True,1,0,0,0
167150,2019-10-24 00:00:00+03:00,out,False,905564,True,1,0,58,58
167150,2019-10-24 00:00:00+03:00,out,True,905574,False,9,181,248,67
167150,2019-10-24 00:00:00+03:00,out,False,905538,False,39,2871,3388,517
167150,2019-10-24 00:00:00+03:00,in,False,-1,True,3,0,104,104
167150,2019-10-24 00:00:00+03:00,in,False,905542,False,2,37,77,40
167150,2019-10-24 00:00:00+03:00,out,True,905542,True,1,0,21,21
167150,2019-10-24 00:00:00+03:00,out,True,905542,False,2,78,87,9
167150,2019-10-24 00:00:00+03:00,out,False,905542,True,6,0,175,175
167150,2019-10-24 00:00:00+03:00,out,False,905566,False,13,756,1019,263
167150,2019-10-24 00:00:00+03:00,out,True,905566,True,1,0,1,1
167150,2019-10-25 00:00:00+03:00,out,True,905564,True,1,0,8,8
167150,2019-10-25 00:00:00+03:00,out,False,905564,False,11,1307,1377,70
167150,2019-10-25 00:00:00+03:00,in,False,905564,False,2,334,377,43
167150,2019-10-25 00:00:00+03:00,out,False,905566,False,3,263,303,40
167150,2019-10-25 00:00:00+03:00,out,False,905538,True,15,0,372,372
167150,2019-10-25 00:00:00+03:00,out,True,905564,False,3,198,222,24
167150,2019-10-25 00:00:00+03:00,out,False,905542,True,1,0,60,60
167150,2019-10-25 00:00:00+03:00,out,False,905542,False,16,1345,1471,126
167150,2019-10-25 00:00:00+03:00,out,True,905574,True,1,0,9,9
167150,2019-10-25 00:00:00+03:00,out,True,905574,False,1,6,14,8
167150,2019-10-25 00:00:00+03:00,out,False,905538,False,24,1334,1629,295
167150,2019-10-25 00:00:00+03:00,in,False,-1,True,2,0,14,14
167150,2019-10-25 00:00:00+03:00,in,False,905542,False,1,28,51,23
167150,2019-10-28 00:00:00+03:00,out,True,905566,False,1,41,63,22
167150,2019-10-28 00:00:00+03:00,out,False,905564,False,8,697,785,88
167150,2019-10-28 00:00:00+03:00,out,False,905542,False,10,1097,1211,114
167150,2019-10-28 00:00:00+03:00,out,False,905564,True,4,0,167,167
167150,2019-10-28 00:00:00+03:00,out,False,905538,True,12,0,433,433
167150,2019-10-28 00:00:00+03:00,out,True,905564,False,2,28,50,22
167150,2019-10-28 00:00:00+03:00,in,False,905566,False,1,175,214,39
167150,2019-10-28 00:00:00+03:00,in,False,905538,False,5,295,407,112
167150,2019-10-28 00:00:00+03:00,out,True,905574,False,3,96,111,15
167150,2019-10-28 00:00:00+03:00,in,False,905542,False,1,29,51,22
167150,2019-10-28 00:00:00+03:00,out,True,905566,True,4,0,60,60
167150,2019-10-28 00:00:00+03:00,out,True,905564,True,1,0,0,0
167150,2019-10-28 00:00:00+03:00,out,False,905566,False,11,1438,1565,127
167150,2019-10-28 00:00:00+03:00,out,True,905542,True,1,0,1,1
167150,2019-10-28 00:00:00+03:00,out,False,905538,False,25,1641,1972,331
167150,2019-10-28 00:00:00+03:00,out,False,905566,True,2,0,27,27
167150,2019-10-28 00:00:00+03:00,in,False,-1,True,1,0,16,16
167150,2019-10-28 00:00:00+03:00,out,False,905542,True,2,0,64,64
167150,2019-10-28 00:00:00+03:00,in,False,905566,False,1,175,214,39
167150,2019-10-28 00:00:00+03:00,out,False,905538,False,25,1641,1972,331
167150,2019-10-28 00:00:00+03:00,in,False,905542,False,1,29,51,22
167150,2019-10-28 00:00:00+03:00,out,True,905574,False,3,96,111,15
167150,2019-10-29 00:00:00+03:00,out,True,905538,True,1,0,13,13
167150,2019-10-29 00:00:00+03:00,out,False,905542,False,38,3918,4255,337
167150,2019-10-29 00:00:00+03:00,out,True,905564,True,1,0,13,13
167150,2019-10-29 00:00:00+03:00,out,False,905538,True,28,0,1172,1172
167150,2019-10-29 00:00:00+03:00,out,True,905542,False,1,7,14,7
167150,2019-10-29 00:00:00+03:00,out,False,905564,False,16,1094,1262,168
167150,2019-10-29 00:00:00+03:00,out,False,905538,False,24,1381,1709,328
167150,2019-10-29 00:00:00+03:00,out,False,905564,True,6,0,149,149
167150,2019-10-29 00:00:00+03:00,out,False,905566,False,7,737,827,90
167150,2019-10-29 00:00:00+03:00,in,False,-1,True,3,0,28,28
167150,2019-10-29 00:00:00+03:00,in,False,905564,False,4,237,323,86
167150,2019-10-29 00:00:00+03:00,out,False,905542,True,5,0,117,117
167150,2019-10-29 00:00:00+03:00,in,False,905538,False,4,217,290,73
167150,2019-10-29 00:00:00+03:00,out,True,905564,False,1,9,24,15
167150,2019-10-29 00:00:00+03:00,out,True,905566,True,1,0,5,5
167150,2019-10-29 00:00:00+03:00,out,True,905574,True,1,0,2,2
167150,2019-10-29 00:00:00+03:00,out,True,905538,False,2,148,159,11
167150,2019-10-29 00:00:00+03:00,out,True,905564,True,1,0,13,13
167150,2019-10-30 00:00:00+03:00,out,False,905542,True,7,0,84,84
167150,2019-10-30 00:00:00+03:00,out,True,905538,False,2,111,158,47
167150,2019-10-30 00:00:00+03:00,out,False,905566,False,10,504,626,122
167150,2019-10-30 00:00:00+03:00,out,True,905542,False,3,119,137,18
167150,2019-10-30 00:00:00+03:00,out,False,905538,False,19,1034,1240,206
167150,2019-10-30 00:00:00+03:00,out,True,905574,False,1,19,25,6
167150,2019-10-30 00:00:00+03:00,in,False,-1,True,3,0,43,43
167150,2019-10-30 00:00:00+03:00,out,True,905542,True,2,0,2,2
167150,2019-10-30 00:00:00+03:00,out,False,905538,True,4,0,64,64
167150,2019-10-30 00:00:00+03:00,in,False,905542,False,1,27,47,20
167150,2019-10-30 00:00:00+03:00,out,True,905566,False,1,5,20,15
167150,2019-10-30 00:00:00+03:00,out,False,905564,False,10,706,808,102
167150,2019-10-30 00:00:00+03:00,out,False,905566,True,1,0,34,34
167150,2019-10-30 00:00:00+03:00,out,True,905564,False,3,44,71,27
167150,2019-10-30 00:00:00+03:00,out,True,905564,True,1,0,2,2
167150,2019-10-30 00:00:00+03:00,out,False,905542,False,17,1250,1448,198
167150,2019-10-30 00:00:00+03:00,in,False,905542,False,1,27,47,20
167150,2019-10-30 00:00:00+03:00,out,True,905574,False,1,19,25,6
167150,2019-10-31 00:00:00+03:00,out,False,905542,True,4,0,64,64
167150,2019-10-31 00:00:00+03:00,out,True,905542,True,2,0,38,38
167150,2019-10-31 00:00:00+03:00,in,False,905566,False,1,27,53,26
167150,2019-10-31 00:00:00+03:00,out,False,905538,False,36,2421,2955,534
167150,2019-10-31 00:00:00+03:00,out,False,905566,False,7,1025,1103,78
167150,2019-10-31 00:00:00+03:00,out,True,905538,False,2,48,61,13
167150,2019-10-31 00:00:00+03:00,out,True,905564,True,1,0,5,5
167150,2019-10-31 00:00:00+03:00,out,False,905542,False,36,2673,2912,239
167150,2019-10-31 00:00:00+03:00,in,False,-1,True,12,0,134,134
167150,2019-10-31 00:00:00+03:00,in,False,905538,False,5,306,418,112
167150,2019-10-31 00:00:00+03:00,out,True,905564,False,2,30,48,18
167150,2019-10-31 00:00:00+03:00,out,False,905538,True,19,0,368,368
167150,2019-10-31 00:00:00+03:00,out,False,905564,False,8,1189,1283,94
167150,2019-10-31 00:00:00+03:00,in,False,905542,False,2,139,185,46
167150,2019-10-31 00:00:00+03:00,out,True,905538,True,1,0,12,12
167150,2019-11-01 00:00:00+03:00,out,False,905542,False,31,2202,2559,357
167150,2019-11-01 00:00:00+03:00,in,False,905538,False,1,59,81,22
167150,2019-11-01 00:00:00+03:00,out,True,905542,True,5,0,59,59
167150,2019-11-01 00:00:00+03:00,in,False,905542,False,1,73,87,14
167150,2019-11-01 00:00:00+03:00,out,False,905542,True,11,0,314,314
167150,2019-11-01 00:00:00+03:00,out,True,905542,False,5,257,286,29
167150,2019-11-01 00:00:00+03:00,in,False,905574,False,1,106,120,14
167150,2019-11-01 00:00:00+03:00,out,False,905564,False,3,332,390,58
167150,2019-11-01 00:00:00+03:00,out,True,905564,True,1,0,2,2
167150,2019-11-01 00:00:00+03:00,out,False,905566,True,1,0,16,16
167150,2019-11-01 00:00:00+03:00,out,False,905570,True,1,0,14,14
167150,2019-11-01 00:00:00+03:00,out,False,905538,True,16,0,346,346
167150,2019-11-01 00:00:00+03:00,out,False,905538,False,19,1712,1943,231
167150,2019-11-01 00:00:00+03:00,out,True,905538,True,2,0,17,17
167150,2019-11-01 00:00:00+03:00,in,False,-1,True,2,0,28,28
167150,2019-11-01 00:00:00+03:00,out,True,905564,False,1,50,64,14
167150,2019-11-01 00:00:00+03:00,out,False,905566,False,5,745,835,90
167150,2019-11-05 00:00:00+03:00,out,False,905538,False,42,2521,3024,503
167150,2019-11-05 00:00:00+03:00,out,True,905566,True,2,0,30,30
167150,2019-11-05 00:00:00+03:00,out,True,905566,False,3,264,294,30
167150,2019-11-05 00:00:00+03:00,in,False,905564,False,1,36,53,17
167150,2019-11-05 00:00:00+03:00,out,False,905542,False,24,1855,2133,278
167150,2019-11-05 00:00:00+03:00,out,True,905538,True,1,0,0,0
167150,2019-11-05 00:00:00+03:00,out,True,905538,False,3,100,132,32
167150,2019-11-05 00:00:00+03:00,out,False,905566,False,9,1062,1130,68
167150,2019-11-05 00:00:00+03:00,out,False,905564,True,1,0,37,37
167150,2019-11-05 00:00:00+03:00,out,False,905574,True,1,0,13,13
167150,2019-11-05 00:00:00+03:00,out,True,905570,False,1,37,40,3
167150,2019-11-05 00:00:00+03:00,out,True,905574,False,5,200,230,30
167150,2019-11-05 00:00:00+03:00,out,False,905542,True,3,0,7,7
167150,2019-11-05 00:00:00+03:00,out,False,905564,False,2,159,185,26
167150,2019-11-05 00:00:00+03:00,out,False,905566,True,5,0,7,7
167150,2019-11-05 00:00:00+03:00,in,False,-1,True,4,0,51,51
167150,2019-11-05 00:00:00+03:00,in,False,905538,False,3,269,343,74
167150,2019-11-05 00:00:00+03:00,out,False,905574,False,4,1111,1157,46
167150,2019-11-05 00:00:00+03:00,out,False,905538,True,21,0,559,559
167150,2019-11-05 00:00:00+03:00,in,False,905542,False,2,49,78,29
167150,2019-11-05 00:00:00+03:00,in,False,905542,True,1,74,106,32
167150,2019-11-05 00:00:00+03:00,out,False,905538,True,21,0,559,559
167150,2019-11-05 00:00:00+03:00,out,True,905538,False,3,100,132,32
167150,2019-11-06 00:00:00+03:00,out,True,905542,False,2,43,58,15
167150,2019-11-06 00:00:00+03:00,out,False,905538,False,29,2158,2503,345
167150,2019-11-06 00:00:00+03:00,in,False,905542,False,1,27,50,23
167150,2019-11-06 00:00:00+03:00,out,False,905566,False,2,50,86,36
167150,2019-11-06 00:00:00+03:00,out,True,905538,False,1,13,27,14
167150,2019-11-06 00:00:00+03:00,in,False,905538,False,5,499,594,95
167150,2019-11-06 00:00:00+03:00,out,True,905570,False,1,46,52,6
167150,2019-11-06 00:00:00+03:00,out,True,905574,False,1,13,16,3
167150,2019-11-06 00:00:00+03:00,out,True,905566,False,2,81,104,23
167150,2019-11-06 00:00:00+03:00,out,True,905566,True,1,0,7,7
167150,2019-11-06 00:00:00+03:00,out,False,905542,False,24,1491,1836,345
167150,2019-11-06 00:00:00+03:00,out,False,905542,True,4,0,85,85
167150,2019-11-06 00:00:00+03:00,out,False,905538,True,20,0,384,384
167150,2019-11-06 00:00:00+03:00,out,False,905564,False,5,790,847,57
167150,2019-11-06 00:00:00+03:00,in,False,-1,True,1,0,8,8
167150,2019-11-06 00:00:00+03:00,out,True,905564,False,1,14,24,10
167150,2019-11-06 00:00:00+03:00,in,False,905542,False,1,27,50,23
167150,2019-11-06 00:00:00+03:00,out,True,905566,False,2,81,104,23
167150,2019-11-07 00:00:00+03:00,out,True,905564,False,3,116,148,32
167150,2019-11-07 00:00:00+03:00,in,False,905538,False,6,638,759,121
167150,2019-11-07 00:00:00+03:00,out,False,905564,False,11,1049,1163,114
167150,2019-11-07 00:00:00+03:00,out,False,905566,False,1,63,67,4
167150,2019-11-07 00:00:00+03:00,out,True,905564,True,2,0,75,75
167150,2019-11-07 00:00:00+03:00,out,True,905538,True,1,0,44,44
167150,2019-11-07 00:00:00+03:00,out,False,905564,True,4,0,142,142
167150,2019-11-07 00:00:00+03:00,in,False,-1,True,4,0,56,56
167150,2019-11-07 00:00:00+03:00,out,True,905570,False,1,20,33,13
167150,2019-11-07 00:00:00+03:00,out,False,905542,True,5,0,184,184
167150,2019-11-07 00:00:00+03:00,in,False,905564,False,1,18,40,22
167150,2019-11-07 00:00:00+03:00,out,False,905538,False,26,2355,2723,368
167150,2019-11-07 00:00:00+03:00,out,True,905566,False,1,5,23,18
167150,2019-11-07 00:00:00+03:00,in,False,905542,False,1,82,105,23
167150,2019-11-07 00:00:00+03:00,out,False,905570,True,1,0,46,46
167150,2019-11-07 00:00:00+03:00,out,False,905538,True,10,0,188,188
167150,2019-11-07 00:00:00+03:00,out,False,905542,False,27,1560,1921,361
167150,2019-11-07 00:00:00+03:00,out,False,905566,False,1,63,67,4
167150,2019-11-08 00:00:00+03:00,out,True,905564,True,2,0,35,35
167150,2019-11-08 00:00:00+03:00,in,False,905542,False,1,13,29,16
167150,2019-11-08 00:00:00+03:00,in,False,905538,False,3,182,244,62
167150,2019-11-08 00:00:00+03:00,in,False,-1,True,6,0,109,109
167150,2019-11-08 00:00:00+03:00,out,False,905542,True,14,0,192,192
167150,2019-11-08 00:00:00+03:00,out,False,905538,False,42,3484,4064,580
167150,2019-11-08 00:00:00+03:00,out,True,905538,True,1,0,33,33
167150,2019-11-08 00:00:00+03:00,out,False,905542,False,29,1995,2296,301
167150,2019-11-08 00:00:00+03:00,out,False,905564,False,5,596,644,48
167150,2019-11-08 00:00:00+03:00,out,True,905564,False,1,54,60,6
167150,2019-11-08 00:00:00+03:00,out,False,905566,False,4,370,395,25
167150,2019-11-08 00:00:00+03:00,out,True,905538,False,2,506,553,47
167150,2019-11-08 00:00:00+03:00,out,False,905538,True,12,0,326,326
167150,2019-11-08 00:00:00+03:00,out,False,905564,True,1,0,26,26
167150,2019-11-11 00:00:00+03:00,in,False,905566,False,1,131,156,25
167150,2019-11-11 00:00:00+03:00,in,False,905538,False,3,248,317,69
167150,2019-11-11 00:00:00+03:00,in,False,905542,False,2,51,87,36
167150,2019-11-11 00:00:00+03:00,out,True,905574,True,1,0,44,44
167150,2019-11-11 00:00:00+03:00,out,True,905538,False,1,32,54,22
167150,2019-11-11 00:00:00+03:00,out,False,905542,False,45,5390,5828,438
167150,2019-11-11 00:00:00+03:00,out,False,905574,True,4,0,8,8
167150,2019-11-11 00:00:00+03:00,out,True,905574,False,1,36,43,7
167150,2019-11-11 00:00:00+03:00,out,False,905564,False,12,1005,1161,156
167150,2019-11-11 00:00:00+03:00,out,True,905564,False,4,269,290,21
167150,2019-11-11 00:00:00+03:00,out,True,905538,True,1,0,38,38
167150,2019-11-11 00:00:00+03:00,out,True,905564,True,1,0,22,22
167150,2019-11-11 00:00:00+03:00,in,False,-1,True,3,0,27,27
167150,2019-11-11 00:00:00+03:00,out,False,905566,False,7,509,563,54
167150,2019-11-11 00:00:00+03:00,out,False,905542,True,16,0,469,469
167150,2019-11-11 00:00:00+03:00,in,False,905564,False,1,13,37,24
167150,2019-11-11 00:00:00+03:00,out,False,905566,True,1,0,1,1
167150,2019-11-11 00:00:00+03:00,out,False,905564,True,3,0,134,134
167150,2019-11-11 00:00:00+03:00,out,False,905538,True,15,0,289,289
167150,2019-11-11 00:00:00+03:00,out,False,905538,False,22,1613,1876,263
167150,2019-11-11 00:00:00+03:00,out,False,905574,True,4,0,8,8
167150,2019-11-12 00:00:00+03:00,in,False,-1,True,3,0,33,33
167150,2019-11-12 00:00:00+03:00,in,False,905538,False,6,458,587,129
167150,2019-11-12 00:00:00+03:00,out,False,905538,False,36,2019,2452,433
167150,2019-11-12 00:00:00+03:00,in,False,905542,False,1,18,43,25
167150,2019-11-12 00:00:00+03:00,out,False,905538,True,13,0,259,259
167150,2019-11-12 00:00:00+03:00,out,False,905566,False,3,201,230,29
167150,2019-11-12 00:00:00+03:00,out,False,905542,False,32,2590,2954,364
167150,2019-11-12 00:00:00+03:00,out,False,905542,True,6,0,119,119
167150,2019-11-12 00:00:00+03:00,out,True,905564,False,2,66,80,14
167150,2019-11-12 00:00:00+03:00,out,False,905564,True,2,0,65,65
167150,2019-11-12 00:00:00+03:00,out,False,905564,False,11,1399,1521,122
167150,2019-11-13 00:00:00+03:00,out,False,905566,False,3,91,117,26
167150,2019-11-13 00:00:00+03:00,out,False,905538,False,74,5890,6740,850
167150,2019-11-13 00:00:00+03:00,out,True,905570,True,1,0,24,24
167150,2019-11-13 00:00:00+03:00,out,False,905574,False,1,6,8,2
167150,2019-11-13 00:00:00+03:00,in,False,905564,False,4,331,430,99
167150,2019-11-13 00:00:00+03:00,out,False,905538,True,29,0,362,362
167150,2019-11-13 00:00:00+03:00,in,False,905542,False,4,162,239,77
167150,2019-11-13 00:00:00+03:00,in,False,905538,False,2,131,161,30
167150,2019-11-13 00:00:00+03:00,out,False,905542,False,38,2893,3360,467
167150,2019-11-13 00:00:00+03:00,in,False,-1,True,5,0,49,49
167150,2019-11-13 00:00:00+03:00,out,True,905564,True,6,0,54,54
167150,2019-11-13 00:00:00+03:00,out,True,905564,False,1,47,70,23
167150,2019-11-13 00:00:00+03:00,out,False,905564,False,7,1259,1313,54
167150,2019-11-13 00:00:00+03:00,out,True,905542,True,3,0,140,140
167150,2019-11-13 00:00:00+03:00,out,False,905564,True,2,0,81,81
167150,2019-11-13 00:00:00+03:00,out,False,905542,True,4,0,143,143
167150,2019-11-13 00:00:00+03:00,in,False,905566,True,1,46,65,19
167150,2019-11-13 00:00:00+03:00,out,False,905538,True,29,0,362,362
167150,2019-11-13 00:00:00+03:00,in,False,905566,True,1,46,65,19
167150,2019-11-13 00:00:00+03:00,out,True,905542,True,3,0,140,140
167150,2019-11-13 00:00:00+03:00,out,False,905542,False,38,2893,3360,467
167150,2019-11-14 00:00:00+03:00,out,False,905542,False,28,2454,2743,289
167150,2019-11-14 00:00:00+03:00,out,False,905564,False,7,824,897,73
167150,2019-11-14 00:00:00+03:00,out,True,905574,True,1,0,0,0
167150,2019-11-14 00:00:00+03:00,in,False,905564,False,3,131,205,74
167150,2019-11-14 00:00:00+03:00,in,False,905538,False,4,136,200,64
167150,2019-11-14 00:00:00+03:00,out,False,905574,False,1,7,16,9
167150,2019-11-14 00:00:00+03:00,in,False,905566,False,1,104,135,31
167150,2019-11-14 00:00:00+03:00,out,True,905574,False,1,106,111,5
167150,2019-11-14 00:00:00+03:00,out,True,905564,True,1,0,21,21
167150,2019-11-14 00:00:00+03:00,in,False,-1,True,8,0,211,211
167150,2019-11-14 00:00:00+03:00,out,False,905538,True,14,0,444,444
167150,2019-11-14 00:00:00+03:00,out,False,905574,True,2,0,42,42
167150,2019-11-14 00:00:00+03:00,out,False,905542,True,5,0,230,230
167150,2019-11-14 00:00:00+03:00,out,False,905538,False,39,2519,2962,443
167150,2019-11-14 00:00:00+03:00,out,False,905564,True,1,0,58,58
167150,2019-11-14 00:00:00+03:00,out,False,905566,False,4,415,429,14
167150,2019-11-14 00:00:00+03:00,in,False,905542,False,3,137,212,75
167150,2019-11-14 00:00:00+03:00,out,True,905538,False,5,211,296,85
167150,2019-11-14 00:00:00+03:00,out,False,905538,False,39,2519,2962,443
167150,2019-11-15 00:00:00+03:00,out,False,905542,True,10,0,254,254
167150,2019-11-15 00:00:00+03:00,in,False,-1,True,4,0,101,101
167150,2019-11-15 00:00:00+03:00,out,True,905542,False,1,10,19,9
167150,2019-11-15 00:00:00+03:00,out,True,905564,False,2,60,86,26
167150,2019-11-15 00:00:00+03:00,out,True,905538,False,1,62,70,8
167150,2019-11-15 00:00:00+03:00,out,True,905542,True,1,0,39,39
167150,2019-11-15 00:00:00+03:00,out,False,905542,False,32,2625,2962,337
167150,2019-11-15 00:00:00+03:00,out,False,905564,True,2,0,0,0
167150,2019-11-15 00:00:00+03:00,out,False,905566,True,5,0,273,273
167150,2019-11-15 00:00:00+03:00,out,False,905538,False,50,3951,4579,628
167150,2019-11-15 00:00:00+03:00,in,False,905564,False,4,93,191,98
167150,2019-11-15 00:00:00+03:00,out,False,905564,False,7,262,329,67
167150,2019-11-15 00:00:00+03:00,out,True,905564,True,2,0,22,22
167150,2019-11-15 00:00:00+03:00,out,False,905538,True,16,0,315,315
167150,2019-11-15 00:00:00+03:00,out,False,905566,False,4,882,935,53
167150,2019-11-15 00:00:00+03:00,in,False,905542,False,5,187,316,129
167150,2019-11-15 00:00:00+03:00,out,False,905574,True,2,0,31,31
167150,2019-11-15 00:00:00+03:00,in,False,905538,False,5,240,384,144
167150,2019-11-15 00:00:00+03:00,out,True,905564,True,2,0,22,22
167150,2019-11-15 00:00:00+03:00,out,False,905538,False,50,3951,4579,628
167150,2019-11-18 00:00:00+03:00,out,False,905542,True,2,0,43,43
167150,2019-11-18 00:00:00+03:00,out,False,905564,True,3,0,80,80
167150,2019-11-18 00:00:00+03:00,out,True,905542,False,1,108,115,7
167150,2019-11-18 00:00:00+03:00,in,False,905538,False,10,553,805,252
167150,2019-11-18 00:00:00+03:00,out,True,905564,False,1,6,11,5
167150,2019-11-18 00:00:00+03:00,out,False,905566,False,3,110,156,46
167150,2019-11-18 00:00:00+03:00,out,False,905542,False,39,2587,2969,382
167150,2019-11-18 00:00:00+03:00,out,False,905538,False,26,1408,1789,381
167150,2019-11-18 00:00:00+03:00,out,True,905538,False,1,44,47,3
167150,2019-11-18 00:00:00+03:00,in,False,905564,False,1,20,44,24
167150,2019-11-18 00:00:00+03:00,in,False,905542,False,2,181,223,42
167150,2019-11-18 00:00:00+03:00,out,False,905538,True,16,0,286,286
167150,2019-11-18 00:00:00+03:00,out,False,905564,False,9,1051,1144,93
167150,2019-11-19 00:00:00+03:00,out,False,905542,False,23,2526,2821,295
167150,2019-11-19 00:00:00+03:00,out,True,905564,True,3,0,50,50
167150,2019-11-19 00:00:00+03:00,out,False,905542,True,4,0,67,67
167150,2019-11-19 00:00:00+03:00,out,False,905538,True,20,0,411,411
167150,2019-11-19 00:00:00+03:00,in,False,905538,False,10,1342,1571,229
167150,2019-11-19 00:00:00+03:00,out,False,905538,False,35,4541,4935,394
167150,2019-11-19 00:00:00+03:00,out,False,905564,True,3,0,10,10
167150,2019-11-19 00:00:00+03:00,out,True,905570,False,1,17,30,13
167150,2019-11-19 00:00:00+03:00,out,False,905574,False,1,59,66,7
167150,2019-11-19 00:00:00+03:00,out,False,905566,False,7,1397,1452,55
167150,2019-11-19 00:00:00+03:00,out,False,905564,False,8,1300,1370,70
167150,2019-11-19 00:00:00+03:00,in,False,-1,True,4,0,42,42
167150,2019-11-19 00:00:00+03:00,out,True,905542,False,1,22,34,12
167150,2019-11-19 00:00:00+03:00,out,False,905566,True,1,0,46,46
167150,2019-11-19 00:00:00+03:00,out,True,905564,False,1,5,18,13
167150,2019-11-19 00:00:00+03:00,out,True,905564,True,3,0,50,50
167150,2019-11-19 00:00:00+03:00,out,False,905542,True,4,0,67,67
167150,2019-11-20 00:00:00+03:00,in,False,905566,False,2,39,97,58
167150,2019-11-20 00:00:00+03:00,out,False,905542,True,5,0,217,217
167150,2019-11-20 00:00:00+03:00,out,False,905566,False,5,298,378,80
167150,2019-11-20 00:00:00+03:00,out,False,905542,False,20,1504,1716,212
167150,2019-11-20 00:00:00+03:00,out,False,905564,True,2,0,20,20
167150,2019-11-20 00:00:00+03:00,out,False,905538,False,68,6233,7123,890
167150,2019-11-20 00:00:00+03:00,in,False,-1,True,7,0,255,255
167150,2019-11-20 00:00:00+03:00,out,True,905564,False,1,6,16,10
167150,2019-11-20 00:00:00+03:00,in,False,905542,False,5,406,529,123
167150,2019-11-20 00:00:00+03:00,out,False,905538,True,22,0,746,746
167150,2019-11-20 00:00:00+03:00,in,False,905538,False,7,567,717,150
167150,2019-11-20 00:00:00+03:00,out,True,905564,True,3,0,7,7
167150,2019-11-20 00:00:00+03:00,out,True,905538,False,3,118,160,42
167150,2019-11-20 00:00:00+03:00,out,False,905564,False,8,852,937,85
167150,2019-11-20 00:00:00+03:00,out,True,905538,True,1,0,27,27
167150,2019-11-21 00:00:00+03:00,out,False,905542,True,12,0,405,405
167150,2019-11-21 00:00:00+03:00,out,True,905566,False,10,1019,1149,130
167150,2019-11-21 00:00:00+03:00,out,False,905542,False,25,1986,2242,256
167150,2019-11-21 00:00:00+03:00,out,True,905574,False,7,489,551,62
167150,2019-11-21 00:00:00+03:00,in,False,905542,False,6,355,508,153
167150,2019-11-21 00:00:00+03:00,out,False,905564,True,1,0,12,12
167150,2019-11-21 00:00:00+03:00,out,False,905538,False,48,4220,4818,598
167150,2019-11-21 00:00:00+03:00,out,False,905566,True,4,0,25,25
167150,2019-11-21 00:00:00+03:00,in,False,905538,False,7,450,641,191
167150,2019-11-21 00:00:00+03:00,out,True,905564,False,2,223,240,17
167150,2019-11-21 00:00:00+03:00,out,False,905538,True,23,0,523,523
167150,2019-11-21 00:00:00+03:00,out,True,905574,True,2,0,62,62
167150,2019-11-21 00:00:00+03:00,in,False,-1,True,5,0,83,83
167150,2019-11-21 00:00:00+03:00,out,False,905564,False,9,899,988,89
167150,2019-11-21 00:00:00+03:00,out,True,905566,True,1,0,3,3
167150,2019-11-21 00:00:00+03:00,out,True,905538,False,2,97,112,15
167150,2019-11-21 00:00:00+03:00,in,False,905564,True,1,1,25,24
167150,2019-11-21 00:00:00+03:00,in,False,905564,False,1,68,92,24
167150,2019-11-21 00:00:00+03:00,out,False,905566,False,9,1566,1700,134
167150,2019-11-21 00:00:00+03:00,out,False,905564,True,1,0,12,12
167150,2019-11-22 00:00:00+03:00,in,False,905566,False,1,27,50,23
167150,2019-11-22 00:00:00+03:00,in,False,-1,True,4,0,86,86
167150,2019-11-22 00:00:00+03:00,out,False,905574,False,2,201,237,36
167150,2019-11-22 00:00:00+03:00,in,False,905538,False,8,573,767,194
167150,2019-11-22 00:00:00+03:00,out,True,905538,False,3,155,204,49
167150,2019-11-22 00:00:00+03:00,out,False,905564,False,6,588,617,29
167150,2019-11-22 00:00:00+03:00,out,False,905538,False,39,2968,3454,486
167150,2019-11-22 00:00:00+03:00,out,True,905542,False,4,115,163,48
167150,2019-11-22 00:00:00+03:00,out,True,905564,True,1,0,18,18
167150,2019-11-22 00:00:00+03:00,out,False,905538,True,13,0,365,365
167150,2019-11-22 00:00:00+03:00,out,False,905542,True,21,0,588,588
167150,2019-11-22 00:00:00+03:00,out,True,905574,False,1,7,14,7
167150,2019-11-22 00:00:00+03:00,out,True,905570,False,3,149,184,35
167150,2019-11-22 00:00:00+03:00,out,True,905564,False,3,52,74,22
167150,2019-11-22 00:00:00+03:00,out,False,905566,True,1,0,33,33
167150,2019-11-22 00:00:00+03:00,out,False,905566,False,8,259,367,108
167150,2019-11-22 00:00:00+03:00,in,False,905542,False,5,307,438,131
167150,2019-11-22 00:00:00+03:00,out,True,905538,True,6,0,73,73
167150,2019-11-22 00:00:00+03:00,out,False,905542,False,30,1967,2324,357
167150,2019-11-22 00:00:00+03:00,out,True,905542,False,4,115,163,48
167150,2019-11-22 00:00:00+03:00,in,False,905538,False,8,573,767,194
167150,2019-11-22 00:00:00+03:00,out,False,905566,True,1,0,33,33
167150,2019-11-23 00:00:00+03:00,in,False,-1,True,1,0,2,2
167150,2019-11-25 00:00:00+03:00,in,False,905564,False,1,12,40,28
167150,2019-11-25 00:00:00+03:00,out,True,905564,True,7,0,19,19
167150,2019-11-25 00:00:00+03:00,out,True,905574,False,5,465,514,49
167150,2019-11-25 00:00:00+03:00,out,True,905570,False,1,181,199,18
167150,2019-11-25 00:00:00+03:00,in,False,-1,True,7,0,199,199
167150,2019-11-25 00:00:00+03:00,out,True,905542,False,1,224,231,7
167150,2019-11-25 00:00:00+03:00,out,False,905566,True,1,0,14,14
167150,2019-11-25 00:00:00+03:00,out,False,905538,False,56,4205,4916,711
167150,2019-11-25 00:00:00+03:00,out,False,905564,True,15,0,426,426
167150,2019-11-25 00:00:00+03:00,out,True,905564,False,3,451,472,21
167150,2019-11-25 00:00:00+03:00,out,True,905566,False,4,205,240,35
167150,2019-11-25 00:00:00+03:00,out,True,905542,True,1,0,1,1
167150,2019-11-25 00:00:00+03:00,in,True,905564,False,1,79,102,23
167150,2019-11-25 00:00:00+03:00,out,False,905566,False,6,756,782,26
167150,2019-11-25 00:00:00+03:00,out,False,905542,False,16,1371,1600,229
167150,2019-11-25 00:00:00+03:00,in,False,905542,False,3,302,377,75
167150,2019-11-25 00:00:00+03:00,out,True,905574,True,2,0,40,40
167150,2019-11-25 00:00:00+03:00,out,False,905564,False,7,530,599,69
167150,2019-11-25 00:00:00+03:00,out,False,905542,True,20,0,725,725
167150,2019-11-25 00:00:00+03:00,out,True,905566,True,2,0,6,6
167150,2019-11-25 00:00:00+03:00,out,True,905538,False,1,1,36,35
167150,2019-11-25 00:00:00+03:00,out,False,905538,True,21,0,499,499
167150,2019-11-25 00:00:00+03:00,in,False,905538,False,9,641,822,181
167150,2019-11-25 00:00:00+03:00,in,False,-1,True,7,0,199,199
167150,2019-11-25 00:00:00+03:00,in,True,905564,False,1,79,102,23
167150,2019-11-26 00:00:00+03:00,out,False,905542,True,13,0,615,615
167150,2019-11-26 00:00:00+03:00,out,False,905538,True,18,0,586,586
167150,2019-11-26 00:00:00+03:00,out,True,905564,False,2,25,38,13
167150,2019-11-26 00:00:00+03:00,in,False,905564,False,1,14,40,26
167150,2019-11-26 00:00:00+03:00,in,False,905538,False,4,328,427,99
167150,2019-11-26 00:00:00+03:00,out,False,905566,False,4,178,236,58
167150,2019-11-26 00:00:00+03:00,out,False,905542,False,20,1791,2031,240
167150,2019-11-26 00:00:00+03:00,out,False,905566,True,2,0,15,15
167150,2019-11-26 00:00:00+03:00,out,True,905570,False,1,73,85,12
167150,2019-11-26 00:00:00+03:00,out,False,905538,False,38,3353,3807,454
167150,2019-11-26 00:00:00+03:00,out,True,905542,False,2,37,59,22
167150,2019-11-26 00:00:00+03:00,in,False,-1,True,4,0,42,42
167150,2019-11-26 00:00:00+03:00,in,False,905538,True,1,94,122,28
167150,2019-11-26 00:00:00+03:00,out,False,905538,True,18,0,586,586
167150,2019-11-27 00:00:00+03:00,out,False,905564,False,8,1220,1317,97
167150,2019-11-27 00:00:00+03:00,out,True,905538,True,3,0,9,9
167150,2019-11-27 00:00:00+03:00,out,False,905538,False,39,3162,3674,512
167150,2019-11-27 00:00:00+03:00,out,False,905566,False,6,385,449,64
167150,2019-11-27 00:00:00+03:00,out,False,905542,False,26,2197,2488,291
167150,2019-11-27 00:00:00+03:00,out,True,905542,False,4,145,192,47
167150,2019-11-27 00:00:00+03:00,out,False,905542,True,15,0,365,365
167150,2019-11-27 00:00:00+03:00,in,False,-1,True,5,0,121,121
167150,2019-11-27 00:00:00+03:00,in,False,905538,False,5,568,708,140
167150,2019-11-27 00:00:00+03:00,out,True,905564,False,1,6,9,3
167150,2019-11-27 00:00:00+03:00,in,False,905564,False,1,12,60,48
167150,2019-11-27 00:00:00+03:00,out,True,905564,True,1,0,21,21
167150,2019-11-27 00:00:00+03:00,out,False,905564,True,4,0,119,119
167150,2019-11-27 00:00:00+03:00,in,False,905542,False,2,80,149,69
167150,2019-11-27 00:00:00+03:00,out,True,905538,False,3,168,204,36
167150,2019-11-27 00:00:00+03:00,out,False,905538,True,22,0,534,534
167150,2019-11-27 00:00:00+03:00,out,False,905564,True,4,0,119,119
167150,2019-11-28 00:00:00+03:00,out,True,905570,False,3,326,340,14
167150,2019-11-28 00:00:00+03:00,out,False,905564,False,2,124,153,29
167150,2019-11-28 00:00:00+03:00,out,True,905542,False,4,709,731,22
167150,2019-11-28 00:00:00+03:00,out,False,905538,False,34,3708,4112,404
167150,2019-11-28 00:00:00+03:00,in,False,905564,False,1,1,25,24
167150,2019-11-28 00:00:00+03:00,out,True,905542,True,1,0,31,31
167150,2019-11-28 00:00:00+03:00,out,True,905574,True,3,0,53,53
167150,2019-11-28 00:00:00+03:00,out,True,905566,False,8,589,656,67
167150,2019-11-28 00:00:00+03:00,out,True,905574,False,12,943,1014,71
167150,2019-11-28 00:00:00+03:00,out,False,905566,False,11,966,1163,197
167150,2019-11-28 00:00:00+03:00,out,True,905570,True,1,0,2,2
167150,2019-11-28 00:00:00+03:00,out,False,905542,False,40,2427,2955,528
167150,2019-11-28 00:00:00+03:00,in,False,928092,False,1,5,67,62
167150,2019-11-28 00:00:00+03:00,in,False,905538,False,9,2378,2593,215
167150,2019-11-28 00:00:00+03:00,out,False,905542,True,14,0,239,239
167150,2019-11-28 00:00:00+03:00,out,True,905538,True,3,0,77,77
167150,2019-11-28 00:00:00+03:00,out,True,905538,False,4,179,245,66
167150,2019-11-28 00:00:00+03:00,out,True,905564,True,2,0,2,2
167150,2019-11-28 00:00:00+03:00,out,True,905564,False,3,52,78,26
167150,2019-11-28 00:00:00+03:00,out,False,905538,True,13,0,389,389
167150,2019-11-28 00:00:00+03:00,in,False,905542,False,8,737,925,188
167150,2019-11-28 00:00:00+03:00,in,False,-1,True,4,0,64,64
167150,2019-11-28 00:00:00+03:00,out,False,905566,True,3,0,70,70
167150,2019-11-28 00:00:00+03:00,in,False,-1,True,4,0,64,64
167150,2019-11-28 00:00:00+03:00,out,True,905566,False,8,589,656,67
167158,2019-09-04 00:00:00+03:00,in,False,-1,True,1,0,2,2
167158,2019-09-05 00:00:00+03:00,in,False,-1,True,2,0,5,5
167158,2019-09-06 00:00:00+03:00,in,False,-1,True,1,0,2,2
167158,2019-09-08 00:00:00+03:00,in,False,-1,True,1,0,2,2
167158,2019-09-08 00:00:00+03:00,in,False,-1,True,1,0,2,2
167158,2019-09-09 00:00:00+03:00,in,False,907502,False,2,63,103,40
167158,2019-09-09 00:00:00+03:00,in,False,-1,True,2,0,32,32
167158,2019-09-10 00:00:00+03:00,in,False,-1,True,2,0,11,11
167158,2019-09-10 00:00:00+03:00,in,False,907502,False,6,581,681,100
167158,2019-09-11 00:00:00+03:00,in,False,-1,True,2,0,32,32
167158,2019-09-11 00:00:00+03:00,in,False,907502,False,3,950,1003,53
167158,2019-09-11 00:00:00+03:00,in,False,-1,True,2,0,32,32
167158,2019-09-12 00:00:00+03:00,in,False,907502,False,4,610,697,87
167158,2019-09-13 00:00:00+03:00,in,False,907502,False,4,80,178,98
167158,2019-09-13 00:00:00+03:00,in,False,-1,True,3,0,63,63
167158,2019-09-14 00:00:00+03:00,in,False,907502,False,1,18,44,26
167158,2019-09-15 00:00:00+03:00,in,False,907502,False,4,240,328,88
167158,2019-09-16 00:00:00+03:00,in,False,907502,False,3,71,133,62
167158,2019-09-16 00:00:00+03:00,in,False,-1,True,7,0,54,54
167158,2019-09-17 00:00:00+03:00,in,False,-1,True,2,0,56,56
167158,2019-09-17 00:00:00+03:00,in,False,907502,False,6,286,405,119
167158,2019-09-17 00:00:00+03:00,in,False,907502,False,6,286,405,119
167158,2019-09-18 00:00:00+03:00,in,False,-1,True,1,0,31,31
167158,2019-09-19 00:00:00+03:00,in,False,-1,True,1,0,28,28
167158,2019-09-19 00:00:00+03:00,in,False,907502,False,7,132,286,154
167158,2019-09-20 00:00:00+03:00,in,False,907502,False,4,76,169,93
167158,2019-09-21 00:00:00+03:00,in,False,907502,False,3,90,152,62
167158,2019-09-22 00:00:00+03:00,in,False,907502,False,2,49,96,47
167158,2019-09-22 00:00:00+03:00,in,False,-1,True,1,0,31,31
167158,2019-09-23 00:00:00+03:00,in,False,907502,False,7,484,651,167
167158,2019-09-24 00:00:00+03:00,in,False,-1,True,1,0,20,20
167158,2019-09-24 00:00:00+03:00,in,False,907502,False,3,79,146,67
167158,2019-09-25 00:00:00+03:00,in,False,907502,False,5,105,209,104
167158,2019-09-25 00:00:00+03:00,in,False,-1,True,1,0,29,29
167158,2019-09-25 00:00:00+03:00,in,False,907502,False,5,105,209,104
167158,2019-09-26 00:00:00+03:00,in,False,907502,False,8,330,476,146
167158,2019-09-26 00:00:00+03:00,in,False,907502,True,1,0,26,26
167158,2019-09-27 00:00:00+03:00,in,False,907502,False,6,204,308,104
167158,2019-09-27 00:00:00+03:00,in,False,-1,True,1,0,24,24
167158,2019-09-29 00:00:00+03:00,in,False,907502,False,4,211,286,75
167158,2019-09-29 00:00:00+03:00,in,False,-1,True,2,0,60,60
167158,2019-09-30 00:00:00+03:00,in,False,-1,True,2,0,26,26
167158,2019-09-30 00:00:00+03:00,in,False,907502,False,5,79,172,93
167158,2019-10-01 00:00:00+03:00,in,False,907502,False,6,165,289,124
167158,2019-10-01 00:00:00+03:00,in,False,907502,True,1,0,21,21
167158,2019-10-01 00:00:00+03:00,in,False,-1,True,2,0,64,64
167158,2019-10-02 00:00:00+03:00,in,False,907502,False,7,215,346,131
167158,2019-10-02 00:00:00+03:00,in,False,-1,True,7,0,135,135
167158,2019-10-03 00:00:00+03:00,in,False,907502,False,1,23,51,28
167158,2019-10-03 00:00:00+03:00,in,False,-1,True,8,0,18,18
167158,2019-10-04 00:00:00+03:00,in,False,907502,False,6,326,450,124
167158,2019-10-05 00:00:00+03:00,in,False,907502,False,2,195,229,34
167158,2019-10-05 00:00:00+03:00,in,False,-1,True,1,0,30,30
167158,2019-10-05 00:00:00+03:00,in,False,907502,False,2,195,229,34
167158,2019-10-06 00:00:00+03:00,in,False,-1,True,7,0,99,99
167158,2019-10-07 00:00:00+03:00,in,False,907502,False,1,35,53,18
167158,2019-10-07 00:00:00+03:00,in,False,-1,True,3,0,43,43
167158,2019-10-08 00:00:00+03:00,in,False,907502,False,10,526,710,184
167158,2019-10-08 00:00:00+03:00,in,False,-1,True,2,0,28,28
167158,2019-10-09 00:00:00+03:00,in,False,907502,False,3,149,203,54
167158,2019-10-09 00:00:00+03:00,in,False,-1,True,4,0,52,52
167158,2019-10-11 00:00:00+03:00,in,False,-1,True,3,0,58,58
167158,2019-10-11 00:00:00+03:00,in,False,907502,False,2,118,152,34
167158,2019-10-12 00:00:00+03:00,in,False,907502,False,1,8,26,18
167158,2019-10-13 00:00:00+03:00,in,False,907502,False,2,194,232,38
167158,2019-10-14 00:00:00+03:00,in,False,907502,False,4,220,284,64
167158,2019-10-14 00:00:00+03:00,in,False,-1,True,2,0,51,51
167158,2019-10-15 00:00:00+03:00,in,False,-1,True,1,0,31,31
167158,2019-10-15 00:00:00+03:00,in,False,907502,False,4,290,373,83
167158,2019-10-16 00:00:00+03:00,in,False,-1,True,6,0,65,65
167158,2019-10-16 00:00:00+03:00,in,False,907502,False,9,288,450,162
167158,2019-10-17 00:00:00+03:00,in,False,-1,True,5,0,84,84
167158,2019-10-17 00:00:00+03:00,in,False,907502,False,4,61,135,74
167158,2019-10-18 00:00:00+03:00,in,False,907502,False,5,186,291,105
167158,2019-10-18 00:00:00+03:00,in,False,-1,True,2,0,35,35
167158,2019-10-18 00:00:00+03:00,in,False,-1,True,2,0,35,35
167158,2019-10-19 00:00:00+03:00,in,False,907502,False,1,103,127,24
167158,2019-10-20 00:00:00+03:00,in,False,-1,True,5,0,113,113
167158,2019-10-20 00:00:00+03:00,in,False,907502,False,4,170,251,81
167158,2019-10-21 00:00:00+03:00,in,False,907502,False,5,143,244,101
167158,2019-10-21 00:00:00+03:00,in,False,-1,True,3,0,53,53
167158,2019-10-22 00:00:00+03:00,in,False,907502,False,3,197,264,67
167158,2019-10-23 00:00:00+03:00,in,False,907502,False,3,72,141,69
167158,2019-10-23 00:00:00+03:00,in,False,-1,True,7,0,110,110
167158,2019-10-23 00:00:00+03:00,in,False,-1,True,7,0,110,110
167158,2019-10-24 00:00:00+03:00,in,False,907502,False,6,206,323,117
167158,2019-10-24 00:00:00+03:00,in,False,-1,True,1,0,31,31
167158,2019-10-24 00:00:00+03:00,in,False,907502,False,6,206,323,117
167158,2019-10-25 00:00:00+03:00,in,False,907502,False,1,26,45,19
167158,2019-10-26 00:00:00+03:00,in,False,907502,False,2,183,230,47
167158,2019-10-27 00:00:00+03:00,in,False,-1,True,2,0,28,28
167158,2019-10-28 00:00:00+03:00,in,False,-1,True,13,0,198,198
167158,2019-10-28 00:00:00+03:00,in,False,907502,False,2,318,363,45
167158,2019-10-29 00:00:00+03:00,in,False,907502,False,4,65,141,76
167158,2019-10-29 00:00:00+03:00,in,False,-1,True,3,0,21,21
167158,2019-10-29 00:00:00+03:00,in,False,-1,True,3,0,21,21
167158,2019-10-30 00:00:00+03:00,in,False,-1,True,1,0,2,2
167158,2019-10-30 00:00:00+03:00,in,False,907502,False,6,155,266,111
167158,2019-10-31 00:00:00+03:00,in,False,-1,True,2,0,20,20
167158,2019-10-31 00:00:00+03:00,in,False,907502,False,4,137,208,71
167158,2019-11-01 00:00:00+03:00,in,False,-1,True,3,0,88,88
167158,2019-11-01 00:00:00+03:00,in,False,907502,False,4,374,464,90
167158,2019-11-02 00:00:00+03:00,in,False,907502,False,2,201,245,44
167158,2019-11-03 00:00:00+03:00,in,False,907502,False,4,468,557,89
167158,2019-11-03 00:00:00+03:00,in,False,-1,True,5,0,123,123
167158,2019-11-04 00:00:00+03:00,in,False,-1,True,1,0,30,30
167158,2019-11-04 00:00:00+03:00,in,False,907502,False,1,44,69,25
167158,2019-11-05 00:00:00+03:00,in,False,-1,True,3,0,53,53
167158,2019-11-05 00:00:00+03:00,in,False,907502,False,9,423,603,180
167158,2019-11-05 00:00:00+03:00,in,False,-1,True,3,0,53,53
167158,2019-11-06 00:00:00+03:00,in,False,-1,True,1,0,6,6
167158,2019-11-06 00:00:00+03:00,in,False,907502,False,6,153,274,121
167158,2019-11-07 00:00:00+03:00,in,False,907502,False,7,437,576,139
167158,2019-11-07 00:00:00+03:00,in,False,-1,True,5,0,110,110
167158,2019-11-08 00:00:00+03:00,in,False,-1,True,1,0,30,30
167158,2019-11-08 00:00:00+03:00,in,False,907502,False,5,95,193,98
167158,2019-11-09 00:00:00+03:00,in,False,907502,False,5,211,307,96
167158,2019-11-10 00:00:00+03:00,in,False,907502,False,2,218,256,38
167158,2019-11-10 00:00:00+03:00,in,False,-1,True,4,0,71,71
167158,2019-11-10 00:00:00+03:00,in,False,907502,False,2,218,256,38
167158,2019-11-11 00:00:00+03:00,in,False,-1,True,16,0,35,35
167158,2019-11-12 00:00:00+03:00,in,False,-1,True,7,0,14,14
167158,2019-11-13 00:00:00+03:00,in,False,-1,True,9,0,18,18
167158,2019-11-14 00:00:00+03:00,in,False,-1,True,7,0,15,15
167158,2019-11-15 00:00:00+03:00,in,False,-1,True,8,0,15,15
167158,2019-11-16 00:00:00+03:00,in,False,-1,True,9,0,18,18
167158,2019-11-17 00:00:00+03:00,in,False,-1,True,7,0,15,15
167158,2019-11-18 00:00:00+03:00,in,False,-1,True,10,0,21,21
167158,2019-11-19 00:00:00+03:00,in,False,-1,True,5,0,11,11
167158,2019-11-19 00:00:00+03:00,in,False,-1,True,5,0,11,11
167158,2019-11-20 00:00:00+03:00,in,False,-1,True,11,0,21,21
167158,2019-11-21 00:00:00+03:00,in,False,-1,True,3,0,4,4
167158,2019-11-22 00:00:00+03:00,in,False,-1,True,7,0,15,15
167158,2019-11-23 00:00:00+03:00,in,False,-1,True,14,0,28,28
167158,2019-11-24 00:00:00+03:00,in,False,-1,True,7,0,14,14
167158,2019-11-25 00:00:00+03:00,in,False,-1,True,2,0,4,4
167158,2019-11-26 00:00:00+03:00,in,False,-1,True,16,0,33,33
167158,2019-11-27 00:00:00+03:00,in,False,-1,True,8,0,17,17
167158,2019-11-27 00:00:00+03:00,in,False,-1,True,8,0,17,17
167158,2019-11-28 00:00:00+03:00,in,False,-1,True,5,0,11,11
167162,2019-09-04 00:00:00+03:00,in,False,-1,True,3,0,6,6
167162,2019-09-05 00:00:00+03:00,in,False,-1,True,2,0,3,3
167162,2019-09-06 00:00:00+03:00,in,False,-1,True,2,0,41,41
167162,2019-09-06 00:00:00+03:00,in,False,905300,False,1,9,16,7
167162,2019-09-09 00:00:00+03:00,in,False,905300,False,1,79,85,6
167162,2019-09-10 00:00:00+03:00,in,False,-1,True,1,0,15,15
167162,2019-09-10 00:00:00+03:00,in,False,905300,False,2,32,60,28
167162,2019-09-12 00:00:00+03:00,in,False,905300,True,3,0,52,52
167162,2019-09-12 00:00:00+03:00,in,False,-1,True,3,0,74,74
167162,2019-09-15 00:00:00+03:00,in,False,905300,False,1,36,56,20
167162,2019-09-15 00:00:00+03:00,in,False,-1,True,1,0,20,20
167162,2019-09-16 00:00:00+03:00,in,False,905300,False,1,23,45,22
167162,2019-09-17 00:00:00+03:00,in,False,905300,False,1,5,27,22
167162,2019-09-18 00:00:00+03:00,in,False,-1,True,1,0,4,4
167162,2019-09-18 00:00:00+03:00,in,False,905300,False,1,82,112,30
167162,2019-09-26 00:00:00+03:00,in,False,905300,False,1,25,50,25
167162,2019-10-03 00:00:00+03:00,in,False,905300,False,2,31,74,43
167162,2019-10-03 00:00:00+03:00,in,False,-1,True,1,0,4,4
167162,2019-10-08 00:00:00+03:00,in,False,905300,False,1,23,46,23
167162,2019-10-09 00:00:00+03:00,in,False,905300,False,4,90,188,98
167162,2019-10-09 00:00:00+03:00,in,False,905300,True,3,0,90,90
167162,2019-10-09 00:00:00+03:00,in,False,-1,True,2,0,15,15
167162,2019-10-09 00:00:00+03:00,in,False,905300,False,4,90,188,98
167162,2019-10-23 00:00:00+03:00,in,False,-1,True,1,0,7,7
167162,2019-10-23 00:00:00+03:00,in,False,905300,False,1,21,49,28
167162,2019-10-24 00:00:00+03:00,in,False,-1,True,1,0,7,7
167162,2019-10-24 00:00:00+03:00,in,False,905300,False,1,9,40,31
167162,2019-11-12 00:00:00+03:00,in,False,905300,False,1,22,49,27
167172,2019-09-05 00:00:00+03:00,in,False,-1,True,8,0,16,16
167172,2019-09-05 00:00:00+03:00,out,False,904202,True,2,0,7,7
167172,2019-09-06 00:00:00+03:00,in,False,904202,False,1,11,17,6
167172,2019-09-06 00:00:00+03:00,out,True,904202,False,2,35,53,18
167172,2019-09-06 00:00:00+03:00,in,True,904202,False,1,7,30,23
167172,2019-09-06 00:00:00+03:00,out,False,904202,False,11,559,738,179
167172,2019-09-06 00:00:00+03:00,in,False,-1,True,7,0,97,97
167172,2019-09-06 00:00:00+03:00,out,False,904202,True,9,0,152,152
167172,2019-09-09 00:00:00+03:00,out,False,904202,True,6,0,154,154
167172,2019-09-09 00:00:00+03:00,in,False,-1,True,5,0,47,47
167172,2019-09-09 00:00:00+03:00,out,False,904202,False,25,4151,4516,365
167172,2019-09-09 00:00:00+03:00,in,True,904200,False,1,8,25,17
167172,2019-09-09 00:00:00+03:00,in,False,904202,False,1,128,142,14
167172,2019-09-10 00:00:00+03:00,in,False,-1,True,6,0,68,68
167172,2019-09-10 00:00:00+03:00,out,False,904202,True,27,0,548,548
167172,2019-09-10 00:00:00+03:00,out,False,904202,False,31,2879,3292,413
167172,2019-09-10 00:00:00+03:00,in,True,904200,False,1,3,15,12
167172,2019-09-10 00:00:00+03:00,in,False,904202,False,2,603,612,9
167172,2019-09-10 00:00:00+03:00,in,False,904202,False,2,603,612,9
167172,2019-09-11 00:00:00+03:00,in,False,-1,True,6,0,58,58
167172,2019-09-11 00:00:00+03:00,out,False,904202,True,27,0,488,488
167172,2019-09-11 00:00:00+03:00,out,False,904202,False,35,2813,3349,536
167172,2019-09-12 00:00:00+03:00,in,False,-1,True,1,0,8,8
167172,2019-09-13 00:00:00+03:00,in,False,904202,False,1,112,117,5
167172,2019-09-13 00:00:00+03:00,in,False,-1,True,1,0,9,9
167172,2019-09-13 00:00:00+03:00,out,False,904202,True,5,0,118,118
167172,2019-09-13 00:00:00+03:00,out,False,904202,False,16,2352,2607,255
167172,2019-09-16 00:00:00+03:00,in,False,-1,True,4,0,35,35
167172,2019-09-16 00:00:00+03:00,in,False,904200,False,1,95,123,28
167172,2019-09-16 00:00:00+03:00,in,False,904200,False,1,95,123,28
167172,2019-09-17 00:00:00+03:00,out,True,904202,True,1,0,9,9
167172,2019-09-17 00:00:00+03:00,out,False,904200,True,2,0,22,22
167172,2019-09-17 00:00:00+03:00,out,False,904202,False,8,1349,1491,142
167172,2019-09-17 00:00:00+03:00,in,False,-1,True,4,0,53,53
167172,2019-09-17 00:00:00+03:00,out,False,904202,True,8,0,230,230
167172,2019-09-17 00:00:00+03:00,out,False,904200,False,1,59,73,14
167172,2019-09-17 00:00:00+03:00,in,False,904202,False,1,19,43,24
167172,2019-09-17 00:00:00+03:00,out,True,904202,True,1,0,9,9
167172,2019-09-18 00:00:00+03:00,in,False,-1,True,6,0,37,37
167172,2019-09-18 00:00:00+03:00,out,False,904200,False,3,18,73,55
167172,2019-09-19 00:00:00+03:00,out,False,904200,False,2,125,160,35
167172,2019-09-19 00:00:00+03:00,in,False,-1,True,3,0,17,17
167172,2019-09-19 00:00:00+03:00,out,False,904200,False,2,125,160,35
167172,2019-09-20 00:00:00+03:00,out,False,904202,True,4,0,57,57
167172,2019-09-20 00:00:00+03:00,out,False,904202,False,12,1277,1508,231
167172,2019-09-20 00:00:00+03:00,out,False,904202,False,12,1277,1508,231
167172,2019-09-23 00:00:00+03:00,out,False,904202,True,2,0,42,42
167172,2019-09-23 00:00:00+03:00,out,False,904202,False,2,111,149,38
167172,2019-09-26 00:00:00+03:00,out,False,904200,True,2,0,28,28
167172,2019-09-26 00:00:00+03:00,in,False,-1,True,1,0,8,8
167172,2019-10-07 00:00:00+03:00,in,False,904200,False,1,5,57,52
167172,2019-10-07 00:00:00+03:00,in,False,-1,True,2,0,31,31
167172,2019-10-08 00:00:00+03:00,in,False,926490,False,1,31,57,26
167172,2019-10-08 00:00:00+03:00,in,False,904200,False,1,8,23,15
167172,2019-10-08 00:00:00+03:00,in,False,-1,True,1,0,23,23
167172,2019-10-09 00:00:00+03:00,out,False,926490,True,1,0,26,26
167172,2019-10-09 00:00:00+03:00,in,False,-1,True,1,0,5,5
167172,2019-10-10 00:00:00+03:00,out,False,926490,True,1,0,26,26
167172,2019-10-10 00:00:00+03:00,out,True,926490,True,1,0,31,31
167172,2019-10-11 00:00:00+03:00,in,False,904200,False,2,8,30,22
167172,2019-10-11 00:00:00+03:00,in,False,-1,True,2,0,30,30
167172,2019-10-11 00:00:00+03:00,in,True,926490,True,1,0,20,20
167172,2019-10-11 00:00:00+03:00,in,False,-1,True,1,0,22,22
167172,2019-10-11 00:00:00+03:00,out,True,904204,False,1,14,27,13
167172,2019-10-11 00:00:00+03:00,out,True,929228,False,2,45,94,49
167172,2019-10-11 00:00:00+03:00,out,True,926490,False,1,9,53,44
167172,2019-10-11 00:00:00+03:00,in,True,926490,False,1,8,59,51
167172,2019-10-11 00:00:00+03:00,out,True,904204,True,13,0,146,146
167172,2019-10-17 00:00:00+03:00,in,False,-1,True,4,0,159,159
167172,2019-10-17 00:00:00+03:00,out,False,926490,False,1,152,181,29
167172,2019-10-18 00:00:00+03:00,in,False,-1,True,2,0,14,14
167172,2019-10-18 00:00:00+03:00,in,False,904204,False,1,11,23,12
167172,2019-10-18 00:00:00+03:00,in,True,926490,False,1,21,45,24
167172,2019-10-18 00:00:00+03:00,out,False,926490,False,1,59,73,14
167172,2019-10-18 00:00:00+03:00,in,False,-1,True,3,0,67,67
167172,2019-10-21 00:00:00+03:00,out,False,929228,True,1,0,7,7
167172,2019-10-21 00:00:00+03:00,out,False,926490,True,1,0,12,12
167172,2019-10-21 00:00:00+03:00,out,True,929228,False,1,9,17,8
167172,2019-10-21 00:00:00+03:00,out,False,929228,False,9,1084,1162,78
167172,2019-10-21 00:00:00+03:00,out,False,926490,False,1,145,162,17
167172,2019-10-22 00:00:00+03:00,out,False,929228,False,4,284,330,46
167172,2019-10-22 00:00:00+03:00,out,False,926490,False,2,237,259,22
167172,2019-10-22 00:00:00+03:00,out,False,926490,True,3,0,41,41
167172,2019-10-22 00:00:00+03:00,out,False,929228,False,4,284,330,46
167172,2019-10-23 00:00:00+03:00,in,False,-1,True,1,0,47,47
167172,2019-10-23 00:00:00+03:00,out,False,943818,False,4,274,363,89
167172,2019-10-23 00:00:00+03:00,out,False,929228,True,5,0,206,206
167172,2019-10-23 00:00:00+03:00,out,True,929228,False,1,186,193,7
167172,2019-10-23 00:00:00+03:00,out,True,943818,False,1,10,25,15
167172,2019-10-23 00:00:00+03:00,out,False,929228,False,4,163,226,63
167172,2019-10-23 00:00:00+03:00,out,True,943818,True,1,0,19,19
167172,2019-10-23 00:00:00+03:00,out,False,926490,False,2,597,643,46
167172,2019-10-23 00:00:00+03:00,out,False,943818,False,4,274,363,89
167172,2019-10-24 00:00:00+03:00,out,False,926490,False,4,309,355,46
167172,2019-10-24 00:00:00+03:00,out,False,904204,True,6,0,17,17
167172,2019-10-24 00:00:00+03:00,in,False,-1,True,1,0,7,7
167172,2019-10-24 00:00:00+03:00,out,False,943818,True,5,0,123,123
167172,2019-10-24 00:00:00+03:00,out,True,904204,True,1,0,12,12
167172,2019-10-24 00:00:00+03:00,out,False,929228,False,4,118,148,30
167172,2019-10-24 00:00:00+03:00,out,False,926490,True,3,0,156,156
167172,2019-10-24 00:00:00+03:00,out,False,943818,False,11,1361,1461,100
167172,2019-10-24 00:00:00+03:00,out,False,904204,False,6,250,444,194
167172,2019-10-25 00:00:00+03:00,out,False,929228,False,3,1048,1061,13
167172,2019-10-25 00:00:00+03:00,out,False,926490,True,1,0,35,35
167172,2019-10-25 00:00:00+03:00,out,False,926490,False,1,37,57,20
167172,2019-10-28 00:00:00+03:00,in,False,904204,False,1,150,161,11
167172,2019-10-28 00:00:00+03:00,out,False,929228,True,1,0,58,58
167172,2019-10-28 00:00:00+03:00,out,False,904204,True,1,0,66,66
167172,2019-10-29 00:00:00+03:00,out,False,929228,False,1,38,47,9
167172,2019-10-29 00:00:00+03:00,out,False,929228,True,5,0,74,74
167172,2019-10-29 00:00:00+03:00,in,False,-1,True,1,0,26,26
167172,2019-10-29 00:00:00+03:00,in,False,929228,False,1,1,25,24
167172,2019-10-29 00:00:00+03:00,out,False,926490,False,1,756,768,12
167172,2019-10-29 00:00:00+03:00,out,False,904204,False,2,175,222,47
167172,2019-10-29 00:00:00+03:00,out,False,926490,False,1,756,768,12
167172,2019-10-30 00:00:00+03:00,out,False,926490,False,6,1792,1840,48
167172,2019-10-30 00:00:00+03:00,out,True,926490,True,1,0,0,0
167172,2019-10-30 00:00:00+03:00,out,False,904204,True,1,0,66,66
167172,2019-10-30 00:00:00+03:00,in,False,-1,True,1,0,10,10
167172,2019-10-30 00:00:00+03:00,in,False,943818,False,1,118,123,5
167172,2019-10-30 00:00:00+03:00,out,False,926490,True,2,0,86,86
167172,2019-10-30 00:00:00+03:00,out,False,926490,False,6,1792,1840,48
167172,2019-10-31 00:00:00+03:00,out,False,904204,False,4,116,153,37
167172,2019-10-31 00:00:00+03:00,out,False,929228,True,1,0,16,16
167172,2019-10-31 00:00:00+03:00,out,False,929228,False,2,297,320,23
167172,2019-11-01 00:00:00+03:00,out,False,904204,True,3,0,71,71
167172,2019-11-01 00:00:00+03:00,out,False,904204,False,1,12,28,16
167172,2019-11-01 00:00:00+03:00,in,False,-1,True,3,0,127,127
167172,2019-11-01 00:00:00+03:00,out,False,904204,False,1,12,28,16
167172,2019-11-06 00:00:00+03:00,in,False,-1,True,2,0,16,16
167172,2019-11-06 00:00:00+03:00,out,False,926490,True,5,0,57,57
167172,2019-11-06 00:00:00+03:00,out,False,926490,False,10,2869,2958,89
167172,2019-11-07 00:00:00+03:00,out,False,929228,False,1,37,46,9
167172,2019-11-07 00:00:00+03:00,out,False,926490,True,7,0,280,280
167172,2019-11-07 00:00:00+03:00,out,False,926490,False,1,103,115,12
167172,2019-11-08 00:00:00+03:00,in,False,-1,True,1,0,6,6
167172,2019-11-08 00:00:00+03:00,out,False,929228,False,2,54,71,17
167172,2019-11-08 00:00:00+03:00,out,False,926490,False,3,289,397,108
167172,2019-11-11 00:00:00+03:00,out,False,926490,True,5,0,245,245
167172,2019-11-11 00:00:00+03:00,out,False,926490,False,8,2158,2201,43
167172,2019-11-11 00:00:00+03:00,out,False,929228,True,1,0,38,38
167172,2019-11-11 00:00:00+03:00,out,True,926490,True,1,0,0,0
167172,2019-11-12 00:00:00+03:00,out,False,904204,False,2,60,92,32
167172,2019-11-12 00:00:00+03:00,out,False,926490,False,2,144,170,26
167172,2019-11-12 00:00:00+03:00,out,False,929228,True,3,0,56,56
167172,2019-11-12 00:00:00+03:00,out,False,929228,False,6,683,720,37
167172,2019-11-12 00:00:00+03:00,out,False,926490,True,3,0,17,17
167172,2019-11-12 00:00:00+03:00,out,False,904204,False,2,60,92,32
167172,2019-11-13 00:00:00+03:00,out,False,926490,False,5,436,492,56
167172,2019-11-13 00:00:00+03:00,out,False,929228,True,1,0,27,27
167172,2019-11-13 00:00:00+03:00,out,False,926490,True,7,0,2,2
167172,2019-11-14 00:00:00+03:00,out,False,904204,False,1,45,69,24
167172,2019-11-14 00:00:00+03:00,out,False,926490,False,4,851,885,34
167172,2019-11-15 00:00:00+03:00,out,False,926490,False,4,2161,2172,11
167172,2019-11-18 00:00:00+03:00,in,False,904204,False,1,5,76,71
167172,2019-11-18 00:00:00+03:00,in,False,-1,True,1,0,33,33
167172,2019-11-18 00:00:00+03:00,out,True,926490,True,1,0,9,9
167172,2019-11-18 00:00:00+03:00,out,False,929228,False,1,29,42,13
167172,2019-11-18 00:00:00+03:00,out,False,926490,False,1,116,130,14
167172,2019-11-18 00:00:00+03:00,out,False,926490,True,4,0,44,44
167172,2019-11-18 00:00:00+03:00,out,True,926490,True,1,0,9,9
167172,2019-11-19 00:00:00+03:00,out,False,904204,False,2,62,137,75
167172,2019-11-19 00:00:00+03:00,in,False,926490,False,1,74,86,12
167172,2019-11-19 00:00:00+03:00,out,False,926490,False,3,958,968,10
167172,2019-11-19 00:00:00+03:00,out,False,929228,False,2,170,189,19
167172,2019-11-19 00:00:00+03:00,out,False,929228,True,6,0,69,69
167172,2019-11-19 00:00:00+03:00,out,False,926490,False,3,958,968,10
167172,2019-11-20 00:00:00+03:00,out,False,929228,False,8,177,265,88
167172,2019-11-20 00:00:00+03:00,in,False,926490,False,3,204,238,34
167172,2019-11-20 00:00:00+03:00,out,False,929228,True,1,0,0,0
167172,2019-11-20 00:00:00+03:00,out,False,904204,False,1,50,64,14
167172,2019-11-20 00:00:00+03:00,in,False,-1,True,1,0,27,27
167172,2019-11-21 00:00:00+03:00,in,False,904204,False,2,47,114,67
167172,2019-11-21 00:00:00+03:00,out,False,929228,False,2,82,109,27
167172,2019-11-21 00:00:00+03:00,in,False,926490,False,1,17,35,18
167172,2019-11-21 00:00:00+03:00,out,False,929228,True,1,0,30,30
167172,2019-11-21 00:00:00+03:00,out,False,904204,False,2,240,264,24
167172,2019-11-21 00:00:00+03:00,out,False,904204,False,2,240,264,24
167172,2019-11-22 00:00:00+03:00,in,False,926490,False,1,223,272,49
167172,2019-11-22 00:00:00+03:00,out,False,926490,False,2,138,167,29
167172,2019-11-22 00:00:00+03:00,out,False,904204,False,2,208,246,38
167172,2019-11-22 00:00:00+03:00,out,False,926490,True,1,0,0,0
167172,2019-11-25 00:00:00+03:00,in,False,-1,True,1,0,10,10
167172,2019-11-25 00:00:00+03:00,out,False,904204,False,3,191,225,34
167172,2019-11-25 00:00:00+03:00,out,False,929228,True,1,0,4,4
167172,2019-11-25 00:00:00+03:00,in,False,926490,False,1,49,61,12
167172,2019-11-25 00:00:00+03:00,out,False,926490,False,1,32,38,6
167172,2019-11-25 00:00:00+03:00,out,False,929228,False,2,30,75,45
167172,2019-11-26 00:00:00+03:00,out,False,929228,False,4,831,867,36
167172,2019-11-26 00:00:00+03:00,out,False,904204,False,1,73,94,21
167172,2019-11-28 00:00:00+03:00,out,False,926490,True,11,0,292,292
167172,2019-11-28 00:00:00+03:00,out,False,926490,False,10,2387,2460,73
167172,2019-11-28 00:00:00+03:00,out,False,904204,False,1,51,64,13
167172,2019-11-28 00:00:00+03:00,out,False,929228,False,1,25,31,6
167172,2019-11-28 00:00:00+03:00,in,False,-1,True,2,0,23,23
167175,2019-09-05 00:00:00+03:00,in,False,-1,True,1,0,2,2
167175,2019-09-06 00:00:00+03:00,out,False,905840,True,2,0,27,27
167175,2019-09-09 00:00:00+03:00,out,False,905840,False,1,257,267,10
167175,2019-09-17 00:00:00+03:00,out,False,905844,False,4,1316,1359,43
167175,2019-09-17 00:00:00+03:00,out,False,905844,True,1,0,17,17
167175,2019-09-17 00:00:00+03:00,out,False,905842,False,6,78,164,86
167175,2019-09-17 00:00:00+03:00,out,False,905840,False,1,17,35,18
167175,2019-09-18 00:00:00+03:00,out,False,905842,True,7,0,122,122
167175,2019-09-18 00:00:00+03:00,out,False,905844,False,5,124,188,64
167175,2019-09-18 00:00:00+03:00,out,False,905844,True,1,0,59,59
167175,2019-09-18 00:00:00+03:00,in,False,-1,True,1,0,12,12
167175,2019-09-18 00:00:00+03:00,out,False,905840,False,1,14,29,15
167175,2019-09-18 00:00:00+03:00,out,False,905842,False,7,347,466,119
167175,2019-09-18 00:00:00+03:00,out,False,905842,False,7,347,466,119
167175,2019-09-19 00:00:00+03:00,in,False,-1,True,1,0,1,1
167175,2019-09-19 00:00:00+03:00,out,False,905844,True,6,0,308,308
167175,2019-09-19 00:00:00+03:00,out,False,905844,False,10,958,1111,153
167175,2019-09-19 00:00:00+03:00,out,False,905842,True,10,0,149,149
167175,2019-09-19 00:00:00+03:00,out,False,905842,False,10,1341,1454,113
167175,2019-09-20 00:00:00+03:00,out,False,905842,False,3,612,657,45
167175,2019-09-20 00:00:00+03:00,in,False,-1,True,1,0,26,26
167175,2019-09-20 00:00:00+03:00,out,False,905844,False,2,98,123,25
167175,2019-09-20 00:00:00+03:00,out,False,905844,True,4,0,68,68
167175,2019-09-20 00:00:00+03:00,out,False,905842,True,6,0,83,83
167175,2019-09-20 00:00:00+03:00,out,False,905840,True,1,0,60,60
167175,2019-09-21 00:00:00+03:00,out,False,905844,True,3,0,102,102
167175,2019-09-21 00:00:00+03:00,out,False,905842,False,6,705,798,93
167175,2019-09-21 00:00:00+03:00,in,False,-1,True,1,0,18,18
167175,2019-09-21 00:00:00+03:00,out,False,905844,False,6,227,298,71
167175,2019-09-21 00:00:00+03:00,out,False,905842,True,11,0,212,212
167175,2019-09-21 00:00:00+03:00,out,False,905844,True,3,0,102,102
167175,2019-09-21 00:00:00+03:00,out,False,905844,False,6,227,298,71
167175,2019-09-22 00:00:00+03:00,out,False,905842,False,2,382,404,22
167175,2019-09-22 00:00:00+03:00,out,False,905842,True,3,0,24,24
167175,2019-09-22 00:00:00+03:00,out,False,905844,False,3,251,294,43
167175,2019-09-22 00:00:00+03:00,in,False,-1,True,1,0,0,0
167175,2019-09-22 00:00:00+03:00,out,False,905844,False,3,251,294,43
167175,2019-09-22 00:00:00+03:00,in,False,-1,True,1,0,0,0
167175,2019-09-22 00:00:00+03:00,out,False,905842,True,3,0,24,24
167175,2019-09-23 00:00:00+03:00,out,False,905842,False,3,340,363,23
167175,2019-09-23 00:00:00+03:00,out,False,905844,False,15,975,1232,257
167175,2019-09-23 00:00:00+03:00,out,False,905844,True,10,0,237,237
167175,2019-09-23 00:00:00+03:00,in,False,-1,True,1,0,34,34
167175,2019-09-23 00:00:00+03:00,out,False,905842,True,4,0,74,74
167175,2019-09-24 00:00:00+03:00,out,False,905844,False,5,1036,1129,93
167175,2019-09-24 00:00:00+03:00,in,False,-1,True,1,0,3,3
167175,2019-09-24 00:00:00+03:00,out,False,905844,True,4,0,78,78
167175,2019-09-24 00:00:00+03:00,out,False,905842,False,4,1177,1227,50
167175,2019-09-24 00:00:00+03:00,out,False,905842,True,11,0,141,141
167175,2019-09-25 00:00:00+03:00,out,False,905842,False,6,1200,1277,77
167175,2019-09-25 00:00:00+03:00,out,False,905844,False,8,1309,1416,107
167175,2019-09-25 00:00:00+03:00,out,False,905842,True,7,0,119,119
167175,2019-09-25 00:00:00+03:00,out,False,905844,True,6,0,309,309
167175,2019-09-26 00:00:00+03:00,out,False,905844,True,3,0,70,70
167175,2019-09-26 00:00:00+03:00,out,False,905842,False,4,1075,1117,42
167175,2019-09-26 00:00:00+03:00,out,False,905844,False,4,671,749,78
167175,2019-09-26 00:00:00+03:00,out,False,905842,True,5,0,84,84
167175,2019-09-26 00:00:00+03:00,out,False,905842,True,5,0,84,84
167175,2019-09-27 00:00:00+03:00,out,False,905844,True,5,0,217,217
167175,2019-09-27 00:00:00+03:00,out,False,905842,False,1,121,128,7
167175,2019-09-27 00:00:00+03:00,out,False,905844,False,10,769,930,161
167175,2019-09-27 00:00:00+03:00,out,False,905842,True,4,0,73,73
167175,2019-09-27 00:00:00+03:00,in,False,905844,False,1,32,42,10
167175,2019-09-27 00:00:00+03:00,out,False,905842,True,4,0,73,73
167175,2019-09-29 00:00:00+03:00,out,False,905844,True,6,0,205,205
167175,2019-09-29 00:00:00+03:00,out,False,905844,False,11,334,605,271
167175,2019-09-29 00:00:00+03:00,in,False,905844,False,1,2,7,5
167175,2019-09-29 00:00:00+03:00,out,False,905842,False,4,630,695,65
167175,2019-09-29 00:00:00+03:00,out,False,905842,True,6,0,104,104
167175,2019-09-29 00:00:00+03:00,out,False,905842,False,4,630,695,65
167175,2019-09-30 00:00:00+03:00,out,False,905842,False,4,358,395,37
167175,2019-09-30 00:00:00+03:00,out,False,905844,False,10,964,1210,246
167175,2019-09-30 00:00:00+03:00,out,False,905844,True,17,0,490,490
167175,2019-09-30 00:00:00+03:00,out,False,905842,True,7,0,100,100
167175,2019-09-30 00:00:00+03:00,in,False,-1,True,1,0,11,11
167175,2019-09-30 00:00:00+03:00,in,False,-1,True,1,0,11,11
167175,2019-10-01 00:00:00+03:00,out,False,905842,False,2,403,425,22
167175,2019-10-01 00:00:00+03:00,out,False,905844,True,2,0,88,88
167175,2019-10-01 00:00:00+03:00,out,False,905844,False,7,749,893,144
167175,2019-10-01 00:00:00+03:00,out,False,905842,True,5,0,83,83
167175,2019-10-02 00:00:00+03:00,out,False,905844,True,6,0,209,209
167175,2019-10-02 00:00:00+03:00,out,False,905842,False,3,695,725,30
167175,2019-10-02 00:00:00+03:00,out,False,905844,False,8,422,583,161
167175,2019-10-02 00:00:00+03:00,out,False,905842,True,11,0,122,122
167175,2019-10-02 00:00:00+03:00,in,False,-1,True,1,0,5,5
167175,2019-10-02 00:00:00+03:00,out,False,905844,False,8,422,583,161
167175,2019-10-03 00:00:00+03:00,out,False,905844,True,3,0,59,59
167175,2019-10-03 00:00:00+03:00,out,False,905844,False,9,234,394,160
167175,2019-10-03 00:00:00+03:00,in,False,905844,False,1,14,33,19
167175,2019-10-03 00:00:00+03:00,out,False,905842,True,3,0,62,62
167175,2019-10-03 00:00:00+03:00,out,False,905842,False,3,903,946,43
167175,2019-10-03 00:00:00+03:00,in,False,905844,False,1,14,33,19
167175,2019-10-04 00:00:00+03:00,out,False,905842,False,1,241,256,15
167175,2019-10-04 00:00:00+03:00,out,False,905844,False,4,96,175,79
167175,2019-10-04 00:00:00+03:00,out,False,905842,True,4,0,62,62
167175,2019-10-04 00:00:00+03:00,out,False,905840,False,1,112,120,8
167175,2019-10-04 00:00:00+03:00,out,False,905844,True,3,0,56,56
167175,2019-10-05 00:00:00+03:00,out,False,905842,False,2,1066,1099,33
167175,2019-10-05 00:00:00+03:00,out,False,905844,False,2,103,139,36
167175,2019-10-06 00:00:00+03:00,out,False,905842,False,3,822,843,21
167175,2019-10-06 00:00:00+03:00,out,False,905842,True,5,0,47,47
167175,2019-10-06 00:00:00+03:00,out,False,905844,True,2,0,68,68
167175,2019-10-06 00:00:00+03:00,in,False,-1,True,1,0,3,3
167175,2019-10-06 00:00:00+03:00,out,False,905844,False,4,161,240,79
167175,2019-10-07 00:00:00+03:00,out,False,905842,True,5,0,64,64
167175,2019-10-07 00:00:00+03:00,out,False,905844,True,1,0,49,49
167175,2019-10-07 00:00:00+03:00,out,False,905844,False,4,330,418,88
167175,2019-10-07 00:00:00+03:00,out,False,905842,False,4,839,892,53
167175,2019-10-08 00:00:00+03:00,in,False,-1,True,1,0,15,15
167175,2019-10-08 00:00:00+03:00,out,False,905844,True,6,0,171,171
167175,2019-10-08 00:00:00+03:00,out,False,905844,False,12,1343,1543,200
167175,2019-10-08 00:00:00+03:00,out,False,905842,False,6,1333,1403,70
167175,2019-10-08 00:00:00+03:00,out,False,905842,True,9,0,144,144
167175,2019-10-09 00:00:00+03:00,out,False,905842,True,29,0,442,442
167175,2019-10-09 00:00:00+03:00,out,False,905844,True,13,0,450,450
167175,2019-10-09 00:00:00+03:00,out,False,905844,False,17,2703,2936,233
167175,2019-10-09 00:00:00+03:00,out,False,905842,False,10,2856,2972,116
167175,2019-10-09 00:00:00+03:00,in,False,-1,True,1,0,22,22
167175,2019-10-10 00:00:00+03:00,in,False,-1,True,1,0,22,22
167175,2019-10-10 00:00:00+03:00,out,False,905844,False,29,4304,4794,490
167175,2019-10-10 00:00:00+03:00,out,False,905842,False,6,1730,1799,69
167175,2019-10-10 00:00:00+03:00,out,False,905844,True,16,0,601,601
167175,2019-10-10 00:00:00+03:00,out,False,905842,True,9,0,131,131
167175,2019-10-11 00:00:00+03:00,in,False,-1,True,3,0,56,56
167175,2019-10-11 00:00:00+03:00,out,False,905842,True,15,0,256,256
167175,2019-10-11 00:00:00+03:00,out,False,905844,True,14,0,371,371
167175,2019-10-11 00:00:00+03:00,out,False,905842,False,18,4330,4581,251
167175,2019-10-11 00:00:00+03:00,out,False,905844,False,17,2105,2405,300
167175,2019-10-12 00:00:00+03:00,out,False,905842,True,3,0,58,58
167175,2019-10-12 00:00:00+03:00,out,False,905842,False,5,905,970,65
167175,2019-10-13 00:00:00+03:00,out,False,905844,True,2,0,59,59
167175,2019-10-13 00:00:00+03:00,out,False,905844,False,8,878,1047,169
167175,2019-10-14 00:00:00+03:00,in,False,905844,False,1,8,15,7
167175,2019-10-14 00:00:00+03:00,out,False,905842,False,17,3014,3214,200
167175,2019-10-14 00:00:00+03:00,out,False,905844,True,21,0,625,625
167175,2019-10-14 00:00:00+03:00,out,False,905842,True,14,0,204,204
167175,2019-10-14 00:00:00+03:00,out,False,905844,False,23,3540,3946,406
167175,2019-10-14 00:00:00+03:00,out,False,905844,False,23,3540,3946,406
167175,2019-10-15 00:00:00+03:00,out,False,905844,True,14,0,376,376
167175,2019-10-15 00:00:00+03:00,out,False,905844,False,17,1551,1810,259
167175,2019-10-15 00:00:00+03:00,in,False,905844,False,1,211,226,15
167175,2019-10-15 00:00:00+03:00,out,False,905842,True,17,0,288,288
167175,2019-10-15 00:00:00+03:00,out,False,905842,False,9,2481,2603,122
167175,2019-10-15 00:00:00+03:00,out,False,905842,False,9,2481,2603,122
167175,2019-10-16 00:00:00+03:00,out,False,905844,False,17,2010,2337,327
167175,2019-10-16 00:00:00+03:00,out,False,905842,False,10,1180,1296,116
167175,2019-10-16 00:00:00+03:00,in,False,-1,True,2,0,14,14
167175,2019-10-16 00:00:00+03:00,out,False,905844,True,12,0,333,333
167175,2019-10-16 00:00:00+03:00,out,False,905842,True,23,0,348,348
167175,2019-10-16 00:00:00+03:00,out,False,905842,False,10,1180,1296,116
167175,2019-10-17 00:00:00+03:00,out,False,905844,False,19,2269,2533,264
167175,2019-10-17 00:00:00+03:00,out,False,905842,False,5,291,357,66
167175,2019-10-17 00:00:00+03:00,out,False,905842,True,26,0,395,395
167175,2019-10-17 00:00:00+03:00,out,False,905844,True,9,0,326,326
167175,2019-10-17 00:00:00+03:00,in,False,-1,True,2,0,29,29
167175,2019-10-17 00:00:00+03:00,out,False,905842,True,26,0,395,395
167175,2019-10-17 00:00:00+03:00,out,False,905844,True,9,0,326,326
167175,2019-10-17 00:00:00+03:00,out,False,905844,False,19,2269,2533,264
167175,2019-10-18 00:00:00+03:00,out,False,905844,False,18,1566,1789,223
167175,2019-10-18 00:00:00+03:00,out,False,905842,False,13,2466,2637,171
167175,2019-10-18 00:00:00+03:00,in,False,905844,False,1,6,24,18
167175,2019-10-18 00:00:00+03:00,out,False,905842,True,24,0,378,378
167175,2019-10-18 00:00:00+03:00,out,False,905844,True,19,0,479,479
167175,2019-10-18 00:00:00+03:00,in,False,905844,False,1,6,24,18
167175,2019-10-19 00:00:00+03:00,out,False,938842,True,3,0,78,78
167175,2019-10-19 00:00:00+03:00,out,False,938842,False,8,1249,1343,94
167175,2019-10-19 00:00:00+03:00,out,False,905844,False,26,2483,2879,396
167175,2019-10-19 00:00:00+03:00,in,False,-1,True,2,0,1,1
167175,2019-10-19 00:00:00+03:00,out,False,905844,True,24,0,535,535
167175,2019-10-19 00:00:00+03:00,out,False,938842,False,8,1249,1343,94
167175,2019-10-19 00:00:00+03:00,in,False,-1,True,2,0,1,1
167175,2019-10-20 00:00:00+03:00,out,False,905842,False,11,2090,2222,132
167175,2019-10-20 00:00:00+03:00,in,False,-1,True,3,0,37,37
167175,2019-10-20 00:00:00+03:00,out,False,905842,True,27,0,388,388
167175,2019-10-20 00:00:00+03:00,out,False,905842,True,27,0,388,388
167175,2019-10-21 00:00:00+03:00,out,False,905844,False,3,175,235,60
167175,2019-10-21 00:00:00+03:00,out,False,905842,True,13,0,187,187
167175,2019-10-21 00:00:00+03:00,out,False,905842,False,19,6226,6457,231
167175,2019-10-21 00:00:00+03:00,out,False,938842,False,8,844,934,90
167175,2019-10-21 00:00:00+03:00,out,False,938842,True,6,0,165,165
167175,2019-10-21 00:00:00+03:00,in,False,-1,True,2,0,21,21
167175,2019-10-21 00:00:00+03:00,out,False,938842,False,8,844,934,90
167175,2019-10-22 00:00:00+03:00,out,False,905842,True,9,0,151,151
167175,2019-10-22 00:00:00+03:00,in,False,-1,True,1,0,1,1
167175,2019-10-22 00:00:00+03:00,in,False,905844,False,1,108,116,8
167175,2019-10-22 00:00:00+03:00,out,False,905844,True,11,0,304,304
167175,2019-10-22 00:00:00+03:00,out,False,905844,False,7,536,642,106
167175,2019-10-22 00:00:00+03:00,out,False,905842,False,6,982,1039,57
167175,2019-10-22 00:00:00+03:00,out,False,905842,True,9,0,151,151
167175,2019-10-24 00:00:00+03:00,out,False,905842,False,10,1798,1917,119
167175,2019-10-24 00:00:00+03:00,in,False,905844,False,1,48,59,11
167175,2019-10-24 00:00:00+03:00,out,False,905842,True,15,0,284,284
167175,2019-10-24 00:00:00+03:00,out,False,905844,True,7,0,227,227
167175,2019-10-24 00:00:00+03:00,out,False,938842,True,8,0,120,120
167175,2019-10-24 00:00:00+03:00,out,False,905844,False,15,1513,1728,215
167175,2019-10-24 00:00:00+03:00,out,False,938842,False,10,1483,1629,146
167175,2019-10-24 00:00:00+03:00,in,False,-1,True,2,0,7,7
167175,2019-10-25 00:00:00+03:00,out,False,905842,True,7,0,125,125
167175,2019-10-25 00:00:00+03:00,out,False,905844,True,8,0,122,122
167175,2019-10-25 00:00:00+03:00,out,False,938842,True,7,0,205,205
167175,2019-10-25 00:00:00+03:00,out,False,905842,False,11,3031,3154,123
167175,2019-10-25 00:00:00+03:00,out,False,905844,False,11,1318,1453,135
167175,2019-10-25 00:00:00+03:00,out,False,938842,False,9,1188,1320,132
167175,2019-10-25 00:00:00+03:00,in,False,-1,True,1,0,96,96
167175,2019-10-25 00:00:00+03:00,out,False,938842,True,7,0,205,205
167175,2019-10-26 00:00:00+03:00,out,False,905844,False,7,893,1011,118
167175,2019-10-26 00:00:00+03:00,out,False,905844,True,6,0,177,177
167175,2019-10-26 00:00:00+03:00,out,False,905842,False,6,1032,1114,82
167175,2019-10-27 00:00:00+03:00,out,False,905842,True,14,0,249,249
167175,2019-10-27 00:00:00+03:00,out,False,905842,False,10,2491,2623,132
167175,2019-10-27 00:00:00+03:00,in,False,-1,True,1,0,18,18
167175,2019-10-28 00:00:00+03:00,out,False,905842,False,12,1573,1701,128
167175,2019-10-28 00:00:00+03:00,out,False,905844,True,3,0,89,89
167175,2019-10-28 00:00:00+03:00,out,False,905844,False,9,692,846,154
167175,2019-10-28 00:00:00+03:00,out,False,905842,True,11,0,193,193
167175,2019-10-28 00:00:00+03:00,out,False,938842,False,15,3039,3227,188
167175,2019-10-28 00:00:00+03:00,out,False,938842,True,8,0,154,154
167175,2019-10-28 00:00:00+03:00,in,False,-1,True,3,0,125,125
167175,2019-10-29 00:00:00+03:00,out,False,938842,False,5,775,840,65
167175,2019-10-29 00:00:00+03:00,out,False,905844,False,10,870,1032,162
167175,2019-10-29 00:00:00+03:00,out,False,905844,True,2,0,66,66
167175,2019-10-29 00:00:00+03:00,out,False,938842,True,3,0,52,52
167175,2019-10-30 00:00:00+03:00,in,False,-1,True,1,0,14,14
167175,2019-10-30 00:00:00+03:00,out,False,905844,True,2,0,83,83
167175,2019-10-30 00:00:00+03:00,out,False,905844,False,3,308,347,39
167175,2019-10-31 00:00:00+03:00,out,False,905842,False,16,3003,3176,173
167175,2019-10-31 00:00:00+03:00,out,False,905844,False,8,712,821,109
167175,2019-10-31 00:00:00+03:00,out,False,905844,True,7,0,179,179
167175,2019-10-31 00:00:00+03:00,out,False,905842,True,15,0,274,274
167175,2019-11-01 00:00:00+03:00,in,False,-1,True,1,0,16,16
167175,2019-11-01 00:00:00+03:00,out,False,905842,False,4,526,570,44
167175,2019-11-01 00:00:00+03:00,out,False,905842,True,9,0,208,208
167175,2019-11-02 00:00:00+03:00,out,False,905842,True,23,0,287,287
167175,2019-11-02 00:00:00+03:00,out,False,905842,False,10,2661,2764,103
167175,2019-11-02 00:00:00+03:00,out,False,905842,True,23,0,287,287
167175,2019-11-03 00:00:00+03:00,out,False,905844,True,1,0,36,36
167175,2019-11-04 00:00:00+03:00,in,False,-1,True,2,0,41,41
167175,2019-11-04 00:00:00+03:00,out,False,905844,True,6,0,161,161
167175,2019-11-04 00:00:00+03:00,out,False,905842,False,15,2087,2270,183
167175,2019-11-04 00:00:00+03:00,out,False,905842,True,18,0,298,298
167175,2019-11-04 00:00:00+03:00,out,False,905844,False,8,782,901,119
167175,2019-11-04 00:00:00+03:00,out,False,905842,True,18,0,298,298
167175,2019-11-05 00:00:00+03:00,out,False,905844,True,12,0,326,326
167175,2019-11-05 00:00:00+03:00,out,False,905844,False,19,1521,1759,238
167175,2019-11-06 00:00:00+03:00,in,False,-1,True,2,0,25,25
167175,2019-11-06 00:00:00+03:00,out,False,905842,False,17,3193,3400,207
167175,2019-11-06 00:00:00+03:00,out,False,905842,True,31,0,517,517
167175,2019-11-06 00:00:00+03:00,out,False,905842,True,31,0,517,517
167175,2019-11-07 00:00:00+03:00,in,False,905842,False,1,14,86,72
167175,2019-11-07 00:00:00+03:00,out,False,905842,False,13,1884,2040,156
167175,2019-11-07 00:00:00+03:00,out,False,905844,True,6,0,142,142
167175,2019-11-07 00:00:00+03:00,out,False,905842,True,13,0,207,207
167175,2019-11-07 00:00:00+03:00,in,False,-1,True,3,0,85,85
167175,2019-11-07 00:00:00+03:00,out,False,905844,False,3,136,197,61
167175,2019-11-08 00:00:00+03:00,in,False,-1,True,1,0,19,19
167175,2019-11-08 00:00:00+03:00,out,False,905842,False,11,2887,3034,147
167175,2019-11-08 00:00:00+03:00,out,False,905842,True,14,0,216,216
167175,2019-11-08 00:00:00+03:00,out,False,905844,True,12,0,263,263
167175,2019-11-08 00:00:00+03:00,out,False,905844,False,25,1507,1902,395
167175,2019-11-09 00:00:00+03:00,out,False,905842,False,4,1250,1301,51
167175,2019-11-09 00:00:00+03:00,out,False,905842,True,4,0,49,49
167175,2019-11-09 00:00:00+03:00,in,False,-1,True,1,0,23,23
167175,2019-11-09 00:00:00+03:00,out,False,905842,True,4,0,49,49
167175,2019-11-10 00:00:00+03:00,in,False,-1,True,1,0,36,36
167175,2019-11-10 00:00:00+03:00,out,False,905844,True,13,0,278,278
167175,2019-11-10 00:00:00+03:00,out,False,905844,False,21,1482,1828,346
167175,2019-11-11 00:00:00+03:00,out,False,905844,True,4,0,117,117
167175,2019-11-11 00:00:00+03:00,out,False,905842,True,13,0,217,217
167175,2019-11-11 00:00:00+03:00,out,False,905844,False,10,507,615,108
167175,2019-11-11 00:00:00+03:00,out,False,905842,False,8,1607,1709,102
167175,2019-11-11 00:00:00+03:00,in,False,-1,True,4,0,45,45
167175,2019-11-11 00:00:00+03:00,out,False,905844,True,4,0,117,117
167175,2019-11-12 00:00:00+03:00,out,False,905844,False,17,1613,1893,280
167175,2019-11-12 00:00:00+03:00,out,False,905842,False,4,1178,1232,54
167175,2019-11-12 00:00:00+03:00,out,False,905842,True,9,0,150,150
167175,2019-11-12 00:00:00+03:00,out,False,905844,True,7,0,198,198
167175,2019-11-13 00:00:00+03:00,out,False,905842,True,12,0,196,196
167175,2019-11-13 00:00:00+03:00,in,False,-1,True,1,0,24,24
167175,2019-11-13 00:00:00+03:00,out,False,905844,False,6,433,516,83
167175,2019-11-13 00:00:00+03:00,out,False,905842,False,5,518,579,61
167175,2019-11-13 00:00:00+03:00,out,False,905844,True,11,0,233,233
167175,2019-11-13 00:00:00+03:00,out,False,905842,True,12,0,196,196
167175,2019-11-14 00:00:00+03:00,out,False,905844,True,8,0,202,202
167175,2019-11-14 00:00:00+03:00,in,False,905844,False,2,92,115,23
167175,2019-11-14 00:00:00+03:00,out,False,905844,False,11,1006,1181,175
167175,2019-11-14 00:00:00+03:00,in,False,905844,False,2,92,115,23
167175,2019-11-14 00:00:00+03:00,out,False,905844,False,11,1006,1181,175
167175,2019-11-15 00:00:00+03:00,out,False,905842,True,15,0,211,211
167175,2019-11-15 00:00:00+03:00,out,False,905842,False,12,4223,4359,136
167175,2019-11-15 00:00:00+03:00,out,False,905842,True,15,0,211,211
167175,2019-11-16 00:00:00+03:00,out,False,905842,False,2,169,190,21
167175,2019-11-16 00:00:00+03:00,out,False,905842,True,3,0,62,62
167175,2019-11-17 00:00:00+03:00,in,False,905842,False,1,13,172,159
167175,2019-11-17 00:00:00+03:00,out,False,905844,True,4,0,84,84
167175,2019-11-17 00:00:00+03:00,out,False,905844,False,8,687,778,91
167175,2019-11-18 00:00:00+03:00,out,False,905842,False,2,1040,1063,23
167175,2019-11-18 00:00:00+03:00,out,False,905844,True,4,0,101,101
167175,2019-11-18 00:00:00+03:00,out,False,905844,False,6,718,808,90
167175,2019-11-18 00:00:00+03:00,out,False,905842,True,2,0,38,38
167175,2019-11-18 00:00:00+03:00,in,False,-1,True,1,0,13,13
167175,2019-11-19 00:00:00+03:00,out,False,905844,True,4,0,60,60
167175,2019-11-19 00:00:00+03:00,out,False,905844,False,7,527,679,152
167175,2019-11-19 00:00:00+03:00,out,False,905842,False,6,1343,1409,66
167175,2019-11-19 00:00:00+03:00,out,False,905842,True,13,0,169,169
167175,2019-11-20 00:00:00+03:00,out,False,905842,False,2,94,117,23
167175,2019-11-20 00:00:00+03:00,out,False,905842,True,5,0,63,63
167175,2019-11-21 00:00:00+03:00,in,False,-1,True,2,0,94,94
167175,2019-11-21 00:00:00+03:00,in,False,905844,False,1,580,614,34
167175,2019-11-21 00:00:00+03:00,out,False,905844,True,3,0,94,94
167175,2019-11-21 00:00:00+03:00,out,False,905844,False,3,523,555,32
167175,2019-11-22 00:00:00+03:00,out,False,905842,True,1,0,17,17
167175,2019-11-22 00:00:00+03:00,out,False,905842,False,1,111,122,11
167175,2019-11-23 00:00:00+03:00,out,False,905842,False,7,1615,1681,66
167175,2019-11-23 00:00:00+03:00,out,False,905842,True,8,0,94,94
167175,2019-11-24 00:00:00+03:00,out,False,905842,True,8,0,107,107
167175,2019-11-24 00:00:00+03:00,out,False,905842,False,2,693,726,33
167175,2019-11-25 00:00:00+03:00,out,False,905844,True,10,0,257,257
167175,2019-11-25 00:00:00+03:00,out,False,905842,False,3,397,416,19
167175,2019-11-25 00:00:00+03:00,in,False,-1,True,1,0,15,15
167175,2019-11-25 00:00:00+03:00,out,False,905842,True,9,0,145,145
167175,2019-11-25 00:00:00+03:00,in,False,905844,False,1,123,132,9
167175,2019-11-25 00:00:00+03:00,out,False,905844,False,8,412,544,132
167175,2019-11-25 00:00:00+03:00,out,False,905844,True,10,0,257,257
167175,2019-11-25 00:00:00+03:00,in,False,-1,True,1,0,15,15
167175,2019-11-26 00:00:00+03:00,out,False,905842,True,1,0,4,4
167175,2019-11-26 00:00:00+03:00,out,False,905842,False,1,345,357,12
167175,2019-11-27 00:00:00+03:00,out,False,905844,True,17,0,396,396
167175,2019-11-27 00:00:00+03:00,out,False,905844,False,24,2113,2423,310
167175,2019-11-28 00:00:00+03:00,in,False,-1,True,2,0,2,2
167175,2019-11-28 00:00:00+03:00,out,False,905842,False,6,1015,1072,57
167175,2019-11-28 00:00:00+03:00,out,False,905844,False,22,3502,3766,264
167175,2019-11-28 00:00:00+03:00,out,False,905842,True,13,0,207,207
167175,2019-11-28 00:00:00+03:00,in,False,905844,False,1,78,82,4
167175,2019-11-28 00:00:00+03:00,out,False,905844,True,26,0,522,522
167175,2019-11-28 00:00:00+03:00,out,False,905842,True,13,0,207,207
167175,2019-11-28 00:00:00+03:00,in,False,905844,False,1,78,82,4
167176,2019-09-05 00:00:00+03:00,in,False,905104,True,1,96,114,18
167176,2019-09-05 00:00:00+03:00,in,False,904344,True,3,135,173,38
167176,2019-09-05 00:00:00+03:00,in,False,905104,False,7,106,240,134
167176,2019-09-05 00:00:00+03:00,in,False,904344,False,1,3,20,17
167176,2019-09-05 00:00:00+03:00,out,True,904344,True,5,0,8,8
167176,2019-09-05 00:00:00+03:00,in,False,-1,True,15,0,280,280
167176,2019-09-05 00:00:00+03:00,in,False,904372,False,2,43,86,43
167176,2019-09-05 00:00:00+03:00,in,False,904344,True,3,135,173,38
167176,2019-09-06 00:00:00+03:00,in,False,905104,False,5,17,121,104
167176,2019-09-06 00:00:00+03:00,in,False,-1,True,5,0,87,87
167176,2019-09-06 00:00:00+03:00,out,False,905104,True,3,0,8,8
167176,2019-09-06 00:00:00+03:00,in,False,904372,False,1,2,27,25
167176,2019-09-06 00:00:00+03:00,in,False,904372,False,1,2,27,25
167176,2019-09-09 00:00:00+03:00,out,True,905104,True,9,0,27,27
167176,2019-09-09 00:00:00+03:00,out,True,905472,True,3,0,27,27
167176,2019-09-09 00:00:00+03:00,in,False,-1,True,13,0,237,237
167176,2019-09-09 00:00:00+03:00,out,False,905104,True,2,0,12,12
167176,2019-09-09 00:00:00+03:00,out,True,905472,False,2,75,82,7
167176,2019-09-09 00:00:00+03:00,out,True,905470,False,3,94,104,10
167176,2019-09-09 00:00:00+03:00,in,False,905104,True,2,24,54,30
167176,2019-09-09 00:00:00+03:00,out,True,905480,True,1,0,5,5
167176,2019-09-09 00:00:00+03:00,out,False,905104,False,1,4,14,10
167176,2019-09-09 00:00:00+03:00,in,False,905104,False,3,97,160,63
167176,2019-09-09 00:00:00+03:00,in,False,907504,False,1,3,39,36
167176,2019-09-09 00:00:00+03:00,out,True,907504,True,1,0,0,0
167176,2019-09-09 00:00:00+03:00,in,False,905104,False,3,97,160,63
167176,2019-09-10 00:00:00+03:00,out,True,907994,False,3,69,82,13
167176,2019-09-10 00:00:00+03:00,out,True,907994,True,1,0,12,12
167176,2019-09-10 00:00:00+03:00,out,True,905104,False,3,99,107,8
167176,2019-09-10 00:00:00+03:00,out,True,907986,False,14,838,882,44
167176,2019-09-10 00:00:00+03:00,in,False,907504,False,2,95,126,31
167176,2019-09-10 00:00:00+03:00,out,True,907952,True,1,0,6,6
167176,2019-09-10 00:00:00+03:00,out,True,907986,True,1,0,16,16
167176,2019-09-10 00:00:00+03:00,out,True,907970,False,10,1244,1273,29
167176,2019-09-10 00:00:00+03:00,in,False,907994,False,1,195,211,16
167176,2019-09-10 00:00:00+03:00,in,False,905472,False,1,17,38,21
167176,2019-09-10 00:00:00+03:00,in,False,905104,False,8,261,392,131
167176,2019-09-10 00:00:00+03:00,out,True,905472,True,4,0,34,34
167176,2019-09-10 00:00:00+03:00,out,True,907952,False,9,467,511,44
167176,2019-09-10 00:00:00+03:00,out,True,907982,False,2,137,142,5
167176,2019-09-10 00:00:00+03:00,in,False,905104,True,2,161,196,35
167176,2019-09-10 00:00:00+03:00,in,False,905478,False,1,22,58,36
167176,2019-09-10 00:00:00+03:00,in,False,907982,False,1,173,188,15
167176,2019-09-10 00:00:00+03:00,out,True,905104,True,9,0,43,43
167176,2019-09-10 00:00:00+03:00,in,False,-1,True,7,0,161,161
167176,2019-09-10 00:00:00+03:00,out,True,907970,True,1,0,21,21
167176,2019-09-10 00:00:00+03:00,out,True,907970,True,1,0,21,21
167176,2019-09-10 00:00:00+03:00,in,False,-1,True,7,0,161,161
167176,2019-09-10 00:00:00+03:00,in,False,905472,False,1,17,38,21
167176,2019-09-11 00:00:00+03:00,in,False,907982,False,1,61,78,17
167176,2019-09-11 00:00:00+03:00,out,True,907952,False,1,124,126,2
167176,2019-09-11 00:00:00+03:00,out,True,907994,False,2,20,28,8
167176,2019-09-11 00:00:00+03:00,out,True,905104,False,2,53,73,20
167176,2019-09-11 00:00:00+03:00,in,False,905104,True,1,43,61,18
167176,2019-09-11 00:00:00+03:00,out,True,907970,False,2,18,23,5
167176,2019-09-11 00:00:00+03:00,out,True,907982,False,1,33,37,4
167176,2019-09-11 00:00:00+03:00,out,False,905104,False,4,622,630,8
167176,2019-09-11 00:00:00+03:00,in,False,907994,False,3,429,485,56
167176,2019-09-11 00:00:00+03:00,out,True,907986,False,7,197,219,22
167176,2019-09-11 00:00:00+03:00,in,False,-1,True,1,0,18,18
167176,2019-09-11 00:00:00+03:00,in,False,905104,False,8,161,282,121
167176,2019-09-11 00:00:00+03:00,out,True,907986,True,1,0,23,23
167176,2019-09-11 00:00:00+03:00,in,False,907504,False,1,5,23,18
167176,2019-09-11 00:00:00+03:00,out,True,905104,True,6,0,20,20
167176,2019-09-12 00:00:00+03:00,out,True,907994,True,1,0,24,24
167176,2019-09-12 00:00:00+03:00,out,True,907986,False,10,345,385,40
167176,2019-09-12 00:00:00+03:00,out,False,905104,False,2,188,205,17
167176,2019-09-12 00:00:00+03:00,in,False,907994,False,2,667,700,33
167176,2019-09-12 00:00:00+03:00,out,True,907952,False,2,127,133,6
167176,2019-09-12 00:00:00+03:00,out,True,905104,True,4,0,21,21
167176,2019-09-12 00:00:00+03:00,out,True,907952,True,1,0,24,24
167176,2019-09-12 00:00:00+03:00,in,False,907982,False,1,110,149,39
167176,2019-09-12 00:00:00+03:00,in,False,-1,True,1,0,12,12
167176,2019-09-12 00:00:00+03:00,in,False,907970,False,1,352,368,16
167176,2019-09-12 00:00:00+03:00,out,False,905104,True,1,0,21,21
167176,2019-09-12 00:00:00+03:00,out,True,907986,True,2,8,45,37
167176,2019-09-12 00:00:00+03:00,in,False,905104,False,1,138,153,15
167176,2019-09-12 00:00:00+03:00,out,True,907994,False,1,1,4,3
167176,2019-09-12 00:00:00+03:00,out,True,907952,True,1,0,24,24
167176,2019-09-13 00:00:00+03:00,out,True,907970,False,8,448,473,25
167176,2019-09-13 00:00:00+03:00,in,False,905104,False,10,316,486,170
167176,2019-09-13 00:00:00+03:00,out,True,907982,False,1,23,26,3
167176,2019-09-13 00:00:00+03:00,in,False,-1,True,1,0,22,22
167176,2019-09-13 00:00:00+03:00,out,True,907952,False,1,67,70,3
167176,2019-09-13 00:00:00+03:00,out,True,905104,True,1,0,3,3
167176,2019-09-13 00:00:00+03:00,out,False,905104,True,1,0,1,1
167176,2019-09-13 00:00:00+03:00,in,False,907982,False,1,166,189,23
167176,2019-09-13 00:00:00+03:00,in,False,907952,False,1,48,66,18
167176,2019-09-13 00:00:00+03:00,out,False,905104,False,2,392,402,10
167176,2019-09-13 00:00:00+03:00,out,True,907970,True,1,0,3,3
167176,2019-09-13 00:00:00+03:00,out,True,905308,True,3,0,15,15
167176,2019-09-16 00:00:00+03:00,out,True,907986,False,5,267,288,21
167176,2019-09-16 00:00:00+03:00,out,False,905104,False,1,80,108,28
167176,2019-09-16 00:00:00+03:00,out,True,907970,False,3,78,92,14
167176,2019-09-16 00:00:00+03:00,in,False,905104,False,4,330,396,66
167176,2019-09-16 00:00:00+03:00,out,True,907986,True,2,0,38,38
167176,2019-09-16 00:00:00+03:00,out,True,907994,True,2,0,21,21
167176,2019-09-16 00:00:00+03:00,out,True,907994,False,4,287,310,23
167176,2019-09-16 00:00:00+03:00,out,True,907952,False,6,734,758,24
167176,2019-09-16 00:00:00+03:00,out,True,907982,False,1,60,63,3
167176,2019-09-16 00:00:00+03:00,out,True,905104,False,1,13,27,14
167176,2019-09-16 00:00:00+03:00,out,True,907994,False,4,287,310,23
167176,2019-09-17 00:00:00+03:00,out,True,907952,False,3,165,176,11
167176,2019-09-17 00:00:00+03:00,out,True,907970,False,5,545,558,13
167176,2019-09-17 00:00:00+03:00,in,False,905104,False,3,190,248,58
167176,2019-09-17 00:00:00+03:00,in,False,-1,True,2,0,23,23
167176,2019-09-17 00:00:00+03:00,out,True,907504,True,1,7,11,4
167176,2019-09-17 00:00:00+03:00,in,False,905104,True,1,59,76,17
167176,2019-09-17 00:00:00+03:00,out,True,907952,True,1,0,11,11
167176,2019-09-17 00:00:00+03:00,in,False,907994,False,1,510,536,26
167176,2019-09-17 00:00:00+03:00,out,True,907982,False,1,183,185,2
167176,2019-09-17 00:00:00+03:00,out,True,905104,False,1,26,32,6
167176,2019-09-17 00:00:00+03:00,in,False,907982,False,1,223,267,44
167176,2019-09-17 00:00:00+03:00,out,True,907970,True,1,0,20,20
167176,2019-09-18 00:00:00+03:00,out,False,905104,False,1,129,131,2
167176,2019-09-18 00:00:00+03:00,out,True,907970,False,2,165,177,12
167176,2019-09-18 00:00:00+03:00,in,False,905104,False,4,247,311,64
167176,2019-09-18 00:00:00+03:00,out,True,907994,False,1,14,17,3
167176,2019-09-18 00:00:00+03:00,out,True,907952,False,1,51,54,3
167176,2019-09-18 00:00:00+03:00,out,True,907982,False,1,34,37,3
167176,2019-09-19 00:00:00+03:00,out,True,907952,False,3,431,443,12
167176,2019-09-19 00:00:00+03:00,in,False,905104,False,2,127,158,31
167176,2019-09-19 00:00:00+03:00,out,True,907970,True,1,0,8,8
167176,2019-09-19 00:00:00+03:00,in,False,907982,False,1,123,138,15
167176,2019-09-19 00:00:00+03:00,out,True,905104,False,1,23,26,3
167176,2019-09-19 00:00:00+03:00,out,True,907952,True,1,0,12,12
167176,2019-09-19 00:00:00+03:00,in,False,907994,False,1,200,216,16
167176,2019-09-19 00:00:00+03:00,out,True,907970,False,5,415,430,15
167176,2019-09-20 00:00:00+03:00,in,False,907982,False,1,309,325,16
167176,2019-09-20 00:00:00+03:00,in,False,907964,False,5,1506,1587,81
167176,2019-09-20 00:00:00+03:00,in,False,905104,False,6,287,388,101
167176,2019-09-20 00:00:00+03:00,out,True,907970,False,3,318,325,7
167176,2019-09-20 00:00:00+03:00,out,False,905104,False,1,135,136,1
167176,2019-09-20 00:00:00+03:00,out,True,907952,False,5,397,423,26
167176,2019-09-20 00:00:00+03:00,in,False,-1,True,3,0,73,73
167176,2019-09-20 00:00:00+03:00,out,True,907952,False,5,397,423,26
167176,2019-09-23 00:00:00+03:00,out,True,907986,False,14,287,333,46
167176,2019-09-23 00:00:00+03:00,out,True,907970,True,1,0,1,1
167176,2019-09-23 00:00:00+03:00,out,True,907982,True,2,0,14,14
167176,2019-09-23 00:00:00+03:00,out,True,907986,True,1,0,43,43
167176,2019-09-23 00:00:00+03:00,out,False,905104,False,3,107,126,19
167176,2019-09-23 00:00:00+03:00,out,True,907952,True,1,0,9,9
167176,2019-09-23 00:00:00+03:00,out,True,907982,False,1,12,20,8
167176,2019-09-23 00:00:00+03:00,out,True,905104,False,2,27,39,12
167176,2019-09-23 00:00:00+03:00,out,True,907970,False,4,271,284,13
167176,2019-09-23 00:00:00+03:00,out,True,907952,False,7,663,685,22
167176,2019-09-23 00:00:00+03:00,in,False,905104,False,3,134,185,51
167176,2019-09-23 00:00:00+03:00,out,True,907986,False,14,287,333,46
167176,2019-09-24 00:00:00+03:00,out,False,905104,False,1,106,111,5
167176,2019-09-24 00:00:00+03:00,in,False,907952,False,1,23,43,20
167176,2019-09-24 00:00:00+03:00,in,False,907970,False,1,338,355,17
167176,2019-09-24 00:00:00+03:00,out,True,907994,False,4,189,205,16
167176,2019-09-24 00:00:00+03:00,out,True,907970,False,2,130,139,9
167176,2019-09-24 00:00:00+03:00,in,False,907994,False,1,218,234,16
167176,2019-09-24 00:00:00+03:00,in,False,907982,False,1,139,164,25
167176,2019-09-24 00:00:00+03:00,out,True,907952,False,3,288,305,17
167176,2019-09-24 00:00:00+03:00,out,True,907970,True,1,0,13,13
167176,2019-09-24 00:00:00+03:00,in,False,905104,False,6,587,702,115
167176,2019-09-24 00:00:00+03:00,out,True,907986,False,19,812,868,56
167176,2019-09-24 00:00:00+03:00,out,True,907986,True,3,6,35,29
167176,2019-09-24 00:00:00+03:00,out,True,907994,False,4,189,205,16
167176,2019-09-25 00:00:00+03:00,in,False,907982,False,4,369,439,70
167176,2019-09-25 00:00:00+03:00,out,True,907986,False,1,19,21,2
167176,2019-09-25 00:00:00+03:00,out,True,907952,False,2,334,342,8
167176,2019-09-25 00:00:00+03:00,out,True,907970,False,3,155,165,10
167176,2019-09-25 00:00:00+03:00,out,True,907994,False,1,57,60,3
167176,2019-09-25 00:00:00+03:00,in,False,-1,True,3,0,42,42
167176,2019-09-25 00:00:00+03:00,out,True,907970,True,1,0,10,10
167176,2019-09-25 00:00:00+03:00,in,False,907970,False,2,1149,1187,38
167176,2019-09-25 00:00:00+03:00,in,False,905104,False,3,339,388,49
167176,2019-09-25 00:00:00+03:00,in,False,907994,False,1,90,107,17
167176,2019-09-25 00:00:00+03:00,out,True,907986,True,1,0,9,9
167176,2019-09-26 00:00:00+03:00,out,True,907970,False,5,143,162,19
167176,2019-09-26 00:00:00+03:00,in,False,-1,True,1,0,6,6
167176,2019-09-26 00:00:00+03:00,out,True,907986,False,19,524,589,65
167176,2019-09-26 00:00:00+03:00,out,True,907994,False,3,105,115,10
167176,2019-09-26 00:00:00+03:00,out,True,905104,False,2,44,51,7
167176,2019-09-26 00:00:00+03:00,out,True,907982,False,4,264,286,22
167176,2019-09-26 00:00:00+03:00,in,False,907970,False,1,478,496,18
167176,2019-09-26 00:00:00+03:00,out,False,905104,False,2,240,269,29
167176,2019-09-26 00:00:00+03:00,out,True,907986,True,4,0,41,41
167176,2019-09-26 00:00:00+03:00,in,False,905104,False,3,166,213,47
167176,2019-09-26 00:00:00+03:00,out,True,907952,False,8,349,375,26
167176,2019-09-26 00:00:00+03:00,out,True,907994,True,1,0,17,17
167176,2019-09-27 00:00:00+03:00,in,False,905104,False,3,184,234,50
167176,2019-09-27 00:00:00+03:00,in,False,907982,False,1,20,37,17
167176,2019-09-27 00:00:00+03:00,in,False,907952,True,1,1,20,19
167176,2019-09-27 00:00:00+03:00,out,True,907952,False,2,36,48,12
167176,2019-09-27 00:00:00+03:00,out,True,907982,False,1,13,18,5
167176,2019-09-27 00:00:00+03:00,in,False,907952,False,1,50,69,19
167176,2019-09-27 00:00:00+03:00,out,True,907982,True,2,0,17,17
167176,2019-09-27 00:00:00+03:00,in,False,-1,True,1,0,18,18
167176,2019-09-27 00:00:00+03:00,out,True,907994,True,1,0,11,11
167176,2019-09-27 00:00:00+03:00,out,True,907994,False,1,60,62,2
167176,2019-09-27 00:00:00+03:00,out,True,907986,False,7,184,201,17
167176,2019-09-27 00:00:00+03:00,out,True,907986,True,1,0,12,12
167176,2019-09-27 00:00:00+03:00,in,False,-1,True,1,0,18,18
167176,2019-09-30 00:00:00+03:00,in,False,907982,False,8,871,1014,143
167176,2019-09-30 00:00:00+03:00,out,True,907982,False,4,549,568,19
167176,2019-09-30 00:00:00+03:00,out,True,907952,False,4,258,274,16
167176,2019-09-30 00:00:00+03:00,in,False,907952,False,2,282,322,40
167176,2019-09-30 00:00:00+03:00,out,True,907952,True,1,0,8,8
167176,2019-09-30 00:00:00+03:00,in,False,907952,True,1,51,71,20
167176,2019-09-30 00:00:00+03:00,out,True,907994,False,2,93,98,5
167176,2019-09-30 00:00:00+03:00,out,True,907970,True,1,0,8,8
167176,2019-09-30 00:00:00+03:00,in,False,-1,True,1,0,15,15
167176,2019-09-30 00:00:00+03:00,out,True,907952,False,4,258,274,16
167176,2019-10-01 00:00:00+03:00,in,False,-1,True,1,0,39,39
167176,2019-10-01 00:00:00+03:00,in,False,907952,False,1,92,111,19
167176,2019-10-01 00:00:00+03:00,out,True,907982,False,1,295,298,3
167176,2019-10-01 00:00:00+03:00,out,True,907952,False,1,61,65,4
167176,2019-10-01 00:00:00+03:00,in,False,907982,False,3,467,519,52
167176,2019-10-01 00:00:00+03:00,in,False,907982,False,3,467,519,52
167176,2019-10-02 00:00:00+03:00,in,False,907952,False,1,76,108,32
167176,2019-10-02 00:00:00+03:00,in,False,-1,True,2,0,90,90
167176,2019-10-02 00:00:00+03:00,in,False,907982,False,3,64,114,50
167176,2019-10-02 00:00:00+03:00,in,False,-1,True,2,0,90,90
167176,2019-10-02 00:00:00+03:00,in,False,907982,False,3,64,114,50
167176,2019-10-03 00:00:00+03:00,out,True,907952,False,2,165,178,13
167176,2019-10-03 00:00:00+03:00,in,False,907964,False,1,590,606,16
167176,2019-10-03 00:00:00+03:00,out,True,907970,False,3,484,492,8
167176,2019-10-03 00:00:00+03:00,in,False,905104,False,8,705,850,145
167176,2019-10-04 00:00:00+03:00,out,True,907952,False,1,92,97,5
167176,2019-10-04 00:00:00+03:00,out,True,907970,False,2,112,117,5
167176,2019-10-04 00:00:00+03:00,in,False,905104,False,3,79,126,47
167176,2019-10-04 00:00:00+03:00,in,False,907994,False,1,572,591,19
167176,2019-10-04 00:00:00+03:00,out,True,907970,True,1,0,8,8
167176,2019-10-04 00:00:00+03:00,in,False,907952,False,1,43,62,19
167176,2019-10-04 00:00:00+03:00,out,True,907952,False,1,92,97,5
167176,2019-10-07 00:00:00+03:00,in,False,907994,False,1,115,131,16
167176,2019-10-07 00:00:00+03:00,out,False,905104,False,1,23,29,6
167176,2019-10-07 00:00:00+03:00,out,True,907952,False,3,136,147,11
167176,2019-10-07 00:00:00+03:00,in,False,905104,False,7,245,363,118
167176,2019-10-07 00:00:00+03:00,in,False,907970,False,1,524,546,22
167176,2019-10-07 00:00:00+03:00,out,True,907952,True,1,0,12,12
167176,2019-10-07 00:00:00+03:00,out,True,907970,True,1,0,7,7
167176,2019-10-07 00:00:00+03:00,out,True,907970,False,4,146,161,15
167176,2019-10-07 00:00:00+03:00,in,False,907964,False,2,636,668,32
167176,2019-10-07 00:00:00+03:00,in,False,907952,False,1,328,344,16
167176,2019-10-07 00:00:00+03:00,in,False,-1,True,4,0,126,126
167176,2019-10-07 00:00:00+03:00,out,True,907952,True,1,0,12,12
167176,2019-10-08 00:00:00+03:00,out,False,905104,False,1,55,63,8
167176,2019-10-08 00:00:00+03:00,out,True,907952,False,1,163,170,7
167176,2019-10-08 00:00:00+03:00,in,False,905104,False,8,1300,1434,134
167176,2019-10-08 00:00:00+03:00,out,True,905104,False,1,20,23,3
167176,2019-10-08 00:00:00+03:00,out,True,907970,False,2,51,57,6
167176,2019-10-08 00:00:00+03:00,in,False,907964,False,1,357,372,15
167176,2019-10-08 00:00:00+03:00,in,False,-1,True,1,0,6,6
167176,2019-10-08 00:00:00+03:00,in,False,905104,False,8,1300,1434,134
167176,2019-10-09 00:00:00+03:00,in,False,907970,False,2,845,876,31
167176,2019-10-09 00:00:00+03:00,out,True,907952,False,2,296,301,5
167176,2019-10-09 00:00:00+03:00,out,True,907952,True,1,0,15,15
167176,2019-10-09 00:00:00+03:00,in,False,905104,False,4,338,403,65
167176,2019-10-09 00:00:00+03:00,out,True,907970,False,1,12,17,5
167176,2019-10-09 00:00:00+03:00,in,False,907952,False,2,107,143,36
167176,2019-10-09 00:00:00+03:00,out,True,907986,True,1,0,2,2
167176,2019-10-09 00:00:00+03:00,in,False,905104,False,4,338,403,65
167176,2019-10-10 00:00:00+03:00,out,True,907986,False,2,70,81,11
167176,2019-10-10 00:00:00+03:00,out,True,907994,False,3,75,88,13
167176,2019-10-10 00:00:00+03:00,in,False,905104,False,4,347,411,64
167176,2019-10-10 00:00:00+03:00,in,False,907994,False,2,703,738,35
167176,2019-10-10 00:00:00+03:00,out,True,907952,True,1,0,4,4
167176,2019-10-10 00:00:00+03:00,out,True,907952,False,2,3,10,7
167176,2019-10-10 00:00:00+03:00,in,False,907964,False,1,655,670,15
167176,2019-10-10 00:00:00+03:00,in,False,907970,False,1,382,397,15
167176,2019-10-10 00:00:00+03:00,out,True,907986,True,2,0,43,43
167176,2019-10-10 00:00:00+03:00,in,False,907970,False,1,382,397,15
167176,2019-10-10 00:00:00+03:00,out,True,907994,False,3,75,88,13
167176,2019-10-11 00:00:00+03:00,out,True,907970,True,1,0,12,12
167176,2019-10-11 00:00:00+03:00,in,False,905104,False,5,195,277,82
167176,2019-10-11 00:00:00+03:00,in,False,907994,False,2,425,460,35
167176,2019-10-11 00:00:00+03:00,out,True,907970,False,2,36,53,17
167176,2019-10-11 00:00:00+03:00,out,True,907952,False,4,121,141,20
167176,2019-10-11 00:00:00+03:00,out,True,907986,True,2,0,21,21
167176,2019-10-11 00:00:00+03:00,out,True,907986,False,11,459,494,35
167176,2019-10-11 00:00:00+03:00,out,True,907994,False,1,35,42,7
167176,2019-10-11 00:00:00+03:00,in,False,-1,True,2,0,18,18
167176,2019-10-14 00:00:00+03:00,out,False,905104,False,1,150,151,1
167176,2019-10-14 00:00:00+03:00,in,False,905104,False,3,179,226,47
167176,2019-10-14 00:00:00+03:00,out,True,907986,True,3,7,34,27
167176,2019-10-14 00:00:00+03:00,out,True,907986,False,13,457,507,50
167176,2019-10-14 00:00:00+03:00,out,True,907994,False,3,93,107,14
167176,2019-10-14 00:00:00+03:00,in,False,907952,False,1,171,186,15
167176,2019-10-14 00:00:00+03:00,out,True,907982,False,4,250,262,12
167176,2019-10-14 00:00:00+03:00,in,False,907964,False,1,82,98,16
167176,2019-10-14 00:00:00+03:00,in,False,907982,False,2,272,332,60
167176,2019-10-14 00:00:00+03:00,out,True,907970,True,6,0,60,60
167176,2019-10-14 00:00:00+03:00,out,True,907970,False,2,32,40,8
167176,2019-10-14 00:00:00+03:00,out,True,907952,False,5,236,262,26
167176,2019-10-14 00:00:00+03:00,out,False,905104,True,1,0,36,36
167176,2019-10-14 00:00:00+03:00,out,True,905104,True,1,0,3,3
167176,2019-10-14 00:00:00+03:00,out,False,905104,True,1,0,36,36
167176,2019-10-14 00:00:00+03:00,in,False,905104,False,3,179,226,47
167176,2019-10-15 00:00:00+03:00,out,True,907952,False,2,45,50,5
167176,2019-10-15 00:00:00+03:00,in,False,-1,True,1,0,15,15
167176,2019-10-15 00:00:00+03:00,out,True,907970,False,3,58,64,6
167176,2019-10-15 00:00:00+03:00,out,False,905104,False,4,982,999,17
167176,2019-10-15 00:00:00+03:00,in,False,907994,False,2,3031,3066,35
167176,2019-10-15 00:00:00+03:00,in,False,905104,False,1,176,192,16
167176,2019-10-15 00:00:00+03:00,out,True,907982,False,2,5,18,13
167176,2019-10-15 00:00:00+03:00,out,True,907986,False,7,151,168,17
167176,2019-10-15 00:00:00+03:00,in,False,907952,False,1,55,117,62
167176,2019-10-15 00:00:00+03:00,in,False,-1,True,1,0,15,15
167176,2019-10-15 00:00:00+03:00,out,True,907970,False,3,58,64,6
167176,2019-10-16 00:00:00+03:00,out,True,907986,True,1,0,2,2
167176,2019-10-16 00:00:00+03:00,out,True,907982,False,1,311,313,2
167176,2019-10-16 00:00:00+03:00,out,True,907952,False,1,45,52,7
167176,2019-10-16 00:00:00+03:00,out,False,905104,False,5,281,293,12
167176,2019-10-16 00:00:00+03:00,in,False,907952,False,2,53,92,39
167176,2019-10-16 00:00:00+03:00,in,False,907994,False,1,681,702,21
167176,2019-10-16 00:00:00+03:00,in,False,907982,False,6,712,873,161
167176,2019-10-16 00:00:00+03:00,out,True,907994,False,3,24,31,7
167176,2019-10-16 00:00:00+03:00,out,True,907994,True,2,0,19,19
167176,2019-10-16 00:00:00+03:00,out,True,907982,True,1,0,12,12
167176,2019-10-16 00:00:00+03:00,in,False,905104,False,9,1162,1316,154
167176,2019-10-16 00:00:00+03:00,out,True,907986,False,14,634,666,32
167176,2019-10-16 00:00:00+03:00,out,False,905104,False,5,281,293,12
167176,2019-10-16 00:00:00+03:00,out,True,907952,False,1,45,52,7
167176,2019-10-17 00:00:00+03:00,out,True,907986,True,1,0,12,12
167176,2019-10-17 00:00:00+03:00,out,True,907986,False,10,292,317,25
167176,2019-10-17 00:00:00+03:00,out,True,907970,False,1,84,87,3
167176,2019-10-17 00:00:00+03:00,out,True,907952,False,1,37,40,3
167176,2019-10-17 00:00:00+03:00,in,False,907982,False,1,77,117,40
167176,2019-10-17 00:00:00+03:00,in,False,907952,False,1,15,33,18
167176,2019-10-17 00:00:00+03:00,out,True,907982,True,1,0,10,10
167176,2019-10-17 00:00:00+03:00,out,False,907970,False,1,2,4,2
167176,2019-10-17 00:00:00+03:00,out,True,907964,False,2,87,100,13
167176,2019-10-17 00:00:00+03:00,out,True,905104,False,2,54,60,6
167176,2019-10-17 00:00:00+03:00,in,False,905104,False,9,1079,1230,151
167176,2019-10-17 00:00:00+03:00,out,False,905104,False,5,549,577,28
167176,2019-10-17 00:00:00+03:00,in,False,907994,False,1,366,382,16
167176,2019-10-17 00:00:00+03:00,out,True,905104,False,2,54,60,6
167176,2019-10-17 00:00:00+03:00,out,True,907982,True,1,0,10,10
167176,2019-10-17 00:00:00+03:00,out,False,905104,False,5,549,577,28
167176,2019-10-18 00:00:00+03:00,out,True,907982,False,1,30,39,9
167176,2019-10-18 00:00:00+03:00,out,True,907504,False,1,9,11,2
167176,2019-10-18 00:00:00+03:00,out,False,905104,False,1,111,114,3
167176,2019-10-18 00:00:00+03:00,out,False,-1,True,1,0,5,5
167176,2019-10-18 00:00:00+03:00,out,True,907986,False,9,163,195,32
167176,2019-10-18 00:00:00+03:00,out,True,907986,True,4,0,55,55
167176,2019-10-18 00:00:00+03:00,out,True,907970,False,3,174,183,9
167176,2019-10-18 00:00:00+03:00,out,True,907994,True,1,0,0,0
167176,2019-10-18 00:00:00+03:00,out,True,907964,False,1,0,3,3
167176,2019-10-18 00:00:00+03:00,out,True,907994,False,3,33,39,6
167176,2019-10-18 00:00:00+03:00,out,True,905104,True,5,0,12,12
167176,2019-10-18 00:00:00+03:00,in,False,907964,False,1,250,268,18
167176,2019-10-18 00:00:00+03:00,out,True,907970,True,2,0,18,18
167176,2019-10-18 00:00:00+03:00,in,False,905104,False,4,191,253,62
167176,2019-10-18 00:00:00+03:00,in,False,-1,True,1,0,13,13
167176,2019-10-18 00:00:00+03:00,out,True,907952,False,2,48,52,4
167176,2019-10-18 00:00:00+03:00,in,False,905104,False,4,191,253,62
167176,2019-10-18 00:00:00+03:00,out,True,907986,False,9,163,195,32
167176,2019-10-18 00:00:00+03:00,in,False,907964,False,1,250,268,18
167176,2019-10-21 00:00:00+03:00,out,True,907994,False,3,16,25,9
167176,2019-10-21 00:00:00+03:00,out,True,907986,True,1,0,12,12
167176,2019-10-21 00:00:00+03:00,out,True,907970,True,1,0,13,13
167176,2019-10-21 00:00:00+03:00,out,True,907970,False,3,48,55,7
167176,2019-10-21 00:00:00+03:00,in,False,-1,True,1,0,6,6
167176,2019-10-21 00:00:00+03:00,out,True,907964,False,1,51,53,2
167176,2019-10-21 00:00:00+03:00,in,False,907994,False,3,1276,1325,49
167176,2019-10-21 00:00:00+03:00,out,True,907952,False,6,292,305,13
167176,2019-10-21 00:00:00+03:00,in,False,907952,False,1,61,82,21
167176,2019-10-21 00:00:00+03:00,out,True,907986,False,16,626,678,52
167176,2019-10-21 00:00:00+03:00,in,False,905104,False,8,504,637,133
167176,2019-10-21 00:00:00+03:00,out,False,905104,False,2,265,269,4
167176,2019-10-21 00:00:00+03:00,out,True,905104,False,1,37,39,2
167176,2019-10-21 00:00:00+03:00,out,True,907994,True,2,0,32,32
167176,2019-10-22 00:00:00+03:00,in,False,907964,False,1,579,595,16
167176,2019-10-22 00:00:00+03:00,out,True,907982,False,2,32,36,4
167176,2019-10-22 00:00:00+03:00,in,False,907986,False,1,212,232,20
167176,2019-10-22 00:00:00+03:00,out,True,907986,True,1,0,4,4
167176,2019-10-22 00:00:00+03:00,in,False,907994,False,2,924,956,32
167176,2019-10-22 00:00:00+03:00,out,True,907986,False,4,143,153,10
167176,2019-10-22 00:00:00+03:00,out,False,905104,False,3,358,372,14
167176,2019-10-22 00:00:00+03:00,out,False,907964,False,7,617,643,26
167176,2019-10-22 00:00:00+03:00,in,False,907952,False,3,61,139,78
167176,2019-10-22 00:00:00+03:00,out,True,907994,False,2,108,113,5
167176,2019-10-22 00:00:00+03:00,in,False,905104,False,7,563,688,125
167176,2019-10-22 00:00:00+03:00,out,True,907952,False,2,54,60,6
167176,2019-10-22 00:00:00+03:00,out,True,907970,False,2,104,113,9
167176,2019-10-22 00:00:00+03:00,in,False,-1,True,2,0,32,32
167176,2019-10-22 00:00:00+03:00,in,False,-1,True,2,0,32,32
167176,2019-10-22 00:00:00+03:00,in,False,907994,False,2,924,956,32
167176,2019-10-23 00:00:00+03:00,in,False,907982,False,2,99,154,55
167176,2019-10-23 00:00:00+03:00,in,False,905104,False,7,965,1078,113
167176,2019-10-23 00:00:00+03:00,out,True,907970,False,3,76,88,12
167176,2019-10-23 00:00:00+03:00,out,True,907986,True,2,0,34,34
167176,2019-10-23 00:00:00+03:00,in,False,907964,False,1,285,301,16
167176,2019-10-23 00:00:00+03:00,out,True,907986,False,12,302,345,43
167176,2019-10-23 00:00:00+03:00,out,False,905104,False,2,125,131,6
167176,2019-10-23 00:00:00+03:00,out,True,907964,True,1,0,0,0
167176,2019-10-23 00:00:00+03:00,out,True,907982,True,4,0,30,30
167176,2019-10-23 00:00:00+03:00,out,True,907952,False,1,287,290,3
167176,2019-10-23 00:00:00+03:00,in,False,907952,False,1,139,157,18
167176,2019-10-23 00:00:00+03:00,out,True,907994,False,3,12,19,7
167176,2019-10-23 00:00:00+03:00,out,True,907964,True,1,0,0,0
167176,2019-10-23 00:00:00+03:00,out,False,905104,False,2,125,131,6
167176,2019-10-24 00:00:00+03:00,in,False,907994,False,1,224,240,16
167176,2019-10-24 00:00:00+03:00,in,False,-1,True,1,0,13,13
167176,2019-10-24 00:00:00+03:00,in,False,907970,False,1,199,215,16
167176,2019-10-24 00:00:00+03:00,out,False,905104,False,1,324,337,13
167176,2019-10-24 00:00:00+03:00,out,True,907970,False,2,98,104,6
167176,2019-10-24 00:00:00+03:00,out,True,907952,False,6,145,163,18
167176,2019-10-24 00:00:00+03:00,in,False,905104,False,4,240,319,79
167176,2019-10-24 00:00:00+03:00,in,False,907952,False,1,65,85,20
167176,2019-10-24 00:00:00+03:00,out,True,907994,True,1,0,18,18
167176,2019-10-24 00:00:00+03:00,out,True,907994,False,1,9,12,3
167176,2019-10-24 00:00:00+03:00,out,True,907986,False,15,473,565,92
167176,2019-10-24 00:00:00+03:00,out,False,905104,True,1,0,4,4
167176,2019-10-24 00:00:00+03:00,out,True,907986,True,3,0,46,46
167176,2019-10-24 00:00:00+03:00,in,False,907994,False,1,224,240,16
167176,2019-10-24 00:00:00+03:00,out,False,905104,False,1,324,337,13
167176,2019-10-25 00:00:00+03:00,in,False,905104,False,5,452,535,83
167176,2019-10-25 00:00:00+03:00,out,True,907952,True,1,0,10,10
167176,2019-10-25 00:00:00+03:00,out,True,907986,False,14,435,471,36
167176,2019-10-25 00:00:00+03:00,out,True,907952,False,5,114,133,19
167176,2019-10-25 00:00:00+03:00,out,True,907994,False,4,67,82,15
167176,2019-10-25 00:00:00+03:00,out,True,907970,False,1,27,29,2
167176,2019-10-25 00:00:00+03:00,out,True,907986,True,1,0,20,20
167176,2019-10-25 00:00:00+03:00,in,False,907982,False,3,236,289,53
167176,2019-10-25 00:00:00+03:00,in,False,907952,False,1,65,85,20
167176,2019-10-25 00:00:00+03:00,out,True,905104,False,1,9,12,3
167176,2019-10-25 00:00:00+03:00,out,False,905104,False,5,1120,1133,13
167176,2019-10-28 00:00:00+03:00,in,False,-1,True,1,0,12,12
167176,2019-10-28 00:00:00+03:00,out,True,907982,False,2,218,224,6
167176,2019-10-28 00:00:00+03:00,out,True,907994,True,1,0,14,14
167176,2019-10-28 00:00:00+03:00,out,True,907994,False,2,12,16,4
167176,2019-10-28 00:00:00+03:00,in,False,907952,False,1,47,66,19
167176,2019-10-28 00:00:00+03:00,out,True,907986,False,11,445,478,33
167176,2019-10-28 00:00:00+03:00,out,False,905104,False,7,1268,1284,16
167176,2019-10-28 00:00:00+03:00,in,False,905104,False,2,188,219,31
167176,2019-10-28 00:00:00+03:00,out,True,905104,False,2,27,44,17
167176,2019-10-28 00:00:00+03:00,in,False,907982,False,1,305,341,36
167176,2019-10-28 00:00:00+03:00,out,True,907970,False,1,53,55,2
167176,2019-10-28 00:00:00+03:00,out,True,907952,False,4,158,171,13
167176,2019-10-28 00:00:00+03:00,out,True,907986,True,1,0,11,11
167176,2019-10-28 00:00:00+03:00,in,False,907994,False,1,174,189,15
167176,2019-10-28 00:00:00+03:00,in,False,905104,False,2,188,219,31
167176,2019-10-28 00:00:00+03:00,in,False,907982,False,1,305,341,36
167176,2019-10-29 00:00:00+03:00,in,False,907970,False,1,617,638,21
167176,2019-10-29 00:00:00+03:00,out,False,905104,False,1,549,552,3
167176,2019-10-29 00:00:00+03:00,in,False,905104,False,5,585,670,85
167176,2019-10-29 00:00:00+03:00,in,False,907982,False,1,13,32,19
167176,2019-10-29 00:00:00+03:00,out,True,907970,False,3,166,172,6
167176,2019-10-29 00:00:00+03:00,out,True,907986,False,6,572,613,41
167176,2019-10-29 00:00:00+03:00,out,True,907970,True,1,0,11,11
167176,2019-10-29 00:00:00+03:00,out,True,907952,False,3,502,510,8
167176,2019-10-29 00:00:00+03:00,out,True,907994,False,1,6,8,2
167176,2019-10-29 00:00:00+03:00,in,False,907952,False,1,504,520,16
167176,2019-10-29 00:00:00+03:00,out,True,907964,True,5,0,14,14
167176,2019-10-29 00:00:00+03:00,out,True,907964,False,4,284,297,13
167176,2019-10-29 00:00:00+03:00,out,True,907970,True,1,0,11,11
167176,2019-10-30 00:00:00+03:00,out,True,907986,False,12,525,596,71
167176,2019-10-30 00:00:00+03:00,out,False,905104,False,3,179,187,8
167176,2019-10-30 00:00:00+03:00,out,True,907986,True,2,0,95,95
167176,2019-10-30 00:00:00+03:00,in,False,907982,False,1,345,381,36
167176,2019-10-30 00:00:00+03:00,out,True,907952,False,1,0,2,2
167176,2019-10-30 00:00:00+03:00,in,False,907952,False,1,313,329,16
167176,2019-10-30 00:00:00+03:00,in,False,905104,False,12,904,1094,190
167176,2019-10-30 00:00:00+03:00,in,False,907970,False,1,389,405,16
167176,2019-10-30 00:00:00+03:00,out,True,907970,False,4,101,126,25
167176,2019-10-30 00:00:00+03:00,in,False,-1,True,1,0,9,9
167176,2019-10-30 00:00:00+03:00,out,True,907982,False,3,379,387,8
167176,2019-10-30 00:00:00+03:00,out,True,907952,True,1,0,13,13
167176,2019-10-30 00:00:00+03:00,out,True,907986,False,12,525,596,71
167176,2019-10-30 00:00:00+03:00,out,True,907952,False,1,0,2,2
167176,2019-10-30 00:00:00+03:00,in,False,-1,True,1,0,9,9
167176,2019-10-31 00:00:00+03:00,in,False,907964,False,1,137,154,17
167176,2019-10-31 00:00:00+03:00,in,False,907952,False,2,1175,1211,36
167176,2019-10-31 00:00:00+03:00,out,True,907952,False,6,1198,1231,33
167176,2019-10-31 00:00:00+03:00,out,True,907964,False,1,20,23,3
167176,2019-10-31 00:00:00+03:00,in,False,907970,False,1,307,324,17
167176,2019-10-31 00:00:00+03:00,in,False,-1,True,7,0,316,316
167176,2019-10-31 00:00:00+03:00,in,False,905104,False,6,305,400,95
167176,2019-10-31 00:00:00+03:00,out,True,907970,False,2,27,31,4
167176,2019-10-31 00:00:00+03:00,out,True,907964,True,1,0,0,0
167176,2019-10-31 00:00:00+03:00,out,True,907970,True,1,0,10,10
167176,2019-11-01 00:00:00+03:00,in,False,-1,True,1,0,18,18
167176,2019-11-01 00:00:00+03:00,out,True,905104,False,1,6,9,3
167176,2019-11-01 00:00:00+03:00,in,False,905104,False,4,84,145,61
167176,2019-11-01 00:00:00+03:00,in,False,907994,False,1,150,166,16
167176,2019-11-01 00:00:00+03:00,out,True,907952,False,1,869,871,2
167176,2019-11-01 00:00:00+03:00,in,False,907982,False,1,181,222,41
167176,2019-11-01 00:00:00+03:00,out,True,907986,False,5,47,59,12
167176,2019-11-01 00:00:00+03:00,out,False,907982,True,1,0,32,32
167176,2019-11-01 00:00:00+03:00,out,False,905104,False,1,147,148,1
167176,2019-11-01 00:00:00+03:00,in,False,907952,False,2,926,961,35
167176,2019-11-01 00:00:00+03:00,out,True,907994,False,1,9,19,10
167176,2019-11-01 00:00:00+03:00,out,False,905104,False,1,147,148,1
167176,2019-11-05 00:00:00+03:00,out,True,907952,False,3,40,49,9
167176,2019-11-05 00:00:00+03:00,out,True,905104,False,1,54,57,3
167176,2019-11-05 00:00:00+03:00,out,True,907504,False,10,114,155,41
167176,2019-11-05 00:00:00+03:00,out,True,907986,True,3,0,49,49
167176,2019-11-05 00:00:00+03:00,out,True,907982,False,2,82,90,8
167176,2019-11-05 00:00:00+03:00,in,False,-1,True,1,0,12,12
167176,2019-11-05 00:00:00+03:00,out,False,907982,False,1,50,52,2
167176,2019-11-05 00:00:00+03:00,in,False,907982,False,2,178,231,53
167176,2019-11-05 00:00:00+03:00,in,False,905104,False,3,193,240,47
167176,2019-11-05 00:00:00+03:00,out,True,907504,True,2,0,9,9
167176,2019-11-05 00:00:00+03:00,out,True,907970,False,3,56,76,20
167176,2019-11-05 00:00:00+03:00,out,True,907986,False,16,513,564,51
167176,2019-11-05 00:00:00+03:00,out,False,907504,True,1,0,10,10
167176,2019-11-06 00:00:00+03:00,out,True,907994,False,2,30,34,4
167176,2019-11-06 00:00:00+03:00,out,True,907964,False,4,63,74,11
167176,2019-11-06 00:00:00+03:00,out,True,907986,True,2,0,43,43
167176,2019-11-06 00:00:00+03:00,out,True,907504,True,2,0,9,9
167176,2019-11-06 00:00:00+03:00,out,False,905104,False,1,48,57,9
167176,2019-11-06 00:00:00+03:00,out,True,907952,False,5,135,151,16
167176,2019-11-06 00:00:00+03:00,out,True,907982,False,3,189,197,8
167176,2019-11-06 00:00:00+03:00,out,True,907994,True,1,0,15,15
167176,2019-11-06 00:00:00+03:00,in,False,907970,False,1,129,146,17
167176,2019-11-06 00:00:00+03:00,out,True,907970,False,4,305,327,22
167176,2019-11-06 00:00:00+03:00,out,True,907952,True,1,0,15,15
167176,2019-11-06 00:00:00+03:00,out,False,907982,False,1,77,78,1
167176,2019-11-06 00:00:00+03:00,out,True,907982,True,1,0,2,2
167176,2019-11-06 00:00:00+03:00,in,False,907994,False,1,253,281,28
167176,2019-11-06 00:00:00+03:00,out,True,907986,False,9,212,233,21
167176,2019-11-06 00:00:00+03:00,in,False,905104,False,7,605,770,165
167176,2019-11-06 00:00:00+03:00,in,False,907970,False,1,129,146,17
167176,2019-11-07 00:00:00+03:00,out,True,907986,True,1,0,16,16
167176,2019-11-07 00:00:00+03:00,in,False,907994,False,2,1036,1070,34
167176,2019-11-07 00:00:00+03:00,out,False,905104,False,1,108,122,14
167176,2019-11-07 00:00:00+03:00,out,True,907994,False,2,17,28,11
167176,2019-11-07 00:00:00+03:00,out,True,907982,True,1,0,13,13
167176,2019-11-07 00:00:00+03:00,out,True,907994,True,1,0,14,14
167176,2019-11-07 00:00:00+03:00,out,True,907982,False,2,149,154,5
167176,2019-11-07 00:00:00+03:00,in,False,-1,True,5,0,147,147
167176,2019-11-07 00:00:00+03:00,in,False,905104,False,11,952,1183,231
167176,2019-11-07 00:00:00+03:00,out,True,907970,True,1,0,3,3
167176,2019-11-07 00:00:00+03:00,out,True,905104,False,1,111,113,2
167176,2019-11-07 00:00:00+03:00,in,False,907952,False,3,463,517,54
167176,2019-11-07 00:00:00+03:00,out,True,907986,False,6,68,100,32
167176,2019-11-07 00:00:00+03:00,in,False,907982,False,1,58,76,18
167176,2019-11-07 00:00:00+03:00,in,False,907504,False,1,74,98,24
167176,2019-11-07 00:00:00+03:00,out,True,907952,False,4,411,421,10
167176,2019-11-08 00:00:00+03:00,out,True,907970,False,2,27,34,7
167176,2019-11-08 00:00:00+03:00,out,False,905104,False,1,97,100,3
167176,2019-11-08 00:00:00+03:00,out,True,907952,False,1,46,48,2
167176,2019-11-08 00:00:00+03:00,out,True,907970,True,1,0,13,13
167176,2019-11-08 00:00:00+03:00,out,True,907964,False,1,23,28,5
167176,2019-11-08 00:00:00+03:00,in,False,907982,False,1,78,96,18
167176,2019-11-08 00:00:00+03:00,out,True,907964,True,1,0,9,9
167176,2019-11-08 00:00:00+03:00,in,False,905104,False,3,129,176,47
167176,2019-11-08 00:00:00+03:00,in,False,-1,True,1,0,9,9
167176,2019-11-08 00:00:00+03:00,in,False,907952,False,2,81,119,38
167176,2019-11-08 00:00:00+03:00,out,True,907986,False,2,12,17,5
167176,2019-11-09 00:00:00+03:00,in,False,-1,True,1,0,3,3
167176,2019-11-11 00:00:00+03:00,in,False,907952,False,4,170,243,73
167176,2019-11-11 00:00:00+03:00,out,True,907964,False,1,4,7,3
167176,2019-11-11 00:00:00+03:00,out,True,907982,False,6,195,214,19
167176,2019-11-11 00:00:00+03:00,out,False,905104,False,1,161,165,4
167176,2019-11-11 00:00:00+03:00,out,False,905104,True,2,0,96,96
167176,2019-11-11 00:00:00+03:00,in,False,905104,False,9,1093,1241,148
167176,2019-11-11 00:00:00+03:00,out,True,907964,True,1,0,14,14
167176,2019-11-11 00:00:00+03:00,out,True,907982,True,1,0,8,8
167176,2019-11-11 00:00:00+03:00,in,False,-1,True,3,0,40,40
167176,2019-11-11 00:00:00+03:00,out,True,907994,True,1,0,13,13
167176,2019-11-11 00:00:00+03:00,out,True,907952,True,1,0,0,0
167176,2019-11-11 00:00:00+03:00,out,True,907994,False,6,126,159,33
167176,2019-11-11 00:00:00+03:00,out,True,907952,False,1,45,47,2
167176,2019-11-11 00:00:00+03:00,in,False,905104,True,1,0,17,17
167176,2019-11-11 00:00:00+03:00,out,True,907986,False,11,310,353,43
167176,2019-11-11 00:00:00+03:00,out,True,907982,True,1,0,8,8
167176,2019-11-11 00:00:00+03:00,out,True,907952,False,1,45,47,2
167176,2019-11-12 00:00:00+03:00,out,True,907970,True,1,0,14,14
167176,2019-11-12 00:00:00+03:00,out,True,907970,False,6,460,486,26
167176,2019-11-12 00:00:00+03:00,out,True,907952,False,4,659,672,13
167176,2019-11-12 00:00:00+03:00,out,True,907986,True,1,0,25,25
167176,2019-11-12 00:00:00+03:00,out,True,907986,False,12,279,319,40
167176,2019-11-12 00:00:00+03:00,out,True,907982,False,1,67,71,4
167176,2019-11-12 00:00:00+03:00,in,False,907952,False,2,485,536,51
167176,2019-11-12 00:00:00+03:00,out,True,907994,False,3,98,108,10
167176,2019-11-12 00:00:00+03:00,out,True,907952,True,1,0,16,16
167176,2019-11-12 00:00:00+03:00,in,False,-1,True,3,0,312,312
167176,2019-11-12 00:00:00+03:00,out,True,907964,False,1,27,32,5
167176,2019-11-12 00:00:00+03:00,out,False,905104,True,2,0,57,57
167176,2019-11-12 00:00:00+03:00,in,False,907982,False,2,172,208,36
167176,2019-11-12 00:00:00+03:00,out,False,905104,False,7,1717,1744,27
167176,2019-11-12 00:00:00+03:00,in,False,905104,False,2,108,139,31
167176,2019-11-12 00:00:00+03:00,out,True,907504,False,3,44,56,12
167176,2019-11-12 00:00:00+03:00,out,True,905104,False,1,19,22,3
167176,2019-11-12 00:00:00+03:00,in,False,907994,False,1,294,315,21
167176,2019-11-12 00:00:00+03:00,in,False,905104,False,2,108,139,31
167176,2019-11-12 00:00:00+03:00,out,True,907986,False,12,279,319,40
167176,2019-11-13 00:00:00+03:00,out,True,907982,False,1,31,34,3
167176,2019-11-13 00:00:00+03:00,out,True,905104,False,2,151,156,5
167176,2019-11-13 00:00:00+03:00,out,True,907952,False,1,8,19,11
167176,2019-11-13 00:00:00+03:00,out,True,907994,False,2,21,31,10
167176,2019-11-13 00:00:00+03:00,out,True,907952,True,1,0,11,11
167176,2019-11-13 00:00:00+03:00,in,False,907952,False,1,41,62,21
167176,2019-11-13 00:00:00+03:00,out,True,907964,False,3,23,37,14
167176,2019-11-13 00:00:00+03:00,in,False,905104,False,5,388,472,84
167176,2019-11-13 00:00:00+03:00,out,True,907964,True,2,0,11,11
167176,2019-11-13 00:00:00+03:00,out,True,907970,False,1,35,38,3
167176,2019-11-13 00:00:00+03:00,out,True,907986,False,5,142,159,17
167176,2019-11-13 00:00:00+03:00,out,False,905104,False,1,69,71,2
167176,2019-11-13 00:00:00+03:00,in,False,907994,False,1,38,63,25
167176,2019-11-13 00:00:00+03:00,in,False,907982,False,3,456,514,58
167176,2019-11-13 00:00:00+03:00,in,False,907982,False,3,456,514,58
167176,2019-11-14 00:00:00+03:00,out,True,907970,True,2,0,29,29
167176,2019-11-14 00:00:00+03:00,out,True,907994,False,5,100,119,19
167176,2019-11-14 00:00:00+03:00,in,False,907994,False,2,671,703,32
167176,2019-11-14 00:00:00+03:00,in,False,907982,False,2,119,154,35
167176,2019-11-14 00:00:00+03:00,out,True,907952,False,6,321,356,35
167176,2019-11-14 00:00:00+03:00,in,False,905104,False,2,287,326,39
167176,2019-11-14 00:00:00+03:00,out,True,907982,False,2,34,45,11
167176,2019-11-14 00:00:00+03:00,out,False,905104,True,1,0,5,5
167176,2019-11-14 00:00:00+03:00,out,False,905104,False,4,134,153,19
167176,2019-11-14 00:00:00+03:00,out,True,907994,True,1,0,18,18
167176,2019-11-14 00:00:00+03:00,out,True,907964,True,1,0,15,15
167176,2019-11-14 00:00:00+03:00,in,False,-1,True,4,0,110,110
167176,2019-11-14 00:00:00+03:00,out,True,907970,False,3,164,171,7
167176,2019-11-14 00:00:00+03:00,out,True,907986,True,2,0,25,25
167176,2019-11-14 00:00:00+03:00,out,True,907986,False,12,187,221,34
167176,2019-11-14 00:00:00+03:00,out,True,907964,False,6,548,581,33
167176,2019-11-14 00:00:00+03:00,out,True,907964,True,1,0,15,15
167176,2019-11-14 00:00:00+03:00,out,False,905104,False,4,134,153,19
167176,2019-11-15 00:00:00+03:00,out,False,907964,True,1,0,7,7
167176,2019-11-15 00:00:00+03:00,out,False,905104,False,1,180,182,2
167176,2019-11-15 00:00:00+03:00,in,False,-1,True,1,0,6,6
167176,2019-11-15 00:00:00+03:00,out,True,907986,False,13,417,482,65
167176,2019-11-15 00:00:00+03:00,out,True,907964,False,2,40,49,9
167176,2019-11-15 00:00:00+03:00,out,True,907994,False,4,50,68,18
167176,2019-11-15 00:00:00+03:00,in,False,905104,False,3,82,137,55
167176,2019-11-15 00:00:00+03:00,out,True,907970,False,3,443,454,11
167176,2019-11-15 00:00:00+03:00,out,True,907970,True,1,0,0,0
167176,2019-11-15 00:00:00+03:00,out,True,907982,True,1,0,9,9
167176,2019-11-15 00:00:00+03:00,out,True,907952,False,8,186,209,23
167176,2019-11-15 00:00:00+03:00,in,False,907982,False,1,304,322,18
167176,2019-11-15 00:00:00+03:00,out,True,907952,True,1,0,6,6
167176,2019-11-15 00:00:00+03:00,out,True,907982,False,1,242,244,2
167176,2019-11-15 00:00:00+03:00,out,True,907986,True,1,0,25,25
167176,2019-11-15 00:00:00+03:00,out,True,907994,False,4,50,68,18
167176,2019-11-18 00:00:00+03:00,out,True,907970,True,1,0,0,0
167176,2019-11-18 00:00:00+03:00,out,True,907952,False,1,12,17,5
167176,2019-11-18 00:00:00+03:00,out,False,907982,False,2,102,121,19
167176,2019-11-18 00:00:00+03:00,out,True,907982,False,3,268,276,8
167176,2019-11-18 00:00:00+03:00,in,False,907982,False,1,58,79,21
167176,2019-11-18 00:00:00+03:00,in,False,-1,True,2,0,29,29
167176,2019-11-18 00:00:00+03:00,out,True,907986,False,8,197,222,25
167176,2019-11-18 00:00:00+03:00,out,True,907970,False,2,81,86,5
167176,2019-11-18 00:00:00+03:00,in,False,907952,False,1,29,48,19
167176,2019-11-18 00:00:00+03:00,in,False,905104,False,5,302,382,80
167176,2019-11-18 00:00:00+03:00,out,True,907964,False,4,208,229,21
167176,2019-11-19 00:00:00+03:00,out,True,907970,False,3,568,575,7
167176,2019-11-19 00:00:00+03:00,in,False,907952,False,1,102,130,28
167176,2019-11-19 00:00:00+03:00,out,False,905104,False,4,515,524,9
167176,2019-11-19 00:00:00+03:00,in,False,907970,False,1,267,285,18
167176,2019-11-19 00:00:00+03:00,out,True,907982,False,1,16,20,4
167176,2019-11-19 00:00:00+03:00,in,False,907994,False,2,382,417,35
167176,2019-11-19 00:00:00+03:00,out,True,907986,False,12,233,286,53
167176,2019-11-19 00:00:00+03:00,out,True,907504,False,4,101,121,20
167176,2019-11-19 00:00:00+03:00,in,False,905104,False,8,465,631,166
167176,2019-11-19 00:00:00+03:00,out,True,907994,False,1,44,47,3
167176,2019-11-19 00:00:00+03:00,out,True,907952,False,1,61,63,2
167176,2019-11-19 00:00:00+03:00,out,True,907952,True,1,0,1,1
167176,2019-11-19 00:00:00+03:00,out,False,905104,True,3,0,39,39
167176,2019-11-19 00:00:00+03:00,in,False,-1,True,2,0,76,76
167176,2019-11-20 00:00:00+03:00,in,False,905104,False,5,290,377,87
167176,2019-11-20 00:00:00+03:00,out,True,907964,False,1,13,15,2
167176,2019-11-20 00:00:00+03:00,in,False,907994,False,1,287,333,46
167176,2019-11-20 00:00:00+03:00,out,True,907952,False,1,70,91,21
167176,2019-11-20 00:00:00+03:00,in,False,907952,False,1,114,133,19
167176,2019-11-20 00:00:00+03:00,out,True,907986,False,8,224,251,27
167176,2019-11-20 00:00:00+03:00,out,True,907982,False,2,157,167,10
167176,2019-11-20 00:00:00+03:00,out,True,907970,False,1,64,67,3
167176,2019-11-20 00:00:00+03:00,out,True,907994,False,1,22,28,6
167176,2019-11-20 00:00:00+03:00,out,True,907994,True,1,0,5,5
167176,2019-11-20 00:00:00+03:00,out,True,907964,True,2,0,16,16
167176,2019-11-20 00:00:00+03:00,out,False,905104,True,3,0,14,14
167176,2019-11-20 00:00:00+03:00,out,True,907986,True,2,0,3,3
167176,2019-11-20 00:00:00+03:00,out,False,905104,False,4,401,430,29
167176,2019-11-21 00:00:00+03:00,in,False,907964,False,1,250,266,16
167176,2019-11-21 00:00:00+03:00,in,False,907982,True,1,0,16,16
167176,2019-11-21 00:00:00+03:00,out,False,905104,False,7,958,1003,45
167176,2019-11-21 00:00:00+03:00,out,True,907964,False,1,15,17,2
167176,2019-11-21 00:00:00+03:00,in,False,907982,False,3,406,464,58
167176,2019-11-21 00:00:00+03:00,in,False,-1,True,2,0,14,14
167176,2019-11-21 00:00:00+03:00,in,False,905104,False,2,191,223,32
167176,2019-11-21 00:00:00+03:00,out,True,907970,False,1,42,44,2
167176,2019-11-21 00:00:00+03:00,out,True,907982,False,1,230,232,2
167176,2019-11-21 00:00:00+03:00,out,True,907964,True,1,0,21,21
167176,2019-11-21 00:00:00+03:00,out,True,907970,True,1,0,7,7
167176,2019-11-21 00:00:00+03:00,out,True,907952,False,1,57,61,4
167176,2019-11-21 00:00:00+03:00,in,False,907952,False,1,93,114,21
167176,2019-11-21 00:00:00+03:00,in,False,907964,False,1,250,266,16
167176,2019-11-22 00:00:00+03:00,in,False,905104,False,1,5,21,16
167176,2019-11-22 00:00:00+03:00,in,False,907964,False,1,141,157,16
167176,2019-11-22 00:00:00+03:00,out,True,907970,False,1,44,46,2
167176,2019-11-22 00:00:00+03:00,out,False,905104,False,1,114,116,2
167176,2019-11-22 00:00:00+03:00,out,True,907982,False,3,249,258,9
167176,2019-11-22 00:00:00+03:00,out,True,907964,False,2,51,67,16
167176,2019-11-22 00:00:00+03:00,out,True,907952,False,1,47,49,2
167176,2019-11-22 00:00:00+03:00,out,True,907986,False,3,50,56,6
167176,2019-11-22 00:00:00+03:00,in,False,-1,True,1,0,2,2
167176,2019-11-22 00:00:00+03:00,in,False,907952,False,2,1083,1117,34
167176,2019-11-22 00:00:00+03:00,out,True,907986,False,3,50,56,6
167176,2019-11-25 00:00:00+03:00,in,False,907982,False,2,198,233,35
167176,2019-11-25 00:00:00+03:00,out,True,907952,False,1,18,21,3
167176,2019-11-25 00:00:00+03:00,out,True,907970,False,4,243,254,11
167176,2019-11-25 00:00:00+03:00,in,False,905104,False,4,278,341,63
167176,2019-11-25 00:00:00+03:00,out,True,907994,False,3,129,135,6
167176,2019-11-25 00:00:00+03:00,out,True,907986,False,4,82,95,13
167176,2019-11-25 00:00:00+03:00,out,True,907982,False,1,80,82,2
167176,2019-11-25 00:00:00+03:00,out,False,905104,False,3,166,187,21
167176,2019-11-25 00:00:00+03:00,out,True,907986,True,1,0,1,1
167176,2019-11-25 00:00:00+03:00,in,False,-1,True,1,0,17,17
167176,2019-11-25 00:00:00+03:00,out,True,907970,True,1,0,1,1
167176,2019-11-25 00:00:00+03:00,in,False,905104,False,4,278,341,63
167176,2019-11-25 00:00:00+03:00,out,True,907970,True,1,0,1,1
167176,2019-11-25 00:00:00+03:00,in,False,-1,True,1,0,17,17
167176,2019-11-25 00:00:00+03:00,out,True,907986,False,4,82,95,13
167176,2019-11-26 00:00:00+03:00,out,True,907970,False,1,105,108,3
167176,2019-11-26 00:00:00+03:00,out,False,905104,False,1,64,68,4
167176,2019-11-26 00:00:00+03:00,out,True,907952,False,1,70,72,2
167176,2019-11-26 00:00:00+03:00,in,False,905104,False,4,251,324,73
167176,2019-11-26 00:00:00+03:00,in,False,907952,False,1,94,112,18
167176,2019-11-26 00:00:00+03:00,out,True,907982,False,3,130,142,12
167176,2019-11-26 00:00:00+03:00,out,True,907994,False,1,7,10,3
167176,2019-11-26 00:00:00+03:00,in,False,907982,False,1,132,148,16
167176,2019-11-26 00:00:00+03:00,out,True,905104,False,1,22,25,3
167176,2019-11-26 00:00:00+03:00,out,True,907986,False,6,203,216,13
167176,2019-11-26 00:00:00+03:00,out,True,905104,False,1,22,25,3
167176,2019-11-27 00:00:00+03:00,out,True,907970,False,3,59,71,12
167176,2019-11-27 00:00:00+03:00,in,False,-1,True,1,0,11,11
167176,2019-11-27 00:00:00+03:00,out,True,907952,False,1,127,130,3
167176,2019-11-27 00:00:00+03:00,in,False,907994,False,1,1048,1064,16
167176,2019-11-27 00:00:00+03:00,out,True,907982,False,2,9,16,7
167176,2019-11-27 00:00:00+03:00,in,False,907970,False,1,106,127,21
167176,2019-11-27 00:00:00+03:00,out,True,907994,True,2,0,28,28
167176,2019-11-27 00:00:00+03:00,in,False,907982,False,1,25,44,19
167176,2019-11-27 00:00:00+03:00,out,True,907994,False,1,13,16,3
167176,2019-11-27 00:00:00+03:00,out,False,905104,True,2,0,39,39
167176,2019-11-27 00:00:00+03:00,out,True,907986,False,5,336,351,15
167176,2019-11-27 00:00:00+03:00,in,False,905104,False,4,160,226,66
167176,2019-11-27 00:00:00+03:00,out,False,905104,False,5,478,500,22
167176,2019-11-27 00:00:00+03:00,in,False,-1,True,1,0,11,11
167176,2019-11-27 00:00:00+03:00,out,True,907994,True,2,0,28,28
167176,2019-11-28 00:00:00+03:00,in,False,-1,True,1,0,3,3
167176,2019-11-28 00:00:00+03:00,out,True,907964,False,2,74,80,6
167176,2019-11-28 00:00:00+03:00,out,False,905104,False,1,97,112,15
167176,2019-11-28 00:00:00+03:00,out,True,907952,False,2,75,84,9
167176,2019-11-28 00:00:00+03:00,out,True,907986,False,4,85,95,10
167176,2019-11-28 00:00:00+03:00,in,False,905104,False,6,526,622,96
167176,2019-11-28 00:00:00+03:00,out,True,907994,False,1,126,128,2
167176,2019-11-28 00:00:00+03:00,out,False,907982,False,1,255,290,35
167176,2019-11-28 00:00:00+03:00,out,False,905104,False,1,97,112,15
167176,2019-11-28 00:00:00+03:00,out,True,907994,False,1,126,128,2
167180,2019-09-13 00:00:00+03:00,out,True,905930,False,2,11,47,36
167180,2019-09-13 00:00:00+03:00,in,False,-1,True,4,0,49,49
167180,2019-09-13 00:00:00+03:00,out,False,905934,False,3,801,835,34
167180,2019-09-13 00:00:00+03:00,out,False,905932,True,4,0,91,91
167180,2019-09-13 00:00:00+03:00,out,False,905932,False,1,7,19,12
167180,2019-09-13 00:00:00+03:00,out,False,905930,False,1,5,14,9
167180,2019-09-13 00:00:00+03:00,out,False,905930,True,1,0,9,9
167180,2019-09-13 00:00:00+03:00,in,False,905930,False,2,75,95,20
167180,2019-09-13 00:00:00+03:00,in,False,-1,True,4,0,49,49
167180,2019-09-13 00:00:00+03:00,out,True,905930,False,2,11,47,36
167180,2019-09-16 00:00:00+03:00,in,False,905934,False,1,249,258,9
167180,2019-09-16 00:00:00+03:00,out,True,905932,True,1,0,3,3
167180,2019-09-16 00:00:00+03:00,out,False,905932,True,2,0,92,92
167180,2019-09-16 00:00:00+03:00,out,False,905932,False,1,24,31,7
167180,2019-09-17 00:00:00+03:00,out,True,905932,True,2,0,0,0
167180,2019-09-17 00:00:00+03:00,out,False,905932,False,7,560,605,45
167180,2019-09-17 00:00:00+03:00,out,False,905932,True,3,0,70,70
167180,2019-09-17 00:00:00+03:00,out,False,905932,False,7,560,605,45
167180,2019-09-18 00:00:00+03:00,in,False,-1,True,3,0,105,105
167180,2019-09-18 00:00:00+03:00,out,False,905932,False,1,40,51,11
167180,2019-09-18 00:00:00+03:00,in,False,905930,False,1,38,47,9
167180,2019-09-18 00:00:00+03:00,out,True,905932,True,1,0,3,3
167180,2019-09-18 00:00:00+03:00,out,False,905932,True,1,0,4,4
167180,2019-09-18 00:00:00+03:00,out,False,905932,True,1,0,4,4
167180,2019-09-18 00:00:00+03:00,in,False,-1,True,3,0,105,105
167180,2019-09-19 00:00:00+03:00,out,False,905934,False,2,267,277,10
167180,2019-09-19 00:00:00+03:00,in,False,905930,False,1,242,249,7
167180,2019-09-19 00:00:00+03:00,out,False,905932,True,1,0,4,4
167180,2019-09-19 00:00:00+03:00,in,False,905932,False,1,2,12,10
167180,2019-09-20 00:00:00+03:00,out,False,905934,False,1,289,292,3
167180,2019-09-20 00:00:00+03:00,in,False,905932,False,1,2,9,7
167180,2019-09-20 00:00:00+03:00,out,False,905932,False,3,397,461,64
167180,2019-09-20 00:00:00+03:00,out,False,905930,False,3,255,258,3
167180,2019-09-20 00:00:00+03:00,out,False,905932,True,3,0,130,130
167180,2019-09-20 00:00:00+03:00,in,False,905930,False,1,87,92,5
167180,2019-09-23 00:00:00+03:00,in,False,905930,False,1,51,58,7
167180,2019-09-23 00:00:00+03:00,out,False,905932,False,13,2214,2367,153
167180,2019-09-23 00:00:00+03:00,out,False,905932,True,5,0,186,186
167180,2019-09-23 00:00:00+03:00,out,False,905930,True,2,0,96,96
167180,2019-09-24 00:00:00+03:00,out,False,905932,True,1,0,4,4
167180,2019-09-24 00:00:00+03:00,out,False,905930,False,2,318,320,2
167180,2019-09-24 00:00:00+03:00,in,False,905930,False,1,64,72,8
167180,2019-09-24 00:00:00+03:00,out,False,905932,False,7,1642,1737,95
167180,2019-09-24 00:00:00+03:00,out,False,905934,True,1,0,3,3
167180,2019-09-24 00:00:00+03:00,out,False,905932,True,1,0,4,4
167180,2019-09-26 00:00:00+03:00,in,False,905932,False,1,254,270,16
167180,2019-09-26 00:00:00+03:00,out,False,905932,True,1,0,3,3
167180,2019-09-26 00:00:00+03:00,out,False,905932,False,3,474,503,29
167180,2019-09-26 00:00:00+03:00,out,False,905930,True,1,0,8,8
167180,2019-09-26 00:00:00+03:00,in,False,-1,True,2,0,20,20
167180,2019-09-26 00:00:00+03:00,out,False,905932,False,3,474,503,29
167180,2019-09-27 00:00:00+03:00,out,False,905932,False,1,39,62,23
167180,2019-09-30 00:00:00+03:00,in,False,905932,False,1,85,90,5
167180,2019-09-30 00:00:00+03:00,out,False,905932,False,12,992,1037,45
167180,2019-09-30 00:00:00+03:00,out,True,905932,True,1,0,0,0
167180,2019-09-30 00:00:00+03:00,out,False,905932,True,2,0,18,18
167180,2019-10-01 00:00:00+03:00,out,False,905932,False,9,1403,1517,114
167180,2019-10-01 00:00:00+03:00,out,False,905930,False,1,49,61,12
167180,2019-10-01 00:00:00+03:00,out,False,905932,True,4,0,33,33
167180,2019-10-01 00:00:00+03:00,in,False,905930,False,2,156,169,13
167180,2019-10-01 00:00:00+03:00,in,False,905932,False,3,330,348,18
167180,2019-10-01 00:00:00+03:00,out,True,905932,True,1,0,2,2
167180,2019-10-01 00:00:00+03:00,out,False,905932,False,9,1403,1517,114
167180,2019-10-02 00:00:00+03:00,out,False,905930,False,19,2769,2842,73
167180,2019-10-02 00:00:00+03:00,out,True,905932,False,1,14,18,4
167180,2019-10-02 00:00:00+03:00,in,False,905932,False,1,45,52,7
167180,2019-10-02 00:00:00+03:00,in,False,905930,False,1,33,40,7
167180,2019-10-02 00:00:00+03:00,out,False,905932,False,1,83,92,9
167180,2019-10-02 00:00:00+03:00,out,True,905930,True,2,0,5,5
167180,2019-10-02 00:00:00+03:00,out,False,905930,True,1,0,3,3
167180,2019-10-02 00:00:00+03:00,out,False,905930,True,1,0,3,3
167180,2019-10-03 00:00:00+03:00,out,True,905932,True,2,0,0,0
167180,2019-10-03 00:00:00+03:00,out,False,905934,True,1,0,60,60
167180,2019-10-03 00:00:00+03:00,out,False,905932,True,16,0,253,253
167180,2019-10-03 00:00:00+03:00,out,False,905930,False,16,2753,2816,63
167180,2019-10-03 00:00:00+03:00,in,False,905932,False,3,98,112,14
167180,2019-10-03 00:00:00+03:00,in,False,905930,False,1,222,234,12
167180,2019-10-03 00:00:00+03:00,out,False,905934,False,3,2725,2750,25
167180,2019-10-03 00:00:00+03:00,out,False,905932,False,11,2417,2502,85
167180,2019-10-03 00:00:00+03:00,out,True,905934,True,2,0,3,3
167180,2019-10-03 00:00:00+03:00,in,False,-1,True,1,0,35,35
167180,2019-10-03 00:00:00+03:00,out,False,905930,False,16,2753,2816,63
167180,2019-10-04 00:00:00+03:00,out,False,905930,True,1,0,3,3
167180,2019-10-04 00:00:00+03:00,out,True,905930,False,1,213,220,7
167180,2019-10-04 00:00:00+03:00,out,False,905930,False,3,1023,1036,13
167180,2019-10-04 00:00:00+03:00,in,False,905932,False,1,396,401,5
167180,2019-10-04 00:00:00+03:00,out,False,905932,False,6,1837,1893,56
167180,2019-10-04 00:00:00+03:00,out,True,905930,True,1,0,3,3
167180,2019-10-04 00:00:00+03:00,out,False,905932,True,2,0,37,37
167180,2019-10-04 00:00:00+03:00,in,False,-1,True,1,0,35,35
167180,2019-10-04 00:00:00+03:00,in,False,905930,False,2,406,417,11
167180,2019-10-07 00:00:00+03:00,out,False,905932,True,1,0,60,60
167180,2019-10-07 00:00:00+03:00,out,False,905932,False,8,1498,1529,31
167180,2019-10-07 00:00:00+03:00,in,False,905930,False,1,43,49,6
167180,2019-10-07 00:00:00+03:00,out,False,905930,False,10,884,942,58
167180,2019-10-07 00:00:00+03:00,out,True,905930,True,1,0,2,2
167180,2019-10-08 00:00:00+03:00,out,True,905930,True,1,0,3,3
167180,2019-10-08 00:00:00+03:00,out,False,905930,True,1,0,1,1
167180,2019-10-08 00:00:00+03:00,out,False,905930,False,11,1232,1352,120
167180,2019-10-08 00:00:00+03:00,out,False,905932,False,4,588,645,57
167180,2019-10-09 00:00:00+03:00,out,False,905930,False,1,518,524,6
167180,2019-10-09 00:00:00+03:00,out,False,905932,False,6,1248,1293,45
167180,2019-10-10 00:00:00+03:00,in,False,905930,False,4,382,406,24
167180,2019-10-10 00:00:00+03:00,in,False,905932,False,2,28,38,10
167180,2019-10-10 00:00:00+03:00,out,False,905930,False,12,1067,1118,51
167180,2019-10-10 00:00:00+03:00,out,False,905932,False,4,382,423,41
167180,2019-10-10 00:00:00+03:00,out,False,905932,True,6,0,24,24
167180,2019-10-10 00:00:00+03:00,out,False,905930,False,12,1067,1118,51
167180,2019-10-11 00:00:00+03:00,in,False,905930,False,1,46,50,4
167180,2019-10-11 00:00:00+03:00,in,False,905932,False,1,51,61,10
167180,2019-10-11 00:00:00+03:00,out,False,905932,False,4,394,447,53
167180,2019-10-11 00:00:00+03:00,out,False,905930,False,6,520,536,16
167180,2019-10-11 00:00:00+03:00,out,False,905932,True,3,0,5,5
167180,2019-10-11 00:00:00+03:00,out,False,905930,True,6,0,123,123
167180,2019-10-14 00:00:00+03:00,out,False,905930,False,5,521,548,27
167180,2019-10-14 00:00:00+03:00,out,False,905932,False,6,810,826,16
167180,2019-10-14 00:00:00+03:00,out,False,905932,True,7,0,43,43
167180,2019-10-14 00:00:00+03:00,out,False,905930,True,3,0,9,9
167180,2019-10-15 00:00:00+03:00,out,False,905930,False,2,144,162,18
167180,2019-10-16 00:00:00+03:00,in,False,905932,False,1,28,34,6
167180,2019-10-16 00:00:00+03:00,out,False,905930,True,3,0,93,93
167180,2019-10-16 00:00:00+03:00,out,False,905932,False,1,506,511,5
167180,2019-10-16 00:00:00+03:00,out,False,905930,False,2,765,770,5
167180,2019-10-16 00:00:00+03:00,in,False,905930,False,2,331,344,13
167180,2019-10-16 00:00:00+03:00,out,False,905930,False,2,765,770,5
167180,2019-10-17 00:00:00+03:00,out,False,905930,True,7,0,285,285
167180,2019-10-17 00:00:00+03:00,out,False,905934,False,1,82,83,1
167180,2019-10-17 00:00:00+03:00,out,False,905932,False,4,311,354,43
167180,2019-10-17 00:00:00+03:00,out,False,905930,False,6,728,776,48
167180,2019-10-17 00:00:00+03:00,out,False,905930,True,7,0,285,285
167180,2019-10-18 00:00:00+03:00,in,False,905932,False,1,15,22,7
167180,2019-10-18 00:00:00+03:00,out,False,905930,False,4,1319,1384,65
167180,2019-10-18 00:00:00+03:00,out,False,905930,True,1,0,2,2
167180,2019-10-18 00:00:00+03:00,out,False,905932,False,4,327,340,13
167180,2019-10-18 00:00:00+03:00,in,False,905932,False,1,15,22,7
167180,2019-10-21 00:00:00+03:00,in,False,905930,False,1,28,33,5
167180,2019-10-21 00:00:00+03:00,in,False,-1,True,1,0,35,35
167180,2019-10-21 00:00:00+03:00,out,False,905932,False,4,620,642,22
167180,2019-10-21 00:00:00+03:00,out,True,905932,True,1,0,1,1
167180,2019-10-21 00:00:00+03:00,out,False,905930,True,1,0,51,51
167180,2019-10-21 00:00:00+03:00,out,True,905932,True,1,0,1,1
167180,2019-10-22 00:00:00+03:00,in,False,905932,False,2,114,123,9
167180,2019-10-22 00:00:00+03:00,out,False,905934,False,1,341,344,3
167180,2019-10-22 00:00:00+03:00,out,False,905932,True,1,0,23,23
167180,2019-10-22 00:00:00+03:00,out,False,905932,False,7,818,906,88
167180,2019-10-22 00:00:00+03:00,out,False,905930,False,2,106,129,23
167180,2019-10-23 00:00:00+03:00,out,False,905930,False,1,47,52,5
167180,2019-10-23 00:00:00+03:00,in,False,905932,False,3,138,160,22
167180,2019-10-23 00:00:00+03:00,out,False,905932,False,1,858,871,13
167180,2019-10-23 00:00:00+03:00,in,False,905930,False,3,830,844,14
167180,2019-10-24 00:00:00+03:00,out,False,905930,True,4,0,107,107
167180,2019-10-24 00:00:00+03:00,out,True,905932,True,2,0,2,2
167180,2019-10-24 00:00:00+03:00,in,False,-1,True,3,0,87,87
167180,2019-10-24 00:00:00+03:00,out,False,905932,True,1,0,18,18
167180,2019-10-24 00:00:00+03:00,in,False,905932,False,1,23,29,6
167180,2019-10-24 00:00:00+03:00,out,False,905932,False,5,2643,2718,75
167180,2019-10-24 00:00:00+03:00,out,False,905930,False,3,204,255,51
167180,2019-10-24 00:00:00+03:00,out,True,905930,True,2,0,0,0
167180,2019-10-24 00:00:00+03:00,in,False,905930,False,9,479,526,47
167180,2019-10-25 00:00:00+03:00,out,False,905930,True,4,0,157,157
167180,2019-10-25 00:00:00+03:00,out,False,905930,False,5,453,541,88
167180,2019-10-25 00:00:00+03:00,in,False,905930,False,6,174,211,37
167180,2019-10-25 00:00:00+03:00,in,False,905932,False,1,20,29,9
167180,2019-10-25 00:00:00+03:00,in,False,-1,True,2,0,70,70
167180,2019-10-25 00:00:00+03:00,out,False,905932,False,8,1220,1280,60
167180,2019-10-25 00:00:00+03:00,out,True,905930,True,2,0,0,0
167180,2019-10-25 00:00:00+03:00,in,False,905930,False,6,174,211,37
167180,2019-10-28 00:00:00+03:00,out,False,905932,False,1,42,45,3
167180,2019-10-28 00:00:00+03:00,out,False,905930,False,1,99,127,28
167180,2019-10-28 00:00:00+03:00,in,False,905930,False,5,209,246,37
167180,2019-10-29 00:00:00+03:00,in,False,905932,False,1,81,97,16
167180,2019-10-29 00:00:00+03:00,out,False,905930,False,1,46,57,11
167180,2019-10-29 00:00:00+03:00,out,True,905930,False,1,75,84,9
167180,2019-10-29 00:00:00+03:00,in,False,905930,False,3,275,288,13
167180,2019-10-30 00:00:00+03:00,in,False,905932,False,1,67,89,22
167180,2019-10-30 00:00:00+03:00,out,False,905930,False,10,531,650,119
167180,2019-10-30 00:00:00+03:00,out,True,905930,True,6,0,15,15
167180,2019-10-30 00:00:00+03:00,out,False,905930,True,2,0,80,80
167180,2019-10-30 00:00:00+03:00,out,True,905932,True,1,0,0,0
167180,2019-10-30 00:00:00+03:00,in,False,905930,False,4,296,349,53
167180,2019-10-30 00:00:00+03:00,out,False,905932,True,1,0,2,2
167180,2019-10-30 00:00:00+03:00,out,False,905932,False,7,857,911,54
167180,2019-10-31 00:00:00+03:00,in,False,-1,True,4,0,140,140
167180,2019-10-31 00:00:00+03:00,in,False,905930,False,1,161,167,6
167180,2019-10-31 00:00:00+03:00,out,False,905934,False,1,59,62,3
167180,2019-10-31 00:00:00+03:00,out,False,905930,False,5,672,685,13
167180,2019-10-31 00:00:00+03:00,out,False,905934,False,1,59,62,3
167180,2019-10-31 00:00:00+03:00,in,False,905930,False,1,161,167,6
167180,2019-11-01 00:00:00+03:00,out,False,905932,True,2,0,103,103
167180,2019-11-01 00:00:00+03:00,out,True,905932,True,1,0,1,1
167180,2019-11-01 00:00:00+03:00,out,False,905932,False,7,723,786,63
167180,2019-11-01 00:00:00+03:00,out,True,905934,True,1,0,0,0
167180,2019-11-01 00:00:00+03:00,out,False,905930,False,5,694,719,25
167180,2019-11-01 00:00:00+03:00,out,False,905930,False,5,694,719,25
167180,2019-11-05 00:00:00+03:00,out,False,905930,False,9,1421,1485,64
167180,2019-11-05 00:00:00+03:00,out,False,905932,True,1,0,14,14
167180,2019-11-05 00:00:00+03:00,out,True,905930,True,1,0,3,3
167180,2019-11-05 00:00:00+03:00,in,False,905932,False,3,900,920,20
167180,2019-11-05 00:00:00+03:00,out,False,905930,True,1,0,32,32
167180,2019-11-05 00:00:00+03:00,out,False,905932,False,4,786,862,76
167180,2019-11-05 00:00:00+03:00,out,True,905934,True,1,0,0,0
167180,2019-11-06 00:00:00+03:00,out,False,905930,True,2,0,18,18
167180,2019-11-06 00:00:00+03:00,out,True,905932,True,1,0,0,0
167180,2019-11-06 00:00:00+03:00,out,False,905930,False,7,752,790,38
167180,2019-11-06 00:00:00+03:00,out,False,905932,False,10,1282,1397,115
167180,2019-11-07 00:00:00+03:00,in,False,905932,False,1,20,27,7
167180,2019-11-07 00:00:00+03:00,out,True,905932,True,1,0,3,3
167180,2019-11-07 00:00:00+03:00,out,False,905932,True,5,0,62,62
167180,2019-11-07 00:00:00+03:00,out,False,905932,False,7,1497,1532,35
167180,2019-11-07 00:00:00+03:00,out,False,905930,False,4,619,664,45
167180,2019-11-08 00:00:00+03:00,out,False,905932,False,3,666,727,61
167180,2019-11-08 00:00:00+03:00,in,False,905932,False,1,17,33,16
167180,2019-11-08 00:00:00+03:00,out,False,905930,False,2,167,177,10
167180,2019-11-11 00:00:00+03:00,out,False,905932,False,6,699,714,15
167180,2019-11-11 00:00:00+03:00,in,False,905932,False,1,28,38,10
167180,2019-11-11 00:00:00+03:00,in,False,905930,False,2,75,84,9
167180,2019-11-11 00:00:00+03:00,in,False,-1,True,2,0,32,32
167180,2019-11-11 00:00:00+03:00,out,True,905932,True,2,0,0,0
167180,2019-11-12 00:00:00+03:00,in,False,-1,True,1,0,31,31
167180,2019-11-12 00:00:00+03:00,out,False,905930,False,4,620,638,18
167180,2019-11-12 00:00:00+03:00,in,False,905930,False,1,60,67,7
167180,2019-11-13 00:00:00+03:00,out,False,905932,False,2,246,305,59
167180,2019-11-13 00:00:00+03:00,out,False,905930,False,2,181,184,3
167180,2019-11-13 00:00:00+03:00,in,False,905930,False,1,36,42,6
167180,2019-11-13 00:00:00+03:00,in,False,905932,False,1,21,34,13
167180,2019-11-13 00:00:00+03:00,out,False,905932,False,2,246,305,59
167180,2019-11-14 00:00:00+03:00,out,False,905932,True,4,0,4,4
167180,2019-11-14 00:00:00+03:00,out,False,905934,False,1,20,24,4
167180,2019-11-14 00:00:00+03:00,out,False,905932,False,6,317,362,45
167180,2019-11-14 00:00:00+03:00,out,False,905930,True,1,0,60,60
167180,2019-11-14 00:00:00+03:00,in,False,905930,False,2,64,69,5
167180,2019-11-14 00:00:00+03:00,out,False,905930,False,8,956,996,40
167180,2019-11-15 00:00:00+03:00,out,True,905930,False,1,133,139,6
167180,2019-11-15 00:00:00+03:00,in,False,905930,False,2,326,334,8
167180,2019-11-15 00:00:00+03:00,out,True,905932,True,1,0,3,3
167180,2019-11-15 00:00:00+03:00,out,False,905930,False,2,758,759,1
167180,2019-11-18 00:00:00+03:00,in,False,905930,False,1,225,232,7
167180,2019-11-18 00:00:00+03:00,out,False,905930,False,6,1409,1428,19
167180,2019-11-18 00:00:00+03:00,out,True,905930,True,1,0,0,0
167180,2019-11-19 00:00:00+03:00,out,True,905930,False,1,303,321,18
167180,2019-11-19 00:00:00+03:00,out,False,905930,False,5,354,387,33
167180,2019-11-19 00:00:00+03:00,out,False,905930,True,3,0,42,42
167180,2019-11-19 00:00:00+03:00,in,False,905930,False,3,625,641,16
167180,2019-11-19 00:00:00+03:00,in,False,905930,False,3,625,641,16
167180,2019-11-20 00:00:00+03:00,out,False,905932,False,1,82,84,2
167180,2019-11-20 00:00:00+03:00,out,False,905930,False,1,78,79,1
167180,2019-11-20 00:00:00+03:00,in,False,905930,False,2,207,214,7
167180,2019-11-20 00:00:00+03:00,out,False,905932,False,1,82,84,2
167180,2019-11-21 00:00:00+03:00,out,False,905930,True,2,0,62,62
167180,2019-11-21 00:00:00+03:00,out,True,905930,True,1,0,0,0
167180,2019-11-21 00:00:00+03:00,out,False,905930,False,5,183,249,66
167180,2019-11-21 00:00:00+03:00,out,False,905932,False,2,200,206,6
167180,2019-11-21 00:00:00+03:00,in,False,905930,False,1,16,23,7
167180,2019-11-21 00:00:00+03:00,out,False,905932,True,1,0,51,51
167180,2019-11-22 00:00:00+03:00,out,False,905932,False,5,424,433,9
167180,2019-11-22 00:00:00+03:00,out,False,905930,False,4,190,221,31
167180,2019-11-22 00:00:00+03:00,out,False,905930,False,4,190,221,31
167180,2019-11-25 00:00:00+03:00,in,False,-1,True,1,0,2,2
167180,2019-11-25 00:00:00+03:00,out,False,905932,True,9,0,0,0
167180,2019-11-25 00:00:00+03:00,out,False,905930,True,5,0,0,0
167180,2019-11-26 00:00:00+03:00,out,True,905930,True,2,0,0,0
167180,2019-11-26 00:00:00+03:00,out,False,905932,False,5,221,243,22
167180,2019-11-26 00:00:00+03:00,out,False,905930,False,14,1987,2085,98
167180,2019-11-26 00:00:00+03:00,out,False,905932,True,1,0,9,9
167180,2019-11-26 00:00:00+03:00,in,False,905932,False,1,26,30,4
167180,2019-11-26 00:00:00+03:00,out,False,905930,True,2,0,58,58
167180,2019-11-27 00:00:00+03:00,out,False,905932,False,13,3464,3527,63
167180,2019-11-27 00:00:00+03:00,out,False,905930,False,11,499,570,71
167180,2019-11-27 00:00:00+03:00,out,False,905932,True,2,0,102,102
167180,2019-11-27 00:00:00+03:00,in,False,905930,False,1,31,36,5
167180,2019-11-27 00:00:00+03:00,out,False,905930,True,16,0,18,18
167180,2019-11-27 00:00:00+03:00,in,False,905932,False,2,102,121,19
167180,2019-11-27 00:00:00+03:00,out,False,905930,True,16,0,18,18
167180,2019-11-27 00:00:00+03:00,in,False,905932,False,2,102,121,19
167180,2019-11-28 00:00:00+03:00,out,False,905930,False,5,727,790,63
167180,2019-11-28 00:00:00+03:00,in,False,905930,False,1,120,125,5
167180,2019-11-28 00:00:00+03:00,out,False,905934,False,1,11,18,7
167180,2019-11-28 00:00:00+03:00,out,False,905932,False,3,314,361,47
167180,2019-11-28 00:00:00+03:00,in,False,-1,True,1,0,0,0
167180,2019-11-28 00:00:00+03:00,out,False,905932,True,1,0,1,1
167180,2019-11-28 00:00:00+03:00,out,False,905930,True,15,0,297,297
167180,2019-11-28 00:00:00+03:00,out,False,905930,False,5,727,790,63
167183,2019-10-09 00:00:00+03:00,out,False,932292,True,1,0,9,9
167183,2019-10-09 00:00:00+03:00,out,False,932246,True,1,0,60,60
167183,2019-10-09 00:00:00+03:00,in,False,932304,False,1,12,37,25
167183,2019-10-09 00:00:00+03:00,in,False,932292,False,1,40,83,43
167183,2019-10-09 00:00:00+03:00,out,False,932304,True,1,0,6,6
167183,2019-10-10 00:00:00+03:00,out,False,932304,False,1,132,140,8
167183,2019-10-11 00:00:00+03:00,out,False,932304,True,3,0,76,76
167183,2019-10-11 00:00:00+03:00,out,False,932304,False,11,668,816,148
167183,2019-10-11 00:00:00+03:00,out,False,932304,False,11,668,816,148
167183,2019-10-14 00:00:00+03:00,out,False,932304,False,2,83,140,57
167183,2019-10-14 00:00:00+03:00,out,False,932304,True,3,0,74,74
167183,2019-10-15 00:00:00+03:00,out,False,932304,True,1,0,43,43
167183,2019-10-15 00:00:00+03:00,out,False,932304,False,2,371,397,26
167183,2019-10-16 00:00:00+03:00,out,False,932304,False,3,311,338,27
167183,2019-10-16 00:00:00+03:00,in,False,-1,True,1,0,33,33
167183,2019-10-16 00:00:00+03:00,out,False,932292,True,2,0,45,45
167183,2019-10-16 00:00:00+03:00,out,False,932292,False,7,611,643,32
167183,2019-10-17 00:00:00+03:00,out,False,932304,True,3,0,79,79
167183,2019-10-17 00:00:00+03:00,out,False,932292,False,6,595,628,33
167183,2019-10-17 00:00:00+03:00,out,False,932304,False,3,633,667,34
167183,2019-10-18 00:00:00+03:00,out,False,932292,True,1,0,42,42
167183,2019-10-18 00:00:00+03:00,out,False,932292,False,8,1066,1157,91
167183,2019-10-18 00:00:00+03:00,out,True,932304,True,1,0,0,0
167183,2019-10-21 00:00:00+03:00,out,False,932292,False,12,1351,1492,141
167183,2019-10-21 00:00:00+03:00,out,False,932304,False,3,494,526,32
167183,2019-10-22 00:00:00+03:00,out,False,932292,True,7,0,274,274
167183,2019-10-22 00:00:00+03:00,out,False,932292,False,5,285,376,91
167183,2019-10-23 00:00:00+03:00,out,False,932304,False,4,732,805,73
167183,2019-10-23 00:00:00+03:00,out,False,932292,False,1,76,87,11
167183,2019-10-23 00:00:00+03:00,out,False,932292,True,4,0,188,188
167183,2019-10-24 00:00:00+03:00,out,False,932292,True,1,0,61,61
167183,2019-10-24 00:00:00+03:00,out,False,932292,False,3,582,619,37
167183,2019-10-28 00:00:00+03:00,in,False,932304,False,1,44,59,15
167183,2019-10-28 00:00:00+03:00,out,False,932292,False,7,217,321,104
167183,2019-10-28 00:00:00+03:00,out,False,932292,True,3,0,72,72
167183,2019-10-28 00:00:00+03:00,out,False,932304,False,1,25,52,27
167183,2019-10-28 00:00:00+03:00,in,False,932292,False,3,40,68,28
167183,2019-10-28 00:00:00+03:00,out,False,932292,False,7,217,321,104
167183,2019-10-28 00:00:00+03:00,out,False,932292,True,3,0,72,72
167183,2019-10-29 00:00:00+03:00,out,False,932304,True,1,0,44,44
167183,2019-10-30 00:00:00+03:00,out,False,932292,False,2,156,174,18
167183,2019-10-30 00:00:00+03:00,out,False,932292,True,4,0,135,135
167183,2019-10-30 00:00:00+03:00,out,False,932292,False,2,156,174,18
167183,2019-10-31 00:00:00+03:00,out,False,932292,False,1,1121,1145,24
167183,2019-10-31 00:00:00+03:00,out,False,932292,True,1,0,4,4
167183,2019-11-01 00:00:00+03:00,out,False,932292,False,3,524,555,31
167183,2019-11-05 00:00:00+03:00,out,False,932292,False,2,72,98,26
167183,2019-11-05 00:00:00+03:00,out,False,932292,True,1,0,45,45
167183,2019-11-05 00:00:00+03:00,out,False,932304,False,1,179,190,11
167183,2019-11-05 00:00:00+03:00,out,False,932304,False,1,179,190,11
167183,2019-11-06 00:00:00+03:00,out,False,932292,False,2,145,165,20
167183,2019-11-07 00:00:00+03:00,out,False,932292,False,4,296,343,47
167183,2019-11-07 00:00:00+03:00,in,False,932292,False,1,47,57,10
167183,2019-11-07 00:00:00+03:00,out,False,932292,True,2,0,61,61
167183,2019-11-08 00:00:00+03:00,out,False,932292,False,1,63,70,7
167183,2019-11-08 00:00:00+03:00,out,False,932292,True,2,0,41,41
167183,2019-11-08 00:00:00+03:00,in,False,932292,False,1,52,59,7
167183,2019-11-11 00:00:00+03:00,out,False,932292,False,4,133,162,29
167185,2019-09-12 00:00:00+03:00,in,False,-1,True,1,0,2,2
167185,2019-09-12 00:00:00+03:00,in,False,-1,True,1,0,2,2
167185,2019-09-16 00:00:00+03:00,in,False,-1,True,8,0,1,1
167185,2019-09-17 00:00:00+03:00,in,False,-1,True,9,0,20,20
167185,2019-09-18 00:00:00+03:00,in,False,-1,True,9,0,0,0
167185,2019-09-20 00:00:00+03:00,in,False,-1,True,3,0,0,0
167185,2019-09-23 00:00:00+03:00,out,False,912296,True,1,0,18,18
167185,2019-09-23 00:00:00+03:00,in,False,912296,False,4,313,343,30
167185,2019-09-23 00:00:00+03:00,in,False,-1,True,3,0,32,32
167185,2019-09-24 00:00:00+03:00,in,False,912296,False,3,94,111,17
167185,2019-09-25 00:00:00+03:00,out,False,912296,False,1,181,193,12
167185,2019-09-25 00:00:00+03:00,out,False,912296,True,2,0,55,55
167185,2019-09-25 00:00:00+03:00,in,False,-1,True,1,0,18,18
167185,2019-09-25 00:00:00+03:00,in,False,912296,False,4,457,482,25
167185,2019-09-26 00:00:00+03:00,out,False,912296,True,6,0,164,164
167185,2019-09-26 00:00:00+03:00,in,False,912296,False,1,200,207,7
167185,2019-09-26 00:00:00+03:00,out,False,912296,False,1,121,129,8
167185,2019-09-26 00:00:00+03:00,out,False,912296,True,6,0,164,164
167185,2019-09-27 00:00:00+03:00,out,False,912296,False,1,1,22,21
167185,2019-09-27 00:00:00+03:00,in,False,912296,False,3,346,370,24
167185,2019-09-27 00:00:00+03:00,out,False,912296,True,1,0,22,22
167185,2019-09-30 00:00:00+03:00,in,False,-1,True,3,0,163,163
167185,2019-10-01 00:00:00+03:00,in,False,912296,False,4,449,478,29
167185,2019-10-01 00:00:00+03:00,out,False,912296,False,2,88,124,36
167185,2019-10-02 00:00:00+03:00,in,False,-1,True,8,0,136,136
167185,2019-10-02 00:00:00+03:00,out,False,912296,True,2,0,26,26
167185,2019-10-02 00:00:00+03:00,out,False,912296,False,1,126,137,11
167185,2019-10-02 00:00:00+03:00,out,False,917680,True,4,0,36,36
167185,2019-10-02 00:00:00+03:00,in,False,912296,False,2,211,226,15
167185,2019-10-02 00:00:00+03:00,out,False,912296,True,2,0,26,26
167185,2019-10-03 00:00:00+03:00,in,False,912296,True,1,0,14,14
167185,2019-10-03 00:00:00+03:00,out,False,912296,False,1,136,146,10
167185,2019-10-03 00:00:00+03:00,in,False,912296,False,1,534,548,14
167185,2019-10-03 00:00:00+03:00,out,False,917680,True,6,0,132,132
167185,2019-10-03 00:00:00+03:00,out,False,917680,False,4,265,326,61
167185,2019-10-03 00:00:00+03:00,in,False,-1,True,1,0,16,16
167185,2019-10-04 00:00:00+03:00,out,False,917682,True,5,0,27,27
167185,2019-10-04 00:00:00+03:00,out,False,917680,False,2,65,84,19
167185,2019-10-04 00:00:00+03:00,in,False,912296,False,3,142,169,27
167185,2019-10-04 00:00:00+03:00,out,False,912296,False,1,60,73,13
167185,2019-10-04 00:00:00+03:00,out,False,917682,False,2,15,37,22
167185,2019-10-04 00:00:00+03:00,out,False,917680,True,3,0,20,20
167185,2019-10-04 00:00:00+03:00,out,False,912296,True,1,0,10,10
167185,2019-10-04 00:00:00+03:00,out,False,912296,False,1,60,73,13
167185,2019-10-07 00:00:00+03:00,in,False,912296,False,4,202,249,47
167185,2019-10-07 00:00:00+03:00,in,False,-1,True,2,0,98,98
167185,2019-10-08 00:00:00+03:00,in,False,912296,False,3,602,645,43
167185,2019-10-10 00:00:00+03:00,out,False,912296,False,7,464,555,91
167185,2019-10-10 00:00:00+03:00,in,False,912296,False,2,235,319,84
167185,2019-10-10 00:00:00+03:00,out,False,912296,True,5,0,161,161
167185,2019-10-10 00:00:00+03:00,out,False,912296,True,5,0,161,161
167185,2019-10-11 00:00:00+03:00,in,False,-1,True,3,0,375,375
167185,2019-10-11 00:00:00+03:00,out,False,912296,False,1,42,49,7
167185,2019-10-11 00:00:00+03:00,in,False,912296,False,2,176,192,16
167185,2019-10-12 00:00:00+03:00,in,False,-1,True,1,0,75,75
167185,2019-10-14 00:00:00+03:00,out,False,912296,False,3,140,192,52
167185,2019-10-14 00:00:00+03:00,out,False,912296,True,9,0,170,170
167185,2019-10-14 00:00:00+03:00,in,False,912296,False,2,91,107,16
167185,2019-10-14 00:00:00+03:00,out,False,912296,False,3,140,192,52
167185,2019-10-15 00:00:00+03:00,in,False,912296,False,3,273,296,23
167185,2019-10-15 00:00:00+03:00,out,False,912296,True,2,0,55,55
167185,2019-10-15 00:00:00+03:00,out,False,912296,False,15,1178,1339,161
167185,2019-10-15 00:00:00+03:00,in,False,-1,True,1,0,9,9
167185,2019-10-16 00:00:00+03:00,in,False,912296,False,2,320,340,20
167185,2019-10-16 00:00:00+03:00,out,False,912296,True,5,0,56,56
167185,2019-10-16 00:00:00+03:00,out,False,912296,False,9,1362,1430,68
167185,2019-10-16 00:00:00+03:00,in,False,-1,True,1,0,44,44
167185,2019-10-17 00:00:00+03:00,in,False,912296,False,1,10,18,8
167185,2019-10-18 00:00:00+03:00,in,False,912296,False,2,109,125,16
167185,2019-10-18 00:00:00+03:00,out,False,912296,False,17,1764,1862,98
167185,2019-10-18 00:00:00+03:00,in,False,-1,True,1,0,5,5
167185,2019-10-18 00:00:00+03:00,out,False,912296,True,3,0,49,49
167185,2019-10-20 00:00:00+03:00,in,False,-1,True,1,0,2,2
167185,2019-10-21 00:00:00+03:00,out,False,912296,True,6,0,115,115
167185,2019-10-21 00:00:00+03:00,in,False,-1,True,1,0,2,2
167185,2019-10-21 00:00:00+03:00,in,False,912296,False,4,326,362,36
167185,2019-10-21 00:00:00+03:00,out,False,912296,False,15,1312,1471,159
167185,2019-10-22 00:00:00+03:00,in,False,912296,False,4,696,736,40
167185,2019-10-22 00:00:00+03:00,out,False,912296,False,16,928,1059,131
167185,2019-10-22 00:00:00+03:00,out,False,912296,True,7,0,91,91
167185,2019-10-23 00:00:00+03:00,in,False,912296,False,4,408,474,66
167185,2019-10-23 00:00:00+03:00,out,False,912296,False,10,563,670,107
167185,2019-10-23 00:00:00+03:00,out,False,912296,True,15,0,160,160
167185,2019-10-24 00:00:00+03:00,in,False,-1,True,2,0,41,41
167185,2019-10-24 00:00:00+03:00,out,False,912296,False,22,1540,1721,181
167185,2019-10-24 00:00:00+03:00,out,False,912296,True,5,0,93,93
167185,2019-10-25 00:00:00+03:00,out,False,912296,False,10,965,1051,86
167185,2019-10-25 00:00:00+03:00,in,False,-1,True,1,0,133,133
167185,2019-10-25 00:00:00+03:00,out,False,912296,True,4,0,27,27
167185,2019-10-25 00:00:00+03:00,in,False,912296,False,5,962,1036,74
167185,2019-10-25 00:00:00+03:00,in,False,-1,True,1,0,133,133
167185,2019-10-27 00:00:00+03:00,in,False,-1,True,1,0,36,36
167185,2019-10-28 00:00:00+03:00,out,False,912296,False,7,1067,1102,35
167185,2019-10-28 00:00:00+03:00,out,False,917680,False,1,22,36,14
167185,2019-10-28 00:00:00+03:00,in,False,-1,True,1,0,3,3
167185,2019-10-28 00:00:00+03:00,out,False,912296,True,6,0,110,110
167185,2019-10-28 00:00:00+03:00,in,False,912296,False,4,326,359,33
167185,2019-10-28 00:00:00+03:00,out,False,917680,True,9,0,5,5
167185,2019-10-29 00:00:00+03:00,in,False,912296,False,8,846,933,87
167185,2019-10-29 00:00:00+03:00,out,False,917680,True,2,0,17,17
167185,2019-10-29 00:00:00+03:00,out,False,912296,False,18,2052,2181,129
167185,2019-10-29 00:00:00+03:00,out,False,912296,True,12,0,157,157
167185,2019-10-29 00:00:00+03:00,out,False,917680,False,1,39,43,4
167185,2019-10-29 00:00:00+03:00,in,False,-1,True,1,0,9,9
167185,2019-10-29 00:00:00+03:00,in,False,917680,False,1,27,201,174
167185,2019-10-30 00:00:00+03:00,out,False,917680,False,3,20,41,21
167185,2019-10-30 00:00:00+03:00,in,False,912296,False,3,537,568,31
167185,2019-10-30 00:00:00+03:00,out,False,912296,False,12,1015,1133,118
167185,2019-10-30 00:00:00+03:00,out,False,912296,True,6,0,103,103
167185,2019-10-30 00:00:00+03:00,in,False,912296,False,3,537,568,31
167185,2019-10-31 00:00:00+03:00,out,False,912296,True,3,0,26,26
167185,2019-10-31 00:00:00+03:00,out,False,917680,True,3,0,52,52
167185,2019-10-31 00:00:00+03:00,in,False,912296,False,5,1187,1290,103
167185,2019-10-31 00:00:00+03:00,out,False,912296,False,9,1553,1633,80
167185,2019-11-01 00:00:00+03:00,out,False,912296,True,2,0,54,54
167185,2019-11-01 00:00:00+03:00,in,False,912296,False,5,843,911,68
167185,2019-11-01 00:00:00+03:00,out,False,912296,False,4,246,278,32
167185,2019-11-03 00:00:00+03:00,in,False,-1,True,1,0,1,1
167185,2019-11-04 00:00:00+03:00,in,False,-1,True,1,0,20,20
167185,2019-11-05 00:00:00+03:00,out,False,912296,False,10,619,723,104
167185,2019-11-05 00:00:00+03:00,out,False,912296,True,3,0,84,84
167185,2019-11-05 00:00:00+03:00,in,False,912296,False,5,278,322,44
167185,2019-11-05 00:00:00+03:00,in,False,-1,True,3,0,127,127
167185,2019-11-05 00:00:00+03:00,in,False,-1,True,3,0,127,127
167185,2019-11-06 00:00:00+03:00,in,False,-1,True,1,0,103,103
167185,2019-11-06 00:00:00+03:00,in,False,912296,False,5,477,519,42
167185,2019-11-06 00:00:00+03:00,out,False,912296,True,4,0,84,84
167185,2019-11-06 00:00:00+03:00,out,False,912296,False,5,364,412,48
167185,2019-11-07 00:00:00+03:00,in,False,912296,False,3,340,379,39
167185,2019-11-07 00:00:00+03:00,out,False,912296,True,2,0,34,34
167185,2019-11-07 00:00:00+03:00,out,False,912296,False,8,822,900,78
167185,2019-11-08 00:00:00+03:00,out,False,912296,True,3,0,72,72
167185,2019-11-08 00:00:00+03:00,out,False,912296,False,7,833,910,77
167185,2019-11-11 00:00:00+03:00,in,False,912296,False,7,538,630,92
167185,2019-11-11 00:00:00+03:00,out,False,912296,True,1,0,22,22
167185,2019-11-11 00:00:00+03:00,out,False,912296,False,8,910,973,63
167185,2019-11-12 00:00:00+03:00,out,False,912296,False,4,456,496,40
167185,2019-11-12 00:00:00+03:00,in,False,-1,True,1,0,95,95
167185,2019-11-12 00:00:00+03:00,in,False,912296,False,4,370,403,33
167185,2019-11-12 00:00:00+03:00,out,False,912296,True,6,0,48,48
167185,2019-11-13 00:00:00+03:00,in,False,912296,True,1,0,13,13
167185,2019-11-13 00:00:00+03:00,out,False,912296,True,3,0,116,116
167185,2019-11-13 00:00:00+03:00,in,False,912296,False,7,604,690,86
167185,2019-11-13 00:00:00+03:00,out,False,912296,False,8,975,1054,79
167185,2019-11-14 00:00:00+03:00,out,False,912296,True,1,0,25,25
167185,2019-11-14 00:00:00+03:00,out,False,912296,False,9,790,867,77
167185,2019-11-14 00:00:00+03:00,in,False,912296,False,4,685,741,56
167185,2019-11-14 00:00:00+03:00,out,False,912296,True,1,0,25,25
167185,2019-11-15 00:00:00+03:00,in,False,912296,False,2,49,66,17
167185,2019-11-15 00:00:00+03:00,in,False,-1,True,1,0,206,206
167185,2019-11-15 00:00:00+03:00,out,False,912296,False,10,623,724,101
167185,2019-11-15 00:00:00+03:00,out,False,912296,True,2,0,20,20
167185,2019-11-15 00:00:00+03:00,out,False,912296,False,10,623,724,101
167185,2019-11-18 00:00:00+03:00,out,False,912296,True,1,0,6,6
167185,2019-11-18 00:00:00+03:00,out,False,917680,True,3,0,61,61
167185,2019-11-18 00:00:00+03:00,out,False,912296,False,5,804,867,63
167185,2019-11-18 00:00:00+03:00,in,False,912296,False,8,1310,1396,86
167185,2019-11-18 00:00:00+03:00,out,False,917680,False,2,123,157,34
167185,2019-11-19 00:00:00+03:00,out,False,912296,True,1,0,18,18
167185,2019-11-19 00:00:00+03:00,in,False,912296,False,5,585,635,50
167185,2019-11-19 00:00:00+03:00,out,False,912296,False,4,840,880,40
167185,2019-11-20 00:00:00+03:00,in,False,-1,True,2,0,155,155
167185,2019-11-20 00:00:00+03:00,out,False,912296,True,5,0,94,94
167185,2019-11-20 00:00:00+03:00,out,False,912296,False,11,2416,2519,103
167185,2019-11-20 00:00:00+03:00,in,False,917680,False,1,194,220,26
167185,2019-11-20 00:00:00+03:00,in,False,912296,False,9,1185,1305,120
167185,2019-11-21 00:00:00+03:00,out,False,912296,False,17,1552,1699,147
167185,2019-11-21 00:00:00+03:00,in,False,912296,True,1,0,9,9
167185,2019-11-21 00:00:00+03:00,in,False,-1,True,3,0,134,134
167185,2019-11-21 00:00:00+03:00,in,False,912296,False,8,1838,1967,129
167185,2019-11-21 00:00:00+03:00,out,False,912296,True,14,0,190,190
167185,2019-11-22 00:00:00+03:00,in,False,912296,False,8,744,833,89
167185,2019-11-22 00:00:00+03:00,out,False,912296,False,11,1289,1412,123
167185,2019-11-22 00:00:00+03:00,in,False,-1,True,2,0,100,100
167185,2019-11-22 00:00:00+03:00,out,False,912296,True,6,0,146,146
167185,2019-11-23 00:00:00+03:00,in,False,-1,True,2,0,429,429
167185,2019-11-25 00:00:00+03:00,in,False,912296,False,1,255,266,11
167185,2019-11-25 00:00:00+03:00,in,False,-1,True,28,0,343,343
167185,2019-11-26 00:00:00+03:00,in,False,912296,False,1,86,98,12
167185,2019-11-26 00:00:00+03:00,in,False,-1,True,1,0,39,39
167185,2019-11-27 00:00:00+03:00,out,False,912296,False,11,996,1084,88
167185,2019-11-27 00:00:00+03:00,in,False,912296,False,3,206,246,40
167185,2019-11-27 00:00:00+03:00,out,False,912296,True,5,0,98,98
167185,2019-11-28 00:00:00+03:00,out,False,912296,True,3,0,40,40
167185,2019-11-28 00:00:00+03:00,out,False,912296,False,9,875,958,83
167185,2019-11-28 00:00:00+03:00,in,False,912296,False,2,364,384,20
167188,2019-09-06 00:00:00+03:00,in,False,-1,True,19,0,235,235
167188,2019-09-07 00:00:00+03:00,in,False,-1,True,1,0,14,14
167188,2019-09-09 00:00:00+03:00,in,False,907618,False,1,39,74,35
167188,2019-09-09 00:00:00+03:00,in,False,-1,True,3,0,21,21
167188,2019-09-10 00:00:00+03:00,in,False,908300,False,1,8,65,57
167188,2019-09-10 00:00:00+03:00,in,True,908180,False,1,6,21,15
167188,2019-09-10 00:00:00+03:00,in,False,-1,True,9,0,391,391
167188,2019-09-10 00:00:00+03:00,in,True,908152,False,1,98,138,40
167188,2019-09-10 00:00:00+03:00,in,True,908300,False,2,21,133,112
167188,2019-09-10 00:00:00+03:00,in,True,908130,False,1,83,112,29
167188,2019-09-10 00:00:00+03:00,in,False,-1,True,2,0,59,59
167188,2019-09-10 00:00:00+03:00,in,True,908300,False,2,21,133,112
167188,2019-09-11 00:00:00+03:00,in,False,-1,True,3,0,23,23
167188,2019-09-11 00:00:00+03:00,in,False,-1,True,2,0,29,29
167188,2019-09-11 00:00:00+03:00,in,False,908152,False,1,52,93,41
167188,2019-09-12 00:00:00+03:00,in,False,909392,False,1,111,134,23
167188,2019-09-12 00:00:00+03:00,in,False,908152,False,2,69,147,78
167188,2019-09-12 00:00:00+03:00,in,False,-1,True,2,0,69,69
167188,2019-09-12 00:00:00+03:00,in,False,908152,False,2,69,147,78
167188,2019-09-15 00:00:00+03:00,in,False,-1,True,1,0,11,11
167188,2019-09-16 00:00:00+03:00,in,False,909392,False,1,203,234,31
167188,2019-09-16 00:00:00+03:00,in,False,-1,True,2,0,55,55
167188,2019-09-17 00:00:00+03:00,in,False,909392,False,1,194,221,27
167188,2019-09-18 00:00:00+03:00,out,True,914338,True,1,0,18,18
167188,2019-09-18 00:00:00+03:00,out,False,914338,True,1,0,0,0
167188,2019-09-18 00:00:00+03:00,out,False,914238,True,1,0,1,1
167188,2019-09-18 00:00:00+03:00,out,True,914238,True,8,0,81,81
167188,2019-09-18 00:00:00+03:00,out,False,914238,False,11,113,143,30
167188,2019-09-18 00:00:00+03:00,out,False,-1,True,1,0,0,0
167188,2019-09-18 00:00:00+03:00,out,False,914338,False,6,103,123,20
167188,2019-09-18 00:00:00+03:00,in,False,-1,True,2,0,31,31
167188,2019-09-19 00:00:00+03:00,out,False,914238,False,12,1098,1164,66
167188,2019-09-19 00:00:00+03:00,out,False,914348,False,3,773,779,6
167188,2019-09-19 00:00:00+03:00,out,False,914348,False,3,773,779,6
167188,2019-09-20 00:00:00+03:00,out,False,914238,False,1,6,8,2
167188,2019-09-20 00:00:00+03:00,out,False,914348,False,1,13,15,2
167188,2019-09-23 00:00:00+03:00,in,False,908152,False,1,3,42,39
167188,2019-09-23 00:00:00+03:00,in,False,909392,False,1,3,33,30
167188,2019-09-23 00:00:00+03:00,in,False,-1,True,2,0,53,53
167188,2019-09-23 00:00:00+03:00,out,False,914238,False,1,9,11,2
167188,2019-09-24 00:00:00+03:00,in,False,908152,False,1,15,56,41
167188,2019-09-24 00:00:00+03:00,out,False,914238,True,1,0,2,2
167188,2019-09-24 00:00:00+03:00,out,False,914238,False,33,2469,2613,144
167188,2019-09-25 00:00:00+03:00,out,False,914238,False,11,438,490,52
167188,2019-09-25 00:00:00+03:00,in,False,908152,False,1,77,117,40
167188,2019-09-25 00:00:00+03:00,out,False,914238,True,2,0,4,4
167188,2019-09-26 00:00:00+03:00,in,False,908130,False,1,117,149,32
167188,2019-09-26 00:00:00+03:00,in,False,-1,True,1,0,54,54
167188,2019-09-29 00:00:00+03:00,in,False,-1,True,2,0,12,12
167188,2019-09-29 00:00:00+03:00,in,False,908162,False,1,8,59,51
167188,2019-09-29 00:00:00+03:00,in,False,908098,False,2,17,62,45
167188,2019-09-30 00:00:00+03:00,out,False,914238,False,1,2,4,2
167188,2019-09-30 00:00:00+03:00,in,False,908130,False,1,24,48,24
167188,2019-09-30 00:00:00+03:00,in,False,909392,False,1,2,21,19
167188,2019-09-30 00:00:00+03:00,in,False,908098,False,3,167,249,82
167188,2019-09-30 00:00:00+03:00,in,True,923646,False,1,14,33,19
167188,2019-09-30 00:00:00+03:00,in,False,-1,True,2,0,90,90
167188,2019-09-30 00:00:00+03:00,in,False,908162,False,2,273,381,108
167188,2019-09-30 00:00:00+03:00,in,True,923646,False,1,14,33,19
167188,2019-09-30 00:00:00+03:00,in,False,908098,False,3,167,249,82
167188,2019-10-01 00:00:00+03:00,in,False,-1,True,1,0,27,27
167188,2019-10-02 00:00:00+03:00,in,False,-1,True,1,0,43,43
167188,2019-10-02 00:00:00+03:00,out,False,914238,False,8,317,354,37
167188,2019-10-02 00:00:00+03:00,in,False,908098,False,1,47,78,31
167188,2019-10-03 00:00:00+03:00,in,False,-1,True,1,0,9,9
167188,2019-10-04 00:00:00+03:00,out,False,914338,False,1,61,62,1
167188,2019-10-04 00:00:00+03:00,in,False,-1,True,2,0,4,4
167188,2019-10-04 00:00:00+03:00,out,True,914338,True,4,0,107,107
167188,2019-10-04 00:00:00+03:00,out,False,914338,True,1,0,2,2
167188,2019-10-05 00:00:00+03:00,in,False,-1,True,2,0,4,4
167188,2019-10-07 00:00:00+03:00,in,False,908152,False,1,64,102,38
167188,2019-10-08 00:00:00+03:00,out,False,914338,False,10,464,513,49
167188,2019-10-08 00:00:00+03:00,out,True,914338,True,1,0,9,9
167188,2019-10-08 00:00:00+03:00,in,False,-1,True,2,0,55,55
167188,2019-10-08 00:00:00+03:00,out,False,914338,True,6,0,9,9
167188,2019-10-09 00:00:00+03:00,out,False,914238,False,35,956,1119,163
167188,2019-10-09 00:00:00+03:00,out,False,914338,False,15,523,588,65
167188,2019-10-10 00:00:00+03:00,out,False,914238,False,54,1622,1866,244
167188,2019-10-10 00:00:00+03:00,in,False,908152,False,1,119,155,36
167188,2019-10-11 00:00:00+03:00,out,False,914238,True,1,0,2,2
167188,2019-10-11 00:00:00+03:00,out,False,914238,False,12,470,519,49
167188,2019-10-11 00:00:00+03:00,in,False,908152,False,4,146,315,169
167188,2019-10-11 00:00:00+03:00,out,False,914238,False,12,470,519,49
167188,2019-10-12 00:00:00+03:00,in,False,-1,True,1,0,13,13
167188,2019-10-14 00:00:00+03:00,out,False,914238,True,4,0,20,20
167188,2019-10-14 00:00:00+03:00,out,False,914238,False,10,274,318,44
167188,2019-10-14 00:00:00+03:00,out,False,914238,False,10,274,318,44
167188,2019-10-15 00:00:00+03:00,in,False,-1,True,1,0,14,14
167188,2019-10-15 00:00:00+03:00,out,False,914238,False,3,83,103,20
167188,2019-10-16 00:00:00+03:00,out,False,914348,True,1,0,25,25
167188,2019-10-16 00:00:00+03:00,out,False,914238,True,2,0,23,23
167188,2019-10-16 00:00:00+03:00,out,False,914238,False,17,615,697,82
167188,2019-10-17 00:00:00+03:00,out,False,914238,False,11,286,336,50
167188,2019-10-17 00:00:00+03:00,out,False,914338,True,1,0,60,60
167188,2019-10-18 00:00:00+03:00,out,False,914238,False,4,121,140,19
167188,2019-10-18 00:00:00+03:00,out,False,914238,True,2,0,8,8
167188,2019-10-22 00:00:00+03:00,out,False,914348,False,1,567,570,3
167188,2019-10-23 00:00:00+03:00,out,False,914238,False,6,109,143,34
167188,2019-10-23 00:00:00+03:00,out,False,914238,False,6,109,143,34
167188,2019-11-06 00:00:00+03:00,out,True,914338,True,1,0,7,7
167188,2019-11-06 00:00:00+03:00,out,False,914238,False,9,170,214,44
167188,2019-11-06 00:00:00+03:00,out,False,914238,False,9,170,214,44
167188,2019-11-07 00:00:00+03:00,in,False,-1,True,2,0,28,28
167188,2019-11-08 00:00:00+03:00,out,True,957022,False,2,32,51,19
167188,2019-11-08 00:00:00+03:00,in,False,-1,True,8,0,59,59
167188,2019-11-08 00:00:00+03:00,out,True,957022,True,1,0,17,17
167188,2019-11-08 00:00:00+03:00,out,False,957022,True,1,0,15,15
167188,2019-11-14 00:00:00+03:00,in,False,-1,True,1,0,13,13
167188,2019-11-14 00:00:00+03:00,in,True,962168,False,1,25,37,12
167188,2019-11-15 00:00:00+03:00,out,False,914238,False,2,60,72,12
167188,2019-11-15 00:00:00+03:00,out,False,914238,True,1,0,2,2
167188,2019-11-17 00:00:00+03:00,in,False,-1,True,1,0,23,23
167188,2019-11-17 00:00:00+03:00,in,False,-1,True,1,0,23,23
167188,2019-11-18 00:00:00+03:00,out,True,964716,True,1,0,15,15
167188,2019-11-18 00:00:00+03:00,out,False,957022,True,1,0,15,15
167188,2019-11-19 00:00:00+03:00,out,False,964716,False,26,2382,2478,96
167188,2019-11-19 00:00:00+03:00,out,True,957022,True,4,0,87,87
167188,2019-11-19 00:00:00+03:00,out,False,957022,False,1,65,80,15
167188,2019-11-19 00:00:00+03:00,out,False,957022,True,3,0,3,3
167188,2019-11-19 00:00:00+03:00,out,True,957022,False,5,463,514,51
167188,2019-11-19 00:00:00+03:00,in,False,-1,True,3,0,1,1
167188,2019-11-19 00:00:00+03:00,out,False,914238,True,1,0,4,4
167188,2019-11-19 00:00:00+03:00,out,True,964716,False,3,511,547,36
167188,2019-11-19 00:00:00+03:00,out,True,964716,True,1,0,42,42
167188,2019-11-19 00:00:00+03:00,out,False,914238,False,46,1070,1344,274
167188,2019-11-19 00:00:00+03:00,out,False,964716,True,6,0,240,240
167188,2019-11-19 00:00:00+03:00,out,False,964716,False,26,2382,2478,96
167188,2019-11-19 00:00:00+03:00,out,True,964716,True,1,0,42,42
167188,2019-11-19 00:00:00+03:00,out,False,957022,True,3,0,3,3
167188,2019-11-20 00:00:00+03:00,out,False,964716,True,9,0,145,145
167188,2019-11-20 00:00:00+03:00,out,False,964716,False,49,5017,5304,287
167188,2019-11-21 00:00:00+03:00,out,False,964716,False,50,4481,4706,225
167188,2019-11-21 00:00:00+03:00,out,False,964716,True,3,0,67,67
167188,2019-11-21 00:00:00+03:00,out,False,964716,True,3,0,67,67
167188,2019-11-22 00:00:00+03:00,out,False,914238,False,5,110,138,28
167188,2019-11-22 00:00:00+03:00,in,False,962168,False,1,153,173,20
167188,2019-11-23 00:00:00+03:00,out,False,914238,False,3,73,90,17
167188,2019-11-25 00:00:00+03:00,out,False,964716,True,7,0,175,175
167188,2019-11-25 00:00:00+03:00,out,False,964716,False,50,4401,4674,273
167188,2019-11-25 00:00:00+03:00,out,False,914238,False,2,32,45,13
167188,2019-11-25 00:00:00+03:00,out,False,914238,False,2,32,45,13
167188,2019-11-26 00:00:00+03:00,out,False,964716,True,2,0,4,4
167188,2019-11-26 00:00:00+03:00,out,False,914238,False,15,329,417,88
167188,2019-11-26 00:00:00+03:00,out,False,964716,False,12,884,989,105
167188,2019-11-26 00:00:00+03:00,in,False,962168,False,1,78,102,24
167188,2019-11-27 00:00:00+03:00,in,False,962168,False,1,27,40,13
167188,2019-11-27 00:00:00+03:00,out,False,964716,True,4,0,88,88
167188,2019-11-27 00:00:00+03:00,out,False,964716,False,30,3888,4009,121
167188,2019-11-28 00:00:00+03:00,out,False,964716,True,2,0,15,15
167188,2019-11-28 00:00:00+03:00,out,False,964716,False,41,3616,3766,150
167189,2019-09-06 00:00:00+03:00,out,False,906070,True,1,0,5,5
167189,2019-09-06 00:00:00+03:00,in,False,-1,True,3,0,6,6
167189,2019-09-09 00:00:00+03:00,out,False,906070,True,1,0,2,2
167189,2019-09-09 00:00:00+03:00,in,False,-1,True,2,0,102,102
167189,2019-09-09 00:00:00+03:00,out,False,906070,True,1,0,2,2
167189,2019-09-10 00:00:00+03:00,in,False,906070,False,1,16,25,9
167189,2019-09-12 00:00:00+03:00,in,False,-1,True,2,0,1,1
167189,2019-09-16 00:00:00+03:00,in,False,906070,False,1,7,16,9
167189,2019-09-17 00:00:00+03:00,in,False,-1,True,2,0,10,10
167189,2019-09-19 00:00:00+03:00,out,False,906070,False,1,8,11,3
167189,2019-09-20 00:00:00+03:00,out,False,906070,False,1,46,59,13
167189,2019-09-20 00:00:00+03:00,in,False,-1,True,1,0,2,2
167189,2019-09-20 00:00:00+03:00,in,False,906070,False,1,541,549,8
167189,2019-09-20 00:00:00+03:00,out,False,906070,True,10,0,133,133
167189,2019-09-20 00:00:00+03:00,out,False,906070,True,10,0,133,133
167189,2019-09-23 00:00:00+03:00,out,False,906070,True,1,0,2,2
167189,2019-09-23 00:00:00+03:00,in,False,906070,False,1,102,112,10
167189,2019-09-23 00:00:00+03:00,in,False,-1,True,2,0,5,5
167189,2019-09-23 00:00:00+03:00,out,False,906070,False,2,77,113,36
167189,2019-09-24 00:00:00+03:00,out,False,906070,False,1,191,194,3
167189,2019-09-25 00:00:00+03:00,in,False,906070,False,2,167,185,18
167189,2019-09-27 00:00:00+03:00,out,False,906070,False,2,12,22,10
167189,2019-09-27 00:00:00+03:00,in,False,-1,True,1,0,1,1
167189,2019-09-29 00:00:00+03:00,in,False,-1,True,4,0,67,67
167189,2019-09-30 00:00:00+03:00,in,False,906070,False,35,6501,7823,1322
167189,2019-09-30 00:00:00+03:00,in,False,-1,True,32,0,1268,1268
167189,2019-09-30 00:00:00+03:00,out,False,906070,False,11,1444,1601,157
167189,2019-09-30 00:00:00+03:00,out,False,906070,True,4,0,25,25
167189,2019-10-01 00:00:00+03:00,in,False,906070,False,64,9336,13061,3725
167189,2019-10-01 00:00:00+03:00,out,False,906070,True,1,0,2,2
167189,2019-10-01 00:00:00+03:00,in,False,-1,True,115,0,5828,5828
167189,2019-10-02 00:00:00+03:00,out,False,906070,True,2,0,33,33
167189,2019-10-02 00:00:00+03:00,in,False,906070,False,54,6534,10029,3495
167189,2019-10-02 00:00:00+03:00,out,False,906070,False,3,234,260,26
167189,2019-10-02 00:00:00+03:00,in,False,906070,True,1,0,14,14
167189,2019-10-02 00:00:00+03:00,in,False,-1,True,71,0,3387,3387
167189,2019-10-02 00:00:00+03:00,out,False,906070,True,2,0,33,33
167189,2019-10-03 00:00:00+03:00,out,False,906070,False,1,725,727,2
167189,2019-10-03 00:00:00+03:00,in,False,906070,True,1,1,95,94
167189,2019-10-03 00:00:00+03:00,in,False,906070,False,49,8371,11571,3200
167189,2019-10-03 00:00:00+03:00,in,False,-1,True,208,0,9272,9272
167189,2019-10-03 00:00:00+03:00,in,False,906076,False,6,747,838,91
167189,2019-10-04 00:00:00+03:00,in,False,906076,False,18,1944,3076,1132
167189,2019-10-04 00:00:00+03:00,out,False,906076,True,1,0,7,7
167189,2019-10-04 00:00:00+03:00,out,False,906070,False,3,1251,1263,12
167189,2019-10-04 00:00:00+03:00,in,False,-1,True,106,0,6410,6410
167189,2019-10-04 00:00:00+03:00,in,False,906070,False,9,1765,2286,521
167189,2019-10-04 00:00:00+03:00,out,False,906070,True,8,0,28,28
167189,2019-10-05 00:00:00+03:00,out,False,906070,False,5,587,660,73
167189,2019-10-05 00:00:00+03:00,in,False,-1,True,172,0,2406,2406
167189,2019-10-05 00:00:00+03:00,in,False,906070,False,54,8013,8452,439
167189,2019-10-05 00:00:00+03:00,out,False,906070,True,6,0,55,55
167189,2019-10-05 00:00:00+03:00,in,False,-1,True,172,0,2406,2406
167189,2019-10-06 00:00:00+03:00,in,False,-1,True,55,0,1055,1055
167189,2019-10-06 00:00:00+03:00,out,False,906070,True,5,0,83,83
167189,2019-10-06 00:00:00+03:00,in,False,906070,False,37,5734,6040,306
167189,2019-10-06 00:00:00+03:00,out,False,906070,False,1,0,1,1
167189,2019-10-06 00:00:00+03:00,out,False,906070,True,5,0,83,83
167189,2019-10-06 00:00:00+03:00,in,False,906070,False,37,5734,6040,306
167189,2019-10-07 00:00:00+03:00,in,False,-1,True,341,0,3553,3553
167189,2019-10-07 00:00:00+03:00,in,False,906070,False,14,1339,1516,177
167189,2019-10-07 00:00:00+03:00,out,False,906070,False,1,222,228,6
167189,2019-10-07 00:00:00+03:00,in,False,-1,True,341,0,3553,3553
167189,2019-10-08 00:00:00+03:00,in,False,-1,True,174,0,822,822
167189,2019-10-09 00:00:00+03:00,in,False,-1,True,96,0,318,318
167189,2019-10-10 00:00:00+03:00,in,False,-1,True,56,0,132,132
167189,2019-10-11 00:00:00+03:00,in,False,-1,True,33,0,67,67
167189,2019-10-11 00:00:00+03:00,in,False,-1,True,33,0,67,67
167189,2019-10-12 00:00:00+03:00,in,False,-1,True,21,0,43,43
167189,2019-10-14 00:00:00+03:00,in,False,-1,True,11,0,22,22
167189,2019-10-15 00:00:00+03:00,in,False,-1,True,11,0,23,23
167189,2019-10-15 00:00:00+03:00,in,False,-1,True,11,0,23,23
167189,2019-10-16 00:00:00+03:00,in,False,-1,True,7,0,15,15
167189,2019-10-17 00:00:00+03:00,in,False,-1,True,3,0,6,6
167189,2019-10-18 00:00:00+03:00,in,False,-1,True,4,0,8,8
167189,2019-10-20 00:00:00+03:00,in,False,-1,True,1,0,2,2
167189,2019-10-22 00:00:00+03:00,in,False,-1,True,1,0,2,2
167189,2019-10-23 00:00:00+03:00,in,False,-1,True,1,0,2,2
167189,2019-10-24 00:00:00+03:00,in,False,-1,True,1,0,2,2
167189,2019-10-25 00:00:00+03:00,in,False,-1,True,1,0,2,2
167189,2019-10-27 00:00:00+03:00,in,False,-1,True,2,0,4,4
167189,2019-10-28 00:00:00+03:00,in,False,-1,True,6,0,12,12
167189,2019-10-30 00:00:00+03:00,in,False,-1,True,2,0,5,5
167189,2019-10-31 00:00:00+03:00,in,False,-1,True,1,0,2,2
167199,2019-09-18 00:00:00+03:00,in,False,911310,False,1,9,41,32
167199,2019-09-20 00:00:00+03:00,in,False,911310,False,5,237,282,45
167199,2019-09-21 00:00:00+03:00,in,False,-1,True,1,0,3,3
167199,2019-09-21 00:00:00+03:00,in,False,911310,False,1,55,64,9
167199,2019-09-21 00:00:00+03:00,in,False,911310,False,1,55,64,9
167199,2019-09-22 00:00:00+03:00,in,False,911310,False,1,34,36,2
167199,2019-09-23 00:00:00+03:00,in,False,-1,True,12,0,0,0
167199,2019-09-23 00:00:00+03:00,in,False,-1,True,12,0,0,0
167199,2019-09-24 00:00:00+03:00,in,False,-1,True,37,0,2,2
167199,2019-09-24 00:00:00+03:00,in,False,911310,False,5,560,596,36
167199,2019-09-25 00:00:00+03:00,in,False,911310,False,13,1043,1258,215
167199,2019-09-25 00:00:00+03:00,in,False,-1,True,1,0,7,7
167199,2019-09-26 00:00:00+03:00,in,False,911310,False,8,786,842,56
167199,2019-09-27 00:00:00+03:00,in,False,911310,False,2,281,295,14
167199,2019-09-27 00:00:00+03:00,in,False,-1,True,19,0,0,0
167199,2019-09-27 00:00:00+03:00,in,False,-1,True,19,0,0,0
167199,2019-09-28 00:00:00+03:00,in,False,-1,True,2,0,0,0
167199,2019-09-28 00:00:00+03:00,in,False,911310,False,1,150,155,5
167199,2019-09-28 00:00:00+03:00,in,False,911310,False,1,150,155,5
167199,2019-09-28 00:00:00+03:00,in,False,-1,True,2,0,0,0
167199,2019-09-29 00:00:00+03:00,in,False,-1,True,2,0,0,0
167199,2019-09-30 00:00:00+03:00,out,False,911310,True,3,0,74,74
167199,2019-09-30 00:00:00+03:00,in,False,-1,True,9,0,6,6
167199,2019-09-30 00:00:00+03:00,in,False,911310,False,3,512,524,12
167199,2019-09-30 00:00:00+03:00,in,False,-1,True,9,0,6,6
167199,2019-10-01 00:00:00+03:00,in,False,-1,True,4,0,1,1
167199,2019-10-01 00:00:00+03:00,in,False,911310,False,1,69,76,7
167199,2019-10-02 00:00:00+03:00,in,False,911310,False,7,611,674,63
167199,2019-10-02 00:00:00+03:00,out,False,911310,False,1,15,29,14
167199,2019-10-02 00:00:00+03:00,in,False,-1,True,8,0,0,0
167199,2019-10-03 00:00:00+03:00,in,False,-1,True,14,0,0,0
167199,2019-10-04 00:00:00+03:00,in,False,-1,True,20,0,0,0
167199,2019-10-05 00:00:00+03:00,in,False,-1,True,6,0,0,0
167199,2019-10-05 00:00:00+03:00,in,False,911310,False,4,252,294,42
167199,2019-10-06 00:00:00+03:00,in,False,911310,False,1,79,95,16
167199,2019-10-07 00:00:00+03:00,in,False,-1,True,43,0,9,9
167199,2019-10-08 00:00:00+03:00,in,False,911310,False,2,437,505,68
167199,2019-10-08 00:00:00+03:00,in,False,-1,True,27,0,7,7
167199,2019-10-09 00:00:00+03:00,in,False,-1,True,44,0,2,2
167199,2019-10-10 00:00:00+03:00,out,False,911310,False,2,54,102,48
167199,2019-10-10 00:00:00+03:00,in,False,-1,True,25,0,1,1
167199,2019-10-10 00:00:00+03:00,in,False,911310,False,4,531,565,34
167199,2019-10-11 00:00:00+03:00,in,False,-1,True,2,0,107,107
167199,2019-10-11 00:00:00+03:00,in,False,911310,False,8,413,668,255
167199,2019-10-11 00:00:00+03:00,out,False,911310,False,2,90,126,36
167199,2019-10-12 00:00:00+03:00,in,False,-1,True,3,0,0,0
167199,2019-10-12 00:00:00+03:00,in,False,-1,True,3,0,0,0
167199,2019-10-13 00:00:00+03:00,in,False,-1,True,1,0,0,0
167199,2019-10-13 00:00:00+03:00,in,False,911310,False,2,149,192,43
167199,2019-10-14 00:00:00+03:00,out,False,911310,False,4,231,291,60
167199,2019-10-14 00:00:00+03:00,in,False,-1,True,27,0,93,93
167199,2019-10-14 00:00:00+03:00,out,True,911310,True,1,0,3,3
167199,2019-10-14 00:00:00+03:00,in,False,911310,False,2,155,176,21
167199,2019-10-14 00:00:00+03:00,out,False,911310,True,3,0,85,85
167199,2019-10-14 00:00:00+03:00,out,False,911310,False,4,231,291,60
167199,2019-10-15 00:00:00+03:00,in,False,-1,True,4,0,179,179
167199,2019-10-15 00:00:00+03:00,out,False,911310,False,1,1,27,26
167199,2019-10-15 00:00:00+03:00,in,False,911310,False,10,798,874,76
167199,2019-10-16 00:00:00+03:00,out,False,911310,True,1,0,18,18
167199,2019-10-16 00:00:00+03:00,in,False,-1,True,30,0,78,78
167199,2019-10-16 00:00:00+03:00,in,False,911310,False,5,550,577,27
167199,2019-10-16 00:00:00+03:00,out,False,911310,True,1,0,18,18
167199,2019-10-17 00:00:00+03:00,in,False,-1,True,3,0,78,78
167199,2019-10-17 00:00:00+03:00,in,False,911310,False,12,905,998,93
167199,2019-10-18 00:00:00+03:00,in,False,911310,False,8,608,811,203
167199,2019-10-18 00:00:00+03:00,out,False,911310,False,3,280,325,45
167199,2019-10-18 00:00:00+03:00,in,False,-1,True,4,0,130,130
167199,2019-10-18 00:00:00+03:00,in,False,-1,True,4,0,130,130
167199,2019-10-19 00:00:00+03:00,in,False,911310,False,5,231,313,82
167199,2019-10-20 00:00:00+03:00,in,False,911310,False,5,412,439,27
167199,2019-10-21 00:00:00+03:00,in,False,911310,False,8,846,912,66
167199,2019-10-21 00:00:00+03:00,in,False,-1,True,37,0,12,12
167199,2019-10-22 00:00:00+03:00,in,False,911310,False,19,1353,1547,194
167199,2019-10-22 00:00:00+03:00,out,False,911310,True,1,0,3,3
167199,2019-10-22 00:00:00+03:00,out,False,911310,False,6,452,509,57
167199,2019-10-22 00:00:00+03:00,in,False,-1,True,34,0,351,351
167199,2019-10-23 00:00:00+03:00,in,False,911310,False,8,759,871,112
167199,2019-10-23 00:00:00+03:00,in,False,-1,True,1,0,99,99
167199,2019-10-23 00:00:00+03:00,out,False,911310,False,3,208,233,25
167199,2019-10-24 00:00:00+03:00,in,False,-1,True,49,0,4,4
167199,2019-10-25 00:00:00+03:00,in,False,911310,False,7,956,1062,106
167199,2019-10-25 00:00:00+03:00,in,False,-1,True,6,0,100,100
167199,2019-10-26 00:00:00+03:00,in,False,911310,False,4,254,282,28
167199,2019-10-27 00:00:00+03:00,out,False,911310,True,1,0,9,9
167199,2019-10-27 00:00:00+03:00,in,False,-1,True,7,0,0,0
167199,2019-10-27 00:00:00+03:00,out,False,911310,False,4,196,282,86
167199,2019-10-27 00:00:00+03:00,out,True,911310,True,1,0,0,0
167199,2019-10-28 00:00:00+03:00,out,False,911310,False,6,229,307,78
167199,2019-10-28 00:00:00+03:00,in,False,911310,True,2,0,163,163
167199,2019-10-28 00:00:00+03:00,in,False,-1,True,24,0,546,546
167199,2019-10-28 00:00:00+03:00,in,False,911310,False,96,5216,6411,1195
167199,2019-10-28 00:00:00+03:00,out,False,911310,True,2,0,68,68
167199,2019-10-29 00:00:00+03:00,out,False,911310,True,1,0,29,29
167199,2019-10-29 00:00:00+03:00,in,False,911310,False,14,737,828,91
167199,2019-10-29 00:00:00+03:00,in,False,-1,True,1,0,11,11
167199,2019-10-30 00:00:00+03:00,in,False,-1,True,1,0,160,160
167199,2019-10-30 00:00:00+03:00,out,False,911310,False,4,43,83,40
167199,2019-10-30 00:00:00+03:00,in,False,911310,False,12,827,993,166
167199,2019-10-31 00:00:00+03:00,in,False,-1,True,5,0,133,133
167199,2019-10-31 00:00:00+03:00,in,False,911310,False,21,1439,1691,252
167199,2019-10-31 00:00:00+03:00,out,False,911310,False,11,584,684,100
167199,2019-10-31 00:00:00+03:00,out,False,911310,True,3,0,63,63
167199,2019-11-01 00:00:00+03:00,in,False,911310,False,2,188,198,10
167199,2019-11-01 00:00:00+03:00,in,False,-1,True,13,0,0,0
167199,2019-11-02 00:00:00+03:00,in,False,-1,True,9,0,0,0
167199,2019-11-02 00:00:00+03:00,in,False,911310,False,6,268,371,103
167199,2019-11-02 00:00:00+03:00,in,False,911310,False,6,268,371,103
167199,2019-11-03 00:00:00+03:00,in,False,-1,True,2,0,32,32
167199,2019-11-03 00:00:00+03:00,out,False,911310,False,3,150,153,3
167199,2019-11-03 00:00:00+03:00,in,False,911310,True,1,0,120,120
167199,2019-11-03 00:00:00+03:00,in,False,911310,False,5,399,541,142
167199,2019-11-03 00:00:00+03:00,out,False,911310,True,1,0,62,62
167199,2019-11-03 00:00:00+03:00,out,False,911310,True,1,0,62,62
167199,2019-11-04 00:00:00+03:00,in,False,911310,False,2,194,204,10
167199,2019-11-05 00:00:00+03:00,in,False,-1,True,1,0,20,20
167199,2019-11-05 00:00:00+03:00,out,False,911310,False,1,35,47,12
167199,2019-11-05 00:00:00+03:00,in,False,911310,False,13,1270,1633,363
167199,2019-11-05 00:00:00+03:00,out,False,911310,True,1,0,61,61
167199,2019-11-06 00:00:00+03:00,in,False,-1,True,5,0,294,294
167199,2019-11-06 00:00:00+03:00,in,False,911310,False,11,741,859,118
167199,2019-11-07 00:00:00+03:00,in,False,911310,False,6,436,602,166
167199,2019-11-07 00:00:00+03:00,out,True,911310,True,1,0,0,0
167199,2019-11-07 00:00:00+03:00,in,False,-1,True,11,0,0,0
167199,2019-11-07 00:00:00+03:00,out,False,911310,True,1,0,60,60
167199,2019-11-07 00:00:00+03:00,out,False,911310,False,3,96,195,99
167199,2019-11-07 00:00:00+03:00,out,False,911310,False,3,96,195,99
167199,2019-11-08 00:00:00+03:00,in,False,911310,False,2,206,216,10
167199,2019-11-08 00:00:00+03:00,in,False,911310,False,2,206,216,10
167199,2019-11-09 00:00:00+03:00,in,False,911310,False,1,45,54,9
167199,2019-11-10 00:00:00+03:00,in,False,911310,False,2,130,142,12
167199,2019-11-11 00:00:00+03:00,in,False,911310,False,9,434,593,159
167199,2019-11-11 00:00:00+03:00,out,True,911310,True,1,0,0,0
167199,2019-11-11 00:00:00+03:00,out,False,911310,False,3,83,122,39
167199,2019-11-11 00:00:00+03:00,in,False,-1,True,7,0,172,172
167199,2019-11-11 00:00:00+03:00,out,False,911310,True,11,0,189,189
167199,2019-11-11 00:00:00+03:00,out,False,-1,True,1,0,0,0
167199,2019-11-11 00:00:00+03:00,out,False,911310,False,3,83,122,39
167199,2019-11-12 00:00:00+03:00,in,False,-1,True,1,0,17,17
167199,2019-11-12 00:00:00+03:00,out,False,911310,True,1,0,14,14
167199,2019-11-12 00:00:00+03:00,in,False,911310,False,6,324,355,31
167199,2019-11-12 00:00:00+03:00,in,False,911310,False,6,324,355,31
167199,2019-11-13 00:00:00+03:00,in,False,911310,False,1,91,95,4
167199,2019-11-13 00:00:00+03:00,in,False,-1,True,2,0,0,0
167199,2019-11-14 00:00:00+03:00,in,False,-1,True,4,0,273,273
167199,2019-11-14 00:00:00+03:00,in,False,911310,False,4,273,363,90
167199,2019-11-15 00:00:00+03:00,out,False,911310,True,3,0,75,75
167199,2019-11-15 00:00:00+03:00,out,False,911310,False,1,123,137,14
167199,2019-11-15 00:00:00+03:00,in,False,911310,False,6,498,591,93
167199,2019-11-15 00:00:00+03:00,in,False,-1,True,2,0,65,65
167199,2019-11-16 00:00:00+03:00,in,False,-1,True,15,0,1,1
167199,2019-11-16 00:00:00+03:00,in,False,911310,False,1,70,78,8
167199,2019-11-17 00:00:00+03:00,in,False,-1,True,1,0,0,0
167199,2019-11-17 00:00:00+03:00,in,False,911310,False,1,18,24,6
167199,2019-11-17 00:00:00+03:00,in,False,911310,False,1,18,24,6
167199,2019-11-18 00:00:00+03:00,in,False,911310,False,6,347,474,127
167199,2019-11-19 00:00:00+03:00,in,False,-1,True,3,0,98,98
167199,2019-11-19 00:00:00+03:00,in,False,911310,False,9,441,508,67
167200,2019-09-06 00:00:00+03:00,in,False,-1,True,1,0,2,2
167200,2019-09-12 00:00:00+03:00,in,False,905862,False,4,77,140,63
167200,2019-09-12 00:00:00+03:00,in,False,-1,True,2,0,38,38
167200,2019-09-16 00:00:00+03:00,in,False,905862,False,1,183,189,6
167200,2019-09-17 00:00:00+03:00,in,False,905862,False,4,3455,3520,65
167200,2019-09-17 00:00:00+03:00,in,False,-1,True,1,0,10,10
167200,2019-09-18 00:00:00+03:00,in,False,905862,False,1,133,143,10
167200,2019-09-18 00:00:00+03:00,in,False,905862,False,1,133,143,10
167200,2019-09-19 00:00:00+03:00,in,False,905862,False,1,128,135,7
167200,2019-10-04 00:00:00+03:00,in,False,905862,True,13,0,14,14
167200,2019-10-04 00:00:00+03:00,in,False,905862,False,13,171,385,214
167200,2019-10-04 00:00:00+03:00,in,False,-1,True,7,0,142,142
167200,2019-10-07 00:00:00+03:00,in,False,905862,False,2,51,85,34
167200,2019-10-08 00:00:00+03:00,in,False,905862,False,3,60,105,45
167200,2019-10-08 00:00:00+03:00,in,False,-1,True,1,0,8,8
167200,2019-10-08 00:00:00+03:00,in,False,905862,True,1,0,1,1
167200,2019-10-08 00:00:00+03:00,in,False,-1,True,1,0,8,8
167200,2019-10-09 00:00:00+03:00,in,False,905862,False,3,83,143,60
167200,2019-10-10 00:00:00+03:00,in,False,905862,False,12,115,243,128
167200,2019-10-11 00:00:00+03:00,in,False,905862,False,5,123,212,89
167200,2019-10-14 00:00:00+03:00,in,False,905862,False,1,142,154,12
167200,2019-10-15 00:00:00+03:00,in,False,905862,False,1,9,17,8
167200,2019-10-15 00:00:00+03:00,in,False,905862,True,1,0,1,1
167200,2019-10-16 00:00:00+03:00,in,False,-1,True,1,0,12,12
167200,2019-10-16 00:00:00+03:00,in,False,905862,False,2,43,59,16
167200,2019-10-16 00:00:00+03:00,in,False,905862,False,2,43,59,16
167200,2019-10-17 00:00:00+03:00,in,False,905862,False,3,24,70,46
167200,2019-10-17 00:00:00+03:00,in,False,-1,True,4,0,48,48
167200,2019-10-18 00:00:00+03:00,in,False,-1,True,1,0,12,12
167200,2019-10-18 00:00:00+03:00,in,False,905862,False,1,8,22,14
167200,2019-10-23 00:00:00+03:00,in,False,905862,False,1,161,179,18
167200,2019-10-24 00:00:00+03:00,in,False,905862,False,2,51,65,14
167200,2019-10-24 00:00:00+03:00,in,False,905862,False,2,51,65,14
167200,2019-10-25 00:00:00+03:00,in,False,905862,False,3,507,535,28
167200,2019-10-25 00:00:00+03:00,in,False,905862,False,3,507,535,28
167200,2019-10-28 00:00:00+03:00,in,False,-1,True,1,0,20,20
167200,2019-10-29 00:00:00+03:00,in,False,905862,False,2,104,136,32
167200,2019-10-30 00:00:00+03:00,in,False,905862,False,1,9,10,1
167200,2019-10-31 00:00:00+03:00,in,False,905862,False,1,9,17,8
167200,2019-11-01 00:00:00+03:00,in,False,-1,True,1,0,0,0
167200,2019-11-02 00:00:00+03:00,in,False,-1,True,2,0,0,0
167200,2019-11-03 00:00:00+03:00,in,False,-1,True,14,0,1,1
167200,2019-11-05 00:00:00+03:00,in,False,-1,True,14,0,9,9
167200,2019-11-06 00:00:00+03:00,in,False,905862,False,3,495,527,32
167200,2019-11-07 00:00:00+03:00,in,False,905862,False,1,342,365,23
167200,2019-11-11 00:00:00+03:00,in,False,-1,True,1,0,19,19
167200,2019-11-11 00:00:00+03:00,in,False,905862,False,1,42,51,9
167200,2019-11-12 00:00:00+03:00,in,False,905862,False,2,273,310,37
167200,2019-11-12 00:00:00+03:00,out,False,905862,True,1,0,0,0
167200,2019-11-12 00:00:00+03:00,in,False,905862,False,2,273,310,37
167200,2019-11-13 00:00:00+03:00,in,False,905862,False,1,222,232,10
167200,2019-11-14 00:00:00+03:00,in,False,905862,False,2,269,299,30
167200,2019-11-15 00:00:00+03:00,in,False,905862,False,2,226,241,15
167200,2019-11-16 00:00:00+03:00,in,False,-1,True,8,0,136,136
167200,2019-11-17 00:00:00+03:00,in,False,-1,True,14,0,238,238
167200,2019-11-18 00:00:00+03:00,in,False,905862,False,1,162,168,6
167200,2019-11-19 00:00:00+03:00,in,False,905862,False,1,27,35,8
167200,2019-11-20 00:00:00+03:00,in,False,905862,False,1,371,382,11
167200,2019-11-20 00:00:00+03:00,in,False,-1,True,1,0,8,8
167200,2019-11-22 00:00:00+03:00,in,False,-1,True,3,0,83,83
167200,2019-11-22 00:00:00+03:00,in,False,905862,False,2,121,133,12
167200,2019-11-28 00:00:00+03:00,in,False,-1,True,1,0,30,30
167200,2019-11-28 00:00:00+03:00,in,False,905862,False,3,218,256,38
167235,2019-09-18 00:00:00+03:00,in,False,-1,True,1,0,2,2
167235,2019-09-19 00:00:00+03:00,out,False,913788,True,3,0,27,27
167235,2019-09-19 00:00:00+03:00,in,False,-1,True,4,0,0,0
167235,2019-09-20 00:00:00+03:00,in,False,-1,True,1,0,8,8
167235,2019-09-22 00:00:00+03:00,out,False,913788,False,4,178,268,90
167235,2019-09-22 00:00:00+03:00,out,False,913788,True,2,0,64,64
167235,2019-09-25 00:00:00+03:00,out,False,913788,False,5,360,442,82
167235,2019-09-25 00:00:00+03:00,in,False,913788,False,10,989,1143,154
167235,2019-09-25 00:00:00+03:00,in,False,-1,True,4,0,44,44
167235,2019-09-25 00:00:00+03:00,out,False,913788,True,4,0,39,39
167235,2019-09-25 00:00:00+03:00,in,False,-1,True,4,0,44,44
167235,2019-09-26 00:00:00+03:00,in,False,-1,True,1,0,1,1
167235,2019-09-26 00:00:00+03:00,out,False,913788,False,11,1874,2058,184
167235,2019-09-26 00:00:00+03:00,in,False,913788,False,5,452,540,88
167235,2019-09-26 00:00:00+03:00,out,False,913788,True,6,0,51,51
167235,2019-09-26 00:00:00+03:00,out,False,913788,True,6,0,51,51
167235,2019-09-26 00:00:00+03:00,in,False,913788,False,5,452,540,88
167235,2019-09-27 00:00:00+03:00,out,False,913788,False,4,667,704,37
167235,2019-09-27 00:00:00+03:00,in,False,913788,False,1,21,33,12
167235,2019-09-27 00:00:00+03:00,in,False,913788,False,1,21,33,12
167235,2019-09-28 00:00:00+03:00,in,False,913788,False,5,537,618,81
167235,2019-09-28 00:00:00+03:00,out,False,913788,False,1,46,55,9
167235,2019-09-28 00:00:00+03:00,in,False,-1,True,1,0,17,17
167235,2019-09-29 00:00:00+03:00,in,False,913788,False,1,9,34,25
167235,2019-09-30 00:00:00+03:00,out,False,913788,False,2,77,108,31
167235,2019-09-30 00:00:00+03:00,out,False,913788,True,6,0,145,145
167235,2019-09-30 00:00:00+03:00,in,False,913788,False,8,451,603,152
167235,2019-09-30 00:00:00+03:00,out,False,913788,True,6,0,145,145
167235,2019-10-01 00:00:00+03:00,out,False,913788,False,9,692,825,133
167235,2019-10-01 00:00:00+03:00,out,False,913788,True,8,0,48,48
167235,2019-10-01 00:00:00+03:00,in,False,913788,False,9,1428,1615,187
167235,2019-10-02 00:00:00+03:00,in,False,913788,False,12,1126,1285,159
167235,2019-10-02 00:00:00+03:00,in,False,-1,True,2,0,8,8
167235,2019-10-02 00:00:00+03:00,out,False,913788,False,4,357,403,46
167235,2019-10-02 00:00:00+03:00,out,False,913788,False,4,357,403,46
167235,2019-10-03 00:00:00+03:00,out,False,913788,True,4,0,44,44
167235,2019-10-03 00:00:00+03:00,in,False,913788,False,8,795,938,143
167235,2019-10-03 00:00:00+03:00,out,False,913788,False,4,86,128,42
167235,2019-10-03 00:00:00+03:00,out,False,913788,True,4,0,44,44
167235,2019-10-04 00:00:00+03:00,in,False,-1,True,2,0,26,26
167235,2019-10-04 00:00:00+03:00,out,False,913788,True,4,0,79,79
167235,2019-10-04 00:00:00+03:00,in,False,913788,False,6,589,686,97
167235,2019-10-04 00:00:00+03:00,out,False,913788,False,11,635,792,157
167235,2019-10-04 00:00:00+03:00,out,False,913788,False,11,635,792,157
167235,2019-10-05 00:00:00+03:00,in,False,913788,False,6,409,531,122
167235,2019-10-05 00:00:00+03:00,in,False,-1,True,1,0,5,5
167235,2019-10-05 00:00:00+03:00,in,False,913788,False,6,409,531,122
167235,2019-10-07 00:00:00+03:00,out,False,913788,False,8,288,390,102
167235,2019-10-07 00:00:00+03:00,in,False,913788,False,17,2045,2274,229
167235,2019-10-07 00:00:00+03:00,out,False,913788,True,9,0,159,159
167235,2019-10-08 00:00:00+03:00,in,False,913788,False,11,1582,1782,200
167235,2019-10-08 00:00:00+03:00,out,False,913788,True,3,0,105,105
167235,2019-10-08 00:00:00+03:00,out,False,913788,False,9,457,578,121
167235,2019-10-08 00:00:00+03:00,out,False,913788,True,3,0,105,105
167235,2019-10-08 00:00:00+03:00,in,False,913788,False,11,1582,1782,200
167235,2019-10-09 00:00:00+03:00,in,False,913788,False,11,1276,1473,197
167235,2019-10-09 00:00:00+03:00,out,False,913788,True,6,0,178,178
167235,2019-10-09 00:00:00+03:00,out,False,913788,False,14,315,599,284
167235,2019-10-10 00:00:00+03:00,in,False,-1,True,2,0,112,112
167235,2019-10-10 00:00:00+03:00,in,False,913788,False,17,1848,2191,343
167235,2019-10-10 00:00:00+03:00,out,False,913788,True,10,0,284,284
167235,2019-10-10 00:00:00+03:00,out,False,913788,False,6,226,322,96
167235,2019-10-11 00:00:00+03:00,out,False,913788,False,9,394,552,158
167235,2019-10-11 00:00:00+03:00,in,False,-1,True,2,0,55,55
167235,2019-10-11 00:00:00+03:00,in,False,913788,False,7,1008,1111,103
167235,2019-10-11 00:00:00+03:00,out,False,913788,True,5,0,103,103
167235,2019-10-12 00:00:00+03:00,out,False,913788,False,5,248,310,62
167235,2019-10-12 00:00:00+03:00,in,False,913788,False,4,475,547,72
167235,2019-10-13 00:00:00+03:00,in,False,913788,False,2,15,67,52
167235,2019-10-13 00:00:00+03:00,in,False,913788,False,2,15,67,52
167235,2019-10-14 00:00:00+03:00,in,False,913788,False,16,1712,1988,276
167235,2019-10-14 00:00:00+03:00,out,False,913788,False,20,1185,1512,327
167235,2019-10-14 00:00:00+03:00,out,False,913788,True,9,0,221,221
167235,2019-10-14 00:00:00+03:00,in,False,-1,True,5,0,33,33
167235,2019-10-15 00:00:00+03:00,out,False,913788,True,6,0,153,153
167235,2019-10-15 00:00:00+03:00,out,False,913788,False,6,252,337,85
167235,2019-10-15 00:00:00+03:00,in,False,913788,False,22,2548,2867,319
167235,2019-10-15 00:00:00+03:00,in,False,-1,True,3,0,216,216
167235,2019-10-16 00:00:00+03:00,out,False,913788,True,4,0,82,82
167235,2019-10-16 00:00:00+03:00,in,False,913788,False,12,1633,1797,164
167235,2019-10-16 00:00:00+03:00,out,False,913788,False,8,421,525,104
167235,2019-10-17 00:00:00+03:00,out,False,913788,True,2,0,23,23
167235,2019-10-17 00:00:00+03:00,in,False,913788,False,21,2216,2528,312
167235,2019-10-17 00:00:00+03:00,out,False,913788,False,17,646,945,299
167235,2019-10-17 00:00:00+03:00,in,False,-1,True,2,0,42,42
167235,2019-10-18 00:00:00+03:00,out,False,913788,False,7,489,597,108
167235,2019-10-18 00:00:00+03:00,in,False,-1,True,2,0,74,74
167235,2019-10-18 00:00:00+03:00,in,False,913788,False,11,1332,1506,174
167235,2019-10-19 00:00:00+03:00,out,False,913788,True,8,0,208,208
167235,2019-10-19 00:00:00+03:00,in,False,913788,False,12,1338,1512,174
167235,2019-10-19 00:00:00+03:00,out,False,913788,False,10,555,756,201
167235,2019-10-19 00:00:00+03:00,in,False,-1,True,6,0,71,71
167235,2019-10-20 00:00:00+03:00,in,False,-1,True,1,0,11,11
167235,2019-10-20 00:00:00+03:00,in,False,913788,False,1,7,33,26
167235,2019-10-21 00:00:00+03:00,in,False,913788,False,13,898,1062,164
167235,2019-10-21 00:00:00+03:00,in,False,-1,True,4,0,89,89
167235,2019-10-21 00:00:00+03:00,out,False,913788,True,2,0,91,91
167235,2019-10-21 00:00:00+03:00,out,False,913788,False,20,683,1005,322
167235,2019-10-22 00:00:00+03:00,out,False,913788,False,9,804,901,97
167235,2019-10-22 00:00:00+03:00,out,False,913788,True,7,0,49,49
167235,2019-10-22 00:00:00+03:00,in,False,-1,True,1,0,5,5
167235,2019-10-22 00:00:00+03:00,in,False,913788,False,8,1090,1213,123
167235,2019-10-23 00:00:00+03:00,in,False,-1,True,1,0,59,59
167235,2019-10-23 00:00:00+03:00,out,False,913788,True,3,0,95,95
167235,2019-10-23 00:00:00+03:00,out,False,913788,False,11,574,721,147
167235,2019-10-23 00:00:00+03:00,in,False,913788,False,10,1331,1507,176
167235,2019-10-24 00:00:00+03:00,out,False,913788,True,2,0,69,69
167235,2019-10-24 00:00:00+03:00,in,False,913788,False,16,1817,2039,222
167235,2019-10-24 00:00:00+03:00,out,False,913788,False,14,655,823,168
167235,2019-10-24 00:00:00+03:00,in,False,-1,True,1,0,38,38
167235,2019-10-25 00:00:00+03:00,in,False,913788,False,16,1698,1919,221
167235,2019-10-25 00:00:00+03:00,out,False,913788,False,8,346,456,110
167235,2019-10-25 00:00:00+03:00,out,False,913788,True,1,0,11,11
167235,2019-10-26 00:00:00+03:00,out,False,913788,True,3,0,58,58
167235,2019-10-26 00:00:00+03:00,out,False,913788,False,12,615,823,208
167235,2019-10-26 00:00:00+03:00,in,False,913788,False,7,941,1042,101
167235,2019-10-26 00:00:00+03:00,in,False,-1,True,2,0,68,68
167235,2019-10-27 00:00:00+03:00,in,False,913788,False,7,67,247,180
167235,2019-10-28 00:00:00+03:00,in,False,913788,False,12,1053,1221,168
167235,2019-10-28 00:00:00+03:00,out,False,913788,True,4,0,109,109
167235,2019-10-28 00:00:00+03:00,in,False,-1,True,1,0,53,53
167235,2019-10-28 00:00:00+03:00,out,False,913788,False,15,645,868,223
167235,2019-10-29 00:00:00+03:00,in,False,913788,False,16,1142,1435,293
167235,2019-10-29 00:00:00+03:00,out,False,913788,False,12,729,963,234
167235,2019-10-29 00:00:00+03:00,out,False,913788,True,3,0,76,76
167235,2019-10-30 00:00:00+03:00,in,False,-1,True,1,0,0,0
167235,2019-10-30 00:00:00+03:00,out,False,913788,True,2,0,69,69
167235,2019-10-30 00:00:00+03:00,out,False,913788,False,6,326,393,67
167235,2019-10-30 00:00:00+03:00,in,False,913788,False,10,769,911,142
167235,2019-10-31 00:00:00+03:00,in,False,913788,False,18,2729,2999,270
167235,2019-10-31 00:00:00+03:00,out,False,913788,False,11,305,456,151
167235,2019-10-31 00:00:00+03:00,in,False,-1,True,2,0,76,76
167235,2019-10-31 00:00:00+03:00,out,False,913788,True,10,0,229,229
167235,2019-11-01 00:00:00+03:00,out,False,913788,True,4,0,163,163
167235,2019-11-01 00:00:00+03:00,out,False,913788,False,3,186,228,42
167235,2019-11-01 00:00:00+03:00,in,False,913788,False,8,697,813,116
167235,2019-11-02 00:00:00+03:00,in,False,913788,False,12,878,1090,212
167235,2019-11-02 00:00:00+03:00,in,False,-1,True,2,0,80,80
167235,2019-11-02 00:00:00+03:00,out,False,913788,False,16,722,939,217
167235,2019-11-02 00:00:00+03:00,out,False,913788,True,4,0,94,94
167235,2019-11-03 00:00:00+03:00,in,False,-1,True,1,0,6,6
167235,2019-11-03 00:00:00+03:00,in,False,913788,False,3,19,96,77
167235,2019-11-03 00:00:00+03:00,in,False,913788,True,1,0,26,26
167235,2019-11-04 00:00:00+03:00,out,False,913788,False,15,338,534,196
167235,2019-11-04 00:00:00+03:00,in,False,-1,True,2,0,63,63
167235,2019-11-04 00:00:00+03:00,out,False,913788,True,6,0,162,162
167235,2019-11-04 00:00:00+03:00,in,False,913788,False,19,1946,2244,298
167235,2019-11-05 00:00:00+03:00,in,False,-1,True,4,0,266,266
167235,2019-11-05 00:00:00+03:00,in,False,913788,False,22,4460,4880,420
167235,2019-11-05 00:00:00+03:00,out,False,913788,False,14,894,1071,177
167235,2019-11-05 00:00:00+03:00,out,False,913788,True,8,0,34,34
167235,2019-11-06 00:00:00+03:00,out,False,913788,False,19,749,1001,252
167235,2019-11-06 00:00:00+03:00,out,False,913788,True,11,0,205,205
167235,2019-11-06 00:00:00+03:00,in,False,-1,True,3,0,207,207
167235,2019-11-06 00:00:00+03:00,in,False,913788,False,26,3139,3570,431
167235,2019-11-07 00:00:00+03:00,in,False,913788,False,10,1287,1417,130
167235,2019-11-07 00:00:00+03:00,out,False,913788,False,14,1824,1995,171
167235,2019-11-07 00:00:00+03:00,out,False,913788,True,3,0,23,23
167235,2019-11-08 00:00:00+03:00,in,False,-1,True,1,0,5,5
167235,2019-11-08 00:00:00+03:00,in,False,913788,False,11,1292,1448,156
167235,2019-11-08 00:00:00+03:00,out,False,913788,True,1,0,20,20
167235,2019-11-08 00:00:00+03:00,out,False,913788,False,14,652,796,144
167235,2019-11-08 00:00:00+03:00,in,False,913788,False,11,1292,1448,156
167235,2019-11-09 00:00:00+03:00,out,False,913788,True,3,0,81,81
167235,2019-11-09 00:00:00+03:00,out,False,913788,False,6,324,438,114
167235,2019-11-09 00:00:00+03:00,in,False,913788,False,13,1619,1805,186
167235,2019-11-10 00:00:00+03:00,in,False,-1,True,1,0,17,17
167235,2019-11-10 00:00:00+03:00,in,False,913788,False,2,12,62,50
167235,2019-11-10 00:00:00+03:00,in,False,-1,True,1,0,17,17
167235,2019-11-10 00:00:00+03:00,in,False,913788,False,2,12,62,50
167235,2019-11-11 00:00:00+03:00,in,False,913788,False,26,2367,2781,414
167235,2019-11-11 00:00:00+03:00,in,False,-1,True,2,0,41,41
167235,2019-11-11 00:00:00+03:00,out,False,913788,False,15,787,984,197
167235,2019-11-11 00:00:00+03:00,out,False,913788,True,15,0,499,499
167235,2019-11-12 00:00:00+03:00,out,False,913788,False,14,714,923,209
167235,2019-11-12 00:00:00+03:00,in,False,-1,True,1,0,10,10
167235,2019-11-12 00:00:00+03:00,out,False,913788,True,5,0,131,131
167235,2019-11-12 00:00:00+03:00,in,False,913788,False,11,1422,1586,164
167235,2019-11-13 00:00:00+03:00,out,False,913788,True,4,0,98,98
167235,2019-11-13 00:00:00+03:00,out,False,913788,False,8,359,531,172
167235,2019-11-13 00:00:00+03:00,in,False,913788,False,22,1910,2209,299
167235,2019-11-14 00:00:00+03:00,out,False,913788,False,26,978,1296,318
167235,2019-11-14 00:00:00+03:00,in,False,-1,True,3,0,158,158
167235,2019-11-14 00:00:00+03:00,in,False,913788,False,22,2929,3298,369
167235,2019-11-14 00:00:00+03:00,in,False,913788,True,1,0,94,94
167235,2019-11-14 00:00:00+03:00,out,False,913788,True,46,0,148,148
167235,2019-11-15 00:00:00+03:00,in,False,913788,False,18,1378,1664,286
167235,2019-11-15 00:00:00+03:00,out,False,913788,True,5,0,93,93
167235,2019-11-15 00:00:00+03:00,out,False,913788,False,23,730,1035,305
167235,2019-11-15 00:00:00+03:00,in,False,-1,True,4,0,194,194
167235,2019-11-16 00:00:00+03:00,out,False,913788,True,4,0,79,79
167235,2019-11-16 00:00:00+03:00,in,False,913788,False,15,1172,1369,197
167235,2019-11-16 00:00:00+03:00,out,False,913788,False,16,836,1082,246
167235,2019-11-17 00:00:00+03:00,in,False,-1,True,1,0,23,23
167235,2019-11-17 00:00:00+03:00,in,False,913788,False,1,9,35,26
167235,2019-11-18 00:00:00+03:00,in,False,-1,True,5,0,63,63
167235,2019-11-18 00:00:00+03:00,out,False,913788,False,22,832,1207,375
167235,2019-11-18 00:00:00+03:00,in,False,913788,False,25,2804,3213,409
167235,2019-11-18 00:00:00+03:00,out,False,913788,True,12,0,307,307
167235,2019-11-19 00:00:00+03:00,in,False,913788,False,19,1450,1734,284
167235,2019-11-19 00:00:00+03:00,out,False,913788,True,12,0,212,212
167235,2019-11-19 00:00:00+03:00,in,False,-1,True,2,0,2,2
167235,2019-11-19 00:00:00+03:00,out,False,913788,False,15,567,795,228
167235,2019-11-19 00:00:00+03:00,in,False,-1,True,2,0,2,2
167235,2019-11-19 00:00:00+03:00,out,False,913788,True,12,0,212,212
167235,2019-11-20 00:00:00+03:00,out,False,913788,False,24,906,1281,375
167235,2019-11-20 00:00:00+03:00,out,False,913788,True,11,0,191,191
167235,2019-11-20 00:00:00+03:00,in,False,913788,False,21,1486,1792,306
167235,2019-11-21 00:00:00+03:00,out,False,913788,False,6,480,606,126
167235,2019-11-21 00:00:00+03:00,in,False,-1,True,5,0,347,347
167235,2019-11-21 00:00:00+03:00,in,False,913788,False,21,2119,2449,330
167235,2019-11-21 00:00:00+03:00,out,False,913788,True,3,0,18,18
167235,2019-11-22 00:00:00+03:00,out,False,913788,True,1,0,33,33
167235,2019-11-22 00:00:00+03:00,out,False,913788,False,12,494,688,194
167235,2019-11-22 00:00:00+03:00,in,False,913788,False,6,913,992,79
167235,2019-11-22 00:00:00+03:00,in,False,-1,True,2,0,30,30
167235,2019-11-22 00:00:00+03:00,in,False,-1,True,2,0,30,30
167235,2019-11-23 00:00:00+03:00,in,False,913788,False,11,1224,1382,158
167235,2019-11-23 00:00:00+03:00,out,False,913788,True,5,0,131,131
167235,2019-11-23 00:00:00+03:00,out,False,913788,False,9,275,415,140
167235,2019-11-23 00:00:00+03:00,in,False,-1,True,1,0,3,3
167235,2019-11-23 00:00:00+03:00,in,False,-1,True,1,0,3,3
167235,2019-11-23 00:00:00+03:00,out,False,913788,True,5,0,131,131
167235,2019-11-24 00:00:00+03:00,in,False,913788,False,4,27,129,102
167235,2019-11-24 00:00:00+03:00,in,False,-1,True,1,0,7,7
167235,2019-11-25 00:00:00+03:00,out,False,913788,False,12,215,442,227
167235,2019-11-25 00:00:00+03:00,out,False,913788,True,6,0,167,167
167235,2019-11-25 00:00:00+03:00,in,False,913788,False,24,1957,2341,384
167235,2019-11-25 00:00:00+03:00,in,False,-1,True,2,0,1,1
167235,2019-11-26 00:00:00+03:00,out,False,913788,True,4,0,83,83
167235,2019-11-26 00:00:00+03:00,in,False,913788,False,15,1673,1929,256
167235,2019-11-26 00:00:00+03:00,in,False,-1,True,4,0,164,164
167235,2019-11-26 00:00:00+03:00,out,False,913788,False,23,652,992,340
167235,2019-11-27 00:00:00+03:00,in,False,913788,False,18,1934,2183,249
167235,2019-11-27 00:00:00+03:00,out,False,913788,True,6,0,134,134
167235,2019-11-27 00:00:00+03:00,in,False,-1,True,3,0,37,37
167235,2019-11-27 00:00:00+03:00,out,False,913788,False,5,203,275,72
167235,2019-11-28 00:00:00+03:00,in,False,913788,False,18,1534,1778,244
167235,2019-11-28 00:00:00+03:00,out,False,913788,True,10,0,168,168
167235,2019-11-28 00:00:00+03:00,in,False,-1,True,4,0,108,108
167235,2019-11-28 00:00:00+03:00,out,False,913788,False,15,294,522,228
167235,2019-11-28 00:00:00+03:00,out,False,913788,False,15,294,522,228
167238,2019-09-11 00:00:00+03:00,in,False,-1,True,1,0,2,2
167238,2019-09-12 00:00:00+03:00,in,False,-1,True,1,0,3,3
167238,2019-09-18 00:00:00+03:00,in,False,-1,True,1,0,3,3
167238,2019-09-22 00:00:00+03:00,in,False,-1,True,1,0,2,2
167238,2019-09-23 00:00:00+03:00,in,False,-1,True,1,0,2,2
167238,2019-09-24 00:00:00+03:00,in,False,-1,True,1,0,2,2
167238,2019-09-26 00:00:00+03:00,in,False,-1,True,2,0,5,5
167238,2019-10-23 00:00:00+03:00,in,False,-1,True,1,0,2,2
167238,2019-10-26 00:00:00+03:00,in,False,-1,True,1,0,2,2
167238,2019-10-28 00:00:00+03:00,in,False,-1,True,2,0,4,4
167238,2019-11-02 00:00:00+03:00,in,False,-1,True,3,0,0,0
167238,2019-11-03 00:00:00+03:00,in,False,-1,True,2,0,1,1
167238,2019-11-06 00:00:00+03:00,in,False,-1,True,2,0,2,2
167238,2019-11-08 00:00:00+03:00,in,False,-1,True,4,0,2,2
167238,2019-11-08 00:00:00+03:00,in,False,-1,True,4,0,2,2
167238,2019-11-10 00:00:00+03:00,in,False,-1,True,5,0,1,1
167238,2019-11-13 00:00:00+03:00,in,False,-1,True,4,0,0,0
167238,2019-11-19 00:00:00+03:00,in,False,-1,True,1,0,0,0
167238,2019-11-21 00:00:00+03:00,in,False,-1,True,1,0,0,0
167238,2019-11-21 00:00:00+03:00,out,False,949420,True,1,0,8,8
167238,2019-11-21 00:00:00+03:00,in,False,949420,False,1,2,3,1
167238,2019-11-22 00:00:00+03:00,in,False,949420,False,1,29,30,1
167238,2019-11-23 00:00:00+03:00,in,False,949420,False,1,887,887,0
167238,2019-11-25 00:00:00+03:00,in,False,949420,False,2,39,41,2
167242,2019-09-19 00:00:00+03:00,in,False,911214,False,1,8,25,17
167242,2019-09-19 00:00:00+03:00,in,False,-1,True,1,0,2,2
167242,2019-11-06 00:00:00+03:00,in,False,911214,False,1,13,32,19
167242,2019-11-06 00:00:00+03:00,in,False,-1,True,2,0,32,32
167242,2019-11-07 00:00:00+03:00,in,False,-1,True,4,0,1,1
167242,2019-11-08 00:00:00+03:00,in,False,-1,True,1,0,0,0
167242,2019-11-11 00:00:00+03:00,in,False,-1,True,1,0,0,0
167244,2019-09-12 00:00:00+03:00,in,False,909896,False,1,16,25,9
167244,2019-09-12 00:00:00+03:00,in,False,-1,True,1,0,37,37
167244,2019-09-12 00:00:00+03:00,in,False,909892,False,1,11,26,15
167244,2019-09-16 00:00:00+03:00,in,False,-1,True,1,0,16,16
167244,2019-09-16 00:00:00+03:00,in,False,-1,True,1,0,16,16
167244,2019-09-18 00:00:00+03:00,in,False,-1,True,2,0,21,21
167244,2019-09-18 00:00:00+03:00,in,False,909892,False,1,66,75,9
167244,2019-09-20 00:00:00+03:00,in,False,909892,False,2,337,355,18
167244,2019-09-20 00:00:00+03:00,out,False,909892,False,2,63,79,16
167244,2019-09-20 00:00:00+03:00,in,False,-1,True,12,0,247,247
167244,2019-09-20 00:00:00+03:00,out,False,909892,True,2,0,14,14
167244,2019-09-25 00:00:00+03:00,in,False,909894,False,1,19,32,13
167244,2019-10-21 00:00:00+03:00,in,False,-1,True,1,0,16,16
167244,2019-10-22 00:00:00+03:00,in,False,-1,True,2,0,28,28
167244,2019-10-23 00:00:00+03:00,in,False,-1,True,1,0,2,2
167244,2019-10-28 00:00:00+03:00,in,False,-1,True,1,0,2,2
167244,2019-10-31 00:00:00+03:00,in,False,-1,True,1,0,2,2
167246,2019-09-10 00:00:00+03:00,in,False,908082,False,1,23,28,5
167246,2019-09-10 00:00:00+03:00,out,False,908082,False,1,74,92,18
167246,2019-09-10 00:00:00+03:00,in,False,908078,False,1,45,79,34
167246,2019-09-10 00:00:00+03:00,in,False,-1,True,1,0,84,84
167246,2019-09-10 00:00:00+03:00,in,False,908078,False,1,45,79,34
167246,2019-09-11 00:00:00+03:00,out,True,908080,False,1,149,155,6
167246,2019-09-11 00:00:00+03:00,in,False,908080,False,1,261,268,7
167246,2019-09-11 00:00:00+03:00,in,False,908080,False,1,261,268,7
167246,2019-09-12 00:00:00+03:00,in,False,908078,False,1,117,124,7
167246,2019-09-15 00:00:00+03:00,in,False,-1,True,1,0,29,29
167246,2019-09-16 00:00:00+03:00,in,False,908078,False,1,59,84,25
167246,2019-09-16 00:00:00+03:00,in,False,908082,False,1,16,26,10
167246,2019-09-17 00:00:00+03:00,in,False,908078,False,1,89,97,8
167246,2019-09-17 00:00:00+03:00,in,False,-1,True,2,0,33,33
167246,2019-09-19 00:00:00+03:00,in,False,-1,True,1,0,6,6
167246,2019-09-23 00:00:00+03:00,in,False,-1,True,1,0,8,8
167246,2019-09-24 00:00:00+03:00,in,False,-1,True,1,0,2,2
167246,2019-09-24 00:00:00+03:00,in,False,908078,False,4,242,283,41
167246,2019-09-24 00:00:00+03:00,out,False,908082,False,2,37,44,7
167246,2019-09-24 00:00:00+03:00,in,False,908082,False,1,175,181,6
167246,2019-09-25 00:00:00+03:00,in,False,908080,False,2,108,138,30
167246,2019-09-25 00:00:00+03:00,in,False,908082,False,1,17,27,10
167246,2019-09-25 00:00:00+03:00,in,False,908078,False,1,62,69,7
167246,2019-09-25 00:00:00+03:00,in,False,908082,False,1,17,27,10
167246,2019-09-26 00:00:00+03:00,out,False,908078,False,6,758,781,23
167246,2019-09-26 00:00:00+03:00,in,False,908080,False,1,125,150,25
167246,2019-09-26 00:00:00+03:00,out,False,908078,True,1,0,8,8
167246,2019-09-26 00:00:00+03:00,in,False,-1,True,1,0,44,44
167246,2019-09-26 00:00:00+03:00,in,False,908078,False,3,184,208,24
167246,2019-09-26 00:00:00+03:00,in,False,908080,False,1,125,150,25
167246,2019-09-26 00:00:00+03:00,out,False,908078,False,6,758,781,23
167246,2019-09-27 00:00:00+03:00,out,False,908082,False,1,91,94,3
167246,2019-09-27 00:00:00+03:00,out,False,908078,False,1,539,553,14
167246,2019-09-27 00:00:00+03:00,in,False,908080,False,1,217,225,8
167246,2019-09-27 00:00:00+03:00,in,False,-1,True,1,0,29,29
167246,2019-09-27 00:00:00+03:00,in,False,908078,False,1,73,78,5
167246,2019-09-27 00:00:00+03:00,in,False,908078,False,1,73,78,5
167246,2019-09-30 00:00:00+03:00,out,False,908082,False,1,18,36,18
167246,2019-09-30 00:00:00+03:00,in,False,-1,True,2,0,9,9
167246,2019-09-30 00:00:00+03:00,out,True,908082,True,1,0,0,0
167246,2019-09-30 00:00:00+03:00,in,False,908078,False,2,173,193,20
167246,2019-09-30 00:00:00+03:00,in,False,908082,False,4,456,492,36
167246,2019-10-01 00:00:00+03:00,in,False,908078,False,1,34,45,11
167246,2019-10-02 00:00:00+03:00,in,False,908082,False,1,226,234,8
167246,2019-10-02 00:00:00+03:00,in,False,908078,False,3,402,418,16
167246,2019-10-03 00:00:00+03:00,in,False,908082,False,2,162,179,17
167246,2019-10-03 00:00:00+03:00,in,False,908078,False,1,18,24,6
167246,2019-10-04 00:00:00+03:00,in,False,908082,False,2,462,490,28
167246,2019-10-04 00:00:00+03:00,in,False,908078,False,1,48,58,10
167246,2019-10-07 00:00:00+03:00,out,False,908078,False,5,210,240,30
167246,2019-10-07 00:00:00+03:00,in,False,908078,False,1,20,55,35
167246,2019-10-07 00:00:00+03:00,in,False,908078,False,1,20,55,35
167246,2019-10-09 00:00:00+03:00,out,False,908082,False,1,258,260,2
167246,2019-10-10 00:00:00+03:00,in,False,-1,True,1,0,70,70
167246,2019-10-10 00:00:00+03:00,out,False,908078,False,3,22,49,27
167246,2019-10-10 00:00:00+03:00,in,False,908082,False,1,31,34,3
167246,2019-10-14 00:00:00+03:00,in,False,908082,False,1,51,66,15
167246,2019-10-14 00:00:00+03:00,in,False,908082,False,1,51,66,15
167246,2019-10-15 00:00:00+03:00,in,False,908082,False,1,93,105,12
167246,2019-10-15 00:00:00+03:00,out,False,908082,False,1,49,54,5
167246,2019-10-15 00:00:00+03:00,in,False,908082,False,1,93,105,12
167246,2019-10-17 00:00:00+03:00,out,False,908078,False,4,443,463,20
167246,2019-10-18 00:00:00+03:00,out,False,908078,False,6,257,285,28
167246,2019-10-18 00:00:00+03:00,in,False,908082,False,2,165,197,32
167246,2019-10-18 00:00:00+03:00,in,False,908078,False,1,1,4,3
167246,2019-10-22 00:00:00+03:00,in,False,908078,False,2,120,162,42
167246,2019-10-23 00:00:00+03:00,in,False,-1,True,1,0,49,49
167246,2019-10-25 00:00:00+03:00,out,False,908078,False,6,282,328,46
167246,2019-10-25 00:00:00+03:00,in,False,-1,True,1,0,16,16
167246,2019-10-30 00:00:00+03:00,in,False,908082,False,2,62,86,24
167246,2019-11-01 00:00:00+03:00,out,False,908078,True,3,0,86,86
167246,2019-11-01 00:00:00+03:00,in,False,908078,False,1,129,155,26
167246,2019-11-01 00:00:00+03:00,out,False,908078,False,6,239,278,39
167246,2019-11-01 00:00:00+03:00,out,False,908078,False,6,239,278,39
167246,2019-11-05 00:00:00+03:00,in,False,908082,False,1,65,74,9
167246,2019-11-06 00:00:00+03:00,in,False,908078,False,1,176,189,13
167246,2019-11-07 00:00:00+03:00,in,False,908078,False,1,75,88,13
167246,2019-11-08 00:00:00+03:00,out,False,908078,False,5,143,161,18
167246,2019-11-11 00:00:00+03:00,out,False,908082,False,3,370,396,26
167246,2019-11-11 00:00:00+03:00,in,False,908078,False,1,190,207,17
167246,2019-11-11 00:00:00+03:00,out,False,908078,False,1,8,14,6
167246,2019-11-11 00:00:00+03:00,in,False,908078,False,1,190,207,17
167246,2019-11-11 00:00:00+03:00,out,False,908078,False,1,8,14,6
167246,2019-11-12 00:00:00+03:00,out,False,908078,False,1,113,114,1
167246,2019-11-12 00:00:00+03:00,out,False,908082,False,6,586,608,22
167246,2019-11-12 00:00:00+03:00,in,False,908078,False,1,72,113,41
167246,2019-11-12 00:00:00+03:00,in,False,908082,False,2,122,141,19
167246,2019-11-13 00:00:00+03:00,in,False,908082,False,1,751,765,14
167246,2019-11-13 00:00:00+03:00,out,False,908082,False,1,654,660,6
167246,2019-11-15 00:00:00+03:00,in,False,908082,False,2,76,93,17
167246,2019-11-15 00:00:00+03:00,in,False,-1,True,2,0,76,76
167246,2019-11-18 00:00:00+03:00,in,False,908078,False,1,59,70,11
167246,2019-11-19 00:00:00+03:00,in,False,908078,False,2,54,111,57
167246,2019-11-20 00:00:00+03:00,in,False,908078,False,1,108,125,17
167246,2019-11-21 00:00:00+03:00,out,False,908078,True,1,0,7,7
167246,2019-11-21 00:00:00+03:00,in,False,908078,False,1,63,80,17
167246,2019-11-21 00:00:00+03:00,in,False,-1,True,1,0,61,61
167246,2019-11-22 00:00:00+03:00,out,False,908078,True,1,0,27,27
167246,2019-11-25 00:00:00+03:00,in,False,908078,False,1,11,68,57
167246,2019-11-26 00:00:00+03:00,in,False,-1,True,1,0,47,47
167246,2019-11-26 00:00:00+03:00,in,False,908078,False,1,80,94,14
167246,2019-11-26 00:00:00+03:00,out,False,908082,True,2,0,6,6
167246,2019-11-27 00:00:00+03:00,in,False,908078,False,1,66,133,67
167246,2019-11-28 00:00:00+03:00,in,False,-1,True,3,0,130,130
167246,2019-11-28 00:00:00+03:00,in,False,908078,False,4,314,364,50
167246,2019-11-28 00:00:00+03:00,out,False,908078,True,1,0,29,29
167246,2019-11-28 00:00:00+03:00,out,False,908078,False,5,450,473,23
167250,2019-09-18 00:00:00+03:00,in,False,913984,False,1,203,220,17
167250,2019-10-16 00:00:00+03:00,in,False,-1,True,4,0,9,9
167250,2019-10-28 00:00:00+03:00,in,False,-1,True,1,0,2,2
167250,2019-11-01 00:00:00+03:00,out,True,913984,True,5,0,23,23
167250,2019-11-01 00:00:00+03:00,out,True,929542,False,1,12,21,9
167250,2019-11-01 00:00:00+03:00,out,False,913984,False,1,10,22,12
167250,2019-11-01 00:00:00+03:00,out,True,913984,True,5,0,23,23
167250,2019-11-08 00:00:00+03:00,out,False,929544,False,4,250,296,46
167250,2019-11-08 00:00:00+03:00,out,True,929542,True,1,0,9,9
167250,2019-11-11 00:00:00+03:00,out,False,929544,False,16,1307,1381,74
167250,2019-11-11 00:00:00+03:00,out,False,929544,True,8,0,146,146
167250,2019-11-12 00:00:00+03:00,out,False,929544,True,1,0,15,15
167250,2019-11-12 00:00:00+03:00,out,False,929544,False,3,173,179,6
167250,2019-11-18 00:00:00+03:00,out,False,929544,False,11,1123,1177,54
167250,2019-11-18 00:00:00+03:00,out,False,929544,True,1,0,15,15
167250,2019-11-20 00:00:00+03:00,out,False,929544,True,4,0,49,49
167250,2019-11-20 00:00:00+03:00,out,False,929544,False,8,961,1000,39
167250,2019-11-22 00:00:00+03:00,out,False,929544,True,3,0,94,94
167250,2019-11-26 00:00:00+03:00,out,False,929544,False,3,264,283,19
167250,2019-11-26 00:00:00+03:00,out,False,929544,True,1,0,35,35
167250,2019-11-27 00:00:00+03:00,out,False,929544,False,3,395,430,35
167263,2019-09-16 00:00:00+03:00,in,False,907972,False,1,104,121,17
167263,2019-09-16 00:00:00+03:00,out,True,907972,True,1,0,1,1
167263,2019-09-16 00:00:00+03:00,in,False,-1,True,7,0,148,148
167263,2019-09-17 00:00:00+03:00,in,False,-1,True,5,0,148,148
167263,2019-09-17 00:00:00+03:00,in,False,907972,False,1,9,30,21
167263,2019-09-17 00:00:00+03:00,in,False,907972,False,1,9,30,21
167263,2019-09-18 00:00:00+03:00,in,False,-1,True,2,0,36,36
167263,2019-09-18 00:00:00+03:00,in,False,907972,False,1,3,12,9
167263,2019-10-01 00:00:00+03:00,in,False,-1,True,1,0,9,9
167263,2019-10-08 00:00:00+03:00,in,False,-1,True,2,0,43,43
167263,2019-10-09 00:00:00+03:00,out,False,907972,True,1,0,0,0
167263,2019-10-11 00:00:00+03:00,in,False,-1,True,1,0,23,23
167263,2019-10-16 00:00:00+03:00,in,False,907974,False,1,171,178,7
167263,2019-10-21 00:00:00+03:00,in,False,907974,False,1,349,359,10
167263,2019-10-21 00:00:00+03:00,in,False,-1,True,1,0,29,29
167263,2019-10-22 00:00:00+03:00,in,False,-1,True,1,0,8,8
167263,2019-10-24 00:00:00+03:00,in,False,-1,True,1,0,21,21
167263,2019-10-28 00:00:00+03:00,in,False,-1,True,2,0,11,11
167263,2019-10-28 00:00:00+03:00,in,False,-1,True,2,0,11,11
167263,2019-11-11 00:00:00+03:00,in,False,907972,False,2,58,68,10
167263,2019-11-11 00:00:00+03:00,in,False,-1,True,1,0,41,41
167263,2019-11-11 00:00:00+03:00,in,False,907974,False,1,761,773,12
167263,2019-11-14 00:00:00+03:00,out,False,907972,False,2,74,81,7
167263,2019-11-19 00:00:00+03:00,in,False,-1,True,1,0,1,1
167263,2019-11-19 00:00:00+03:00,in,False,-1,True,1,0,1,1
167263,2019-11-20 00:00:00+03:00,in,False,-1,True,1,0,1,1
167263,2019-11-21 00:00:00+03:00,out,False,907972,True,2,0,94,94
167263,2019-11-21 00:00:00+03:00,out,False,907972,False,2,499,532,33
167263,2019-11-25 00:00:00+03:00,in,False,-1,True,1,0,29,29
167263,2019-11-25 00:00:00+03:00,in,False,-1,True,1,0,29,29
167264,2019-09-25 00:00:00+03:00,in,False,919554,False,1,14,42,28
167264,2019-09-25 00:00:00+03:00,in,False,-1,True,1,0,2,2
167264,2019-09-26 00:00:00+03:00,in,False,919552,False,1,4,21,17
167264,2019-09-27 00:00:00+03:00,in,False,-1,True,6,0,179,179
167264,2019-09-27 00:00:00+03:00,out,False,919554,True,1,0,12,12
167264,2019-09-27 00:00:00+03:00,in,False,919552,False,4,369,488,119
167264,2019-09-27 00:00:00+03:00,in,False,919554,False,5,788,963,175
167264,2019-09-27 00:00:00+03:00,in,False,919552,False,4,369,488,119
167264,2019-09-28 00:00:00+03:00,in,False,919552,False,6,870,1125,255
167264,2019-09-28 00:00:00+03:00,in,False,-1,True,1,0,27,27
167264,2019-09-28 00:00:00+03:00,in,False,919554,False,3,234,337,103
167264,2019-09-28 00:00:00+03:00,in,False,919554,False,3,234,337,103
167264,2019-09-29 00:00:00+03:00,in,False,919554,False,3,295,394,99
167264,2019-09-29 00:00:00+03:00,in,False,-1,True,2,0,52,52
167264,2019-09-30 00:00:00+03:00,in,False,919552,False,13,1281,1813,532
167264,2019-09-30 00:00:00+03:00,in,False,919554,False,15,1352,1938,586
167264,2019-09-30 00:00:00+03:00,in,False,-1,True,13,0,452,452
167264,2019-10-01 00:00:00+03:00,in,False,919554,False,20,2114,2792,678
167264,2019-10-01 00:00:00+03:00,in,False,919552,False,9,1809,2165,356
167264,2019-10-01 00:00:00+03:00,in,False,-1,True,8,0,240,240
167264,2019-10-01 00:00:00+03:00,out,False,919552,False,1,96,114,18
167264,2019-10-01 00:00:00+03:00,in,False,919554,False,20,2114,2792,678
167264,2019-10-01 00:00:00+03:00,in,False,-1,True,8,0,240,240
167264,2019-10-01 00:00:00+03:00,out,False,919552,False,1,96,114,18
167264,2019-10-02 00:00:00+03:00,in,False,919554,True,1,102,144,42
167264,2019-10-02 00:00:00+03:00,in,False,-1,True,9,0,277,277
167264,2019-10-02 00:00:00+03:00,in,False,919554,False,20,2427,3084,657
167264,2019-10-02 00:00:00+03:00,in,False,919552,False,15,2538,3095,557
167264,2019-10-03 00:00:00+03:00,out,False,919552,False,1,48,49,1
167264,2019-10-03 00:00:00+03:00,out,False,919554,False,1,15,26,11
167264,2019-10-03 00:00:00+03:00,in,False,-1,True,8,0,256,256
167264,2019-10-03 00:00:00+03:00,in,False,919552,False,6,1001,1229,228
167264,2019-10-03 00:00:00+03:00,in,False,919554,False,18,1977,2613,636
167264,2019-10-03 00:00:00+03:00,in,False,919552,False,6,1001,1229,228
167264,2019-10-04 00:00:00+03:00,in,False,-1,True,11,0,323,323
167264,2019-10-04 00:00:00+03:00,in,False,919554,False,22,1833,2489,656
167264,2019-10-04 00:00:00+03:00,out,False,919552,False,2,278,280,2
167264,2019-10-04 00:00:00+03:00,in,False,919552,False,14,1630,2124,494
167264,2019-10-04 00:00:00+03:00,out,False,919552,False,2,278,280,2
167264,2019-10-05 00:00:00+03:00,in,False,-1,True,6,0,301,301
167264,2019-10-05 00:00:00+03:00,in,False,919552,False,7,1172,1404,232
167264,2019-10-05 00:00:00+03:00,in,False,919554,False,10,748,1118,370
167264,2019-10-05 00:00:00+03:00,out,False,919552,False,3,584,611,27
167264,2019-10-06 00:00:00+03:00,in,False,919554,False,8,1137,1434,297
167264,2019-10-06 00:00:00+03:00,in,False,919552,False,5,759,932,173
167264,2019-10-07 00:00:00+03:00,in,False,919554,False,23,3330,4064,734
167264,2019-10-07 00:00:00+03:00,in,False,-1,True,15,0,612,612
167264,2019-10-07 00:00:00+03:00,in,False,919552,False,10,1196,1418,222
167264,2019-10-07 00:00:00+03:00,in,False,-1,True,15,0,612,612
167264,2019-10-08 00:00:00+03:00,in,False,-1,True,22,0,687,687
167264,2019-10-08 00:00:00+03:00,in,False,919552,False,28,2640,3475,835
167264,2019-10-08 00:00:00+03:00,in,False,919554,False,20,1743,2436,693
167264,2019-10-09 00:00:00+03:00,out,False,919552,False,1,17,44,27
167264,2019-10-09 00:00:00+03:00,in,False,-1,True,11,0,372,372
167264,2019-10-09 00:00:00+03:00,in,False,919552,False,21,3869,4566,697
167264,2019-10-09 00:00:00+03:00,in,False,919554,False,21,2056,2824,768
167264,2019-10-10 00:00:00+03:00,out,False,919552,True,1,0,2,2
167264,2019-10-10 00:00:00+03:00,out,False,919552,False,4,282,340,58
167264,2019-10-10 00:00:00+03:00,in,False,-1,True,19,0,846,846
167264,2019-10-10 00:00:00+03:00,in,False,919554,False,26,3278,4095,817
167264,2019-10-10 00:00:00+03:00,in,False,919552,False,15,2553,3058,505
167264,2019-10-10 00:00:00+03:00,in,False,-1,True,19,0,846,846
167264,2019-10-11 00:00:00+03:00,in,False,919554,False,27,3057,4001,944
167264,2019-10-11 00:00:00+03:00,in,False,-1,True,18,0,598,598
167264,2019-10-11 00:00:00+03:00,in,False,919552,False,26,2562,3410,848
167264,2019-10-11 00:00:00+03:00,out,False,919552,True,1,0,31,31
167264,2019-10-11 00:00:00+03:00,out,False,919552,False,1,33,44,11
167264,2019-10-12 00:00:00+03:00,in,False,919554,False,17,1528,2072,544
167264,2019-10-12 00:00:00+03:00,in,False,919552,False,17,1551,2102,551
167264,2019-10-12 00:00:00+03:00,out,False,919552,False,2,208,210,2
167264,2019-10-12 00:00:00+03:00,in,False,-1,True,14,0,480,480
167264,2019-10-12 00:00:00+03:00,in,False,919554,False,17,1528,2072,544
167264,2019-10-13 00:00:00+03:00,in,False,919552,False,17,2614,3219,605
167264,2019-10-13 00:00:00+03:00,in,False,-1,True,13,0,421,421
167264,2019-10-13 00:00:00+03:00,in,False,919554,False,15,1198,1656,458
167264,2019-10-13 00:00:00+03:00,in,False,919552,False,17,2614,3219,605
167264,2019-10-14 00:00:00+03:00,in,False,919554,False,19,1971,2594,623
167264,2019-10-14 00:00:00+03:00,in,False,-1,True,9,0,337,337
167264,2019-10-14 00:00:00+03:00,in,False,919552,False,19,3333,3946,613
167264,2019-10-15 00:00:00+03:00,in,False,-1,True,9,0,257,257
167264,2019-10-15 00:00:00+03:00,in,False,919554,False,21,2136,2804,668
167264,2019-10-15 00:00:00+03:00,in,False,919552,False,20,2059,2643,584
167264,2019-10-16 00:00:00+03:00,out,False,919552,False,1,1,24,23
167264,2019-10-16 00:00:00+03:00,in,False,919552,False,21,1895,2563,668
167264,2019-10-16 00:00:00+03:00,in,False,-1,True,8,0,414,414
167264,2019-10-16 00:00:00+03:00,in,False,919554,False,21,2058,2784,726
167264,2019-10-17 00:00:00+03:00,in,False,-1,True,15,0,819,819
167264,2019-10-17 00:00:00+03:00,in,False,919554,False,25,2265,3062,797
167264,2019-10-17 00:00:00+03:00,in,False,919552,False,29,4220,5086,866
167264,2019-10-17 00:00:00+03:00,out,True,919552,True,3,0,0,0
167264,2019-10-17 00:00:00+03:00,out,False,919552,False,1,184,191,7
167264,2019-10-17 00:00:00+03:00,out,False,919552,True,1,0,16,16
167264,2019-10-17 00:00:00+03:00,in,False,919554,True,1,49,75,26
167264,2019-10-17 00:00:00+03:00,in,False,-1,True,15,0,819,819
167264,2019-10-18 00:00:00+03:00,in,False,919552,False,25,3027,3859,832
167264,2019-10-18 00:00:00+03:00,in,False,919554,False,22,1589,2272,683
167264,2019-10-18 00:00:00+03:00,in,False,-1,True,13,0,496,496
167264,2019-10-19 00:00:00+03:00,out,False,919552,False,2,450,490,40
167264,2019-10-19 00:00:00+03:00,in,False,-1,True,6,0,247,247
167264,2019-10-19 00:00:00+03:00,out,False,919552,True,1,0,33,33
167264,2019-10-19 00:00:00+03:00,in,False,919554,False,11,1594,1966,372
167264,2019-10-19 00:00:00+03:00,in,False,919552,False,22,2561,3398,837
167264,2019-10-20 00:00:00+03:00,in,False,-1,True,7,0,167,167
167264,2019-10-20 00:00:00+03:00,in,False,919554,False,16,1239,1774,535
167264,2019-10-20 00:00:00+03:00,in,False,919552,False,8,646,882,236
167264,2019-10-21 00:00:00+03:00,in,False,919554,False,22,1788,2469,681
167264,2019-10-21 00:00:00+03:00,in,False,-1,True,12,0,537,537
167264,2019-10-21 00:00:00+03:00,out,False,919552,True,2,0,63,63
167264,2019-10-21 00:00:00+03:00,out,False,919552,False,1,83,98,15
167264,2019-10-21 00:00:00+03:00,in,False,919554,True,1,1,32,31
167264,2019-10-21 00:00:00+03:00,in,False,919552,False,17,1888,2506,618
167264,2019-10-22 00:00:00+03:00,in,False,919554,False,20,1544,2153,609
167264,2019-10-22 00:00:00+03:00,in,False,-1,True,20,0,712,712
167264,2019-10-22 00:00:00+03:00,in,False,919554,True,1,84,125,41
167264,2019-10-22 00:00:00+03:00,in,False,919552,False,26,3774,4676,902
167264,2019-10-22 00:00:00+03:00,out,False,919552,False,1,183,196,13
167264,2019-10-23 00:00:00+03:00,in,False,919554,False,20,1946,2572,626
167264,2019-10-23 00:00:00+03:00,in,False,919552,False,26,3795,4723,928
167264,2019-10-23 00:00:00+03:00,in,False,-1,True,17,0,749,749
167264,2019-10-23 00:00:00+03:00,out,False,919552,False,1,121,131,10
167264,2019-10-23 00:00:00+03:00,in,False,919552,False,26,3795,4723,928
167264,2019-10-23 00:00:00+03:00,in,False,919554,False,20,1946,2572,626
167264,2019-10-24 00:00:00+03:00,in,False,919554,False,25,2823,3693,870
167264,2019-10-24 00:00:00+03:00,in,False,919552,False,18,1721,2365,644
167264,2019-10-24 00:00:00+03:00,in,False,-1,True,11,0,330,330
167264,2019-10-24 00:00:00+03:00,out,False,919552,False,2,8,20,12
167264,2019-10-25 00:00:00+03:00,in,False,919552,False,18,2341,2924,583
167264,2019-10-25 00:00:00+03:00,in,False,-1,True,13,0,551,551
167264,2019-10-25 00:00:00+03:00,in,False,919554,False,37,2647,3810,1163
167264,2019-10-25 00:00:00+03:00,in,False,-1,True,13,0,551,551
167264,2019-10-25 00:00:00+03:00,in,False,919554,False,37,2647,3810,1163
167264,2019-10-26 00:00:00+03:00,in,False,919552,False,7,1006,1276,270
167264,2019-10-26 00:00:00+03:00,in,False,-1,True,2,0,49,49
167264,2019-10-26 00:00:00+03:00,in,False,919554,False,13,880,1315,435
167264,2019-10-26 00:00:00+03:00,in,False,-1,True,2,0,49,49
167264,2019-10-26 00:00:00+03:00,in,False,919552,False,7,1006,1276,270
167264,2019-10-27 00:00:00+03:00,in,False,919554,False,13,1049,1459,410
167264,2019-10-27 00:00:00+03:00,out,False,919552,True,1,0,30,30
167264,2019-10-27 00:00:00+03:00,in,False,919552,False,11,1010,1430,420
167264,2019-10-27 00:00:00+03:00,in,False,-1,True,1,0,12,12
167264,2019-10-28 00:00:00+03:00,in,False,919554,False,31,4270,5245,975
167264,2019-10-28 00:00:00+03:00,in,False,919552,False,25,2902,3801,899
167264,2019-10-28 00:00:00+03:00,in,False,-1,True,6,0,151,151
167264,2019-10-28 00:00:00+03:00,out,False,919552,False,1,6,44,38
167264,2019-10-29 00:00:00+03:00,in,False,919554,False,16,1030,1483,453
167264,2019-10-29 00:00:00+03:00,in,False,-1,True,12,0,437,437
167264,2019-10-29 00:00:00+03:00,in,False,919552,False,24,2371,3146,775
167264,2019-10-30 00:00:00+03:00,in,False,-1,True,12,0,453,453
167264,2019-10-30 00:00:00+03:00,in,False,919552,False,17,1945,2500,555
167264,2019-10-30 00:00:00+03:00,in,False,919554,False,22,1889,2558,669
167264,2019-10-30 00:00:00+03:00,in,False,-1,True,12,0,453,453
167264,2019-10-31 00:00:00+03:00,in,False,919554,False,25,2092,2853,761
167264,2019-10-31 00:00:00+03:00,in,False,919552,False,25,3244,4169,925
167264,2019-10-31 00:00:00+03:00,in,False,-1,True,9,0,445,445
167264,2019-10-31 00:00:00+03:00,in,False,919552,False,25,3244,4169,925
167264,2019-11-01 00:00:00+03:00,in,False,919554,False,21,2790,3479,689
167264,2019-11-01 00:00:00+03:00,in,False,919552,False,11,2016,2413,397
167264,2019-11-01 00:00:00+03:00,out,False,919554,False,3,1981,2028,47
167264,2019-11-01 00:00:00+03:00,in,False,-1,True,3,0,154,154
167264,2019-11-01 00:00:00+03:00,in,False,919554,False,21,2790,3479,689
167264,2019-11-02 00:00:00+03:00,out,False,919552,True,1,0,47,47
167264,2019-11-02 00:00:00+03:00,in,False,919552,False,15,1553,2174,621
167264,2019-11-02 00:00:00+03:00,in,False,919554,False,13,1125,1562,437
167264,2019-11-02 00:00:00+03:00,in,False,-1,True,8,0,239,239
167264,2019-11-02 00:00:00+03:00,out,False,919552,True,1,0,47,47
167264,2019-11-03 00:00:00+03:00,in,False,-1,True,5,0,189,189
167264,2019-11-03 00:00:00+03:00,in,False,919554,True,1,119,161,42
167264,2019-11-03 00:00:00+03:00,in,False,919552,False,13,2142,2573,431
167264,2019-11-03 00:00:00+03:00,in,False,919554,False,11,727,1043,316
167264,2019-11-04 00:00:00+03:00,in,False,919552,False,10,1244,1603,359
167264,2019-11-04 00:00:00+03:00,in,False,-1,True,3,0,73,73
167264,2019-11-04 00:00:00+03:00,in,False,919554,False,10,970,1301,331
167264,2019-11-05 00:00:00+03:00,in,False,919552,False,13,1508,1967,459
167264,2019-11-05 00:00:00+03:00,out,False,919552,False,1,198,208,10
167264,2019-11-05 00:00:00+03:00,in,False,919554,False,34,4686,5717,1031
167264,2019-11-05 00:00:00+03:00,in,False,-1,True,3,0,174,174
167264,2019-11-05 00:00:00+03:00,out,False,919554,False,1,6,42,36
167264,2019-11-06 00:00:00+03:00,in,False,919552,False,27,3564,4578,1014
167264,2019-11-06 00:00:00+03:00,in,False,919554,False,26,1339,2279,940
167264,2019-11-06 00:00:00+03:00,out,False,919552,False,2,310,325,15
167264,2019-11-06 00:00:00+03:00,in,False,-1,True,10,0,313,313
167264,2019-11-06 00:00:00+03:00,in,False,919552,True,1,100,154,54
167264,2019-11-06 00:00:00+03:00,out,False,919552,False,2,310,325,15
167264,2019-11-07 00:00:00+03:00,out,True,919554,True,1,0,0,0
167264,2019-11-07 00:00:00+03:00,in,False,-1,True,2,0,47,47
167264,2019-11-07 00:00:00+03:00,in,False,919552,False,23,2350,3179,829
167264,2019-11-07 00:00:00+03:00,out,False,919552,False,3,569,582,13
167264,2019-11-07 00:00:00+03:00,in,False,919554,False,13,1261,1719,458
167264,2019-11-08 00:00:00+03:00,in,False,919552,False,17,1925,2545,620
167264,2019-11-08 00:00:00+03:00,in,False,-1,True,9,0,350,350
167264,2019-11-08 00:00:00+03:00,in,False,919554,False,19,1189,1742,553
167264,2019-11-09 00:00:00+03:00,in,False,919554,False,15,1106,1545,439
167264,2019-11-09 00:00:00+03:00,in,False,-1,True,4,0,199,199
167264,2019-11-09 00:00:00+03:00,out,False,919552,False,1,96,108,12
167264,2019-11-09 00:00:00+03:00,in,False,919552,False,12,1067,1423,356
167264,2019-11-09 00:00:00+03:00,out,False,919554,False,1,91,99,8
167264,2019-11-10 00:00:00+03:00,out,False,919552,False,1,34,41,7
167264,2019-11-10 00:00:00+03:00,in,False,919552,False,13,2830,3331,501
167264,2019-11-10 00:00:00+03:00,in,False,919554,False,15,1232,1696,464
167264,2019-11-10 00:00:00+03:00,in,False,-1,True,6,0,317,317
167264,2019-11-11 00:00:00+03:00,in,False,919554,True,1,36,79,43
167264,2019-11-11 00:00:00+03:00,in,False,-1,True,22,0,759,759
167264,2019-11-11 00:00:00+03:00,in,False,919554,False,23,1592,2297,705
167264,2019-11-11 00:00:00+03:00,in,False,919552,False,42,4808,6207,1399
167264,2019-11-12 00:00:00+03:00,out,False,919552,False,1,113,114,1
167264,2019-11-12 00:00:00+03:00,in,False,919554,False,23,1693,2414,721
167264,2019-11-12 00:00:00+03:00,in,False,919552,False,23,2322,3121,799
167264,2019-11-12 00:00:00+03:00,in,False,-1,True,7,0,228,228
167264,2019-11-13 00:00:00+03:00,out,False,919552,False,1,85,95,10
167264,2019-11-13 00:00:00+03:00,in,False,919552,False,23,2152,2873,721
167264,2019-11-13 00:00:00+03:00,in,False,-1,True,8,0,291,291
167264,2019-11-13 00:00:00+03:00,in,False,919554,False,14,2388,2839,451
167264,2019-11-14 00:00:00+03:00,in,False,919552,False,32,4331,5328,997
167264,2019-11-14 00:00:00+03:00,out,False,919552,False,1,52,52,0
167264,2019-11-14 00:00:00+03:00,in,False,-1,True,34,0,1385,1385
167264,2019-11-14 00:00:00+03:00,in,False,919554,False,23,1810,2566,756
167264,2019-11-14 00:00:00+03:00,out,False,919552,False,1,52,52,0
167264,2019-11-15 00:00:00+03:00,in,False,919552,False,16,2360,2986,626
167264,2019-11-15 00:00:00+03:00,in,False,919554,False,17,1267,1755,488
167264,2019-11-15 00:00:00+03:00,in,False,-1,True,21,0,695,695
167264,2019-11-15 00:00:00+03:00,out,False,919552,False,2,92,109,17
167264,2019-11-16 00:00:00+03:00,in,False,-1,True,3,0,99,99
167264,2019-11-16 00:00:00+03:00,in,False,919554,False,13,1694,2095,401
167264,2019-11-16 00:00:00+03:00,in,False,919552,False,12,815,1183,368
167264,2019-11-16 00:00:00+03:00,in,False,919552,False,12,815,1183,368
167264,2019-11-17 00:00:00+03:00,in,False,919554,False,9,656,905,249
167264,2019-11-17 00:00:00+03:00,in,False,-1,True,7,0,164,164
167264,2019-11-17 00:00:00+03:00,in,False,919552,False,8,693,913,220
167264,2019-11-18 00:00:00+03:00,in,False,-1,True,15,0,482,482
167264,2019-11-18 00:00:00+03:00,in,False,919552,False,23,2657,3392,735
167264,2019-11-18 00:00:00+03:00,out,False,919552,False,1,9,13,4
167264,2019-11-18 00:00:00+03:00,in,False,919554,False,24,2389,3157,768
167264,2019-11-18 00:00:00+03:00,in,False,919554,False,24,2389,3157,768
167264,2019-11-19 00:00:00+03:00,out,False,919552,False,1,66,72,6
167264,2019-11-19 00:00:00+03:00,in,False,919552,False,22,3886,4722,836
167264,2019-11-19 00:00:00+03:00,in,False,919554,False,30,2701,3674,973
167264,2019-11-19 00:00:00+03:00,in,False,919554,True,1,120,147,27
167264,2019-11-19 00:00:00+03:00,in,False,-1,True,10,0,351,351
167264,2019-11-20 00:00:00+03:00,in,False,919552,False,28,1894,2774,880
167264,2019-11-20 00:00:00+03:00,in,False,919554,False,20,1192,1912,720
167264,2019-11-20 00:00:00+03:00,out,False,919554,False,2,559,563,4
167264,2019-11-20 00:00:00+03:00,out,False,919552,False,4,680,687,7
167264,2019-11-20 00:00:00+03:00,in,False,-1,True,24,0,764,764
167264,2019-11-20 00:00:00+03:00,out,False,919554,False,2,559,563,4
167264,2019-11-21 00:00:00+03:00,in,False,-1,True,6,0,245,245
167264,2019-11-21 00:00:00+03:00,in,False,919554,False,22,2577,3291,714
167264,2019-11-21 00:00:00+03:00,in,False,919552,False,17,1967,2629,662
167264,2019-11-21 00:00:00+03:00,in,False,919554,True,1,125,151,26
167264,2019-11-21 00:00:00+03:00,in,False,919554,False,22,2577,3291,714
167264,2019-11-21 00:00:00+03:00,in,False,919552,False,17,1967,2629,662
167264,2019-11-22 00:00:00+03:00,in,False,919552,False,18,2362,2940,578
167264,2019-11-22 00:00:00+03:00,in,False,919554,False,21,3031,3794,763
167264,2019-11-22 00:00:00+03:00,out,False,919552,True,1,0,0,0
167264,2019-11-22 00:00:00+03:00,in,False,-1,True,18,0,623,623
167264,2019-11-23 00:00:00+03:00,out,False,919552,False,2,367,393,26
167264,2019-11-23 00:00:00+03:00,in,False,919554,False,11,808,1125,317
167264,2019-11-23 00:00:00+03:00,in,False,919554,True,1,87,116,29
167264,2019-11-23 00:00:00+03:00,in,False,-1,True,9,0,429,429
167264,2019-11-23 00:00:00+03:00,in,False,919552,False,10,2933,3260,327
167264,2019-11-23 00:00:00+03:00,in,False,919552,False,10,2933,3260,327
167264,2019-11-23 00:00:00+03:00,in,False,-1,True,9,0,429,429
167264,2019-11-24 00:00:00+03:00,in,False,919552,False,8,656,948,292
167264,2019-11-24 00:00:00+03:00,in,False,919554,False,10,642,963,321
167264,2019-11-24 00:00:00+03:00,in,False,-1,True,3,0,89,89
167264,2019-11-24 00:00:00+03:00,in,False,-1,True,3,0,89,89
167264,2019-11-25 00:00:00+03:00,in,False,-1,True,40,0,662,662
167264,2019-11-25 00:00:00+03:00,in,False,919554,True,1,131,172,41
167264,2019-11-25 00:00:00+03:00,in,False,919554,False,19,1357,1970,613
167264,2019-11-25 00:00:00+03:00,in,False,919552,False,26,2895,3702,807
167264,2019-11-25 00:00:00+03:00,in,False,919552,False,26,2895,3702,807
167264,2019-11-26 00:00:00+03:00,in,False,919554,False,17,1354,1844,490
167264,2019-11-26 00:00:00+03:00,in,False,919552,False,16,2290,2803,513
167264,2019-11-26 00:00:00+03:00,in,False,-1,True,25,0,1109,1109
167264,2019-11-26 00:00:00+03:00,out,False,919552,False,3,325,356,31
167264,2019-11-27 00:00:00+03:00,out,False,919552,False,2,165,175,10
167264,2019-11-27 00:00:00+03:00,in,False,-1,True,14,0,594,594
167264,2019-11-27 00:00:00+03:00,in,False,919552,False,15,1467,1994,527
167264,2019-11-27 00:00:00+03:00,in,False,919554,False,30,3344,4278,934
167264,2019-11-27 00:00:00+03:00,out,True,919554,True,1,0,0,0
167264,2019-11-27 00:00:00+03:00,out,True,919554,True,1,0,0,0
167264,2019-11-28 00:00:00+03:00,in,False,919554,False,14,1408,1874,466
167264,2019-11-28 00:00:00+03:00,in,False,919554,True,1,20,64,44
167264,2019-11-28 00:00:00+03:00,in,False,919552,False,21,2772,3481,709
167264,2019-11-28 00:00:00+03:00,in,False,-1,True,8,0,397,397
167265,2019-09-20 00:00:00+03:00,in,False,-1,True,1,0,2,2
167265,2019-09-21 00:00:00+03:00,in,False,-1,True,1,0,2,2
167265,2019-09-21 00:00:00+03:00,in,False,-1,True,1,0,2,2
167265,2019-10-09 00:00:00+03:00,in,False,-1,True,1,0,2,2
167265,2019-10-15 00:00:00+03:00,in,False,-1,True,1,0,1,1
167265,2019-10-18 00:00:00+03:00,in,False,-1,True,1,0,2,2
167265,2019-10-25 00:00:00+03:00,in,False,-1,True,2,0,4,4
167265,2019-11-28 00:00:00+03:00,in,False,-1,True,1,0,2,2
167272,2019-09-11 00:00:00+03:00,in,False,-1,True,1,0,2,2
167272,2019-09-12 00:00:00+03:00,in,False,-1,True,2,0,21,21
167272,2019-09-12 00:00:00+03:00,in,False,910018,False,1,14,22,8
167272,2019-09-13 00:00:00+03:00,in,False,-1,True,2,0,22,22
167272,2019-09-16 00:00:00+03:00,in,False,-1,True,1,0,40,40
167272,2019-09-20 00:00:00+03:00,in,False,910018,False,1,1070,1088,18
167272,2019-09-20 00:00:00+03:00,in,True,912684,False,1,10,73,63
167272,2019-09-24 00:00:00+03:00,in,False,910018,False,4,2269,2339,70
167272,2019-09-24 00:00:00+03:00,in,False,912684,False,1,252,302,50
167272,2019-09-25 00:00:00+03:00,in,False,910018,False,1,446,480,34
167272,2019-09-25 00:00:00+03:00,in,False,910018,False,1,446,480,34
167272,2019-09-26 00:00:00+03:00,in,False,912684,False,1,36,86,50
167272,2019-09-26 00:00:00+03:00,in,False,910018,False,3,2233,2290,57
167272,2019-09-28 00:00:00+03:00,in,False,910018,False,1,26,53,27
167272,2019-09-30 00:00:00+03:00,in,False,910018,False,2,232,269,37
167272,2019-10-01 00:00:00+03:00,in,False,910018,False,2,410,445,35
167272,2019-10-01 00:00:00+03:00,in,False,-1,True,1,0,0,0
167272,2019-10-02 00:00:00+03:00,in,False,910018,False,1,311,334,23
167272,2019-10-02 00:00:00+03:00,in,False,912684,False,1,19,71,52
167272,2019-10-03 00:00:00+03:00,in,False,910018,False,4,411,480,69
167272,2019-10-03 00:00:00+03:00,in,False,912684,False,2,187,288,101
167272,2019-10-03 00:00:00+03:00,in,False,-1,True,3,0,150,150
167272,2019-10-05 00:00:00+03:00,in,False,910018,False,1,387,412,25
167272,2019-10-07 00:00:00+03:00,in,False,910018,False,1,261,276,15
167272,2019-10-08 00:00:00+03:00,in,False,910018,False,1,34,57,23
167272,2019-10-09 00:00:00+03:00,in,False,-1,True,1,0,8,8
167272,2019-10-09 00:00:00+03:00,in,False,-1,True,1,0,7,7
167272,2019-10-09 00:00:00+03:00,in,False,910018,False,1,44,66,22
167272,2019-10-09 00:00:00+03:00,in,True,912684,False,1,4,25,21
167272,2019-10-10 00:00:00+03:00,in,False,912684,False,8,930,1114,184
167272,2019-10-10 00:00:00+03:00,in,False,910018,False,2,257,357,100
167272,2019-10-12 00:00:00+03:00,in,False,-1,True,3,0,170,170
167272,2019-10-14 00:00:00+03:00,in,False,912684,False,4,362,450,88
167272,2019-10-15 00:00:00+03:00,in,False,912684,False,1,37,61,24
167272,2019-10-15 00:00:00+03:00,in,False,-1,True,1,0,7,7
167272,2019-10-15 00:00:00+03:00,in,False,910018,False,1,61,81,20
167272,2019-10-15 00:00:00+03:00,in,True,912684,False,1,10,43,33
167272,2019-10-15 00:00:00+03:00,in,False,-1,True,1,0,7,7
167272,2019-10-16 00:00:00+03:00,in,False,912684,False,1,61,116,55
167272,2019-10-16 00:00:00+03:00,in,True,910018,False,1,26,53,27
167272,2019-10-16 00:00:00+03:00,in,False,910018,False,1,527,546,19
167272,2019-10-16 00:00:00+03:00,in,True,910018,False,1,26,53,27
167272,2019-10-16 00:00:00+03:00,in,False,910018,False,1,527,546,19
167272,2019-10-17 00:00:00+03:00,in,False,910018,False,2,789,836,47
167272,2019-10-18 00:00:00+03:00,in,False,910018,False,9,1491,1719,228
167272,2019-10-20 00:00:00+03:00,in,False,910018,False,1,118,148,30
167272,2019-10-20 00:00:00+03:00,in,False,910018,False,1,118,148,30
167272,2019-10-21 00:00:00+03:00,in,False,910018,False,3,980,1061,81
167272,2019-10-22 00:00:00+03:00,in,False,910018,False,2,172,215,43
167272,2019-10-22 00:00:00+03:00,in,False,910018,False,2,172,215,43
167272,2019-10-23 00:00:00+03:00,in,False,910018,False,2,266,303,37
167272,2019-10-24 00:00:00+03:00,in,False,910018,False,1,382,403,21
167272,2019-10-24 00:00:00+03:00,in,False,-1,True,1,0,5,5
167272,2019-10-24 00:00:00+03:00,in,False,910018,False,1,382,403,21
167272,2019-10-25 00:00:00+03:00,in,False,910018,False,4,339,443,104
167272,2019-10-25 00:00:00+03:00,in,False,-1,True,2,0,20,20
167272,2019-10-28 00:00:00+03:00,in,False,-1,True,1,0,36,36
167272,2019-10-28 00:00:00+03:00,in,False,910018,False,4,573,685,112
167272,2019-10-28 00:00:00+03:00,in,False,-1,True,1,0,36,36
167272,2019-10-29 00:00:00+03:00,in,False,910018,False,1,24,42,18
167272,2019-10-30 00:00:00+03:00,in,False,910018,False,5,860,967,107
167272,2019-10-30 00:00:00+03:00,in,False,912684,True,1,1,61,60
167272,2019-10-31 00:00:00+03:00,in,False,910018,False,1,33,54,21
167272,2019-10-31 00:00:00+03:00,in,False,-1,True,1,0,12,12
167272,2019-11-05 00:00:00+03:00,in,False,910018,False,2,382,424,42
167272,2019-11-06 00:00:00+03:00,in,False,910018,False,2,541,610,69
167272,2019-11-07 00:00:00+03:00,in,False,910018,False,3,210,265,55
167272,2019-11-08 00:00:00+03:00,in,False,910018,False,2,163,228,65
167272,2019-11-11 00:00:00+03:00,in,False,910018,False,3,634,693,59
167272,2019-11-14 00:00:00+03:00,in,False,910018,False,3,233,309,76
167272,2019-11-15 00:00:00+03:00,in,False,910018,False,3,428,520,92
167272,2019-11-17 00:00:00+03:00,in,False,910018,False,1,123,147,24
167272,2019-11-19 00:00:00+03:00,in,False,910018,False,3,164,275,111
167272,2019-11-19 00:00:00+03:00,in,False,910018,False,3,164,275,111
167272,2019-11-20 00:00:00+03:00,in,False,910018,False,11,1696,1984,288
167272,2019-11-20 00:00:00+03:00,in,False,-1,True,1,0,5,5
167272,2019-11-21 00:00:00+03:00,in,False,910018,False,1,714,738,24
167272,2019-11-22 00:00:00+03:00,in,False,-1,True,1,0,19,19
167272,2019-11-22 00:00:00+03:00,in,False,910018,False,5,1158,1269,111
167272,2019-11-23 00:00:00+03:00,in,False,-1,True,2,0,73,73
167272,2019-11-23 00:00:00+03:00,in,False,910018,False,1,9,56,47
167272,2019-11-24 00:00:00+03:00,in,False,910018,False,2,39,132,93
167272,2019-11-24 00:00:00+03:00,in,False,-1,True,1,0,32,32
167272,2019-11-25 00:00:00+03:00,in,False,-1,True,1,0,20,20
167272,2019-11-25 00:00:00+03:00,in,True,910018,False,2,8,35,27
167272,2019-11-25 00:00:00+03:00,in,False,-1,True,1,0,4,4
167272,2019-11-25 00:00:00+03:00,in,False,910018,False,5,355,428,73
167272,2019-11-25 00:00:00+03:00,in,False,912684,False,1,43,99,56
167272,2019-11-26 00:00:00+03:00,in,False,910018,False,4,776,847,71
167272,2019-11-27 00:00:00+03:00,in,False,910018,False,2,638,677,39
167272,2019-11-27 00:00:00+03:00,in,False,912684,False,1,31,83,52
167272,2019-11-28 00:00:00+03:00,in,False,910018,False,3,254,302,48
167272,2019-11-28 00:00:00+03:00,in,False,912684,False,1,142,159,17
167272,2019-11-28 00:00:00+03:00,in,False,-1,True,1,0,44,44
167275,2019-09-12 00:00:00+03:00,in,False,-1,True,1,0,2,2
167275,2019-09-25 00:00:00+03:00,out,False,919536,True,4,0,31,31
167275,2019-09-25 00:00:00+03:00,out,False,919536,False,1,89,96,7
167275,2019-09-25 00:00:00+03:00,in,False,919536,False,1,29,40,11
167275,2019-09-25 00:00:00+03:00,in,False,-1,True,2,0,4,4
167275,2019-09-25 00:00:00+03:00,out,False,919536,True,4,0,31,31
167275,2019-09-25 00:00:00+03:00,out,False,919536,False,1,89,96,7
167275,2019-09-26 00:00:00+03:00,out,False,919536,False,1,291,301,10
167275,2019-09-26 00:00:00+03:00,out,False,919536,True,1,0,32,32
167275,2019-09-27 00:00:00+03:00,in,False,-1,True,3,0,0,0
167275,2019-09-30 00:00:00+03:00,in,False,-1,True,6,0,37,37
167275,2019-09-30 00:00:00+03:00,out,False,919536,True,1,0,7,7
167275,2019-09-30 00:00:00+03:00,in,False,919536,False,1,29,36,7
167275,2019-10-24 00:00:00+03:00,in,False,946032,False,1,95,103,8
167275,2019-10-28 00:00:00+03:00,in,False,-1,True,1,0,1,1
167275,2019-10-30 00:00:00+03:00,in,False,-1,True,1,0,20,20
167275,2019-11-07 00:00:00+03:00,in,False,-1,True,1,0,30,30
167275,2019-11-13 00:00:00+03:00,in,False,946020,False,1,5,8,3
167275,2019-11-21 00:00:00+03:00,in,False,-1,True,2,0,25,25
167275,2019-11-21 00:00:00+03:00,out,True,967310,True,4,0,71,71
167275,2019-11-21 00:00:00+03:00,in,False,-1,True,1,0,16,16
167275,2019-11-21 00:00:00+03:00,in,False,967310,False,1,53,61,8
167275,2019-11-21 00:00:00+03:00,out,False,967310,True,4,0,54,54
167275,2019-11-21 00:00:00+03:00,out,False,967310,False,7,359,570,211
167275,2019-11-22 00:00:00+03:00,out,False,967310,False,3,134,176,42
167275,2019-11-22 00:00:00+03:00,out,False,967310,True,6,0,145,145
167275,2019-11-22 00:00:00+03:00,out,True,967310,True,1,0,13,13
167275,2019-11-26 00:00:00+03:00,out,False,967310,False,2,38,97,59
167275,2019-11-26 00:00:00+03:00,out,False,967310,True,6,0,143,143
167275,2019-11-26 00:00:00+03:00,out,True,967310,False,3,49,74,25
167275,2019-11-26 00:00:00+03:00,out,False,967310,True,6,0,143,143
167275,2019-11-27 00:00:00+03:00,out,False,967310,True,1,0,10,10
167275,2019-11-27 00:00:00+03:00,out,False,967310,False,9,478,631,153
167275,2019-11-28 00:00:00+03:00,out,False,967310,False,5,235,324,89
167275,2019-11-28 00:00:00+03:00,out,False,967310,True,1,0,0,0
167277,2019-09-13 00:00:00+03:00,in,False,-1,True,2,0,28,28
167277,2019-09-13 00:00:00+03:00,in,False,-1,True,2,0,4,4
167277,2019-09-30 00:00:00+03:00,in,False,-1,True,1,0,2,2
167277,2019-10-04 00:00:00+03:00,in,False,910224,False,1,17,31,14
167277,2019-10-04 00:00:00+03:00,in,False,-1,True,1,0,21,21
167277,2019-10-10 00:00:00+03:00,in,False,-1,True,1,0,30,30
167277,2019-10-18 00:00:00+03:00,in,False,910224,False,1,57,64,7
167277,2019-10-22 00:00:00+03:00,in,False,910224,False,1,16,21,5
167277,2019-11-15 00:00:00+03:00,in,False,910224,False,2,12,59,47
167277,2019-11-19 00:00:00+03:00,in,False,910224,False,1,22,30,8
167277,2019-11-22 00:00:00+03:00,in,False,910224,False,1,66,83,17
167277,2019-11-25 00:00:00+03:00,in,False,910224,False,2,42,77,35
167277,2019-11-26 00:00:00+03:00,in,False,910224,False,2,101,121,20
167277,2019-11-26 00:00:00+03:00,in,False,-1,True,2,0,53,53
167285,2019-09-10 00:00:00+03:00,out,False,908640,True,1,0,5,5
167285,2019-09-10 00:00:00+03:00,out,False,908640,False,1,73,86,13
167285,2019-09-11 00:00:00+03:00,out,False,908640,True,1,0,27,27
167285,2019-09-11 00:00:00+03:00,out,False,908640,False,2,349,380,31
167285,2019-09-11 00:00:00+03:00,out,True,908640,False,1,49,52,3
167285,2019-09-11 00:00:00+03:00,out,True,908640,True,1,0,0,0
167285,2019-09-24 00:00:00+03:00,out,False,908640,True,51,0,715,715
167285,2019-09-24 00:00:00+03:00,out,False,908640,False,35,1899,2209,310
167285,2019-09-24 00:00:00+03:00,out,False,908640,False,35,1899,2209,310
167285,2019-10-02 00:00:00+03:00,out,False,908640,True,56,0,736,736
167285,2019-10-02 00:00:00+03:00,out,False,908640,False,54,2822,3259,437
167285,2019-10-02 00:00:00+03:00,out,False,908640,True,56,0,736,736
167285,2019-10-03 00:00:00+03:00,in,False,-1,True,2,0,2,2
167285,2019-10-03 00:00:00+03:00,out,False,908640,False,168,5510,6898,1388
167285,2019-10-03 00:00:00+03:00,out,False,908640,True,303,0,3158,3158
167285,2019-10-03 00:00:00+03:00,out,False,-1,True,1,0,3,3
167285,2019-10-03 00:00:00+03:00,out,False,-1,True,1,0,3,3
167285,2019-10-04 00:00:00+03:00,in,False,-1,True,3,0,3,3
167285,2019-10-04 00:00:00+03:00,out,False,908640,False,224,6370,8359,1989
167285,2019-10-04 00:00:00+03:00,out,False,-1,True,1,0,1,1
167285,2019-10-04 00:00:00+03:00,out,False,908640,True,512,0,6448,6448
167285,2019-10-07 00:00:00+03:00,out,False,908640,True,332,0,2791,2791
167285,2019-10-07 00:00:00+03:00,out,False,908640,False,308,13589,15955,2366
167285,2019-10-07 00:00:00+03:00,in,False,-1,True,8,0,4,4
167285,2019-10-07 00:00:00+03:00,in,False,-1,True,8,0,4,4
167285,2019-10-08 00:00:00+03:00,out,False,-1,True,4,0,3,3
167285,2019-10-08 00:00:00+03:00,out,False,908640,False,330,14730,17419,2689
167285,2019-10-08 00:00:00+03:00,in,False,-1,True,4,0,4,4
167285,2019-10-08 00:00:00+03:00,out,False,908640,True,441,0,4231,4231
167285,2019-10-09 00:00:00+03:00,out,False,908640,True,1055,0,5153,5153
167285,2019-10-09 00:00:00+03:00,in,False,-1,True,5,0,5,5
167285,2019-10-09 00:00:00+03:00,out,False,-1,True,2,0,0,0
167285,2019-10-09 00:00:00+03:00,out,False,908640,False,397,18169,21531,3362
167285,2019-10-09 00:00:00+03:00,in,False,-1,True,5,0,5,5
167285,2019-10-10 00:00:00+03:00,in,False,-1,True,7,0,5,5
167285,2019-10-10 00:00:00+03:00,out,False,908640,False,517,22990,27235,4245
167285,2019-10-10 00:00:00+03:00,out,False,908640,True,385,0,5534,5534
167285,2019-10-11 00:00:00+03:00,out,True,908640,False,1,284,287,3
167285,2019-10-11 00:00:00+03:00,out,False,908640,True,631,0,9824,9824
167285,2019-10-11 00:00:00+03:00,out,False,908640,False,490,20428,24863,4435
167285,2019-10-11 00:00:00+03:00,in,False,-1,True,11,0,12,12
167285,2019-10-11 00:00:00+03:00,out,False,908640,True,631,0,9824,9824
167285,2019-10-11 00:00:00+03:00,out,True,908640,False,1,284,287,3
167285,2019-10-14 00:00:00+03:00,out,False,-1,True,2,0,1,1
167285,2019-10-14 00:00:00+03:00,out,False,908640,False,241,12611,14549,1938
167285,2019-10-14 00:00:00+03:00,out,False,908640,True,155,0,1278,1278
167285,2019-10-14 00:00:00+03:00,out,False,908640,False,241,12611,14549,1938
167285,2019-10-15 00:00:00+03:00,out,False,908640,True,310,0,3958,3958
167285,2019-10-15 00:00:00+03:00,out,False,908640,False,310,13928,16813,2885
167285,2019-10-15 00:00:00+03:00,in,False,-1,True,5,0,5,5
167285,2019-10-15 00:00:00+03:00,out,False,-1,True,2,0,2,2
167285,2019-10-15 00:00:00+03:00,out,False,908640,True,310,0,3958,3958
167285,2019-10-16 00:00:00+03:00,out,False,908640,True,366,0,4915,4915
167285,2019-10-16 00:00:00+03:00,out,False,-1,True,2,0,0,0
167285,2019-10-16 00:00:00+03:00,in,False,-1,True,18,0,12,12
167285,2019-10-16 00:00:00+03:00,out,False,908640,False,392,18049,21605,3556
167285,2019-10-17 00:00:00+03:00,out,True,908640,True,1,0,22,22
167285,2019-10-17 00:00:00+03:00,in,False,-1,True,1,0,1,1
167285,2019-10-17 00:00:00+03:00,out,False,908640,False,262,12382,14735,2353
167285,2019-10-17 00:00:00+03:00,out,False,-1,True,1,0,1,1
167285,2019-10-17 00:00:00+03:00,out,True,908640,False,1,89,108,19
167285,2019-10-17 00:00:00+03:00,out,False,908640,True,217,0,3263,3263
167285,2019-10-17 00:00:00+03:00,in,False,-1,True,1,0,1,1
167285,2019-10-17 00:00:00+03:00,out,True,908640,False,1,89,108,19
167285,2019-10-18 00:00:00+03:00,out,False,908640,True,509,0,7337,7337
167285,2019-10-18 00:00:00+03:00,out,False,-1,True,1,0,0,0
167285,2019-10-18 00:00:00+03:00,out,False,908640,False,549,20620,25327,4707
167285,2019-10-18 00:00:00+03:00,in,False,-1,True,5,0,7,7
167285,2019-10-21 00:00:00+03:00,out,False,-1,True,1,0,0,0
167285,2019-10-21 00:00:00+03:00,out,False,908640,False,560,21727,26825,5098
167285,2019-10-21 00:00:00+03:00,in,False,-1,True,4,0,4,4
167285,2019-10-21 00:00:00+03:00,out,False,908640,True,719,0,9781,9781
167285,2019-10-21 00:00:00+03:00,out,False,908640,False,560,21727,26825,5098
167285,2019-10-22 00:00:00+03:00,out,False,-1,True,1,0,0,0
167285,2019-10-22 00:00:00+03:00,in,False,-1,True,9,0,12,12
167285,2019-10-22 00:00:00+03:00,out,False,908640,False,607,26994,32672,5678
167285,2019-10-22 00:00:00+03:00,out,False,908640,True,1141,0,16994,16994
167285,2019-10-23 00:00:00+03:00,in,False,-1,True,10,0,10,10
167285,2019-10-23 00:00:00+03:00,out,False,908640,False,625,25142,30864,5722
167285,2019-10-23 00:00:00+03:00,out,False,908640,True,977,0,12731,12731
167285,2019-10-23 00:00:00+03:00,out,False,908640,False,625,25142,30864,5722
167286,2019-09-11 00:00:00+03:00,in,False,-1,True,1,0,1,1
167286,2019-09-11 00:00:00+03:00,in,False,909768,False,1,63,81,18
167286,2019-09-12 00:00:00+03:00,in,False,909768,False,1,3,22,19
167286,2019-09-14 00:00:00+03:00,in,False,910540,False,1,24,54,30
167286,2019-09-15 00:00:00+03:00,in,False,-1,True,1,0,7,7
167286,2019-09-17 00:00:00+03:00,in,False,-1,True,1,0,1,1
167286,2019-09-19 00:00:00+03:00,in,False,-1,True,1,0,16,16
167286,2019-09-23 00:00:00+03:00,in,False,-1,True,2,0,68,68
167286,2019-09-23 00:00:00+03:00,in,False,910540,False,2,261,292,31
167286,2019-09-23 00:00:00+03:00,in,False,909768,False,1,473,520,47
167286,2019-09-24 00:00:00+03:00,in,False,910540,False,1,67,78,11
167286,2019-09-24 00:00:00+03:00,in,False,-1,True,1,0,12,12
167286,2019-09-25 00:00:00+03:00,in,False,910540,False,3,366,452,86
167286,2019-09-25 00:00:00+03:00,in,False,-1,True,1,0,1,1
167286,2019-09-26 00:00:00+03:00,in,False,910540,False,1,411,434,23
167286,2019-09-26 00:00:00+03:00,in,False,-1,True,1,0,17,17
167286,2019-09-27 00:00:00+03:00,in,False,-1,True,1,0,5,5
167286,2019-09-27 00:00:00+03:00,in,False,910540,False,3,529,593,64
167286,2019-09-27 00:00:00+03:00,in,False,909768,False,1,108,163,55
167286,2019-09-30 00:00:00+03:00,in,False,910540,False,1,224,250,26
167286,2019-09-30 00:00:00+03:00,in,False,910540,False,1,224,250,26
167286,2019-10-01 00:00:00+03:00,in,False,910540,False,3,951,1012,61
167286,2019-10-02 00:00:00+03:00,in,False,909768,False,1,323,345,22
167286,2019-10-02 00:00:00+03:00,in,False,910540,False,2,73,107,34
167286,2019-10-03 00:00:00+03:00,in,False,910540,False,2,172,221,49
167286,2019-10-04 00:00:00+03:00,in,False,-1,True,3,0,42,42
167286,2019-10-04 00:00:00+03:00,in,False,910540,False,4,880,951,71
167286,2019-10-07 00:00:00+03:00,in,False,910540,False,1,103,121,18
167286,2019-10-08 00:00:00+03:00,in,False,910540,False,2,607,657,50
167286,2019-10-08 00:00:00+03:00,in,False,-1,True,1,0,6,6
167286,2019-10-08 00:00:00+03:00,in,False,-1,True,1,0,9,9
167286,2019-10-08 00:00:00+03:00,in,False,-1,True,1,0,6,6
167286,2019-10-09 00:00:00+03:00,in,False,909768,False,1,367,418,51
167286,2019-10-09 00:00:00+03:00,in,False,910540,False,1,303,320,17
167286,2019-10-10 00:00:00+03:00,in,False,910540,False,2,793,829,36
167286,2019-10-10 00:00:00+03:00,in,False,910540,True,1,0,14,14
167286,2019-10-10 00:00:00+03:00,in,False,-1,True,2,0,22,22
167286,2019-10-10 00:00:00+03:00,in,False,-1,True,2,0,22,22
167286,2019-10-11 00:00:00+03:00,in,False,-1,True,2,0,13,13
167286,2019-10-11 00:00:00+03:00,in,False,910540,False,2,779,828,49
167286,2019-10-12 00:00:00+03:00,in,False,910540,False,2,285,327,42
167286,2019-10-13 00:00:00+03:00,in,False,-1,True,1,0,41,41
167286,2019-10-14 00:00:00+03:00,in,False,910540,False,5,1201,1292,91
167286,2019-10-15 00:00:00+03:00,in,False,910540,False,3,801,858,57
167286,2019-10-16 00:00:00+03:00,in,False,910540,False,2,492,534,42
167286,2019-10-17 00:00:00+03:00,in,False,910540,False,3,767,820,53
167286,2019-10-18 00:00:00+03:00,in,False,910540,False,2,330,373,43
167286,2019-10-20 00:00:00+03:00,in,False,-1,True,1,0,39,39
167286,2019-10-21 00:00:00+03:00,in,False,910540,False,1,413,434,21
167286,2019-10-22 00:00:00+03:00,in,False,910540,False,2,342,375,33
167286,2019-10-24 00:00:00+03:00,in,False,-1,True,1,0,11,11
167286,2019-10-24 00:00:00+03:00,in,False,910540,False,3,310,361,51
167286,2019-10-25 00:00:00+03:00,in,False,910540,False,1,242,266,24
167286,2019-10-26 00:00:00+03:00,in,False,910540,False,1,501,526,25
167286,2019-10-27 00:00:00+03:00,in,False,910540,False,1,29,51,22
167286,2019-10-27 00:00:00+03:00,in,False,-1,True,1,0,11,11
167286,2019-10-28 00:00:00+03:00,in,False,910540,False,2,913,976,63
167286,2019-10-29 00:00:00+03:00,in,False,909768,False,1,58,116,58
167286,2019-10-29 00:00:00+03:00,in,False,910540,False,4,1063,1149,86
167286,2019-10-29 00:00:00+03:00,in,False,-1,True,1,0,1,1
167286,2019-10-29 00:00:00+03:00,in,False,-1,True,1,0,1,1
167286,2019-10-30 00:00:00+03:00,in,False,910540,False,2,574,615,41
167286,2019-10-31 00:00:00+03:00,in,False,910540,False,1,182,200,18
167286,2019-11-01 00:00:00+03:00,in,False,-1,True,1,0,4,4
167286,2019-11-01 00:00:00+03:00,in,False,910540,False,3,786,840,54
167286,2019-11-02 00:00:00+03:00,in,False,910540,False,1,105,124,19
167286,2019-11-03 00:00:00+03:00,in,False,-1,True,1,0,13,13
167286,2019-11-04 00:00:00+03:00,in,False,-1,True,1,0,12,12
167286,2019-11-04 00:00:00+03:00,in,False,910540,False,2,769,826,57
167286,2019-11-04 00:00:00+03:00,in,False,910540,False,2,769,826,57
167286,2019-11-05 00:00:00+03:00,in,False,910540,False,7,1943,2075,132
167286,2019-11-07 00:00:00+03:00,in,False,910540,False,4,1018,1098,80
167286,2019-11-07 00:00:00+03:00,in,False,909768,False,1,1012,1050,38
167286,2019-11-08 00:00:00+03:00,in,False,909768,False,1,322,381,59
167286,2019-11-08 00:00:00+03:00,in,False,-1,True,2,0,13,13
167286,2019-11-08 00:00:00+03:00,in,False,910540,False,1,226,243,17
167286,2019-11-08 00:00:00+03:00,in,False,-1,True,2,0,13,13
167286,2019-11-09 00:00:00+03:00,in,False,910540,False,1,55,79,24
167286,2019-11-09 00:00:00+03:00,in,False,-1,True,1,0,40,40
167286,2019-11-10 00:00:00+03:00,in,False,-1,True,1,0,21,21
167286,2019-11-11 00:00:00+03:00,in,False,910540,False,7,1263,1430,167
167286,2019-11-12 00:00:00+03:00,in,False,910540,False,4,581,657,76
167286,2019-11-13 00:00:00+03:00,in,False,910540,False,4,636,733,97
167286,2019-11-13 00:00:00+03:00,in,False,-1,True,1,0,13,13
167286,2019-11-14 00:00:00+03:00,in,False,910540,False,3,377,462,85
167286,2019-11-15 00:00:00+03:00,in,False,910540,False,1,137,156,19
167286,2019-11-16 00:00:00+03:00,in,False,-1,True,1,0,13,13
167286,2019-11-16 00:00:00+03:00,in,False,909768,False,1,278,337,59
167286,2019-11-16 00:00:00+03:00,in,False,910540,False,2,392,440,48
167286,2019-11-17 00:00:00+03:00,in,False,910540,False,2,219,279,60
167286,2019-11-18 00:00:00+03:00,in,False,909768,False,1,205,232,27
167286,2019-11-18 00:00:00+03:00,in,False,910540,False,4,494,578,84
167286,2019-11-19 00:00:00+03:00,in,False,910540,False,5,593,685,92
167286,2019-11-20 00:00:00+03:00,in,False,910540,False,5,503,607,104
167286,2019-11-21 00:00:00+03:00,in,False,910540,False,4,979,1055,76
167286,2019-11-21 00:00:00+03:00,in,False,-1,True,1,0,1,1
167286,2019-11-21 00:00:00+03:00,in,False,910540,False,4,979,1055,76
167286,2019-11-22 00:00:00+03:00,in,False,910540,False,7,741,881,140
167286,2019-11-22 00:00:00+03:00,in,False,909768,False,1,210,236,26
167286,2019-11-22 00:00:00+03:00,in,False,-1,True,1,0,9,9
167286,2019-11-22 00:00:00+03:00,in,False,910540,False,7,741,881,140
167286,2019-11-23 00:00:00+03:00,in,False,910540,False,1,134,165,31
167286,2019-11-23 00:00:00+03:00,in,False,909768,False,1,478,531,53
167286,2019-11-23 00:00:00+03:00,in,False,910540,False,1,134,165,31
167286,2019-11-24 00:00:00+03:00,in,False,-1,True,3,0,78,78
167286,2019-11-25 00:00:00+03:00,in,False,909768,False,1,1,57,56
167286,2019-11-25 00:00:00+03:00,in,False,-1,True,1,0,1,1
167286,2019-11-25 00:00:00+03:00,in,False,910540,False,5,491,576,85
167286,2019-11-26 00:00:00+03:00,in,False,910540,False,9,991,1179,188
167286,2019-11-27 00:00:00+03:00,in,False,910540,False,3,273,323,50
167286,2019-11-27 00:00:00+03:00,in,False,-1,True,1,0,10,10
167286,2019-11-27 00:00:00+03:00,in,False,-1,True,1,0,10,10
167286,2019-11-28 00:00:00+03:00,in,False,910540,False,1,562,586,24
167288,2019-09-10 00:00:00+03:00,in,False,-1,True,7,0,4,4
167288,2019-09-10 00:00:00+03:00,in,False,-1,True,6,0,0,0
167288,2019-09-11 00:00:00+03:00,out,True,908718,True,1,0,39,39
167288,2019-09-11 00:00:00+03:00,out,False,908718,False,1,44,85,41
167288,2019-09-11 00:00:00+03:00,out,False,908718,True,1,0,36,36
167338,2019-09-18 00:00:00+03:00,in,False,912252,False,1,36,50,14
167338,2019-09-19 00:00:00+03:00,in,False,-1,True,1,0,156,156
167338,2019-09-19 00:00:00+03:00,out,False,912252,False,1,10,11,1
167338,2019-09-19 00:00:00+03:00,in,False,-1,True,1,0,156,156
167338,2019-09-20 00:00:00+03:00,in,False,-1,True,2,0,85,85
167338,2019-09-21 00:00:00+03:00,in,False,912252,False,1,8,30,22
167338,2019-09-22 00:00:00+03:00,out,False,912252,False,3,704,762,58
167338,2019-09-23 00:00:00+03:00,in,False,912252,False,1,522,534,12
167338,2019-09-24 00:00:00+03:00,out,False,912252,False,1,269,293,24
167338,2019-09-25 00:00:00+03:00,out,False,912252,False,2,663,683,20
167338,2019-09-25 00:00:00+03:00,in,False,-1,True,2,0,85,85
167338,2019-09-25 00:00:00+03:00,in,False,912252,False,1,101,111,10
167338,2019-09-26 00:00:00+03:00,in,False,-1,True,1,0,4,4
167338,2019-09-26 00:00:00+03:00,in,False,-1,True,1,0,4,4
167338,2019-09-27 00:00:00+03:00,in,False,912252,False,1,26,38,12
167338,2019-09-27 00:00:00+03:00,out,False,912252,False,2,163,173,10
167338,2019-09-28 00:00:00+03:00,in,False,912252,False,1,56,68,12
167338,2019-09-30 00:00:00+03:00,out,False,912252,False,1,14,25,11
167338,2019-09-30 00:00:00+03:00,out,False,912252,False,1,14,25,11
167338,2019-10-03 00:00:00+03:00,out,False,912252,True,1,0,6,6
167338,2019-10-07 00:00:00+03:00,out,False,912252,False,3,100,145,45
167338,2019-10-07 00:00:00+03:00,out,False,912252,False,3,100,145,45
167338,2019-10-10 00:00:00+03:00,out,False,912252,False,4,404,452,48
167338,2019-10-10 00:00:00+03:00,out,False,912252,True,2,0,2,2
167338,2019-10-14 00:00:00+03:00,out,False,912252,True,2,0,17,17
167338,2019-10-14 00:00:00+03:00,out,False,912252,False,3,107,154,47
167338,2019-10-15 00:00:00+03:00,out,False,912252,True,2,0,43,43
167338,2019-10-15 00:00:00+03:00,out,False,912252,False,2,135,167,32
167338,2019-10-17 00:00:00+03:00,out,False,912252,True,2,0,72,72
167338,2019-10-17 00:00:00+03:00,out,False,912252,False,1,27,47,20
167338,2019-10-17 00:00:00+03:00,out,False,912252,False,1,27,47,20
167338,2019-10-18 00:00:00+03:00,out,False,912252,False,3,125,156,31
167338,2019-10-18 00:00:00+03:00,out,False,912252,True,7,0,185,185
167338,2019-10-19 00:00:00+03:00,out,False,912252,False,1,22,32,10
167338,2019-10-21 00:00:00+03:00,out,False,912252,False,4,250,297,47
167338,2019-10-21 00:00:00+03:00,out,False,912252,True,4,0,81,81
167338,2019-10-21 00:00:00+03:00,out,False,912252,True,4,0,81,81
167338,2019-10-22 00:00:00+03:00,out,False,912252,True,3,0,11,11
167338,2019-10-22 00:00:00+03:00,out,False,912252,False,4,306,333,27
167338,2019-10-22 00:00:00+03:00,out,False,912252,True,3,0,11,11
167338,2019-10-23 00:00:00+03:00,out,False,912252,False,1,277,286,9
167338,2019-10-24 00:00:00+03:00,out,False,912252,False,2,138,162,24
167338,2019-10-24 00:00:00+03:00,out,False,912252,True,2,0,88,88
167338,2019-10-25 00:00:00+03:00,out,False,912252,False,2,401,438,37
167338,2019-10-25 00:00:00+03:00,in,False,912252,False,1,152,161,9
167338,2019-10-27 00:00:00+03:00,in,False,912252,False,2,216,261,45
167338,2019-10-27 00:00:00+03:00,out,False,912252,False,5,882,951,69
167338,2019-10-27 00:00:00+03:00,out,False,912252,True,5,0,107,107
167338,2019-10-28 00:00:00+03:00,in,False,912252,False,1,58,68,10
167338,2019-10-28 00:00:00+03:00,out,False,912252,True,6,0,138,138
167338,2019-10-28 00:00:00+03:00,out,False,912252,False,8,1337,1468,131
167338,2019-10-29 00:00:00+03:00,out,False,912252,True,1,0,27,27
167338,2019-10-29 00:00:00+03:00,out,False,912252,False,1,418,433,15
167338,2019-10-29 00:00:00+03:00,in,False,912252,False,1,613,652,39
167338,2019-10-29 00:00:00+03:00,in,False,912252,False,1,613,652,39
167338,2019-10-30 00:00:00+03:00,out,False,912252,False,10,546,669,123
167338,2019-10-30 00:00:00+03:00,in,False,912252,False,1,69,86,17
167338,2019-10-30 00:00:00+03:00,out,False,912252,True,2,0,64,64
167338,2019-10-31 00:00:00+03:00,in,False,912252,False,2,320,342,22
167338,2019-10-31 00:00:00+03:00,out,False,912252,True,2,0,78,78
167338,2019-10-31 00:00:00+03:00,out,False,912252,False,5,643,717,74
167338,2019-10-31 00:00:00+03:00,in,False,912252,False,2,320,342,22
167338,2019-11-01 00:00:00+03:00,out,False,912252,False,10,1477,1647,170
167338,2019-11-01 00:00:00+03:00,out,False,912252,True,6,0,95,95
167338,2019-11-01 00:00:00+03:00,in,False,912252,False,4,646,720,74
167338,2019-11-05 00:00:00+03:00,in,False,912252,False,1,142,152,10
167338,2019-11-05 00:00:00+03:00,out,False,912252,False,3,762,796,34
167338,2019-11-05 00:00:00+03:00,out,False,912252,True,1,0,34,34
167338,2019-11-06 00:00:00+03:00,in,False,912252,False,1,235,244,9
167338,2019-11-06 00:00:00+03:00,out,False,912252,False,3,110,137,27
167338,2019-11-06 00:00:00+03:00,out,False,912252,True,1,0,60,60
167338,2019-11-06 00:00:00+03:00,out,False,912252,False,3,110,137,27
167338,2019-11-07 00:00:00+03:00,in,False,912252,False,1,118,128,10
167338,2019-11-07 00:00:00+03:00,out,False,912252,True,1,0,60,60
167338,2019-11-07 00:00:00+03:00,out,False,912252,False,3,416,470,54
167338,2019-11-08 00:00:00+03:00,out,False,912252,False,13,401,581,180
167338,2019-11-08 00:00:00+03:00,out,False,912252,True,10,0,247,247
167338,2019-11-08 00:00:00+03:00,in,False,912252,False,2,443,474,31
167338,2019-11-08 00:00:00+03:00,out,False,912252,True,10,0,247,247
167338,2019-11-09 00:00:00+03:00,out,False,912252,True,1,0,39,39
167338,2019-11-09 00:00:00+03:00,in,False,912252,False,1,102,112,10
167338,2019-11-09 00:00:00+03:00,out,False,912252,False,3,482,569,87
167338,2019-11-11 00:00:00+03:00,out,False,912252,True,6,0,92,92
167338,2019-11-11 00:00:00+03:00,out,False,912252,False,10,1020,1169,149
167338,2019-11-11 00:00:00+03:00,out,False,912252,False,10,1020,1169,149
167338,2019-11-12 00:00:00+03:00,out,False,912252,False,1,91,100,9
167338,2019-11-13 00:00:00+03:00,in,False,-1,True,1,0,1,1
167338,2019-11-13 00:00:00+03:00,in,False,912252,False,1,177,193,16
167338,2019-11-14 00:00:00+03:00,out,False,912252,False,8,2108,2231,123
167338,2019-11-14 00:00:00+03:00,out,False,912252,True,2,0,32,32
167338,2019-11-14 00:00:00+03:00,in,False,912252,False,1,48,64,16
167338,2019-11-14 00:00:00+03:00,in,False,-1,True,2,0,36,36
167338,2019-11-15 00:00:00+03:00,out,False,912252,True,1,0,42,42
167338,2019-11-15 00:00:00+03:00,out,False,912252,False,5,1843,1907,64
167338,2019-11-15 00:00:00+03:00,out,False,912252,True,1,0,42,42
167338,2019-11-19 00:00:00+03:00,out,False,912252,False,8,514,617,103
167338,2019-11-19 00:00:00+03:00,out,False,912252,True,2,0,43,43
167338,2019-11-19 00:00:00+03:00,in,False,-1,True,2,0,113,113
167338,2019-11-19 00:00:00+03:00,in,False,912252,False,3,851,923,72
167338,2019-11-19 00:00:00+03:00,out,False,912252,True,2,0,43,43
167338,2019-11-20 00:00:00+03:00,out,False,912252,False,3,114,156,42
167338,2019-11-20 00:00:00+03:00,out,False,912252,True,2,0,56,56
167338,2019-11-20 00:00:00+03:00,in,False,912252,False,3,273,303,30
167338,2019-11-20 00:00:00+03:00,out,False,912252,True,2,0,56,56
167338,2019-11-21 00:00:00+03:00,in,False,912252,False,1,124,134,10
167338,2019-11-24 00:00:00+03:00,in,False,912252,False,1,153,168,15
167338,2019-11-25 00:00:00+03:00,out,False,912252,True,2,0,36,36
167338,2019-11-25 00:00:00+03:00,out,False,912252,False,3,269,304,35
167338,2019-11-25 00:00:00+03:00,in,False,912252,False,1,39,58,19
167338,2019-11-25 00:00:00+03:00,in,False,-1,True,1,0,37,37
167338,2019-11-25 00:00:00+03:00,out,False,912252,False,3,269,304,35
167338,2019-11-27 00:00:00+03:00,out,False,912252,True,1,0,12,12
167338,2019-11-27 00:00:00+03:00,out,False,912252,False,2,120,171,51
167338,2019-11-27 00:00:00+03:00,in,False,912252,False,3,426,468,42
167338,2019-11-28 00:00:00+03:00,out,False,912252,False,2,444,473,29
167338,2019-11-28 00:00:00+03:00,in,False,912252,False,1,12,28,16
167338,2019-11-28 00:00:00+03:00,out,False,912252,True,1,0,50,50
167338,2019-11-28 00:00:00+03:00,out,False,912252,False,2,444,473,29
167359,2019-09-17 00:00:00+03:00,out,False,912722,True,3,0,86,86
167359,2019-09-17 00:00:00+03:00,out,False,912722,False,3,217,257,40
167359,2019-09-17 00:00:00+03:00,in,False,-1,True,2,0,14,14
167359,2019-09-18 00:00:00+03:00,in,False,912722,False,2,141,151,10
167359,2019-09-18 00:00:00+03:00,out,False,912722,False,2,263,292,29
167359,2019-09-19 00:00:00+03:00,out,False,912722,False,8,759,844,85
167359,2019-09-19 00:00:00+03:00,out,True,912722,True,2,0,10,10
167359,2019-09-19 00:00:00+03:00,out,False,912722,True,6,0,162,162
167359,2019-09-19 00:00:00+03:00,out,False,915360,False,1,249,251,2
167359,2019-09-19 00:00:00+03:00,out,True,915358,False,4,56,83,27
167359,2019-09-19 00:00:00+03:00,in,False,912722,False,4,155,171,16
167359,2019-09-19 00:00:00+03:00,in,False,-1,True,1,0,35,35
167359,2019-09-19 00:00:00+03:00,out,True,912722,False,5,173,197,24
167359,2019-09-20 00:00:00+03:00,out,True,915358,False,4,291,307,16
167359,2019-09-20 00:00:00+03:00,out,False,915360,True,1,0,13,13
167359,2019-09-20 00:00:00+03:00,out,True,912722,True,5,0,58,58
167359,2019-09-20 00:00:00+03:00,out,True,912722,False,2,97,103,6
167359,2019-09-20 00:00:00+03:00,out,False,912722,False,5,918,946,28
167359,2019-09-20 00:00:00+03:00,in,False,912722,False,6,1253,1288,35
167359,2019-09-20 00:00:00+03:00,out,False,915360,False,19,947,1012,65
167359,2019-09-21 00:00:00+03:00,in,False,-1,True,2,0,65,65
167359,2019-09-23 00:00:00+03:00,out,False,915360,True,1,0,11,11
167359,2019-09-23 00:00:00+03:00,out,False,915360,False,1,710,714,4
167359,2019-09-23 00:00:00+03:00,out,True,912722,False,2,32,43,11
167359,2019-09-23 00:00:00+03:00,out,False,912722,False,2,137,156,19
167359,2019-09-23 00:00:00+03:00,out,True,915358,False,7,73,119,46
167359,2019-09-23 00:00:00+03:00,in,False,912722,False,3,622,647,25
167359,2019-09-23 00:00:00+03:00,out,True,912722,True,2,0,29,29
167359,2019-09-24 00:00:00+03:00,out,False,915360,False,3,352,374,22
167359,2019-09-24 00:00:00+03:00,out,False,918452,True,3,0,44,44
167359,2019-09-24 00:00:00+03:00,out,True,915358,False,2,192,201,9
167359,2019-09-24 00:00:00+03:00,out,False,918452,False,10,2786,2906,120
167359,2019-09-24 00:00:00+03:00,out,True,912722,True,2,0,26,26
167359,2019-09-24 00:00:00+03:00,in,False,912722,False,1,8,9,1
167359,2019-09-24 00:00:00+03:00,out,True,918452,False,2,104,122,18
167359,2019-09-24 00:00:00+03:00,out,True,912722,False,2,69,78,9
167359,2019-09-24 00:00:00+03:00,out,True,918452,True,3,0,0,0
167359,2019-09-24 00:00:00+03:00,out,True,915358,True,1,0,21,21
167359,2019-09-25 00:00:00+03:00,out,True,915360,True,1,0,0,0
167359,2019-09-25 00:00:00+03:00,out,False,920146,True,2,0,33,33
167359,2019-09-25 00:00:00+03:00,in,False,-1,True,3,0,111,111
167359,2019-09-25 00:00:00+03:00,out,False,920146,True,2,0,33,33
167359,2019-09-26 00:00:00+03:00,out,False,918452,True,1,0,12,12
167359,2019-09-26 00:00:00+03:00,out,True,912722,True,5,0,104,104
167359,2019-09-26 00:00:00+03:00,out,False,918452,False,6,2175,2236,61
167359,2019-09-26 00:00:00+03:00,out,True,915358,True,1,0,10,10
167359,2019-09-26 00:00:00+03:00,out,True,912722,False,1,6,12,6
167359,2019-09-26 00:00:00+03:00,in,False,912722,False,1,352,359,7
167359,2019-09-26 00:00:00+03:00,out,False,912722,False,2,204,210,6
167359,2019-09-26 00:00:00+03:00,out,True,918452,False,1,16,19,3
167359,2019-09-26 00:00:00+03:00,out,True,921316,True,1,0,0,0
167359,2019-09-26 00:00:00+03:00,out,True,915358,False,5,75,97,22
167359,2019-09-26 00:00:00+03:00,out,True,915358,False,5,75,97,22
167359,2019-09-27 00:00:00+03:00,out,True,912722,True,2,0,14,14
167359,2019-09-27 00:00:00+03:00,out,False,912722,False,5,97,146,49
167359,2019-09-27 00:00:00+03:00,out,False,918452,False,1,140,154,14
167359,2019-09-27 00:00:00+03:00,out,True,915358,False,4,145,163,18
167359,2019-09-27 00:00:00+03:00,in,False,912722,False,4,909,935,26
167359,2019-09-27 00:00:00+03:00,out,False,912722,True,9,0,209,209
167359,2019-09-27 00:00:00+03:00,out,True,921316,True,4,0,41,41
167359,2019-09-27 00:00:00+03:00,out,False,920146,True,1,0,2,2
167359,2019-09-27 00:00:00+03:00,out,True,912722,False,2,7,17,10
167359,2019-09-27 00:00:00+03:00,in,False,-1,True,2,0,32,32
167359,2019-09-27 00:00:00+03:00,out,True,912722,False,2,7,17,10
167359,2019-09-27 00:00:00+03:00,in,False,912722,False,4,909,935,26
167359,2019-09-30 00:00:00+03:00,out,False,912722,False,4,590,651,61
167359,2019-09-30 00:00:00+03:00,out,False,918452,False,7,1548,1674,126
167359,2019-09-30 00:00:00+03:00,out,True,912722,False,3,138,147,9
167359,2019-09-30 00:00:00+03:00,out,True,912722,True,7,0,108,108
167359,2019-09-30 00:00:00+03:00,out,False,918452,True,1,0,4,4
167359,2019-09-30 00:00:00+03:00,out,False,912722,True,2,0,99,99
167359,2019-09-30 00:00:00+03:00,out,True,918452,False,2,19,29,10
167359,2019-09-30 00:00:00+03:00,out,True,915358,True,1,0,1,1
167359,2019-09-30 00:00:00+03:00,in,False,912722,False,5,427,511,84
167359,2019-09-30 00:00:00+03:00,out,True,915358,False,5,56,73,17
167359,2019-10-01 00:00:00+03:00,out,False,915360,False,1,24,32,8
167359,2019-10-01 00:00:00+03:00,out,True,915358,True,2,0,36,36
167359,2019-10-01 00:00:00+03:00,out,True,924356,False,2,15,42,27
167359,2019-10-01 00:00:00+03:00,out,True,921316,True,1,0,11,11
167359,2019-10-01 00:00:00+03:00,out,True,924356,True,8,0,6,6
167359,2019-10-01 00:00:00+03:00,out,True,912722,True,1,0,4,4
167359,2019-10-01 00:00:00+03:00,out,True,924370,False,3,24,34,10
167359,2019-10-01 00:00:00+03:00,in,False,912722,False,3,75,90,15
167359,2019-10-01 00:00:00+03:00,out,False,918452,False,6,359,443,84
167359,2019-10-02 00:00:00+03:00,in,False,912722,False,2,11,18,7
167359,2019-10-02 00:00:00+03:00,out,False,912722,False,4,301,357,56
167359,2019-10-02 00:00:00+03:00,out,True,912722,True,2,0,11,11
167359,2019-10-02 00:00:00+03:00,out,False,924370,False,1,47,48,1
167359,2019-10-02 00:00:00+03:00,out,True,924356,True,1,0,27,27
167359,2019-10-02 00:00:00+03:00,out,False,912722,True,3,0,69,69
167359,2019-10-03 00:00:00+03:00,out,True,924370,False,1,16,24,8
167359,2019-10-03 00:00:00+03:00,out,True,924356,False,3,129,150,21
167359,2019-10-03 00:00:00+03:00,out,False,915358,True,1,0,9,9
167359,2019-10-03 00:00:00+03:00,out,False,915360,False,4,399,423,24
167359,2019-10-03 00:00:00+03:00,in,False,-1,True,1,0,24,24
167359,2019-10-03 00:00:00+03:00,out,True,921316,True,2,0,24,24
167359,2019-10-03 00:00:00+03:00,out,True,924356,True,2,0,54,54
167359,2019-10-03 00:00:00+03:00,out,False,912722,False,7,563,697,134
167359,2019-10-03 00:00:00+03:00,out,False,915360,True,3,0,34,34
167359,2019-10-03 00:00:00+03:00,out,False,921316,True,1,0,9,9
167359,2019-10-03 00:00:00+03:00,in,False,912722,False,2,158,167,9
167359,2019-10-03 00:00:00+03:00,out,True,915358,False,7,268,304,36
167359,2019-10-03 00:00:00+03:00,out,True,912722,False,1,46,51,5
167359,2019-10-03 00:00:00+03:00,out,False,918452,False,11,1139,1266,127
167359,2019-10-03 00:00:00+03:00,out,False,921316,False,1,112,114,2
167359,2019-10-03 00:00:00+03:00,out,False,918452,True,1,0,33,33
167359,2019-10-03 00:00:00+03:00,out,False,921316,True,1,0,9,9
167359,2019-10-04 00:00:00+03:00,out,True,921316,True,2,0,26,26
167359,2019-10-04 00:00:00+03:00,out,False,921316,False,6,1066,1077,11
167359,2019-10-04 00:00:00+03:00,out,False,915360,False,2,192,209,17
167359,2019-10-04 00:00:00+03:00,out,False,921316,True,9,0,70,70
167359,2019-10-04 00:00:00+03:00,out,True,912722,True,1,0,14,14
167359,2019-10-04 00:00:00+03:00,out,False,912722,False,1,125,141,16
167359,2019-10-04 00:00:00+03:00,out,False,918452,True,1,0,24,24
167359,2019-10-04 00:00:00+03:00,out,False,918452,False,5,281,338,57
167359,2019-10-04 00:00:00+03:00,in,False,912722,False,3,221,238,17
167359,2019-10-04 00:00:00+03:00,in,False,912722,False,3,221,238,17
167359,2019-10-04 00:00:00+03:00,out,True,912722,True,1,0,14,14
167359,2019-10-07 00:00:00+03:00,out,False,918452,False,7,716,798,82
167359,2019-10-07 00:00:00+03:00,out,True,921316,True,4,0,45,45
167359,2019-10-07 00:00:00+03:00,out,False,921316,False,3,284,289,5
167359,2019-10-07 00:00:00+03:00,out,True,921316,False,1,16,23,7
167359,2019-10-07 00:00:00+03:00,out,True,912722,False,1,279,290,11
167359,2019-10-07 00:00:00+03:00,out,False,918452,True,3,0,87,87
167359,2019-10-07 00:00:00+03:00,out,False,912722,False,2,192,214,22
167359,2019-10-07 00:00:00+03:00,out,False,915360,False,4,815,914,99
167359,2019-10-07 00:00:00+03:00,out,True,924370,False,1,103,112,9
167359,2019-10-07 00:00:00+03:00,out,True,924356,False,1,75,84,9
167359,2019-10-07 00:00:00+03:00,out,False,912722,True,3,0,123,123
167359,2019-10-07 00:00:00+03:00,out,True,918452,False,3,799,811,12
167359,2019-10-07 00:00:00+03:00,out,False,915360,True,2,0,85,85
167359,2019-10-07 00:00:00+03:00,out,True,918452,True,4,0,5,5
167359,2019-10-07 00:00:00+03:00,out,True,924370,False,1,103,112,9
167359,2019-10-07 00:00:00+03:00,out,False,912722,False,2,192,214,22
167359,2019-10-08 00:00:00+03:00,in,False,912722,False,1,160,167,7
167359,2019-10-08 00:00:00+03:00,out,True,921316,True,2,0,18,18
167359,2019-10-08 00:00:00+03:00,out,True,924356,False,1,9,29,20
167359,2019-10-08 00:00:00+03:00,out,False,924356,False,1,100,108,8
167359,2019-10-08 00:00:00+03:00,out,True,912722,True,1,0,3,3
167359,2019-10-08 00:00:00+03:00,out,False,918452,False,2,219,229,10
167359,2019-10-08 00:00:00+03:00,out,False,915360,False,6,558,585,27
167359,2019-10-08 00:00:00+03:00,out,True,918452,True,1,0,1,1
167359,2019-10-08 00:00:00+03:00,out,False,921316,False,2,76,82,6
167359,2019-10-09 00:00:00+03:00,out,True,912722,True,2,0,15,15
167359,2019-10-09 00:00:00+03:00,out,False,912722,False,2,360,400,40
167359,2019-10-09 00:00:00+03:00,out,True,915358,False,1,11,14,3
167359,2019-10-09 00:00:00+03:00,out,True,924370,True,1,0,25,25
167359,2019-10-09 00:00:00+03:00,out,False,915360,False,11,605,768,163
167359,2019-10-09 00:00:00+03:00,out,True,924370,False,1,45,51,6
167359,2019-10-09 00:00:00+03:00,out,True,915358,False,1,11,14,3
167359,2019-10-09 00:00:00+03:00,out,True,924370,True,1,0,25,25
167359,2019-10-10 00:00:00+03:00,out,False,912722,True,5,0,158,158
167359,2019-10-10 00:00:00+03:00,out,False,912722,False,6,1037,1140,103
167359,2019-10-10 00:00:00+03:00,out,True,924370,False,2,181,193,12
167359,2019-10-10 00:00:00+03:00,out,True,915360,False,5,227,270,43
167359,2019-10-10 00:00:00+03:00,out,True,912722,False,1,32,37,5
167359,2019-10-10 00:00:00+03:00,out,True,918452,False,5,386,419,33
167359,2019-10-10 00:00:00+03:00,out,False,915360,True,1,0,12,12
167359,2019-10-10 00:00:00+03:00,out,False,924356,False,4,380,408,28
167359,2019-10-10 00:00:00+03:00,out,True,924356,False,4,270,295,25
167359,2019-10-10 00:00:00+03:00,out,False,915360,False,4,115,168,53
167359,2019-10-10 00:00:00+03:00,out,False,924356,True,4,0,125,125
167359,2019-10-10 00:00:00+03:00,in,False,912722,False,6,860,894,34
167359,2019-10-10 00:00:00+03:00,out,True,915360,True,6,0,93,93
167359,2019-10-10 00:00:00+03:00,out,False,918452,False,6,664,734,70
167359,2019-10-11 00:00:00+03:00,out,False,912722,False,2,304,343,39
167359,2019-10-11 00:00:00+03:00,in,False,912722,False,2,204,211,7
167359,2019-10-11 00:00:00+03:00,out,True,915360,True,3,0,39,39
167359,2019-10-11 00:00:00+03:00,out,True,921316,True,3,0,13,13
167359,2019-10-11 00:00:00+03:00,out,False,918452,False,1,189,216,27
167359,2019-10-11 00:00:00+03:00,out,True,915360,False,4,37,50,13
167359,2019-10-11 00:00:00+03:00,out,False,924370,False,1,114,116,2
167359,2019-10-11 00:00:00+03:00,out,True,918452,False,3,94,109,15
167359,2019-10-11 00:00:00+03:00,out,True,915358,False,3,61,70,9
167359,2019-10-11 00:00:00+03:00,out,True,915360,True,3,0,39,39
167359,2019-10-14 00:00:00+03:00,out,True,924356,False,3,481,497,16
167359,2019-10-14 00:00:00+03:00,out,True,924356,True,3,0,49,49
167359,2019-10-14 00:00:00+03:00,out,True,921316,True,1,0,13,13
167359,2019-10-14 00:00:00+03:00,out,False,918452,False,5,374,439,65
167359,2019-10-14 00:00:00+03:00,out,False,924356,False,1,144,167,23
167359,2019-10-14 00:00:00+03:00,out,True,915360,False,1,52,67,15
167359,2019-10-14 00:00:00+03:00,out,True,912722,False,1,13,16,3
167359,2019-10-14 00:00:00+03:00,out,False,921316,False,1,105,118,13
167359,2019-10-14 00:00:00+03:00,out,False,912722,True,5,0,137,137
167359,2019-10-14 00:00:00+03:00,out,False,915360,False,9,2452,2478,26
167359,2019-10-14 00:00:00+03:00,out,False,912722,False,6,848,938,90
167359,2019-10-14 00:00:00+03:00,out,True,912722,True,1,0,16,16
167359,2019-10-14 00:00:00+03:00,out,True,915358,False,4,163,182,19
167359,2019-10-14 00:00:00+03:00,out,False,924356,True,2,0,46,46
167359,2019-10-14 00:00:00+03:00,in,False,-1,True,1,0,30,30
167359,2019-10-14 00:00:00+03:00,out,True,918452,False,7,348,379,31
167359,2019-10-14 00:00:00+03:00,out,True,915360,True,2,0,37,37
167359,2019-10-14 00:00:00+03:00,in,False,912722,False,4,220,241,21
167359,2019-10-15 00:00:00+03:00,out,True,921316,False,2,308,313,5
167359,2019-10-15 00:00:00+03:00,out,True,915358,False,6,212,235,23
167359,2019-10-15 00:00:00+03:00,out,True,912722,True,1,0,0,0
167359,2019-10-15 00:00:00+03:00,out,True,924356,False,10,804,843,39
167359,2019-10-15 00:00:00+03:00,out,True,918452,True,1,0,10,10
167359,2019-10-15 00:00:00+03:00,out,True,915360,True,1,0,10,10
167359,2019-10-15 00:00:00+03:00,out,False,918452,False,1,121,132,11
167359,2019-10-15 00:00:00+03:00,out,False,924356,True,1,0,2,2
167359,2019-10-15 00:00:00+03:00,out,True,915358,True,1,0,44,44
167359,2019-10-15 00:00:00+03:00,out,False,915360,False,3,499,508,9
167359,2019-10-15 00:00:00+03:00,in,False,912722,False,3,309,324,15
167359,2019-10-15 00:00:00+03:00,out,True,915360,False,9,552,603,51
167359,2019-10-15 00:00:00+03:00,out,False,918452,True,1,0,42,42
167359,2019-10-15 00:00:00+03:00,out,True,924356,True,5,0,82,82
167359,2019-10-15 00:00:00+03:00,out,False,924356,False,5,109,121,12
167359,2019-10-15 00:00:00+03:00,out,False,912722,False,4,479,542,63
167359,2019-10-15 00:00:00+03:00,out,True,918452,False,7,575,599,24
167359,2019-10-15 00:00:00+03:00,out,True,918452,True,1,0,10,10
167359,2019-10-15 00:00:00+03:00,out,True,915358,False,6,212,235,23
167359,2019-10-16 00:00:00+03:00,out,True,918452,True,1,0,18,18
167359,2019-10-16 00:00:00+03:00,out,False,912722,True,1,0,6,6
167359,2019-10-16 00:00:00+03:00,in,False,-1,True,1,0,79,79
167359,2019-10-16 00:00:00+03:00,out,True,915360,False,2,44,57,13
167359,2019-10-16 00:00:00+03:00,out,False,915360,False,1,177,181,4
167359,2019-10-16 00:00:00+03:00,out,False,918452,True,1,0,0,0
167359,2019-10-16 00:00:00+03:00,in,False,912722,False,3,541,553,12
167359,2019-10-16 00:00:00+03:00,out,True,912722,False,1,358,360,2
167359,2019-10-16 00:00:00+03:00,out,False,912722,False,5,686,774,88
167359,2019-10-16 00:00:00+03:00,out,False,918452,False,1,9,26,17
167359,2019-10-16 00:00:00+03:00,out,True,918452,True,1,0,18,18
167359,2019-10-17 00:00:00+03:00,out,False,918452,False,1,97,112,15
167359,2019-10-17 00:00:00+03:00,out,True,915358,False,7,228,252,24
167359,2019-10-17 00:00:00+03:00,out,True,915360,True,5,0,85,85
167359,2019-10-17 00:00:00+03:00,out,True,912722,True,1,0,15,15
167359,2019-10-17 00:00:00+03:00,out,True,915358,True,3,0,62,62
167359,2019-10-17 00:00:00+03:00,in,False,912722,False,1,42,49,7
167359,2019-10-17 00:00:00+03:00,in,False,-1,True,1,0,40,40
167359,2019-10-17 00:00:00+03:00,out,False,912722,False,2,258,298,40
167359,2019-10-17 00:00:00+03:00,out,True,912722,False,2,27,34,7
167359,2019-10-17 00:00:00+03:00,out,True,915360,False,2,15,20,5
167359,2019-10-17 00:00:00+03:00,out,True,924356,False,6,244,273,29
167359,2019-10-17 00:00:00+03:00,out,False,912722,True,2,0,5,5
167359,2019-10-17 00:00:00+03:00,out,True,924356,True,1,0,28,28
167359,2019-10-17 00:00:00+03:00,out,True,924356,False,6,244,273,29
167359,2019-10-17 00:00:00+03:00,out,False,912722,False,2,258,298,40
167359,2019-10-18 00:00:00+03:00,out,False,912722,False,8,975,1052,77
167359,2019-10-18 00:00:00+03:00,out,True,915360,False,11,206,246,40
167359,2019-10-18 00:00:00+03:00,out,False,912722,True,2,0,45,45
167359,2019-10-18 00:00:00+03:00,out,True,915358,False,5,232,254,22
167359,2019-10-18 00:00:00+03:00,out,True,912722,False,9,420,472,52
167359,2019-10-18 00:00:00+03:00,out,True,918452,True,1,0,18,18
167359,2019-10-18 00:00:00+03:00,out,True,915358,True,1,0,13,13
167359,2019-10-18 00:00:00+03:00,out,True,915360,True,3,0,39,39
167359,2019-10-18 00:00:00+03:00,out,True,918452,False,9,813,841,28
167359,2019-10-18 00:00:00+03:00,out,True,915360,True,3,0,39,39
167359,2019-10-18 00:00:00+03:00,out,True,915358,False,5,232,254,22
167359,2019-10-18 00:00:00+03:00,out,True,912722,False,9,420,472,52
167359,2019-10-18 00:00:00+03:00,out,False,912722,True,2,0,45,45
167359,2019-10-19 00:00:00+03:00,out,False,915358,False,1,61,71,10
167359,2019-10-19 00:00:00+03:00,in,False,-1,True,2,0,77,77
167359,2019-10-19 00:00:00+03:00,out,True,915358,False,1,28,30,2
167359,2019-10-21 00:00:00+03:00,out,True,924356,True,6,0,103,103
167359,2019-10-21 00:00:00+03:00,out,False,912722,True,1,0,14,14
167359,2019-10-21 00:00:00+03:00,out,True,924356,False,3,119,131,12
167359,2019-10-21 00:00:00+03:00,out,True,915358,True,1,0,32,32
167359,2019-10-21 00:00:00+03:00,out,True,918452,False,6,386,425,39
167359,2019-10-21 00:00:00+03:00,out,True,915360,False,4,167,193,26
167359,2019-10-21 00:00:00+03:00,out,False,912722,False,2,328,351,23
167359,2019-10-22 00:00:00+03:00,out,False,912722,True,1,0,31,31
167359,2019-10-22 00:00:00+03:00,out,False,924356,False,2,232,240,8
167359,2019-10-22 00:00:00+03:00,out,False,918452,True,1,0,12,12
167359,2019-10-22 00:00:00+03:00,out,False,912722,False,1,26,50,24
167359,2019-10-22 00:00:00+03:00,out,True,915358,False,2,86,91,5
167359,2019-10-22 00:00:00+03:00,out,False,915358,False,3,913,921,8
167359,2019-10-22 00:00:00+03:00,out,True,918452,False,7,758,787,29
167359,2019-10-22 00:00:00+03:00,in,False,912722,False,1,58,64,6
167359,2019-10-22 00:00:00+03:00,out,False,918452,False,3,107,154,47
167359,2019-10-22 00:00:00+03:00,out,False,915360,False,10,545,598,53
167359,2019-10-22 00:00:00+03:00,out,False,921316,True,1,0,6,6
167359,2019-10-22 00:00:00+03:00,out,True,924370,False,1,44,49,5
167359,2019-10-22 00:00:00+03:00,out,False,921316,False,1,47,61,14
167359,2019-10-22 00:00:00+03:00,out,True,915360,False,9,424,451,27
167359,2019-10-22 00:00:00+03:00,out,True,918452,True,2,0,12,12
167359,2019-10-22 00:00:00+03:00,out,True,924356,True,3,0,73,73
167359,2019-10-22 00:00:00+03:00,out,True,924356,False,8,1110,1135,25
167359,2019-10-22 00:00:00+03:00,out,False,924356,True,4,0,164,164
167359,2019-10-23 00:00:00+03:00,out,False,912722,False,1,16,28,12
167359,2019-10-23 00:00:00+03:00,out,True,915360,True,1,0,33,33
167359,2019-10-23 00:00:00+03:00,in,False,912722,False,3,284,297,13
167359,2019-10-23 00:00:00+03:00,out,False,915360,False,3,178,186,8
167359,2019-10-23 00:00:00+03:00,out,False,912722,True,1,0,33,33
167359,2019-10-23 00:00:00+03:00,out,False,915360,True,1,0,5,5
167359,2019-10-23 00:00:00+03:00,out,True,912722,False,1,228,233,5
167359,2019-10-23 00:00:00+03:00,in,False,-1,True,2,0,90,90
167359,2019-10-23 00:00:00+03:00,out,False,915360,False,3,178,186,8
167359,2019-10-24 00:00:00+03:00,out,True,918452,True,2,0,33,33
167359,2019-10-24 00:00:00+03:00,out,True,912722,True,1,0,10,10
167359,2019-10-24 00:00:00+03:00,out,False,912722,False,3,209,257,48
167359,2019-10-24 00:00:00+03:00,in,False,912722,False,4,380,469,89
167359,2019-10-24 00:00:00+03:00,out,True,924356,True,2,0,36,36
167359,2019-10-24 00:00:00+03:00,out,True,915360,False,5,539,559,20
167359,2019-10-24 00:00:00+03:00,out,True,918452,False,5,415,427,12
167359,2019-10-24 00:00:00+03:00,out,True,915358,False,1,10,12,2
167359,2019-10-24 00:00:00+03:00,out,True,924356,False,9,1175,1214,39
167359,2019-10-24 00:00:00+03:00,out,True,912722,False,3,108,120,12
167359,2019-10-24 00:00:00+03:00,out,False,912722,True,1,0,3,3
167359,2019-10-24 00:00:00+03:00,out,False,924356,False,4,285,299,14
167359,2019-10-24 00:00:00+03:00,out,True,912722,False,3,108,120,12
167359,2019-10-24 00:00:00+03:00,out,True,915360,False,5,539,559,20
167359,2019-10-24 00:00:00+03:00,out,False,912722,False,3,209,257,48
167359,2019-10-24 00:00:00+03:00,out,False,912722,True,1,0,3,3
167359,2019-10-25 00:00:00+03:00,out,True,912722,True,1,0,0,0
167359,2019-10-25 00:00:00+03:00,out,True,918452,True,2,0,12,12
167359,2019-10-25 00:00:00+03:00,out,False,921316,False,2,125,145,20
167359,2019-10-25 00:00:00+03:00,out,True,915360,False,14,1051,1105,54
167359,2019-10-25 00:00:00+03:00,out,True,912722,False,5,95,123,28
167359,2019-10-25 00:00:00+03:00,in,False,912722,False,1,12,17,5
167359,2019-10-25 00:00:00+03:00,out,True,915358,False,7,152,176,24
167359,2019-10-25 00:00:00+03:00,out,True,918452,False,8,306,329,23
167359,2019-10-25 00:00:00+03:00,out,False,912722,True,1,0,11,11
167359,2019-10-25 00:00:00+03:00,out,True,915358,True,4,0,82,82
167359,2019-10-25 00:00:00+03:00,out,False,912722,False,3,599,642,43
167359,2019-10-25 00:00:00+03:00,out,True,918452,True,2,0,12,12
167359,2019-10-25 00:00:00+03:00,in,False,912722,False,1,12,17,5
167359,2019-10-28 00:00:00+03:00,out,True,921316,False,1,1,28,27
167359,2019-10-28 00:00:00+03:00,out,True,918452,False,2,63,67,4
167359,2019-10-28 00:00:00+03:00,out,False,924356,False,3,549,576,27
167359,2019-10-28 00:00:00+03:00,out,True,915360,False,3,330,350,20
167359,2019-10-28 00:00:00+03:00,in,False,912722,False,4,236,257,21
167359,2019-10-28 00:00:00+03:00,out,True,924356,True,6,0,110,110
167359,2019-10-28 00:00:00+03:00,out,True,924356,False,10,460,487,27
167359,2019-10-28 00:00:00+03:00,out,True,915358,False,7,337,361,24
167359,2019-10-28 00:00:00+03:00,out,True,912722,False,2,131,137,6
167359,2019-10-29 00:00:00+03:00,out,False,912722,False,3,140,192,52
167359,2019-10-29 00:00:00+03:00,out,True,915358,False,12,473,511,38
167359,2019-10-29 00:00:00+03:00,out,True,924356,True,8,0,159,159
167359,2019-10-29 00:00:00+03:00,out,True,912722,True,1,0,0,0
167359,2019-10-29 00:00:00+03:00,out,True,912722,False,4,147,167,20
167359,2019-10-29 00:00:00+03:00,in,False,912722,False,2,90,98,8
167359,2019-10-29 00:00:00+03:00,out,True,924356,False,4,265,278,13
167359,2019-10-29 00:00:00+03:00,out,True,918452,False,3,96,106,10
167359,2019-10-29 00:00:00+03:00,out,False,920146,True,1,0,5,5
167359,2019-10-29 00:00:00+03:00,out,True,920146,True,2,0,0,0
167359,2019-10-29 00:00:00+03:00,out,True,915360,False,5,573,592,19
167359,2019-10-30 00:00:00+03:00,out,True,915360,True,2,0,0,0
167359,2019-10-30 00:00:00+03:00,in,False,912722,False,1,162,167,5
167359,2019-10-30 00:00:00+03:00,out,True,912722,True,1,0,18,18
167359,2019-10-30 00:00:00+03:00,out,True,924356,True,2,0,14,14
167359,2019-10-31 00:00:00+03:00,out,False,924356,True,1,0,13,13
167359,2019-10-31 00:00:00+03:00,out,True,918452,True,1,0,25,25
167359,2019-10-31 00:00:00+03:00,out,False,924356,False,6,452,509,57
167359,2019-10-31 00:00:00+03:00,out,False,912722,False,2,280,317,37
167359,2019-10-31 00:00:00+03:00,out,True,915358,False,7,230,263,33
167359,2019-10-31 00:00:00+03:00,out,True,912722,True,1,0,19,19
167359,2019-10-31 00:00:00+03:00,out,True,912722,False,3,432,440,8
167359,2019-10-31 00:00:00+03:00,out,False,912722,True,2,0,46,46
167359,2019-10-31 00:00:00+03:00,out,True,924356,False,9,157,208,51
167359,2019-10-31 00:00:00+03:00,in,False,912722,False,5,831,851,20
167359,2019-10-31 00:00:00+03:00,out,True,918452,False,5,422,436,14
167359,2019-10-31 00:00:00+03:00,out,True,924356,True,4,0,23,23
167359,2019-10-31 00:00:00+03:00,out,True,915360,False,8,141,169,28
167359,2019-10-31 00:00:00+03:00,out,True,915358,True,2,0,23,23
167359,2019-10-31 00:00:00+03:00,out,True,921316,False,1,31,34,3
167359,2019-10-31 00:00:00+03:00,out,True,915358,False,7,230,263,33
167359,2019-11-01 00:00:00+03:00,out,True,921316,True,1,0,4,4
167359,2019-11-01 00:00:00+03:00,out,True,915358,False,8,247,277,30
167359,2019-11-01 00:00:00+03:00,out,False,912722,False,4,365,425,60
167359,2019-11-01 00:00:00+03:00,out,True,915358,True,1,0,39,39
167359,2019-11-01 00:00:00+03:00,out,False,915358,True,2,0,58,58
167359,2019-11-01 00:00:00+03:00,out,True,915360,False,1,84,86,2
167359,2019-11-01 00:00:00+03:00,in,False,-1,True,1,0,60,60
167359,2019-11-01 00:00:00+03:00,out,True,918452,True,2,0,32,32
167359,2019-11-01 00:00:00+03:00,out,True,912722,False,3,303,319,16
167359,2019-11-01 00:00:00+03:00,out,True,912722,True,6,0,105,105
167359,2019-11-01 00:00:00+03:00,out,True,918452,False,7,264,301,37
167359,2019-11-01 00:00:00+03:00,out,False,915358,False,1,289,293,4
167359,2019-11-04 00:00:00+03:00,in,False,-1,True,1,0,1,1
167359,2019-11-05 00:00:00+03:00,out,False,912722,False,5,495,566,71
167359,2019-11-05 00:00:00+03:00,out,True,924356,True,3,0,56,56
167359,2019-11-05 00:00:00+03:00,out,False,921316,False,2,553,559,6
167359,2019-11-05 00:00:00+03:00,out,True,915358,True,2,0,28,28
167359,2019-11-05 00:00:00+03:00,out,True,924356,False,15,2509,2603,94
167359,2019-11-05 00:00:00+03:00,in,False,912722,False,1,45,50,5
167359,2019-11-05 00:00:00+03:00,out,True,915358,False,9,299,321,22
167359,2019-11-05 00:00:00+03:00,out,True,912722,False,2,47,65,18
167359,2019-11-05 00:00:00+03:00,out,False,912722,True,1,0,31,31
167359,2019-11-05 00:00:00+03:00,in,False,-1,True,5,0,334,334
167359,2019-11-05 00:00:00+03:00,out,True,921316,False,1,7,9,2
167359,2019-11-05 00:00:00+03:00,out,True,921316,True,3,0,0,0
167359,2019-11-05 00:00:00+03:00,out,True,918452,False,7,741,762,21
167359,2019-11-05 00:00:00+03:00,out,False,924356,False,5,1502,1524,22
167359,2019-11-05 00:00:00+03:00,out,True,921316,False,1,7,9,2
167359,2019-11-05 00:00:00+03:00,out,False,921316,False,2,553,559,6
167359,2019-11-06 00:00:00+03:00,out,True,915360,False,1,13,18,5
167359,2019-11-06 00:00:00+03:00,out,False,915360,False,1,227,238,11
167359,2019-11-06 00:00:00+03:00,in,False,912722,False,8,586,622,36
167359,2019-11-06 00:00:00+03:00,out,True,918452,False,1,28,32,4
167359,2019-11-06 00:00:00+03:00,out,False,921316,False,1,158,168,10
167359,2019-11-06 00:00:00+03:00,out,True,921316,True,1,0,23,23
167359,2019-11-06 00:00:00+03:00,out,True,912722,True,1,0,18,18
167359,2019-11-06 00:00:00+03:00,out,False,912722,False,2,283,304,21
167359,2019-11-06 00:00:00+03:00,out,True,915360,False,1,13,18,5
167359,2019-11-06 00:00:00+03:00,in,False,912722,False,8,586,622,36
167359,2019-11-07 00:00:00+03:00,out,False,918452,False,3,498,542,44
167359,2019-11-07 00:00:00+03:00,out,True,915360,False,3,239,247,8
167359,2019-11-07 00:00:00+03:00,out,True,912722,True,1,0,4,4
167359,2019-11-07 00:00:00+03:00,out,True,918452,False,6,452,476,24
167359,2019-11-07 00:00:00+03:00,out,False,912722,True,4,0,133,133
167359,2019-11-07 00:00:00+03:00,in,False,912722,False,10,1809,1854,45
167359,2019-11-07 00:00:00+03:00,out,True,921316,False,5,137,154,17
167359,2019-11-07 00:00:00+03:00,in,False,-1,True,1,0,26,26
167359,2019-11-07 00:00:00+03:00,out,True,924356,False,4,124,143,19
167359,2019-11-07 00:00:00+03:00,out,False,915360,True,2,0,1,1
167359,2019-11-07 00:00:00+03:00,out,False,921316,False,1,86,88,2
167359,2019-11-07 00:00:00+03:00,out,True,924356,True,4,0,103,103
167359,2019-11-07 00:00:00+03:00,out,True,912722,False,7,1055,1109,54
167359,2019-11-07 00:00:00+03:00,out,False,912722,False,4,402,457,55
167359,2019-11-07 00:00:00+03:00,out,True,921316,True,5,0,0,0
167359,2019-11-07 00:00:00+03:00,out,True,918452,True,1,0,12,12
167359,2019-11-07 00:00:00+03:00,out,False,915360,False,1,612,614,2
167359,2019-11-07 00:00:00+03:00,out,True,915360,True,1,0,23,23
167359,2019-11-07 00:00:00+03:00,out,True,912722,False,7,1055,1109,54
167359,2019-11-08 00:00:00+03:00,out,True,912722,False,2,40,52,12
167359,2019-11-08 00:00:00+03:00,out,True,912722,True,1,0,19,19
167359,2019-11-08 00:00:00+03:00,out,True,918452,True,3,0,49,49
167359,2019-11-08 00:00:00+03:00,out,False,915360,False,4,867,877,10
167359,2019-11-08 00:00:00+03:00,out,False,918452,False,1,343,356,13
167359,2019-11-08 00:00:00+03:00,out,True,915358,False,11,181,230,49
167359,2019-11-08 00:00:00+03:00,out,True,921316,True,1,0,21,21
167359,2019-11-08 00:00:00+03:00,out,True,915360,False,5,205,224,19
167359,2019-11-08 00:00:00+03:00,out,True,915358,True,1,0,20,20
167359,2019-11-08 00:00:00+03:00,out,True,924356,True,1,0,18,18
167359,2019-11-08 00:00:00+03:00,in,False,912722,False,2,208,214,6
167359,2019-11-08 00:00:00+03:00,out,True,924356,False,3,320,336,16
167359,2019-11-08 00:00:00+03:00,out,False,912722,True,1,0,30,30
167359,2019-11-08 00:00:00+03:00,out,False,912722,False,1,116,127,11
167359,2019-11-08 00:00:00+03:00,out,False,924356,False,1,508,510,2
167359,2019-11-08 00:00:00+03:00,out,True,918452,False,2,308,314,6
167359,2019-11-08 00:00:00+03:00,out,True,915360,True,2,0,14,14
167359,2019-11-08 00:00:00+03:00,out,False,918452,False,1,343,356,13
167359,2019-11-09 00:00:00+03:00,in,False,-1,True,2,0,29,29
167359,2019-11-11 00:00:00+03:00,out,False,924356,False,1,82,94,12
167359,2019-11-11 00:00:00+03:00,out,True,924356,True,4,0,111,111
167359,2019-11-11 00:00:00+03:00,out,True,918452,False,3,140,151,11
167359,2019-11-11 00:00:00+03:00,out,True,915358,False,3,38,52,14
167359,2019-11-11 00:00:00+03:00,out,False,912722,True,3,0,49,49
167359,2019-11-11 00:00:00+03:00,out,True,915360,True,1,0,0,0
167359,2019-11-11 00:00:00+03:00,out,False,915360,False,2,434,440,6
167359,2019-11-11 00:00:00+03:00,out,True,918452,True,1,0,1,1
167359,2019-11-11 00:00:00+03:00,out,True,912722,False,2,198,204,6
167359,2019-11-11 00:00:00+03:00,out,True,924356,False,7,256,302,46
167359,2019-11-11 00:00:00+03:00,out,False,924356,True,1,0,25,25
167359,2019-11-11 00:00:00+03:00,out,True,915360,False,1,10,12,2
167359,2019-11-11 00:00:00+03:00,out,False,912722,False,5,229,297,68
167359,2019-11-11 00:00:00+03:00,in,False,912722,False,2,208,249,41
167359,2019-11-11 00:00:00+03:00,out,True,912722,False,2,198,204,6
167359,2019-11-11 00:00:00+03:00,out,False,912722,True,3,0,49,49
167359,2019-11-12 00:00:00+03:00,out,True,915358,True,3,0,51,51
167359,2019-11-12 00:00:00+03:00,out,True,915358,False,9,739,781,42
167359,2019-11-12 00:00:00+03:00,in,False,-1,True,1,0,40,40
167359,2019-11-12 00:00:00+03:00,out,True,912722,False,3,48,60,12
167359,2019-11-12 00:00:00+03:00,out,True,915360,False,7,579,609,30
167359,2019-11-12 00:00:00+03:00,out,True,924356,True,4,0,97,97
167359,2019-11-12 00:00:00+03:00,out,True,920146,False,1,72,74,2
167359,2019-11-12 00:00:00+03:00,out,True,920146,True,1,0,13,13
167359,2019-11-12 00:00:00+03:00,out,True,918452,False,5,434,450,16
167359,2019-11-12 00:00:00+03:00,in,False,912722,False,4,598,612,14
167359,2019-11-12 00:00:00+03:00,out,False,918452,False,2,266,297,31
167359,2019-11-12 00:00:00+03:00,out,True,918452,True,1,0,25,25
167359,2019-11-12 00:00:00+03:00,out,False,920146,False,2,364,383,19
167359,2019-11-12 00:00:00+03:00,out,False,915358,False,1,4,5,1
167359,2019-11-12 00:00:00+03:00,out,True,915360,True,2,0,53,53
167359,2019-11-12 00:00:00+03:00,out,True,924356,False,9,676,715,39
167359,2019-11-12 00:00:00+03:00,out,False,912722,False,2,113,137,24
167359,2019-11-12 00:00:00+03:00,out,False,912722,True,2,0,43,43
167359,2019-11-12 00:00:00+03:00,out,False,924370,False,1,152,153,1
167359,2019-11-12 00:00:00+03:00,out,False,915360,False,2,383,389,6
167359,2019-11-13 00:00:00+03:00,out,False,920146,True,1,0,8,8
167359,2019-11-13 00:00:00+03:00,out,False,912722,True,1,0,22,22
167359,2019-11-13 00:00:00+03:00,in,False,912722,False,2,205,214,9
167359,2019-11-13 00:00:00+03:00,out,False,915360,False,1,57,62,5
167359,2019-11-13 00:00:00+03:00,out,False,912722,False,2,123,155,32
167359,2019-11-13 00:00:00+03:00,out,True,912722,True,1,0,18,18
167359,2019-11-13 00:00:00+03:00,in,False,-1,True,2,0,48,48
167359,2019-11-13 00:00:00+03:00,out,True,918452,False,1,13,17,4
167359,2019-11-13 00:00:00+03:00,out,True,912722,False,1,23,26,3
167359,2019-11-13 00:00:00+03:00,out,True,912722,False,1,23,26,3
167359,2019-11-13 00:00:00+03:00,out,False,912722,True,1,0,22,22
167359,2019-11-13 00:00:00+03:00,out,True,918452,False,1,13,17,4
167359,2019-11-13 00:00:00+03:00,in,False,912722,False,2,205,214,9
167359,2019-11-14 00:00:00+03:00,out,True,924356,False,9,369,420,51
167359,2019-11-14 00:00:00+03:00,in,False,912722,False,2,113,123,10
167359,2019-11-14 00:00:00+03:00,out,False,915360,False,1,274,277,3
167359,2019-11-14 00:00:00+03:00,out,True,918452,False,3,273,290,17
167359,2019-11-14 00:00:00+03:00,out,True,920146,True,5,0,53,53
167359,2019-11-14 00:00:00+03:00,in,False,-1,True,1,0,19,19
167359,2019-11-14 00:00:00+03:00,out,True,915358,True,2,0,2,2
167359,2019-11-14 00:00:00+03:00,out,True,924356,True,1,0,15,15
167359,2019-11-14 00:00:00+03:00,out,False,920146,True,1,0,33,33
167359,2019-11-14 00:00:00+03:00,out,True,912722,False,2,91,98,7
167359,2019-11-14 00:00:00+03:00,out,True,915358,False,14,653,755,102
167359,2019-11-14 00:00:00+03:00,out,True,912722,True,2,0,27,27
167359,2019-11-14 00:00:00+03:00,out,False,915360,True,1,0,4,4
167359,2019-11-14 00:00:00+03:00,out,True,920146,False,6,118,159,41
167359,2019-11-14 00:00:00+03:00,out,False,920146,False,2,84,101,17
167359,2019-11-14 00:00:00+03:00,out,True,915360,False,9,764,804,40
167359,2019-11-14 00:00:00+03:00,out,False,915360,False,1,274,277,3
167359,2019-11-15 00:00:00+03:00,in,False,-1,True,2,0,56,56
167359,2019-11-15 00:00:00+03:00,in,False,912722,False,3,510,526,16
167359,2019-11-15 00:00:00+03:00,out,False,915360,False,2,194,207,13
167359,2019-11-15 00:00:00+03:00,out,False,920146,False,6,1104,1117,13
167359,2019-11-15 00:00:00+03:00,out,True,915360,True,1,0,0,0
167359,2019-11-18 00:00:00+03:00,out,False,918452,False,13,1342,1488,146
167359,2019-11-18 00:00:00+03:00,out,True,924356,False,2,169,175,6
167359,2019-11-18 00:00:00+03:00,in,False,-1,True,1,0,40,40
167359,2019-11-18 00:00:00+03:00,out,False,912722,True,1,0,33,33
167359,2019-11-18 00:00:00+03:00,out,True,918452,False,5,571,586,15
167359,2019-11-18 00:00:00+03:00,in,False,912722,False,2,102,111,9
167359,2019-11-18 00:00:00+03:00,out,False,918452,True,3,0,36,36
167359,2019-11-18 00:00:00+03:00,out,False,920146,False,2,90,98,8
167359,2019-11-18 00:00:00+03:00,out,True,915358,False,5,38,75,37
167359,2019-11-18 00:00:00+03:00,out,False,912722,False,3,88,109,21
167359,2019-11-18 00:00:00+03:00,out,True,924356,True,1,0,22,22
167359,2019-11-18 00:00:00+03:00,out,True,918452,True,1,0,0,0
167359,2019-11-18 00:00:00+03:00,out,True,915358,True,1,0,0,0
167359,2019-11-18 00:00:00+03:00,out,True,912722,True,2,0,15,15
167359,2019-11-18 00:00:00+03:00,in,False,-1,True,1,0,40,40
167359,2019-11-18 00:00:00+03:00,out,False,912722,True,1,0,33,33
167359,2019-11-19 00:00:00+03:00,out,True,912722,False,2,30,45,15
167359,2019-11-19 00:00:00+03:00,out,False,918452,False,2,349,374,25
167359,2019-11-19 00:00:00+03:00,out,True,915358,False,3,55,63,8
167359,2019-11-19 00:00:00+03:00,out,True,920146,True,1,0,0,0
167359,2019-11-19 00:00:00+03:00,out,True,918452,False,4,185,216,31
167359,2019-11-19 00:00:00+03:00,in,False,-1,True,1,0,29,29
167359,2019-11-19 00:00:00+03:00,out,False,920146,True,3,0,8,8
167359,2019-11-19 00:00:00+03:00,out,False,920146,False,4,540,579,39
167359,2019-11-19 00:00:00+03:00,in,False,912722,False,3,221,240,19
167359,2019-11-19 00:00:00+03:00,out,True,918452,True,1,0,0,0
167359,2019-11-19 00:00:00+03:00,out,False,912722,False,4,368,419,51
167359,2019-11-19 00:00:00+03:00,out,True,924356,True,2,0,36,36
167359,2019-11-19 00:00:00+03:00,out,False,912722,True,7,0,144,144
167359,2019-11-19 00:00:00+03:00,out,True,920146,False,1,29,38,9
167359,2019-11-19 00:00:00+03:00,in,False,-1,True,1,0,29,29
167359,2019-11-20 00:00:00+03:00,in,False,912722,False,11,865,920,55
167359,2019-11-20 00:00:00+03:00,out,True,915358,False,2,54,69,15
167359,2019-11-20 00:00:00+03:00,out,True,915358,True,1,0,24,24
167359,2019-11-20 00:00:00+03:00,out,False,920146,False,3,222,263,41
167359,2019-11-20 00:00:00+03:00,out,False,912722,False,1,67,79,12
167359,2019-11-20 00:00:00+03:00,out,False,918452,False,4,309,348,39
167359,2019-11-20 00:00:00+03:00,out,True,915360,False,1,12,15,3
167359,2019-11-20 00:00:00+03:00,out,False,918452,True,2,0,52,52
167359,2019-11-20 00:00:00+03:00,out,True,918452,True,1,0,0,0
167359,2019-11-20 00:00:00+03:00,in,False,-1,True,5,0,176,176
167359,2019-11-20 00:00:00+03:00,out,True,915360,True,4,0,0,0
167359,2019-11-20 00:00:00+03:00,out,True,918452,False,7,566,597,31
167359,2019-11-20 00:00:00+03:00,out,True,912722,False,1,56,59,3
167359,2019-11-21 00:00:00+03:00,out,False,918452,False,2,231,270,39
167359,2019-11-21 00:00:00+03:00,out,False,918452,True,1,0,26,26
167359,2019-11-21 00:00:00+03:00,out,False,921316,False,2,162,197,35
167359,2019-11-21 00:00:00+03:00,out,True,918452,False,6,336,350,14
167359,2019-11-21 00:00:00+03:00,out,False,920146,False,1,148,152,4
167359,2019-11-21 00:00:00+03:00,out,True,912722,False,3,54,70,16
167359,2019-11-21 00:00:00+03:00,out,False,912722,True,1,0,5,5
167359,2019-11-21 00:00:00+03:00,in,False,912722,False,5,688,708,20
167359,2019-11-21 00:00:00+03:00,out,False,912722,False,4,225,285,60
167359,2019-11-21 00:00:00+03:00,out,True,912722,True,1,0,15,15
167359,2019-11-21 00:00:00+03:00,out,True,924370,False,1,204,208,4
167359,2019-11-21 00:00:00+03:00,in,False,-1,True,1,0,46,46
167359,2019-11-21 00:00:00+03:00,out,False,920146,True,2,0,50,50
167359,2019-11-21 00:00:00+03:00,out,True,921316,True,1,0,0,0
167359,2019-11-21 00:00:00+03:00,out,True,915358,False,1,28,39,11
167359,2019-11-22 00:00:00+03:00,out,False,912722,False,4,224,271,47
167359,2019-11-22 00:00:00+03:00,out,True,912722,True,1,0,1,1
167359,2019-11-22 00:00:00+03:00,out,True,912722,False,2,29,41,12
167359,2019-11-22 00:00:00+03:00,out,True,915358,True,4,0,76,76
167359,2019-11-22 00:00:00+03:00,out,False,915358,True,1,0,2,2
167359,2019-11-22 00:00:00+03:00,in,False,912722,False,2,277,287,10
167359,2019-11-22 00:00:00+03:00,out,False,918452,False,1,320,336,16
167359,2019-11-22 00:00:00+03:00,out,False,920146,False,5,1401,1438,37
167359,2019-11-22 00:00:00+03:00,out,True,918452,False,2,36,45,9
167359,2019-11-22 00:00:00+03:00,out,True,920146,True,1,0,16,16
167359,2019-11-22 00:00:00+03:00,out,False,912722,True,2,0,12,12
167359,2019-11-22 00:00:00+03:00,out,True,915358,False,15,838,937,99
167359,2019-11-22 00:00:00+03:00,out,False,915358,False,1,64,70,6
167359,2019-11-22 00:00:00+03:00,in,False,-1,True,2,0,110,110
167359,2019-11-22 00:00:00+03:00,out,True,912722,False,2,29,41,12
167359,2019-11-22 00:00:00+03:00,out,True,912722,True,1,0,1,1
167359,2019-11-23 00:00:00+03:00,in,False,-1,True,1,0,56,56
167359,2019-11-24 00:00:00+03:00,in,False,-1,True,1,0,27,27
167359,2019-11-25 00:00:00+03:00,out,True,924356,True,3,0,70,70
167359,2019-11-25 00:00:00+03:00,out,False,920146,True,4,0,79,79
167359,2019-11-25 00:00:00+03:00,out,True,918452,True,2,0,45,45
167359,2019-11-25 00:00:00+03:00,out,True,912722,True,2,0,37,37
167359,2019-11-25 00:00:00+03:00,out,False,920146,False,4,205,264,59
167359,2019-11-25 00:00:00+03:00,out,True,915360,True,2,0,67,67
167359,2019-11-25 00:00:00+03:00,out,True,915360,False,6,460,492,32
167359,2019-11-25 00:00:00+03:00,out,True,915358,True,1,0,17,17
167359,2019-11-25 00:00:00+03:00,in,False,912722,False,7,892,926,34
167359,2019-11-25 00:00:00+03:00,out,True,915358,False,9,588,643,55
167359,2019-11-25 00:00:00+03:00,out,True,924356,False,3,29,46,17
167359,2019-11-25 00:00:00+03:00,out,True,921316,True,3,0,76,76
167359,2019-11-25 00:00:00+03:00,out,False,912722,False,3,335,384,49
167359,2019-11-25 00:00:00+03:00,out,True,921316,False,1,67,69,2
167359,2019-11-25 00:00:00+03:00,out,True,918452,False,4,547,561,14
167359,2019-11-25 00:00:00+03:00,out,False,912722,True,1,0,28,28
167359,2019-11-25 00:00:00+03:00,out,True,912722,False,3,210,224,14
167359,2019-11-25 00:00:00+03:00,out,True,921316,True,3,0,76,76
167359,2019-11-26 00:00:00+03:00,out,True,915360,True,1,0,16,16
167359,2019-11-26 00:00:00+03:00,out,True,924356,True,6,0,144,144
167359,2019-11-26 00:00:00+03:00,out,True,918452,True,3,0,64,64
167359,2019-11-26 00:00:00+03:00,out,True,915358,True,4,0,99,99
167359,2019-11-26 00:00:00+03:00,out,True,920146,False,1,1,14,13
167359,2019-11-26 00:00:00+03:00,in,False,912722,False,4,632,649,17
167359,2019-11-26 00:00:00+03:00,out,False,915360,False,2,381,386,5
167359,2019-11-26 00:00:00+03:00,out,True,915358,False,4,211,232,21
167359,2019-11-26 00:00:00+03:00,out,True,912722,False,3,58,67,9
167359,2019-11-26 00:00:00+03:00,out,True,924356,False,1,54,57,3
167359,2019-11-26 00:00:00+03:00,out,False,915360,True,1,0,2,2
167359,2019-11-26 00:00:00+03:00,out,False,920146,False,2,441,476,35
167359,2019-11-26 00:00:00+03:00,out,False,920146,True,1,0,5,5
167359,2019-11-26 00:00:00+03:00,out,False,918452,False,1,18,32,14
167359,2019-11-26 00:00:00+03:00,in,False,-1,True,5,0,854,854
167359,2019-11-26 00:00:00+03:00,out,True,912722,False,3,58,67,9
167359,2019-11-26 00:00:00+03:00,in,False,912722,False,4,632,649,17
167359,2019-11-27 00:00:00+03:00,out,True,918452,False,1,62,70,8
167359,2019-11-27 00:00:00+03:00,out,True,920146,True,1,0,0,0
167359,2019-11-27 00:00:00+03:00,out,False,912722,True,1,0,13,13
167359,2019-11-27 00:00:00+03:00,out,True,912722,True,1,0,16,16
167359,2019-11-27 00:00:00+03:00,out,False,918452,True,1,0,39,39
167359,2019-11-27 00:00:00+03:00,out,True,918452,True,3,0,59,59
167359,2019-11-27 00:00:00+03:00,out,False,920146,True,1,0,0,0
167359,2019-11-27 00:00:00+03:00,out,True,915360,True,1,0,36,36
167359,2019-11-27 00:00:00+03:00,in,False,912722,False,1,163,169,6
167359,2019-11-27 00:00:00+03:00,out,False,920146,False,3,461,480,19
167359,2019-11-27 00:00:00+03:00,out,True,912722,False,2,9,21,12
167359,2019-11-27 00:00:00+03:00,out,False,915360,False,3,332,336,4
167359,2019-11-27 00:00:00+03:00,out,False,912722,False,4,399,443,44
167359,2019-11-27 00:00:00+03:00,out,False,920146,False,3,461,480,19
167359,2019-11-27 00:00:00+03:00,out,True,920146,True,1,0,0,0
167359,2019-11-28 00:00:00+03:00,out,False,918452,False,6,413,513,100
167359,2019-11-28 00:00:00+03:00,out,False,918452,True,2,0,10,10
167359,2019-11-28 00:00:00+03:00,out,True,915360,False,2,27,34,7
167359,2019-11-28 00:00:00+03:00,out,True,918452,True,2,0,29,29
167359,2019-11-28 00:00:00+03:00,out,False,924356,True,1,0,5,5
167359,2019-11-28 00:00:00+03:00,out,True,924356,True,1,0,17,17
167359,2019-11-28 00:00:00+03:00,out,True,924356,False,6,203,235,32
167359,2019-11-28 00:00:00+03:00,out,True,912722,True,2,0,27,27
167359,2019-11-28 00:00:00+03:00,out,True,912722,False,10,574,635,61
167359,2019-11-28 00:00:00+03:00,out,False,912722,False,8,634,716,82
167359,2019-11-28 00:00:00+03:00,in,False,912722,False,7,1542,1602,60
167359,2019-11-28 00:00:00+03:00,in,False,-1,True,3,0,18,18
167359,2019-11-28 00:00:00+03:00,out,False,924356,False,2,56,91,35
167359,2019-11-28 00:00:00+03:00,out,True,920146,True,4,0,67,67
167359,2019-11-28 00:00:00+03:00,out,False,920146,True,3,0,68,68
167359,2019-11-28 00:00:00+03:00,out,False,912722,True,1,0,31,31
167359,2019-11-28 00:00:00+03:00,out,True,915358,False,10,258,300,42
167359,2019-11-28 00:00:00+03:00,out,True,915358,True,1,0,47,47
167359,2019-11-28 00:00:00+03:00,out,True,920146,False,6,298,339,41
167359,2019-11-28 00:00:00+03:00,out,True,918452,False,5,471,492,21
167359,2019-11-28 00:00:00+03:00,in,False,-1,True,3,0,18,18
167359,2019-11-28 00:00:00+03:00,out,False,918452,False,6,413,513,100
167359,2019-11-28 00:00:00+03:00,out,False,912722,True,1,0,31,31
167359,2019-11-28 00:00:00+03:00,out,False,918452,True,2,0,10,10
167364,2019-10-01 00:00:00+03:00,in,False,-1,True,7,0,0,0
167364,2019-10-02 00:00:00+03:00,in,False,-1,True,2,0,20,20
167364,2019-10-09 00:00:00+03:00,in,False,-1,True,1,0,19,19
167364,2019-11-14 00:00:00+03:00,out,False,924572,True,1,0,1,1
167397,2019-10-02 00:00:00+03:00,in,False,-1,True,1,0,2,2
167397,2019-10-03 00:00:00+03:00,in,False,927142,False,1,36,39,3
167397,2019-11-05 00:00:00+03:00,in,False,-1,True,1,0,0,0
167397,2019-11-19 00:00:00+03:00,in,False,927142,False,1,2325,2329,4
167397,2019-11-19 00:00:00+03:00,out,False,927142,True,1,0,12,12
167397,2019-11-20 00:00:00+03:00,out,False,927142,True,1,0,3,3
167397,2019-11-20 00:00:00+03:00,in,False,927142,False,1,5,10,5
167397,2019-11-22 00:00:00+03:00,in,False,927142,False,1,6,9,3
167397,2019-11-27 00:00:00+03:00,out,False,927142,False,1,7,14,7
167397,2019-11-28 00:00:00+03:00,in,False,-1,True,2,0,40,40
167402,2019-09-16 00:00:00+03:00,in,False,-1,True,6,0,16,16
167402,2019-09-17 00:00:00+03:00,in,False,-1,True,22,0,2,2
167402,2019-09-18 00:00:00+03:00,in,False,912010,False,1,4,7,3
167402,2019-09-18 00:00:00+03:00,in,False,-1,True,8,0,4,4
167402,2019-09-19 00:00:00+03:00,in,False,-1,True,11,0,142,142
167402,2019-09-19 00:00:00+03:00,in,False,912010,False,9,370,501,131
167402,2019-09-19 00:00:00+03:00,in,False,-1,False,1,31,52,21
167402,2019-09-19 00:00:00+03:00,in,False,912010,True,1,0,19,19
167402,2019-09-20 00:00:00+03:00,in,False,912010,False,1,54,66,12
167402,2019-09-23 00:00:00+03:00,in,False,912010,False,8,549,747,198
167402,2019-09-23 00:00:00+03:00,in,False,-1,True,3,0,107,107
167402,2019-09-23 00:00:00+03:00,in,True,912010,False,1,248,264,16
167402,2019-09-23 00:00:00+03:00,in,True,912010,False,1,248,264,16
167402,2019-09-24 00:00:00+03:00,in,False,912010,False,2,164,190,26
167402,2019-09-24 00:00:00+03:00,in,False,-1,True,1,0,28,28
167402,2019-09-25 00:00:00+03:00,in,False,912010,False,2,42,90,48
167402,2019-09-25 00:00:00+03:00,in,False,-1,True,1,0,26,26
167402,2019-09-26 00:00:00+03:00,in,False,912010,False,1,11,62,51
167402,2019-09-26 00:00:00+03:00,in,False,-1,True,1,0,26,26
167402,2019-09-26 00:00:00+03:00,in,False,912010,False,1,11,62,51
167402,2019-09-27 00:00:00+03:00,in,False,-1,True,2,0,3,3
167402,2019-09-27 00:00:00+03:00,in,False,912010,False,4,314,364,50
167402,2019-09-28 00:00:00+03:00,in,False,-1,True,2,0,64,64
167402,2019-09-28 00:00:00+03:00,in,False,912010,False,2,142,177,35
167402,2019-09-29 00:00:00+03:00,in,False,-1,True,1,0,20,20
167402,2019-09-30 00:00:00+03:00,in,False,912010,False,1,53,72,19
167402,2019-10-01 00:00:00+03:00,in,False,912010,False,2,113,153,40
167402,2019-10-01 00:00:00+03:00,in,False,-1,True,2,0,59,59
167402,2019-10-02 00:00:00+03:00,in,False,912010,False,3,391,458,67
167402,2019-10-02 00:00:00+03:00,in,False,-1,True,2,0,67,67
167402,2019-10-03 00:00:00+03:00,in,False,912010,False,5,149,241,92
167402,2019-10-04 00:00:00+03:00,in,False,912010,False,2,218,258,40
167402,2019-10-08 00:00:00+03:00,in,False,912010,False,4,518,604,86
167402,2019-10-09 00:00:00+03:00,in,False,912010,True,1,0,30,30
167402,2019-10-09 00:00:00+03:00,in,False,912010,False,3,567,605,38
167402,2019-10-10 00:00:00+03:00,in,False,-1,True,8,0,162,162
167402,2019-10-10 00:00:00+03:00,in,False,912010,False,7,248,306,58
167402,2019-10-11 00:00:00+03:00,in,False,-1,True,1,0,45,45
167402,2019-10-14 00:00:00+03:00,in,False,-1,True,1,0,37,37
167402,2019-10-15 00:00:00+03:00,in,False,-1,True,1,0,35,35
167402,2019-10-15 00:00:00+03:00,in,False,912010,False,1,29,53,24
167402,2019-10-16 00:00:00+03:00,in,False,912010,False,4,239,316,77
167402,2019-10-17 00:00:00+03:00,in,False,912010,False,4,100,158,58
167402,2019-10-17 00:00:00+03:00,in,False,-1,True,3,0,28,28
167402,2019-10-18 00:00:00+03:00,in,False,912010,False,4,18,62,44
167402,2019-10-19 00:00:00+03:00,in,False,912010,False,1,13,47,34
167402,2019-10-20 00:00:00+03:00,in,False,912010,False,1,5,40,35
167402,2019-10-21 00:00:00+03:00,in,False,912010,False,2,37,110,73
167402,2019-10-21 00:00:00+03:00,in,False,-1,True,1,0,26,26
167402,2019-10-22 00:00:00+03:00,in,False,912010,False,4,235,294,59
167402,2019-10-22 00:00:00+03:00,in,False,-1,True,2,0,0,0
167402,2019-10-23 00:00:00+03:00,in,False,-1,True,1,0,2,2
167402,2019-10-23 00:00:00+03:00,in,False,-1,True,1,0,2,2
167402,2019-10-24 00:00:00+03:00,in,False,-1,True,2,0,4,4
167402,2019-10-25 00:00:00+03:00,in,False,-1,True,3,0,6,6
167402,2019-10-26 00:00:00+03:00,in,False,-1,True,2,0,4,4
167402,2019-10-27 00:00:00+03:00,in,False,-1,True,6,0,12,12
167402,2019-10-28 00:00:00+03:00,in,False,-1,True,5,0,39,39
167402,2019-10-28 00:00:00+03:00,in,False,912010,False,3,29,148,119
167402,2019-10-29 00:00:00+03:00,in,False,912010,False,5,194,258,64
167402,2019-10-30 00:00:00+03:00,in,False,912010,False,6,185,303,118
167402,2019-10-31 00:00:00+03:00,in,False,-1,True,1,0,27,27
167402,2019-10-31 00:00:00+03:00,in,False,912010,False,2,233,258,25
167402,2019-11-01 00:00:00+03:00,in,False,912010,False,1,3,41,38
167402,2019-11-02 00:00:00+03:00,in,False,912010,False,6,265,337,72
167402,2019-11-04 00:00:00+03:00,in,False,912010,False,1,18,56,38
167402,2019-11-05 00:00:00+03:00,in,False,-1,True,1,0,27,27
167402,2019-11-05 00:00:00+03:00,in,False,912010,False,8,265,361,96
167402,2019-11-06 00:00:00+03:00,in,False,912010,False,1,120,129,9
167402,2019-11-06 00:00:00+03:00,in,False,-1,True,1,0,33,33
167402,2019-11-07 00:00:00+03:00,in,False,912010,False,1,52,63,11
167402,2019-11-08 00:00:00+03:00,in,False,912010,False,1,1,8,7
167402,2019-11-08 00:00:00+03:00,in,False,-1,True,1,0,8,8
167402,2019-11-08 00:00:00+03:00,in,False,-1,True,1,0,8,8
167402,2019-11-11 00:00:00+03:00,in,False,912010,False,4,133,192,59
167402,2019-11-12 00:00:00+03:00,in,False,-1,True,1,0,17,17
167402,2019-11-13 00:00:00+03:00,in,False,912010,False,3,390,428,38
167402,2019-11-15 00:00:00+03:00,in,False,912010,False,1,36,45,9
167402,2019-11-16 00:00:00+03:00,in,False,912010,False,2,184,216,32
167402,2019-11-18 00:00:00+03:00,in,False,912010,False,1,42,71,29
167402,2019-11-19 00:00:00+03:00,in,False,-1,True,1,0,9,9
167402,2019-11-19 00:00:00+03:00,in,False,-1,True,2,0,34,34
167402,2019-11-20 00:00:00+03:00,in,False,912010,False,1,14,22,8
167402,2019-11-21 00:00:00+03:00,in,False,912010,False,1,71,105,34
167402,2019-11-22 00:00:00+03:00,in,False,912010,False,1,134,150,16
167402,2019-11-23 00:00:00+03:00,in,False,912010,False,3,222,275,53
167402,2019-11-24 00:00:00+03:00,in,False,912010,False,1,87,100,13
167402,2019-11-25 00:00:00+03:00,in,False,-1,True,1,0,33,33
167402,2019-11-25 00:00:00+03:00,in,False,912010,False,4,15,159,144
167402,2019-11-26 00:00:00+03:00,in,False,912010,False,4,660,721,61
167402,2019-11-27 00:00:00+03:00,in,False,912010,False,2,31,72,41
167412,2019-09-17 00:00:00+03:00,in,False,-1,True,1,0,2,2
167412,2019-09-18 00:00:00+03:00,in,True,914440,False,1,15,38,23
167412,2019-09-18 00:00:00+03:00,out,True,914440,True,1,0,2,2
167412,2019-09-18 00:00:00+03:00,in,False,914440,False,5,176,242,66
167412,2019-09-18 00:00:00+03:00,in,False,-1,True,6,0,173,173
167412,2019-09-18 00:00:00+03:00,in,False,-1,True,7,0,140,140
167412,2019-09-19 00:00:00+03:00,in,False,-1,True,4,0,62,62
167412,2019-09-19 00:00:00+03:00,in,True,914440,True,1,0,17,17
167412,2019-09-19 00:00:00+03:00,in,False,-1,True,3,0,52,52
167412,2019-09-19 00:00:00+03:00,in,False,-1,True,4,0,62,62
167412,2019-09-21 00:00:00+03:00,in,False,-1,True,1,0,12,12
167412,2019-09-21 00:00:00+03:00,in,False,914440,False,1,488,504,16
167412,2019-09-22 00:00:00+03:00,in,False,-1,True,1,0,33,33
167412,2019-09-26 00:00:00+03:00,in,False,-1,True,1,0,13,13
167412,2019-09-27 00:00:00+03:00,in,False,-1,True,2,0,19,19
167412,2019-09-28 00:00:00+03:00,in,False,-1,True,1,0,24,24
167412,2019-09-28 00:00:00+03:00,in,False,-1,True,1,0,24,24
167412,2019-09-30 00:00:00+03:00,in,False,914440,False,1,116,135,19
167412,2019-09-30 00:00:00+03:00,in,False,-1,True,1,0,30,30
167412,2019-10-01 00:00:00+03:00,in,False,914440,False,3,649,702,53
167412,2019-10-04 00:00:00+03:00,in,False,-1,True,1,0,8,8
167412,2019-10-05 00:00:00+03:00,in,False,914440,False,1,57,76,19
167412,2019-10-07 00:00:00+03:00,in,False,914440,False,1,36,58,22
167412,2019-10-09 00:00:00+03:00,in,False,-1,True,1,0,30,30
167412,2019-10-09 00:00:00+03:00,in,False,914440,False,3,372,418,46
167412,2019-10-10 00:00:00+03:00,in,False,914440,False,1,367,383,16
167412,2019-10-14 00:00:00+03:00,in,False,-1,True,1,0,1,1
167412,2019-10-14 00:00:00+03:00,in,False,914440,False,1,61,85,24
167412,2019-10-20 00:00:00+03:00,in,False,-1,True,1,0,42,42
167412,2019-10-22 00:00:00+03:00,in,False,914440,False,1,108,122,14
167412,2019-10-28 00:00:00+03:00,in,False,914440,False,1,28,52,24
167412,2019-10-30 00:00:00+03:00,in,False,-1,True,1,0,18,18
167412,2019-10-30 00:00:00+03:00,in,False,914440,False,2,417,464,47
167412,2019-10-31 00:00:00+03:00,in,False,914440,False,1,25,71,46
167412,2019-11-03 00:00:00+03:00,in,False,914440,False,1,93,109,16
167412,2019-11-04 00:00:00+03:00,in,False,914440,False,1,7,22,15
167412,2019-11-05 00:00:00+03:00,in,False,-1,True,1,0,30,30
167412,2019-11-05 00:00:00+03:00,in,False,954290,False,1,39,58,19
167412,2019-11-08 00:00:00+03:00,in,False,954290,False,2,446,481,35
167412,2019-11-08 00:00:00+03:00,in,False,954290,False,2,446,481,35
167412,2019-11-09 00:00:00+03:00,in,False,954290,False,2,51,95,44
167412,2019-11-12 00:00:00+03:00,in,False,954290,False,2,331,364,33
167412,2019-11-13 00:00:00+03:00,in,False,954290,False,1,129,160,31
167412,2019-11-13 00:00:00+03:00,in,False,-1,True,1,0,16,16
167412,2019-11-16 00:00:00+03:00,in,False,-1,True,1,0,2,2
167412,2019-11-16 00:00:00+03:00,in,True,954290,False,1,18,33,15
167412,2019-11-17 00:00:00+03:00,in,False,954290,False,1,57,77,20
167412,2019-11-19 00:00:00+03:00,in,False,-1,True,1,0,13,13
167412,2019-11-20 00:00:00+03:00,in,False,-1,True,1,0,2,2
167412,2019-11-21 00:00:00+03:00,in,False,-1,True,1,0,19,19
167412,2019-11-23 00:00:00+03:00,in,False,914440,False,3,547,595,48
167412,2019-11-25 00:00:00+03:00,in,True,965942,False,2,13,30,17
167412,2019-11-25 00:00:00+03:00,in,False,914440,False,1,82,124,42
167412,2019-11-25 00:00:00+03:00,in,False,965942,False,2,202,236,34
167412,2019-11-25 00:00:00+03:00,in,False,-1,True,2,0,4,4
167436,2019-09-17 00:00:00+03:00,in,False,-1,True,1,0,2,2
167436,2019-09-18 00:00:00+03:00,in,False,914256,False,1,13,25,12
167436,2019-09-18 00:00:00+03:00,in,False,-1,True,1,0,4,4
167436,2019-09-19 00:00:00+03:00,in,False,914256,False,1,6,18,12
167436,2019-09-21 00:00:00+03:00,in,False,-1,True,1,0,13,13
167436,2019-09-23 00:00:00+03:00,in,False,914256,False,1,267,282,15
167436,2019-09-23 00:00:00+03:00,in,False,914256,False,1,267,282,15
167436,2019-09-25 00:00:00+03:00,in,False,914256,False,1,62,75,13
167436,2019-10-01 00:00:00+03:00,out,False,914266,False,1,2,18,16
167436,2019-10-02 00:00:00+03:00,in,False,914256,False,2,95,123,28
167436,2019-10-15 00:00:00+03:00,out,False,914256,False,1,6,15,9
167436,2019-10-15 00:00:00+03:00,out,False,914266,False,2,21,42,21
167436,2019-10-15 00:00:00+03:00,out,True,914266,False,2,49,79,30
167436,2019-10-16 00:00:00+03:00,in,False,914256,False,1,18,29,11
167436,2019-10-18 00:00:00+03:00,out,False,939886,True,1,0,46,46
167436,2019-10-18 00:00:00+03:00,out,False,939886,False,1,74,84,10
167436,2019-10-18 00:00:00+03:00,in,False,914256,False,1,165,175,10
167436,2019-10-18 00:00:00+03:00,out,False,939886,False,1,74,84,10
167436,2019-10-18 00:00:00+03:00,out,False,939886,True,1,0,46,46
167436,2019-10-21 00:00:00+03:00,in,False,914256,False,1,10,41,31
167436,2019-10-21 00:00:00+03:00,out,False,939886,False,11,465,565,100
167436,2019-10-21 00:00:00+03:00,out,False,939886,True,1,0,31,31
167436,2019-10-22 00:00:00+03:00,out,False,939886,False,17,2326,2538,212
167436,2019-10-22 00:00:00+03:00,in,False,-1,True,1,0,25,25
167436,2019-10-22 00:00:00+03:00,out,False,939886,True,4,0,122,122
167436,2019-10-22 00:00:00+03:00,in,False,914256,False,2,65,116,51
167436,2019-10-22 00:00:00+03:00,out,True,939886,True,1,0,8,8
167436,2019-10-23 00:00:00+03:00,out,False,939886,True,4,0,38,38
167436,2019-10-23 00:00:00+03:00,out,False,939886,False,10,704,805,101
167436,2019-10-23 00:00:00+03:00,in,False,-1,True,1,0,37,37
167436,2019-10-24 00:00:00+03:00,in,False,-1,True,3,0,94,94
167436,2019-10-25 00:00:00+03:00,out,False,939886,True,1,0,13,13
167436,2019-10-25 00:00:00+03:00,in,False,-1,True,1,0,32,32
167436,2019-10-25 00:00:00+03:00,out,False,939886,False,4,1009,1044,35
167436,2019-10-28 00:00:00+03:00,in,False,914256,False,5,247,314,67
167436,2019-10-29 00:00:00+03:00,out,False,939886,False,4,354,376,22
167436,2019-10-29 00:00:00+03:00,in,False,914256,False,1,29,59,30
167436,2019-10-29 00:00:00+03:00,out,False,939886,True,1,0,3,3
167436,2019-10-29 00:00:00+03:00,in,False,-1,True,2,0,64,64
167436,2019-10-31 00:00:00+03:00,in,False,914256,False,1,6,14,8
167436,2019-11-02 00:00:00+03:00,in,False,-1,True,1,0,32,32
167436,2019-11-05 00:00:00+03:00,in,False,914256,False,2,194,215,21
167436,2019-11-06 00:00:00+03:00,in,False,-1,True,1,0,32,32
167436,2019-11-06 00:00:00+03:00,out,False,939886,False,32,2796,2975,179
167436,2019-11-06 00:00:00+03:00,out,False,939886,True,7,0,296,296
167436,2019-11-06 00:00:00+03:00,in,False,914256,False,3,79,110,31
167436,2019-11-07 00:00:00+03:00,out,False,939886,True,1,0,60,60
167436,2019-11-07 00:00:00+03:00,out,False,939886,False,8,1550,1599,49
167436,2019-11-08 00:00:00+03:00,in,False,914256,False,1,137,165,28
167436,2019-11-08 00:00:00+03:00,out,False,939886,True,4,0,70,70
167436,2019-11-08 00:00:00+03:00,out,False,939886,False,28,1848,2085,237
167436,2019-11-08 00:00:00+03:00,out,False,939886,False,28,1848,2085,237
167436,2019-11-10 00:00:00+03:00,in,False,-1,True,1,0,21,21
167436,2019-11-11 00:00:00+03:00,out,False,939886,False,9,1616,1745,129
167436,2019-11-11 00:00:00+03:00,out,False,939886,True,1,0,46,46
167436,2019-11-12 00:00:00+03:00,out,True,939886,True,2,0,33,33
167436,2019-11-12 00:00:00+03:00,out,False,939886,False,9,3047,3075,28
167436,2019-11-12 00:00:00+03:00,out,False,939886,True,4,0,15,15
167436,2019-11-13 00:00:00+03:00,out,False,939886,False,9,752,826,74
167436,2019-11-13 00:00:00+03:00,in,False,-1,True,6,0,146,146
167436,2019-11-13 00:00:00+03:00,out,False,939886,True,2,0,31,31
167436,2019-11-14 00:00:00+03:00,in,False,-1,True,9,0,253,253
167436,2019-11-14 00:00:00+03:00,in,False,-1,True,5,0,185,185
167436,2019-11-14 00:00:00+03:00,out,False,939886,True,6,0,143,143
167436,2019-11-14 00:00:00+03:00,out,False,914272,True,1,0,9,9
167436,2019-11-14 00:00:00+03:00,out,False,939886,False,9,767,850,83
167436,2019-11-15 00:00:00+03:00,in,False,-1,True,1,0,44,44
167436,2019-11-15 00:00:00+03:00,out,False,939886,False,5,1129,1136,7
167436,2019-11-18 00:00:00+03:00,out,False,939886,False,15,840,918,78
167436,2019-11-18 00:00:00+03:00,out,False,939886,True,7,0,136,136
167436,2019-11-19 00:00:00+03:00,out,False,939886,False,2,48,76,28
167436,2019-11-19 00:00:00+03:00,out,False,939886,True,1,0,5,5
167436,2019-11-20 00:00:00+03:00,out,False,939886,False,5,219,250,31
167436,2019-11-20 00:00:00+03:00,out,False,939886,True,3,0,6,6
167436,2019-11-21 00:00:00+03:00,out,True,939886,False,4,70,87,17
167436,2019-11-21 00:00:00+03:00,out,True,961552,True,5,0,26,26
167436,2019-11-21 00:00:00+03:00,out,True,939886,True,5,0,23,23
167436,2019-11-21 00:00:00+03:00,in,False,-1,True,1,0,25,25
167436,2019-11-21 00:00:00+03:00,in,False,-1,True,5,0,63,63
167436,2019-11-21 00:00:00+03:00,out,False,961552,False,2,12,36,24
167436,2019-11-21 00:00:00+03:00,in,False,961552,False,3,76,180,104
167436,2019-11-21 00:00:00+03:00,out,False,939886,False,2,57,70,13
167436,2019-11-21 00:00:00+03:00,out,True,961552,False,3,18,20,2
167436,2019-11-21 00:00:00+03:00,out,True,961552,True,5,0,26,26
167436,2019-11-22 00:00:00+03:00,out,False,939886,True,4,0,81,81
167436,2019-11-22 00:00:00+03:00,out,False,961552,False,1,466,467,1
167436,2019-11-22 00:00:00+03:00,out,False,939886,False,7,559,614,55
167436,2019-11-22 00:00:00+03:00,out,False,961552,False,1,466,467,1
167436,2019-11-25 00:00:00+03:00,out,False,939886,False,1,121,122,1
167436,2019-11-26 00:00:00+03:00,out,False,939886,False,1,114,117,3
167436,2019-11-26 00:00:00+03:00,out,True,939886,False,1,17,36,19
167436,2019-11-27 00:00:00+03:00,out,False,939886,True,7,0,168,168
167436,2019-11-27 00:00:00+03:00,in,False,-1,True,1,0,5,5
167436,2019-11-27 00:00:00+03:00,out,False,939886,False,20,2010,2230,220
167436,2019-11-28 00:00:00+03:00,in,False,-1,True,1,0,35,35
167445,2019-09-27 00:00:00+03:00,out,False,920902,True,1,0,10,10
167445,2019-09-27 00:00:00+03:00,out,False,920838,False,1,9,29,20
167445,2019-09-27 00:00:00+03:00,out,False,920720,False,5,90,191,101
167445,2019-09-27 00:00:00+03:00,in,False,920852,False,1,26,33,7
167445,2019-09-27 00:00:00+03:00,in,False,920726,False,2,278,302,24
167445,2019-09-27 00:00:00+03:00,out,False,920852,False,1,3,16,13
167445,2019-09-27 00:00:00+03:00,out,False,920852,True,1,0,3,3
167445,2019-09-27 00:00:00+03:00,out,False,920720,True,2,0,33,33
167445,2019-09-27 00:00:00+03:00,out,False,920726,False,3,31,57,26
167445,2019-09-27 00:00:00+03:00,out,False,920838,True,1,0,11,11
167445,2019-09-27 00:00:00+03:00,in,False,-1,True,2,0,69,69
167445,2019-09-27 00:00:00+03:00,out,True,920720,True,1,0,0,0
167445,2019-09-27 00:00:00+03:00,in,False,920720,False,1,10,16,6
167445,2019-09-27 00:00:00+03:00,out,True,920838,True,1,0,0,0
167445,2019-09-27 00:00:00+03:00,in,False,920706,False,1,7,17,10
167445,2019-09-27 00:00:00+03:00,out,False,921062,False,1,10,22,12
167445,2019-09-27 00:00:00+03:00,in,False,920902,False,1,9,15,6
167445,2019-09-27 00:00:00+03:00,in,False,921062,False,1,16,23,7
167445,2019-09-27 00:00:00+03:00,out,False,920838,False,1,9,29,20
167445,2019-09-27 00:00:00+03:00,out,True,920838,True,1,0,0,0
167445,2019-09-30 00:00:00+03:00,out,False,920720,False,3,71,107,36
167445,2019-09-30 00:00:00+03:00,in,False,-1,True,4,0,77,77
167445,2019-09-30 00:00:00+03:00,in,False,920706,False,1,92,98,6
167445,2019-09-30 00:00:00+03:00,in,False,920720,False,4,107,128,21
167445,2019-09-30 00:00:00+03:00,out,False,920706,False,3,90,134,44
167445,2019-09-30 00:00:00+03:00,out,True,920720,True,2,0,0,0
167445,2019-10-01 00:00:00+03:00,out,True,920728,True,17,0,15,15
167445,2019-10-01 00:00:00+03:00,in,False,-1,True,13,0,128,128
167445,2019-10-01 00:00:00+03:00,out,False,920728,False,1,27,32,5
167445,2019-10-01 00:00:00+03:00,out,True,920728,False,1,6,9,3
167445,2019-10-01 00:00:00+03:00,in,False,920732,False,2,77,95,18
167445,2019-10-01 00:00:00+03:00,in,False,920728,False,1,10,16,6
167445,2019-10-02 00:00:00+03:00,out,False,920728,False,1,1,8,7
167445,2019-10-02 00:00:00+03:00,in,False,-1,True,4,0,73,73
167445,2019-10-03 00:00:00+03:00,in,False,-1,True,5,0,333,333
167445,2019-10-04 00:00:00+03:00,in,False,-1,True,5,0,101,101
167445,2019-10-05 00:00:00+03:00,in,False,-1,True,5,0,103,103
167445,2019-10-06 00:00:00+03:00,in,False,-1,True,1,0,20,20
167445,2019-10-07 00:00:00+03:00,in,False,920706,False,4,74,128,54
167445,2019-10-07 00:00:00+03:00,in,False,-1,True,6,0,229,229
167445,2019-10-07 00:00:00+03:00,in,False,920732,False,1,60,71,11
167445,2019-10-07 00:00:00+03:00,out,False,920706,True,2,0,16,16
167445,2019-10-08 00:00:00+03:00,in,False,920706,False,1,43,65,22
167445,2019-10-08 00:00:00+03:00,out,False,920720,False,4,1478,1570,92
167445,2019-10-08 00:00:00+03:00,in,False,920732,False,3,113,133,20
167445,2019-10-08 00:00:00+03:00,out,False,920732,True,1,0,24,24
167445,2019-10-08 00:00:00+03:00,in,False,920720,False,5,1792,1827,35
167445,2019-10-08 00:00:00+03:00,out,True,920732,True,1,0,2,2
167445,2019-10-08 00:00:00+03:00,in,False,-1,True,9,0,237,237
167445,2019-10-08 00:00:00+03:00,out,False,920720,True,8,0,185,185
167445,2019-10-09 00:00:00+03:00,in,False,920728,False,2,264,280,16
167445,2019-10-09 00:00:00+03:00,out,False,920728,True,1,0,7,7
167445,2019-10-09 00:00:00+03:00,in,False,920720,False,6,913,967,54
167445,2019-10-09 00:00:00+03:00,in,False,-1,True,3,0,102,102
167445,2019-10-09 00:00:00+03:00,out,False,920706,True,1,0,60,60
167445,2019-10-09 00:00:00+03:00,out,False,920720,False,11,2710,2876,166
167445,2019-10-09 00:00:00+03:00,out,False,920720,True,21,0,308,308
167445,2019-10-09 00:00:00+03:00,out,False,920706,False,1,46,56,10
167445,2019-10-09 00:00:00+03:00,in,False,920706,False,2,32,80,48
167445,2019-10-09 00:00:00+03:00,in,False,920706,False,2,32,80,48
167445,2019-10-09 00:00:00+03:00,in,False,-1,True,3,0,102,102
167445,2019-10-10 00:00:00+03:00,out,False,920720,False,2,283,302,19
167445,2019-10-10 00:00:00+03:00,out,False,920720,True,5,0,55,55
167445,2019-10-10 00:00:00+03:00,in,False,-1,True,7,0,218,218
167445,2019-10-10 00:00:00+03:00,in,False,920720,False,4,494,549,55
167445,2019-10-10 00:00:00+03:00,out,False,920728,False,1,140,150,10
167445,2019-10-10 00:00:00+03:00,in,False,920728,False,3,182,212,30
167445,2019-10-11 00:00:00+03:00,in,False,920720,False,9,761,851,90
167445,2019-10-11 00:00:00+03:00,out,False,920720,True,2,0,12,12
167445,2019-10-11 00:00:00+03:00,in,False,-1,True,6,0,64,64
167445,2019-10-11 00:00:00+03:00,out,False,920720,False,6,554,643,89
167445,2019-10-11 00:00:00+03:00,in,False,920706,False,4,221,469,248
167445,2019-10-11 00:00:00+03:00,in,False,920728,False,5,1445,1474,29
167445,2019-10-12 00:00:00+03:00,out,False,920720,False,4,139,183,44
167445,2019-10-12 00:00:00+03:00,in,False,-1,True,5,0,274,274
167445,2019-10-12 00:00:00+03:00,in,False,920720,False,2,153,178,25
167445,2019-10-13 00:00:00+03:00,in,False,-1,True,4,0,158,158
167445,2019-10-14 00:00:00+03:00,out,False,920720,True,2,0,13,13
167445,2019-10-14 00:00:00+03:00,in,False,920902,False,1,8,16,8
167445,2019-10-14 00:00:00+03:00,in,False,920720,False,10,727,1089,362
167445,2019-10-14 00:00:00+03:00,in,False,-1,True,10,0,285,285
167445,2019-10-14 00:00:00+03:00,in,False,920706,False,2,66,126,60
167445,2019-10-14 00:00:00+03:00,in,False,920728,False,3,672,691,19
167445,2019-10-14 00:00:00+03:00,out,False,920720,False,2,80,108,28
167445,2019-10-14 00:00:00+03:00,in,False,920706,False,2,66,126,60
167445,2019-10-14 00:00:00+03:00,in,False,920720,False,10,727,1089,362
167445,2019-10-15 00:00:00+03:00,in,False,-1,True,7,0,275,275
167445,2019-10-15 00:00:00+03:00,in,False,920728,False,2,232,247,15
167445,2019-10-15 00:00:00+03:00,in,False,920720,False,4,164,255,91
167445,2019-10-15 00:00:00+03:00,in,False,920706,False,1,67,92,25
167445,2019-10-15 00:00:00+03:00,out,False,920720,False,1,170,178,8
167445,2019-10-15 00:00:00+03:00,out,False,920902,True,4,0,75,75
167445,2019-10-15 00:00:00+03:00,out,False,920706,False,2,279,302,23
167445,2019-10-15 00:00:00+03:00,out,False,920728,False,1,366,376,10
167445,2019-10-15 00:00:00+03:00,out,False,920720,True,2,0,19,19
167445,2019-10-15 00:00:00+03:00,out,False,920706,True,3,0,27,27
167445,2019-10-15 00:00:00+03:00,in,False,920902,False,4,451,517,66
167445,2019-10-16 00:00:00+03:00,out,False,920720,False,5,1804,1884,80
167445,2019-10-16 00:00:00+03:00,in,False,920732,False,5,673,702,29
167445,2019-10-16 00:00:00+03:00,in,False,920902,False,2,351,380,29
167445,2019-10-16 00:00:00+03:00,out,False,920902,False,1,48,70,22
167445,2019-10-16 00:00:00+03:00,in,False,-1,True,9,0,337,337
167445,2019-10-16 00:00:00+03:00,in,False,920720,False,2,160,177,17
167445,2019-10-16 00:00:00+03:00,out,True,920732,True,2,0,0,0
167445,2019-10-16 00:00:00+03:00,out,False,920706,True,1,0,13,13
167445,2019-10-16 00:00:00+03:00,in,False,920728,False,1,98,101,3
167445,2019-10-16 00:00:00+03:00,in,False,920706,False,1,9,24,15
167445,2019-10-16 00:00:00+03:00,out,False,920728,True,2,0,2,2
167445,2019-10-16 00:00:00+03:00,in,False,-1,True,9,0,337,337
167445,2019-10-16 00:00:00+03:00,in,False,920706,False,1,9,24,15
167445,2019-10-16 00:00:00+03:00,in,False,920728,False,1,98,101,3
167445,2019-10-17 00:00:00+03:00,out,False,920728,False,1,20,28,8
167445,2019-10-17 00:00:00+03:00,out,False,920706,True,5,0,29,29
167445,2019-10-17 00:00:00+03:00,in,False,920720,False,1,55,60,5
167445,2019-10-17 00:00:00+03:00,out,False,920706,False,1,44,58,14
167445,2019-10-17 00:00:00+03:00,out,False,920902,False,2,314,331,17
167445,2019-10-17 00:00:00+03:00,in,False,920706,False,5,343,408,65
167445,2019-10-17 00:00:00+03:00,out,False,920720,False,3,227,275,48
167445,2019-10-17 00:00:00+03:00,in,False,920902,False,1,5,143,138
167445,2019-10-17 00:00:00+03:00,in,False,-1,True,11,0,334,334
167445,2019-10-17 00:00:00+03:00,in,False,920902,False,1,5,143,138
167445,2019-10-17 00:00:00+03:00,in,False,920706,False,5,343,408,65
167445,2019-10-18 00:00:00+03:00,in,False,920720,False,2,972,986,14
167445,2019-10-18 00:00:00+03:00,out,False,920720,True,1,0,5,5
167445,2019-10-18 00:00:00+03:00,out,False,920706,False,1,18,31,13
167445,2019-10-18 00:00:00+03:00,in,False,-1,True,9,0,216,216
167445,2019-10-18 00:00:00+03:00,in,False,920706,False,1,28,38,10
167445,2019-10-18 00:00:00+03:00,out,False,920720,False,3,1064,1092,28
167445,2019-10-18 00:00:00+03:00,in,False,920728,False,1,451,457,6
167445,2019-10-19 00:00:00+03:00,out,False,920720,False,1,161,178,17
167445,2019-10-19 00:00:00+03:00,in,False,-1,True,1,0,40,40
167445,2019-10-19 00:00:00+03:00,in,False,920706,False,2,35,90,55
167445,2019-10-20 00:00:00+03:00,in,False,-1,True,2,0,10,10
167445,2019-10-21 00:00:00+03:00,in,False,920902,False,1,365,404,39
167445,2019-10-21 00:00:00+03:00,out,False,920720,True,3,0,30,30
167445,2019-10-21 00:00:00+03:00,in,False,-1,True,7,0,210,210
167445,2019-10-21 00:00:00+03:00,out,True,921062,True,3,0,0,0
167445,2019-10-21 00:00:00+03:00,out,True,920732,False,1,13,22,9
167445,2019-10-21 00:00:00+03:00,out,False,920728,False,1,128,145,17
167445,2019-10-21 00:00:00+03:00,out,False,920720,False,2,351,374,23
167445,2019-10-21 00:00:00+03:00,out,False,920706,True,2,0,23,23
167445,2019-10-21 00:00:00+03:00,in,False,920720,False,3,583,619,36
167445,2019-10-21 00:00:00+03:00,out,False,920852,True,1,0,7,7
167445,2019-10-21 00:00:00+03:00,out,False,921062,True,2,0,26,26
167445,2019-10-21 00:00:00+03:00,in,False,920732,False,2,501,519,18
167445,2019-10-21 00:00:00+03:00,out,False,920838,True,15,0,140,140
167445,2019-10-21 00:00:00+03:00,out,False,921062,True,2,0,26,26
167445,2019-10-21 00:00:00+03:00,in,False,920902,False,1,365,404,39
167445,2019-10-22 00:00:00+03:00,out,False,920838,False,5,1617,1675,58
167445,2019-10-22 00:00:00+03:00,in,False,920838,False,1,38,48,10
167445,2019-10-22 00:00:00+03:00,out,False,920706,False,2,205,208,3
167445,2019-10-22 00:00:00+03:00,out,False,943066,False,7,1434,1530,96
167445,2019-10-22 00:00:00+03:00,out,False,920720,False,2,123,145,22
167445,2019-10-22 00:00:00+03:00,in,False,920732,False,1,85,90,5
167445,2019-10-22 00:00:00+03:00,out,False,920732,False,2,370,385,15
167445,2019-10-22 00:00:00+03:00,out,False,920732,True,2,0,1,1
167445,2019-10-22 00:00:00+03:00,out,False,920720,True,1,0,21,21
167445,2019-10-22 00:00:00+03:00,in,False,920706,False,1,20,30,10
167445,2019-10-22 00:00:00+03:00,in,False,920720,False,3,229,271,42
167445,2019-10-22 00:00:00+03:00,in,False,-1,True,12,0,194,194
167445,2019-10-22 00:00:00+03:00,out,False,943066,True,3,0,51,51
167445,2019-10-22 00:00:00+03:00,in,False,920902,False,2,145,246,101
167445,2019-10-22 00:00:00+03:00,out,False,920838,True,5,0,121,121
167445,2019-10-22 00:00:00+03:00,in,False,-1,True,12,0,194,194
167445,2019-10-22 00:00:00+03:00,in,False,920902,False,2,145,246,101
167445,2019-10-22 00:00:00+03:00,out,False,943066,False,7,1434,1530,96
167445,2019-10-23 00:00:00+03:00,out,False,920728,True,5,0,64,64
167445,2019-10-23 00:00:00+03:00,in,False,920706,False,1,244,255,11
167445,2019-10-23 00:00:00+03:00,out,False,920720,False,4,271,323,52
167445,2019-10-23 00:00:00+03:00,out,False,920838,True,1,0,5,5
167445,2019-10-23 00:00:00+03:00,out,False,920728,False,2,626,650,24
167445,2019-10-23 00:00:00+03:00,out,False,920852,True,7,0,54,54
167445,2019-10-23 00:00:00+03:00,out,False,920706,False,6,1407,1419,12
167445,2019-10-23 00:00:00+03:00,out,False,920726,True,1,0,13,13
167445,2019-10-23 00:00:00+03:00,in,False,920728,False,2,407,424,17
167445,2019-10-23 00:00:00+03:00,in,False,920838,False,1,53,59,6
167445,2019-10-23 00:00:00+03:00,out,False,920732,False,3,325,360,35
167445,2019-10-23 00:00:00+03:00,out,False,943066,True,1,0,39,39
167445,2019-10-23 00:00:00+03:00,in,False,920720,False,5,531,641,110
167445,2019-10-23 00:00:00+03:00,in,False,921062,False,5,852,894,42
167445,2019-10-23 00:00:00+03:00,out,False,920902,False,4,174,225,51
167445,2019-10-23 00:00:00+03:00,out,True,920706,False,1,57,64,7
167445,2019-10-23 00:00:00+03:00,in,False,-1,True,80,0,868,868
167445,2019-10-23 00:00:00+03:00,out,True,920706,True,1,0,1,1
167445,2019-10-23 00:00:00+03:00,out,False,920720,True,5,0,56,56
167445,2019-10-23 00:00:00+03:00,in,False,920902,False,7,949,1155,206
167445,2019-10-23 00:00:00+03:00,out,False,920732,True,1,0,35,35
167445,2019-10-23 00:00:00+03:00,in,False,920852,False,5,339,373,34
167445,2019-10-23 00:00:00+03:00,in,False,-1,True,80,0,868,868
167445,2019-10-23 00:00:00+03:00,in,False,920720,False,5,531,641,110
167445,2019-10-23 00:00:00+03:00,out,False,920902,False,4,174,225,51
167445,2019-10-23 00:00:00+03:00,out,False,920732,False,3,325,360,35
167445,2019-10-24 00:00:00+03:00,out,False,920728,False,1,507,520,13
167445,2019-10-24 00:00:00+03:00,out,False,920852,True,2,0,16,16
167445,2019-10-24 00:00:00+03:00,out,False,920838,True,15,0,78,78
167445,2019-10-24 00:00:00+03:00,out,False,920720,True,3,0,20,20
167445,2019-10-24 00:00:00+03:00,in,False,-1,True,40,0,270,270
167445,2019-10-24 00:00:00+03:00,in,False,920902,False,1,79,81,2
167445,2019-10-24 00:00:00+03:00,in,False,920838,False,1,187,196,9
167445,2019-10-24 00:00:00+03:00,in,False,920720,False,6,1078,1173,95
167445,2019-10-24 00:00:00+03:00,in,False,920852,False,3,130,161,31
167445,2019-10-24 00:00:00+03:00,in,False,921062,False,3,345,365,20
167445,2019-10-24 00:00:00+03:00,out,False,920902,False,1,44,59,15
167445,2019-10-24 00:00:00+03:00,out,False,920706,False,1,563,566,3
167445,2019-10-24 00:00:00+03:00,out,False,920852,False,1,83,124,41
167445,2019-10-24 00:00:00+03:00,in,False,920728,False,5,567,659,92
167445,2019-10-24 00:00:00+03:00,out,False,920720,False,7,1169,1268,99
167445,2019-10-24 00:00:00+03:00,in,False,920852,False,3,130,161,31
167445,2019-10-25 00:00:00+03:00,out,False,920838,False,1,62,74,12
167445,2019-10-25 00:00:00+03:00,out,False,920852,True,1,0,11,11
167445,2019-10-25 00:00:00+03:00,in,False,920732,False,1,60,68,8
167445,2019-10-25 00:00:00+03:00,in,False,920852,False,5,394,442,48
167445,2019-10-25 00:00:00+03:00,in,False,920720,False,2,273,304,31
167445,2019-10-25 00:00:00+03:00,in,False,-1,True,14,0,274,274
167445,2019-10-25 00:00:00+03:00,out,False,943066,False,2,635,654,19
167445,2019-10-25 00:00:00+03:00,out,False,920720,True,2,0,85,85
167445,2019-10-25 00:00:00+03:00,out,False,943066,True,1,0,34,34
167445,2019-10-25 00:00:00+03:00,in,False,920838,False,1,53,80,27
167445,2019-10-25 00:00:00+03:00,in,False,920728,False,4,687,731,44
167445,2019-10-25 00:00:00+03:00,in,False,921062,False,3,659,684,25
167445,2019-10-25 00:00:00+03:00,out,False,920720,False,1,100,109,9
167445,2019-10-25 00:00:00+03:00,out,False,920720,False,1,100,109,9
167445,2019-10-26 00:00:00+03:00,out,False,920852,False,2,72,92,20
167445,2019-10-26 00:00:00+03:00,in,False,920852,False,5,345,419,74
167445,2019-10-26 00:00:00+03:00,in,False,-1,True,14,0,486,486
167445,2019-10-26 00:00:00+03:00,out,False,943066,False,3,595,628,33
167445,2019-10-26 00:00:00+03:00,in,False,921062,False,2,411,443,32
167445,2019-10-26 00:00:00+03:00,out,False,943066,True,1,0,23,23
167445,2019-10-27 00:00:00+03:00,out,False,920838,False,4,364,422,58
167445,2019-10-27 00:00:00+03:00,in,False,-1,True,21,0,224,224
167445,2019-10-27 00:00:00+03:00,out,False,920852,True,1,0,17,17
167445,2019-10-27 00:00:00+03:00,out,False,943066,True,1,0,11,11
167445,2019-10-27 00:00:00+03:00,in,False,921062,False,3,195,265,70
167445,2019-10-27 00:00:00+03:00,in,False,920852,False,3,155,187,32
167445,2019-10-27 00:00:00+03:00,out,False,920838,True,2,0,62,62
167445,2019-10-28 00:00:00+03:00,in,False,943066,False,2,94,110,16
167445,2019-10-28 00:00:00+03:00,in,False,920902,False,1,127,131,4
167445,2019-10-28 00:00:00+03:00,out,True,920706,False,1,36,41,5
167445,2019-10-28 00:00:00+03:00,in,False,920706,False,5,387,430,43
167445,2019-10-28 00:00:00+03:00,in,False,920852,False,3,121,152,31
167445,2019-10-28 00:00:00+03:00,out,False,920852,True,2,0,71,71
167445,2019-10-28 00:00:00+03:00,out,False,920706,True,1,0,1,1
167445,2019-10-28 00:00:00+03:00,out,False,920728,True,1,0,12,12
167445,2019-10-28 00:00:00+03:00,out,False,920902,True,2,0,54,54
167445,2019-10-28 00:00:00+03:00,out,False,920838,True,1,0,13,13
167445,2019-10-28 00:00:00+03:00,in,False,920706,True,1,140,150,10
167445,2019-10-28 00:00:00+03:00,in,False,920732,False,2,153,179,26
167445,2019-10-28 00:00:00+03:00,out,False,920720,False,1,87,94,7
167445,2019-10-28 00:00:00+03:00,out,False,920728,False,2,284,307,23
167445,2019-10-28 00:00:00+03:00,out,False,943066,False,11,2060,2203,143
167445,2019-10-28 00:00:00+03:00,out,False,920852,False,5,420,513,93
167445,2019-10-28 00:00:00+03:00,out,False,920706,False,13,2083,2155,72
167445,2019-10-28 00:00:00+03:00,in,False,920720,False,3,424,449,25
167445,2019-10-28 00:00:00+03:00,in,False,920728,False,8,914,1017,103
167445,2019-10-28 00:00:00+03:00,in,False,921062,False,3,150,178,28
167445,2019-10-28 00:00:00+03:00,in,False,-1,True,10,0,188,188
167445,2019-10-28 00:00:00+03:00,out,False,920838,False,1,7,10,3
167445,2019-10-28 00:00:00+03:00,out,True,920706,True,1,0,1,1
167445,2019-10-28 00:00:00+03:00,out,False,943066,True,1,0,26,26
167445,2019-10-28 00:00:00+03:00,out,False,920720,True,2,0,61,61
167445,2019-10-28 00:00:00+03:00,in,False,920732,False,2,153,179,26
167445,2019-10-29 00:00:00+03:00,out,False,920852,True,2,0,46,46
167445,2019-10-29 00:00:00+03:00,in,False,920728,False,10,1131,1270,139
167445,2019-10-29 00:00:00+03:00,in,False,920852,False,8,213,277,64
167445,2019-10-29 00:00:00+03:00,out,False,920838,True,1,0,56,56
167445,2019-10-29 00:00:00+03:00,in,False,920732,False,2,403,415,12
167445,2019-10-29 00:00:00+03:00,out,False,920838,False,2,524,536,12
167445,2019-10-29 00:00:00+03:00,out,True,920728,True,1,0,12,12
167445,2019-10-29 00:00:00+03:00,in,False,921062,False,4,382,406,24
167445,2019-10-29 00:00:00+03:00,in,False,-1,True,15,0,370,370
167445,2019-10-29 00:00:00+03:00,out,False,920732,False,1,18,37,19
167445,2019-10-29 00:00:00+03:00,out,False,920706,False,1,214,217,3
167445,2019-10-29 00:00:00+03:00,in,False,943066,False,1,545,553,8
167445,2019-10-29 00:00:00+03:00,out,False,920720,False,1,13,23,10
167445,2019-10-29 00:00:00+03:00,out,True,920852,True,1,0,4,4
167445,2019-10-29 00:00:00+03:00,in,False,920720,False,2,141,170,29
167445,2019-10-29 00:00:00+03:00,out,False,943066,True,2,0,44,44
167445,2019-10-29 00:00:00+03:00,out,False,943066,False,3,631,662,31
167445,2019-10-29 00:00:00+03:00,out,False,920728,False,3,81,122,41
167445,2019-10-29 00:00:00+03:00,out,False,920852,False,8,226,323,97
167445,2019-10-29 00:00:00+03:00,out,False,920706,False,1,214,217,3
167445,2019-10-29 00:00:00+03:00,out,False,920732,False,1,18,37,19
167445,2019-10-29 00:00:00+03:00,in,False,920732,False,2,403,415,12
167445,2019-10-29 00:00:00+03:00,out,True,920728,True,1,0,12,12
167445,2019-10-30 00:00:00+03:00,in,False,920720,False,3,275,388,113
167445,2019-10-30 00:00:00+03:00,in,False,-1,True,12,0,491,491
167445,2019-10-30 00:00:00+03:00,out,False,943066,False,1,641,665,24
167445,2019-10-30 00:00:00+03:00,in,False,921062,False,2,112,133,21
167445,2019-10-30 00:00:00+03:00,out,False,920852,False,3,418,469,51
167445,2019-10-30 00:00:00+03:00,out,False,920720,False,2,171,196,25
167445,2019-10-30 00:00:00+03:00,out,False,920852,True,8,0,83,83
167445,2019-10-30 00:00:00+03:00,in,False,920838,False,2,87,104,17
167445,2019-10-30 00:00:00+03:00,out,False,920838,False,3,202,234,32
167445,2019-10-30 00:00:00+03:00,in,False,943066,False,1,169,183,14
167445,2019-10-30 00:00:00+03:00,in,False,920728,False,13,786,931,145
167445,2019-10-30 00:00:00+03:00,out,False,920720,True,3,0,43,43
167445,2019-10-30 00:00:00+03:00,in,False,920852,False,7,774,839,65
167445,2019-10-30 00:00:00+03:00,out,False,920728,False,1,63,71,8
167445,2019-10-30 00:00:00+03:00,in,False,921062,False,2,112,133,21
167445,2019-10-31 00:00:00+03:00,in,False,920852,False,6,403,453,50
167445,2019-10-31 00:00:00+03:00,in,False,-1,True,10,0,267,267
167445,2019-10-31 00:00:00+03:00,in,False,920728,False,6,1733,1790,57
167445,2019-10-31 00:00:00+03:00,in,False,920720,False,3,311,330,19
167445,2019-10-31 00:00:00+03:00,in,False,921062,False,2,240,295,55
167445,2019-10-31 00:00:00+03:00,out,True,920706,True,1,0,26,26
167445,2019-10-31 00:00:00+03:00,out,False,943066,False,2,56,81,25
167445,2019-10-31 00:00:00+03:00,out,False,920838,True,2,0,45,45
167445,2019-10-31 00:00:00+03:00,in,False,920728,True,2,0,58,58
167445,2019-10-31 00:00:00+03:00,out,False,920720,False,4,294,332,38
167445,2019-10-31 00:00:00+03:00,out,False,920838,False,5,960,1015,55
167445,2019-10-31 00:00:00+03:00,out,False,920852,False,8,331,423,92
167445,2019-10-31 00:00:00+03:00,in,False,920838,False,3,296,340,44
167445,2019-10-31 00:00:00+03:00,out,False,920852,False,8,331,423,92
167445,2019-10-31 00:00:00+03:00,out,True,920706,True,1,0,26,26
167445,2019-11-01 00:00:00+03:00,in,False,920728,False,5,1200,1295,95
167445,2019-11-01 00:00:00+03:00,out,False,920838,True,1,0,4,4
167445,2019-11-01 00:00:00+03:00,in,False,920732,False,3,737,778,41
167445,2019-11-01 00:00:00+03:00,in,False,920720,False,4,381,424,43
167445,2019-11-01 00:00:00+03:00,in,False,920726,False,1,29,44,15
167445,2019-11-01 00:00:00+03:00,out,False,920838,False,5,324,393,69
167445,2019-11-01 00:00:00+03:00,in,False,921062,False,3,260,333,73
167445,2019-11-01 00:00:00+03:00,in,False,-1,True,14,0,439,439
167445,2019-11-01 00:00:00+03:00,out,False,920852,False,4,200,249,49
167445,2019-11-01 00:00:00+03:00,out,False,920720,False,2,341,364,23
167445,2019-11-01 00:00:00+03:00,out,False,920732,False,1,26,46,20
167445,2019-11-01 00:00:00+03:00,in,False,920852,False,4,558,601,43
167445,2019-11-01 00:00:00+03:00,in,False,920838,False,2,99,124,25
167445,2019-11-01 00:00:00+03:00,out,False,920732,False,1,26,46,20
167445,2019-11-01 00:00:00+03:00,out,False,920838,True,1,0,4,4
167445,2019-11-01 00:00:00+03:00,out,False,920838,False,5,324,393,69
167445,2019-11-02 00:00:00+03:00,out,False,920852,False,3,221,248,27
167445,2019-11-02 00:00:00+03:00,out,False,920720,False,1,224,234,10
167445,2019-11-02 00:00:00+03:00,in,False,-1,True,14,0,418,418
167445,2019-11-02 00:00:00+03:00,out,False,920852,True,3,0,35,35
167445,2019-11-02 00:00:00+03:00,in,False,920720,False,3,191,222,31
167445,2019-11-02 00:00:00+03:00,out,False,943066,False,2,758,785,27
167445,2019-11-02 00:00:00+03:00,in,False,920852,False,2,71,94,23
167445,2019-11-03 00:00:00+03:00,in,False,-1,True,8,0,344,344
167445,2019-11-03 00:00:00+03:00,in,False,920902,False,1,65,77,12
167445,2019-11-03 00:00:00+03:00,in,False,920852,False,3,271,298,27
167445,2019-11-03 00:00:00+03:00,out,False,920852,False,2,56,82,26
167445,2019-11-03 00:00:00+03:00,in,False,920720,False,1,142,158,16
167445,2019-11-03 00:00:00+03:00,in,False,920726,False,1,137,151,14
167445,2019-11-03 00:00:00+03:00,in,False,921062,False,1,102,113,11
167445,2019-11-03 00:00:00+03:00,out,False,920720,False,1,32,42,10
167445,2019-11-04 00:00:00+03:00,out,False,920852,False,7,244,336,92
167445,2019-11-04 00:00:00+03:00,in,False,-1,True,11,0,420,420
167445,2019-11-04 00:00:00+03:00,out,False,920726,True,2,0,27,27
167445,2019-11-04 00:00:00+03:00,in,False,920852,False,7,379,461,82
167445,2019-11-04 00:00:00+03:00,in,False,920726,False,1,155,163,8
167445,2019-11-04 00:00:00+03:00,in,False,921062,False,2,63,102,39
167445,2019-11-04 00:00:00+03:00,out,False,920720,False,4,312,370,58
167445,2019-11-04 00:00:00+03:00,out,True,920726,True,1,0,1,1
167445,2019-11-05 00:00:00+03:00,out,False,920720,True,2,0,22,22
167445,2019-11-05 00:00:00+03:00,out,False,920732,False,2,218,261,43
167445,2019-11-05 00:00:00+03:00,out,False,920706,False,1,14,16,2
167445,2019-11-05 00:00:00+03:00,in,False,920852,False,6,332,390,58
167445,2019-11-05 00:00:00+03:00,out,False,920838,False,3,470,490,20
167445,2019-11-05 00:00:00+03:00,out,True,920706,False,1,112,115,3
167445,2019-11-05 00:00:00+03:00,out,False,920852,True,2,0,38,38
167445,2019-11-05 00:00:00+03:00,in,False,920728,False,9,335,470,135
167445,2019-11-05 00:00:00+03:00,out,False,920728,False,1,37,47,10
167445,2019-11-05 00:00:00+03:00,out,False,920732,True,1,0,35,35
167445,2019-11-05 00:00:00+03:00,in,False,920732,False,2,309,320,11
167445,2019-11-05 00:00:00+03:00,in,False,921062,False,5,206,278,72
167445,2019-11-05 00:00:00+03:00,out,False,920720,False,9,665,749,84
167445,2019-11-05 00:00:00+03:00,in,False,920838,False,7,805,862,57
167445,2019-11-05 00:00:00+03:00,in,False,-1,True,11,0,468,468
167445,2019-11-05 00:00:00+03:00,out,False,920852,False,17,1108,1336,228
167445,2019-11-05 00:00:00+03:00,in,False,920720,False,4,345,371,26
167445,2019-11-05 00:00:00+03:00,out,True,920706,False,1,112,115,3
167445,2019-11-05 00:00:00+03:00,in,False,920720,False,4,345,371,26
167445,2019-11-06 00:00:00+03:00,out,False,920852,False,8,1405,1495,90
167445,2019-11-06 00:00:00+03:00,out,False,920852,True,9,0,45,45
167445,2019-11-06 00:00:00+03:00,in,False,920728,False,9,830,965,135
167445,2019-11-06 00:00:00+03:00,in,False,-1,True,19,0,662,662
167445,2019-11-06 00:00:00+03:00,in,False,920706,False,2,145,222,77
167445,2019-11-06 00:00:00+03:00,out,True,920706,False,1,5,8,3
167445,2019-11-06 00:00:00+03:00,out,False,920706,True,1,0,1,1
167445,2019-11-06 00:00:00+03:00,in,False,920720,False,4,243,288,45
167445,2019-11-06 00:00:00+03:00,out,False,920838,True,5,0,286,286
167445,2019-11-06 00:00:00+03:00,out,False,920720,False,7,1181,1251,70
167445,2019-11-06 00:00:00+03:00,out,False,920720,True,1,0,31,31
167445,2019-11-06 00:00:00+03:00,in,False,920852,False,6,538,598,60
167445,2019-11-06 00:00:00+03:00,in,False,921062,False,7,722,770,48
167445,2019-11-06 00:00:00+03:00,out,False,920838,False,5,1492,1584,92
167445,2019-11-06 00:00:00+03:00,out,False,920902,True,1,0,16,16
167445,2019-11-06 00:00:00+03:00,in,False,920838,False,2,68,91,23
167445,2019-11-06 00:00:00+03:00,out,False,920728,False,1,161,174,13
167445,2019-11-06 00:00:00+03:00,out,False,920852,True,9,0,45,45
167445,2019-11-07 00:00:00+03:00,out,False,920726,True,3,0,45,45
167445,2019-11-07 00:00:00+03:00,in,False,-1,True,20,0,982,982
167445,2019-11-07 00:00:00+03:00,in,False,920726,False,4,249,290,41
167445,2019-11-07 00:00:00+03:00,in,False,920852,False,7,379,445,66
167445,2019-11-07 00:00:00+03:00,out,False,920706,False,2,211,241,30
167445,2019-11-07 00:00:00+03:00,out,False,920720,True,1,0,40,40
167445,2019-11-07 00:00:00+03:00,in,False,920732,False,2,298,314,16
167445,2019-11-07 00:00:00+03:00,in,False,921062,False,1,6,20,14
167445,2019-11-07 00:00:00+03:00,out,False,920852,False,3,162,202,40
167445,2019-11-07 00:00:00+03:00,out,False,920732,False,2,233,253,20
167445,2019-11-07 00:00:00+03:00,in,False,920706,True,1,88,123,35
167445,2019-11-07 00:00:00+03:00,in,False,920838,False,2,381,408,27
167445,2019-11-07 00:00:00+03:00,out,False,920838,False,5,1135,1250,115
167445,2019-11-07 00:00:00+03:00,out,False,920720,False,2,27,78,51
167445,2019-11-07 00:00:00+03:00,out,False,920706,False,2,211,241,30
167445,2019-11-07 00:00:00+03:00,out,False,920852,False,3,162,202,40
167445,2019-11-08 00:00:00+03:00,in,False,920706,False,2,274,292,18
167445,2019-11-08 00:00:00+03:00,out,False,920732,False,4,1474,1567,93
167445,2019-11-08 00:00:00+03:00,out,False,920726,False,1,20,30,10
167445,2019-11-08 00:00:00+03:00,out,False,920720,False,1,50,72,22
167445,2019-11-08 00:00:00+03:00,out,False,920852,True,1,0,16,16
167445,2019-11-08 00:00:00+03:00,in,False,920726,False,1,48,98,50
167445,2019-11-08 00:00:00+03:00,in,False,920838,False,1,25,39,14
167445,2019-11-08 00:00:00+03:00,in,False,920720,False,1,75,88,13
167445,2019-11-08 00:00:00+03:00,in,False,921062,False,3,229,246,17
167445,2019-11-08 00:00:00+03:00,out,False,920706,False,10,1259,1360,101
167445,2019-11-08 00:00:00+03:00,in,False,-1,True,13,0,469,469
167445,2019-11-08 00:00:00+03:00,in,False,920728,False,3,610,662,52
167445,2019-11-08 00:00:00+03:00,in,False,920732,False,1,100,105,5
167445,2019-11-08 00:00:00+03:00,in,False,920902,False,3,380,718,338
167445,2019-11-08 00:00:00+03:00,out,False,920852,False,2,46,92,46
167445,2019-11-08 00:00:00+03:00,out,False,920732,True,1,0,40,40
167445,2019-11-08 00:00:00+03:00,out,False,920838,False,3,110,147,37
167445,2019-11-08 00:00:00+03:00,out,False,920706,True,2,0,44,44
167445,2019-11-08 00:00:00+03:00,in,False,920852,False,5,168,224,56
167445,2019-11-09 00:00:00+03:00,in,False,-1,True,13,0,417,417
167445,2019-11-09 00:00:00+03:00,out,False,920852,True,1,0,5,5
167445,2019-11-09 00:00:00+03:00,in,False,920852,False,1,44,77,33
167445,2019-11-09 00:00:00+03:00,out,False,943066,False,1,38,64,26
167445,2019-11-09 00:00:00+03:00,in,False,920726,False,1,68,79,11
167445,2019-11-09 00:00:00+03:00,in,False,921062,False,3,351,380,29
167445,2019-11-09 00:00:00+03:00,out,False,920852,False,3,273,312,39
167445,2019-11-10 00:00:00+03:00,in,False,-1,True,17,0,92,92
167445,2019-11-10 00:00:00+03:00,out,False,920726,True,1,0,28,28
167445,2019-11-10 00:00:00+03:00,out,False,920838,False,1,45,59,14
167445,2019-11-10 00:00:00+03:00,in,False,920726,False,2,189,263,74
167445,2019-11-10 00:00:00+03:00,in,False,921062,False,4,161,202,41
167445,2019-11-10 00:00:00+03:00,out,False,920852,False,2,77,109,32
167445,2019-11-10 00:00:00+03:00,out,False,920852,True,2,0,51,51
167445,2019-11-10 00:00:00+03:00,in,False,920852,False,6,326,382,56
167445,2019-11-10 00:00:00+03:00,out,False,920726,False,2,156,170,14
167445,2019-11-10 00:00:00+03:00,out,False,943066,False,3,588,624,36
167445,2019-11-10 00:00:00+03:00,out,False,920726,False,2,156,170,14
167445,2019-11-11 00:00:00+03:00,out,False,920706,True,12,0,308,308
167445,2019-11-11 00:00:00+03:00,out,False,920728,False,2,116,143,27
167445,2019-11-11 00:00:00+03:00,out,True,920706,True,6,0,69,69
167445,2019-11-11 00:00:00+03:00,out,False,943066,False,3,611,643,32
167445,2019-11-11 00:00:00+03:00,in,False,920720,False,4,426,458,32
167445,2019-11-11 00:00:00+03:00,out,False,920732,False,5,423,520,97
167445,2019-11-11 00:00:00+03:00,in,False,-1,True,35,0,909,909
167445,2019-11-11 00:00:00+03:00,in,False,920726,False,4,354,396,42
167445,2019-11-11 00:00:00+03:00,in,False,920706,False,4,455,560,105
167445,2019-11-11 00:00:00+03:00,out,False,920720,False,5,472,539,67
167445,2019-11-11 00:00:00+03:00,in,False,943066,False,1,105,118,13
167445,2019-11-11 00:00:00+03:00,out,False,920720,True,3,0,4,4
167445,2019-11-11 00:00:00+03:00,in,False,920902,False,2,130,183,53
167445,2019-11-11 00:00:00+03:00,in,False,920838,False,1,115,134,19
167445,2019-11-11 00:00:00+03:00,out,False,920838,False,3,277,309,32
167445,2019-11-11 00:00:00+03:00,out,False,920852,False,5,504,563,59
167445,2019-11-11 00:00:00+03:00,out,False,920852,True,3,0,93,93
167445,2019-11-11 00:00:00+03:00,in,False,920852,False,6,454,527,73
167445,2019-11-11 00:00:00+03:00,out,False,920706,False,17,2101,2267,166
167445,2019-11-11 00:00:00+03:00,in,False,920728,False,3,431,466,35
167445,2019-11-11 00:00:00+03:00,in,False,921062,False,1,124,129,5
167445,2019-11-11 00:00:00+03:00,in,False,943066,False,1,105,118,13
167445,2019-11-11 00:00:00+03:00,out,False,920706,False,17,2101,2267,166
167445,2019-11-11 00:00:00+03:00,in,False,920720,False,4,426,458,32
167445,2019-11-11 00:00:00+03:00,out,False,920720,True,3,0,4,4
167445,2019-11-12 00:00:00+03:00,in,False,-1,True,23,0,916,916
167445,2019-11-12 00:00:00+03:00,out,False,943066,False,3,545,598,53
167445,2019-11-12 00:00:00+03:00,out,False,920852,True,2,0,14,14
167445,2019-11-12 00:00:00+03:00,in,False,920852,False,8,458,557,99
167445,2019-11-12 00:00:00+03:00,out,False,920838,False,2,876,900,24
167445,2019-11-12 00:00:00+03:00,out,False,920720,False,4,284,330,46
167445,2019-11-12 00:00:00+03:00,out,False,920852,False,4,337,372,35
167445,2019-11-12 00:00:00+03:00,in,False,920706,False,5,500,734,234
167445,2019-11-12 00:00:00+03:00,in,False,920838,False,2,491,521,30
167445,2019-11-12 00:00:00+03:00,in,False,920728,False,7,916,1027,111
167445,2019-11-12 00:00:00+03:00,in,False,920720,False,4,228,287,59
167445,2019-11-12 00:00:00+03:00,out,False,943066,True,1,0,2,2
167445,2019-11-12 00:00:00+03:00,out,False,920732,False,8,1331,1466,135
167445,2019-11-12 00:00:00+03:00,in,False,920902,False,1,83,200,117
167445,2019-11-12 00:00:00+03:00,out,False,920706,False,4,512,557,45
167445,2019-11-12 00:00:00+03:00,out,False,920732,True,5,0,92,92
167445,2019-11-12 00:00:00+03:00,in,False,921062,False,4,379,414,35
167445,2019-11-12 00:00:00+03:00,out,True,920706,True,1,0,25,25
167445,2019-11-12 00:00:00+03:00,out,False,920706,True,5,0,183,183
167445,2019-11-12 00:00:00+03:00,out,True,920706,True,1,0,25,25
167445,2019-11-12 00:00:00+03:00,out,False,943066,False,3,545,598,53
167445,2019-11-12 00:00:00+03:00,out,False,920706,False,4,512,557,45
167445,2019-11-13 00:00:00+03:00,out,False,920732,False,9,1470,1592,122
167445,2019-11-13 00:00:00+03:00,in,False,920728,False,6,1136,1232,96
167445,2019-11-13 00:00:00+03:00,in,False,920838,False,4,458,487,29
167445,2019-11-13 00:00:00+03:00,out,False,920720,True,2,0,52,52
167445,2019-11-13 00:00:00+03:00,out,False,920732,True,11,0,435,435
167445,2019-11-13 00:00:00+03:00,out,False,920838,False,1,77,83,6
167445,2019-11-13 00:00:00+03:00,out,False,920726,True,2,0,83,83
167445,2019-11-13 00:00:00+03:00,out,False,920852,False,3,788,816,28
167445,2019-11-13 00:00:00+03:00,in,False,920732,False,3,228,305,77
167445,2019-11-13 00:00:00+03:00,out,False,943066,False,1,204,219,15
167445,2019-11-13 00:00:00+03:00,in,False,921062,False,4,462,491,29
167445,2019-11-13 00:00:00+03:00,out,False,920706,False,10,1134,1283,149
167445,2019-11-13 00:00:00+03:00,out,False,920720,False,4,406,470,64
167445,2019-11-13 00:00:00+03:00,in,False,-1,True,18,0,743,743
167445,2019-11-13 00:00:00+03:00,in,False,920852,True,1,0,19,19
167445,2019-11-13 00:00:00+03:00,in,False,920720,False,2,140,153,13
167445,2019-11-13 00:00:00+03:00,in,False,920706,False,1,205,225,20
167445,2019-11-13 00:00:00+03:00,out,False,920726,False,3,264,296,32
167445,2019-11-13 00:00:00+03:00,in,False,920902,False,1,80,197,117
167445,2019-11-13 00:00:00+03:00,in,False,920852,False,4,514,568,54
167445,2019-11-13 00:00:00+03:00,out,False,920852,True,1,0,39,39
167445,2019-11-13 00:00:00+03:00,out,True,920706,True,2,0,1,1
167445,2019-11-13 00:00:00+03:00,out,False,920706,True,8,0,136,136
167445,2019-11-13 00:00:00+03:00,out,False,943066,False,1,204,219,15
167445,2019-11-13 00:00:00+03:00,out,False,920720,False,4,406,470,64
167445,2019-11-14 00:00:00+03:00,in,False,921062,False,3,87,119,32
167445,2019-11-14 00:00:00+03:00,in,False,-1,True,34,0,1094,1094
167445,2019-11-14 00:00:00+03:00,in,False,920902,True,1,0,51,51
167445,2019-11-14 00:00:00+03:00,in,False,920720,False,1,10,31,21
167445,2019-11-14 00:00:00+03:00,in,False,920706,False,4,547,595,48
167445,2019-11-14 00:00:00+03:00,out,False,920726,False,1,64,75,11
167445,2019-11-14 00:00:00+03:00,out,False,920728,False,5,1177,1241,64
167445,2019-11-14 00:00:00+03:00,in,False,920726,False,2,163,205,42
167445,2019-11-14 00:00:00+03:00,out,False,920706,False,2,1054,1061,7
167445,2019-11-14 00:00:00+03:00,out,False,920852,False,12,863,1032,169
167445,2019-11-14 00:00:00+03:00,in,False,920852,False,12,1055,1177,122
167445,2019-11-14 00:00:00+03:00,in,False,920902,False,3,169,390,221
167445,2019-11-14 00:00:00+03:00,out,False,920852,True,2,0,12,12
167445,2019-11-14 00:00:00+03:00,out,False,920838,True,2,0,60,60
167445,2019-11-14 00:00:00+03:00,in,False,920728,False,7,1942,2264,322
167445,2019-11-14 00:00:00+03:00,out,False,920720,False,1,13,26,13
167445,2019-11-14 00:00:00+03:00,in,False,920838,False,2,56,74,18
167445,2019-11-14 00:00:00+03:00,out,False,920838,False,6,197,284,87
167445,2019-11-14 00:00:00+03:00,out,False,920728,False,5,1177,1241,64
167445,2019-11-14 00:00:00+03:00,in,False,920902,False,3,169,390,221
167445,2019-11-14 00:00:00+03:00,out,False,920706,False,2,1054,1061,7
167445,2019-11-15 00:00:00+03:00,out,False,920726,False,1,195,211,16
167445,2019-11-15 00:00:00+03:00,in,False,920706,False,3,256,286,30
167445,2019-11-15 00:00:00+03:00,in,False,920728,False,2,347,374,27
167445,2019-11-15 00:00:00+03:00,out,True,920706,False,1,29,36,7
167445,2019-11-15 00:00:00+03:00,in,False,-1,True,29,0,1253,1253
167445,2019-11-15 00:00:00+03:00,out,False,920838,False,6,1026,1100,74
167445,2019-11-15 00:00:00+03:00,out,False,920732,False,6,516,603,87
167445,2019-11-15 00:00:00+03:00,in,False,920852,False,8,791,909,118
167445,2019-11-15 00:00:00+03:00,in,False,920706,True,4,244,309,65
167445,2019-11-15 00:00:00+03:00,in,False,920838,False,1,40,45,5
167445,2019-11-15 00:00:00+03:00,in,False,920732,False,4,710,749,39
167445,2019-11-15 00:00:00+03:00,out,False,920732,True,1,0,9,9
167445,2019-11-15 00:00:00+03:00,in,False,920902,False,5,171,388,217
167445,2019-11-15 00:00:00+03:00,out,False,920720,False,4,357,383,26
167445,2019-11-15 00:00:00+03:00,out,False,920852,False,5,902,980,78
167445,2019-11-15 00:00:00+03:00,in,False,920720,False,2,393,442,49
167445,2019-11-15 00:00:00+03:00,in,False,921062,False,3,270,305,35
167445,2019-11-15 00:00:00+03:00,out,False,920902,False,1,9,10,1
167445,2019-11-15 00:00:00+03:00,out,False,920732,True,1,0,9,9
167445,2019-11-15 00:00:00+03:00,in,False,920728,False,2,347,374,27
167445,2019-11-16 00:00:00+03:00,in,False,921062,False,2,101,139,38
167445,2019-11-16 00:00:00+03:00,in,False,920726,False,3,270,313,43
167445,2019-11-16 00:00:00+03:00,out,False,920726,False,1,44,55,11
167445,2019-11-16 00:00:00+03:00,in,False,920902,False,3,147,308,161
167445,2019-11-16 00:00:00+03:00,in,False,-1,True,23,0,740,740
167445,2019-11-16 00:00:00+03:00,in,False,920852,False,1,104,126,22
167445,2019-11-16 00:00:00+03:00,out,False,920720,False,1,71,81,10
167445,2019-11-16 00:00:00+03:00,in,False,920852,False,1,104,126,22
167445,2019-11-16 00:00:00+03:00,in,False,920902,False,3,147,308,161
167445,2019-11-17 00:00:00+03:00,in,False,-1,True,9,0,74,74
167445,2019-11-17 00:00:00+03:00,out,False,943066,True,1,0,41,41
167445,2019-11-17 00:00:00+03:00,in,False,920838,False,1,43,55,12
167445,2019-11-17 00:00:00+03:00,out,False,920726,True,1,0,2,2
167445,2019-11-17 00:00:00+03:00,out,False,920726,False,4,97,143,46
167445,2019-11-17 00:00:00+03:00,in,False,943066,False,1,31,34,3
167445,2019-11-17 00:00:00+03:00,in,False,920852,False,1,114,123,9
167445,2019-11-17 00:00:00+03:00,out,False,920838,False,3,93,135,42
167445,2019-11-17 00:00:00+03:00,out,False,943066,False,3,615,648,33
167445,2019-11-17 00:00:00+03:00,out,False,920838,True,1,0,60,60
167445,2019-11-17 00:00:00+03:00,in,False,920720,False,2,48,173,125
167445,2019-11-17 00:00:00+03:00,in,False,920726,False,4,258,308,50
167445,2019-11-17 00:00:00+03:00,out,False,943066,False,3,615,648,33
167445,2019-11-18 00:00:00+03:00,out,False,920732,True,2,0,101,101
167445,2019-11-18 00:00:00+03:00,in,False,920726,False,1,288,355,67
167445,2019-11-18 00:00:00+03:00,out,False,920852,False,3,297,348,51
167445,2019-11-18 00:00:00+03:00,out,False,920838,False,1,565,579,14
167445,2019-11-18 00:00:00+03:00,in,False,920902,False,2,165,274,109
167445,2019-11-18 00:00:00+03:00,out,False,920706,False,1,791,795,4
167445,2019-11-18 00:00:00+03:00,in,False,-1,True,48,0,557,557
167445,2019-11-18 00:00:00+03:00,out,False,920732,False,13,1385,1546,161
167445,2019-11-18 00:00:00+03:00,in,False,920728,False,7,717,802,85
167445,2019-11-18 00:00:00+03:00,out,False,943066,False,20,1331,1530,199
167445,2019-11-18 00:00:00+03:00,out,False,920726,False,2,108,128,20
167445,2019-11-18 00:00:00+03:00,out,False,943066,True,5,0,54,54
167445,2019-11-18 00:00:00+03:00,in,False,920728,True,1,0,13,13
167445,2019-11-18 00:00:00+03:00,in,False,920852,False,2,79,101,22
167445,2019-11-18 00:00:00+03:00,in,False,943066,False,14,902,1088,186
167445,2019-11-18 00:00:00+03:00,in,False,920732,False,9,657,747,90
167445,2019-11-18 00:00:00+03:00,in,False,920852,True,1,0,21,21
167445,2019-11-18 00:00:00+03:00,out,True,920706,False,1,7,21,14
167445,2019-11-18 00:00:00+03:00,in,False,921062,False,2,167,181,14
167445,2019-11-18 00:00:00+03:00,in,False,920706,False,3,411,515,104
167445,2019-11-18 00:00:00+03:00,in,False,920706,False,3,411,515,104
167445,2019-11-18 00:00:00+03:00,out,False,920732,True,2,0,101,101
167445,2019-11-18 00:00:00+03:00,in,False,920852,True,1,0,21,21
167445,2019-11-18 00:00:00+03:00,out,False,920706,False,1,791,795,4
167445,2019-11-18 00:00:00+03:00,out,True,920706,False,1,7,21,14
167445,2019-11-19 00:00:00+03:00,out,False,920838,False,6,633,705,72
167445,2019-11-19 00:00:00+03:00,in,False,-1,True,18,0,552,552
167445,2019-11-19 00:00:00+03:00,in,False,921062,False,4,567,598,31
167445,2019-11-19 00:00:00+03:00,in,False,920720,False,1,89,109,20
167445,2019-11-19 00:00:00+03:00,in,False,920728,False,6,711,779,68
167445,2019-11-19 00:00:00+03:00,out,False,943066,True,2,0,18,18
167445,2019-11-19 00:00:00+03:00,out,False,920728,False,7,679,758,79
167445,2019-11-19 00:00:00+03:00,out,False,943066,False,4,208,254,46
167445,2019-11-19 00:00:00+03:00,in,False,920902,False,1,208,296,88
167445,2019-11-19 00:00:00+03:00,out,False,920720,False,4,390,463,73
167445,2019-11-19 00:00:00+03:00,out,False,920852,True,5,0,107,107
167445,2019-11-19 00:00:00+03:00,out,False,920726,False,2,99,118,19
167445,2019-11-19 00:00:00+03:00,in,False,920706,False,6,498,696,198
167445,2019-11-19 00:00:00+03:00,out,False,920852,False,11,1895,2044,149
167445,2019-11-19 00:00:00+03:00,in,False,943066,False,6,450,515,65
167445,2019-11-19 00:00:00+03:00,out,False,920728,True,2,0,68,68
167445,2019-11-19 00:00:00+03:00,in,False,920726,False,10,1650,1711,61
167445,2019-11-19 00:00:00+03:00,in,False,920732,False,3,427,477,50
167445,2019-11-19 00:00:00+03:00,in,False,920852,False,9,551,616,65
167445,2019-11-19 00:00:00+03:00,in,False,920838,False,7,940,1031,91
167445,2019-11-19 00:00:00+03:00,out,False,920852,False,11,1895,2044,149
167445,2019-11-20 00:00:00+03:00,out,False,920728,False,3,489,543,54
167445,2019-11-20 00:00:00+03:00,in,False,920720,False,1,152,159,7
167445,2019-11-20 00:00:00+03:00,out,False,920838,True,3,0,105,105
167445,2019-11-20 00:00:00+03:00,out,False,920852,False,5,243,349,106
167445,2019-11-20 00:00:00+03:00,in,False,920852,False,7,509,602,93
167445,2019-11-20 00:00:00+03:00,in,False,921062,False,1,157,165,8
167445,2019-11-20 00:00:00+03:00,out,False,920720,False,2,187,223,36
167445,2019-11-20 00:00:00+03:00,in,False,-1,True,47,0,1193,1193
167445,2019-11-20 00:00:00+03:00,out,False,943066,True,8,0,124,124
167445,2019-11-20 00:00:00+03:00,in,False,920726,False,1,128,134,6
167445,2019-11-20 00:00:00+03:00,out,False,920838,False,5,543,596,53
167445,2019-11-20 00:00:00+03:00,out,False,920852,True,1,0,7,7
167445,2019-11-20 00:00:00+03:00,in,False,920902,False,1,41,48,7
167445,2019-11-20 00:00:00+03:00,out,False,920732,False,1,5,41,36
167445,2019-11-20 00:00:00+03:00,out,False,920726,False,1,23,32,9
167445,2019-11-20 00:00:00+03:00,in,False,920728,False,6,579,690,111
167445,2019-11-20 00:00:00+03:00,out,False,920732,True,1,0,41,41
167445,2019-11-20 00:00:00+03:00,out,False,943066,False,12,1934,2110,176
167445,2019-11-20 00:00:00+03:00,in,False,943066,False,21,1877,2146,269
167445,2019-11-20 00:00:00+03:00,in,False,920902,False,1,41,48,7
167445,2019-11-20 00:00:00+03:00,out,False,920720,False,2,187,223,36
167445,2019-11-20 00:00:00+03:00,in,False,921062,False,1,157,165,8
167445,2019-11-21 00:00:00+03:00,in,False,943066,False,13,687,838,151
167445,2019-11-21 00:00:00+03:00,out,False,920838,False,3,486,529,43
167445,2019-11-21 00:00:00+03:00,out,False,920728,False,2,109,156,47
167445,2019-11-21 00:00:00+03:00,out,False,920852,True,2,0,23,23
167445,2019-11-21 00:00:00+03:00,in,False,920838,False,3,247,277,30
167445,2019-11-21 00:00:00+03:00,out,False,920732,False,3,340,395,55
167445,2019-11-21 00:00:00+03:00,in,False,920852,False,5,422,483,61
167445,2019-11-21 00:00:00+03:00,in,False,920732,False,10,1178,1405,227
167445,2019-11-21 00:00:00+03:00,out,False,920852,False,5,864,936,72
167445,2019-11-21 00:00:00+03:00,out,False,943066,True,4,0,21,21
167445,2019-11-21 00:00:00+03:00,in,False,920728,False,6,623,767,144
167445,2019-11-21 00:00:00+03:00,in,False,920726,False,1,40,47,7
167445,2019-11-21 00:00:00+03:00,out,False,943066,False,12,1804,1913,109
167445,2019-11-21 00:00:00+03:00,in,False,920728,True,1,0,35,35
167445,2019-11-21 00:00:00+03:00,in,False,-1,True,32,0,959,959
167445,2019-11-21 00:00:00+03:00,out,False,943066,True,4,0,21,21
167445,2019-11-22 00:00:00+03:00,in,False,935956,False,1,36,126,90
167445,2019-11-22 00:00:00+03:00,in,False,920726,False,2,245,296,51
167445,2019-11-22 00:00:00+03:00,in,False,920838,False,3,104,153,49
167445,2019-11-22 00:00:00+03:00,in,False,920728,False,2,631,648,17
167445,2019-11-22 00:00:00+03:00,out,False,943066,False,6,354,446,92
167445,2019-11-22 00:00:00+03:00,out,False,920732,False,3,198,235,37
167445,2019-11-22 00:00:00+03:00,out,False,920838,False,1,397,415,18
167445,2019-11-22 00:00:00+03:00,out,False,920732,True,2,0,7,7
167445,2019-11-22 00:00:00+03:00,out,False,920726,True,1,0,7,7
167445,2019-11-22 00:00:00+03:00,out,False,920838,True,1,0,41,41
167445,2019-11-22 00:00:00+03:00,out,False,920726,False,3,298,340,42
167445,2019-11-22 00:00:00+03:00,in,False,-1,True,45,0,998,998
167445,2019-11-22 00:00:00+03:00,in,False,943066,False,3,388,442,54
167445,2019-11-22 00:00:00+03:00,out,False,920728,True,3,0,133,133
167445,2019-11-22 00:00:00+03:00,in,False,921062,False,4,659,707,48
167445,2019-11-22 00:00:00+03:00,out,False,920852,False,9,1169,1304,135
167445,2019-11-22 00:00:00+03:00,out,False,943066,True,3,0,70,70
167445,2019-11-22 00:00:00+03:00,in,False,920732,False,10,1722,1850,128
167445,2019-11-22 00:00:00+03:00,in,False,920852,False,5,464,534,70
167445,2019-11-22 00:00:00+03:00,in,False,921062,False,4,659,707,48
167445,2019-11-23 00:00:00+03:00,in,False,920838,False,1,15,24,9
167445,2019-11-23 00:00:00+03:00,out,False,920852,False,8,665,769,104
167445,2019-11-23 00:00:00+03:00,out,False,920838,False,1,896,908,12
167445,2019-11-23 00:00:00+03:00,in,False,920728,False,7,927,1041,114
167445,2019-11-23 00:00:00+03:00,out,False,943066,True,4,0,85,85
167445,2019-11-23 00:00:00+03:00,in,False,920852,False,5,364,414,50
167445,2019-11-23 00:00:00+03:00,in,False,920732,False,8,1097,1186,89
167445,2019-11-23 00:00:00+03:00,out,False,920728,False,2,24,37,13
167445,2019-11-23 00:00:00+03:00,in,False,921062,False,3,209,255,46
167445,2019-11-23 00:00:00+03:00,out,False,920732,True,2,0,8,8
167445,2019-11-23 00:00:00+03:00,out,False,920726,False,1,76,96,20
167445,2019-11-23 00:00:00+03:00,in,False,-1,True,24,0,915,915
167445,2019-11-23 00:00:00+03:00,out,False,920732,False,11,1228,1413,185
167445,2019-11-23 00:00:00+03:00,out,False,920726,True,1,0,2,2
167445,2019-11-23 00:00:00+03:00,out,False,943066,False,8,724,830,106
167445,2019-11-23 00:00:00+03:00,in,False,943066,False,7,603,750,147
167445,2019-11-24 00:00:00+03:00,out,False,920726,False,1,11,13,2
167445,2019-11-24 00:00:00+03:00,out,False,920852,False,6,462,564,102
167445,2019-11-24 00:00:00+03:00,in,False,-1,True,26,0,453,453
167445,2019-11-24 00:00:00+03:00,out,False,920852,True,4,0,5,5
167445,2019-11-24 00:00:00+03:00,in,False,920852,False,2,483,497,14
167445,2019-11-24 00:00:00+03:00,in,False,920726,False,1,7,15,8
167445,2019-11-24 00:00:00+03:00,out,False,943066,False,7,275,347,72
167445,2019-11-24 00:00:00+03:00,in,False,943066,False,1,17,32,15
167445,2019-11-25 00:00:00+03:00,out,False,920728,False,2,364,387,23
167445,2019-11-25 00:00:00+03:00,out,False,920726,False,3,68,97,29
167445,2019-11-25 00:00:00+03:00,out,False,935956,False,1,173,187,14
167445,2019-11-25 00:00:00+03:00,in,False,935956,False,1,50,65,15
167445,2019-11-25 00:00:00+03:00,in,False,920728,False,16,1278,1536,258
167445,2019-11-25 00:00:00+03:00,out,False,920852,True,5,0,15,15
167445,2019-11-25 00:00:00+03:00,in,False,921062,False,7,761,838,77
167445,2019-11-25 00:00:00+03:00,out,False,920838,True,2,0,54,54
167445,2019-11-25 00:00:00+03:00,out,False,943066,True,4,0,52,52
167445,2019-11-25 00:00:00+03:00,out,False,920852,False,10,1321,1429,108
167445,2019-11-25 00:00:00+03:00,in,False,-1,True,64,0,1544,1544
167445,2019-11-25 00:00:00+03:00,in,False,920838,False,6,678,769,91
167445,2019-11-25 00:00:00+03:00,in,False,943066,False,6,458,557,99
167445,2019-11-25 00:00:00+03:00,in,False,920902,False,2,277,305,28
167445,2019-11-25 00:00:00+03:00,in,False,920732,False,10,1221,1384,163
167445,2019-11-25 00:00:00+03:00,in,False,920726,False,4,446,545,99
167445,2019-11-25 00:00:00+03:00,out,False,920838,False,11,1051,1232,181
167445,2019-11-25 00:00:00+03:00,out,False,943066,False,4,319,367,48
167445,2019-11-25 00:00:00+03:00,out,False,920732,False,7,276,369,93
167445,2019-11-25 00:00:00+03:00,out,False,920728,True,2,0,20,20
167445,2019-11-25 00:00:00+03:00,in,False,920852,False,8,576,667,91
167445,2019-11-25 00:00:00+03:00,out,False,943066,True,4,0,52,52
167445,2019-11-25 00:00:00+03:00,out,False,920728,True,2,0,20,20
167445,2019-11-25 00:00:00+03:00,out,False,920838,True,2,0,54,54
167445,2019-11-26 00:00:00+03:00,in,False,943066,False,1,52,73,21
167445,2019-11-26 00:00:00+03:00,in,False,-1,True,40,0,1565,1565
167445,2019-11-26 00:00:00+03:00,in,False,920726,True,1,1,30,29
167445,2019-11-26 00:00:00+03:00,out,False,920732,False,15,2118,2404,286
167445,2019-11-26 00:00:00+03:00,in,False,920852,False,3,177,202,25
167445,2019-11-26 00:00:00+03:00,in,False,920732,False,19,4323,4721,398
167445,2019-11-26 00:00:00+03:00,out,False,943066,True,2,0,15,15
167445,2019-11-26 00:00:00+03:00,in,False,921062,False,7,472,528,56
167445,2019-11-26 00:00:00+03:00,in,False,920728,False,12,743,996,253
167445,2019-11-26 00:00:00+03:00,out,False,920728,True,2,0,82,82
167445,2019-11-26 00:00:00+03:00,out,False,920838,False,7,2246,2376,130
167445,2019-11-26 00:00:00+03:00,out,False,920732,True,5,0,99,99
167445,2019-11-26 00:00:00+03:00,out,False,920726,True,2,0,33,33
167445,2019-11-26 00:00:00+03:00,out,False,920728,False,4,455,491,36
167445,2019-11-26 00:00:00+03:00,out,False,920852,True,1,0,44,44
167445,2019-11-26 00:00:00+03:00,out,False,920726,False,6,646,712,66
167445,2019-11-26 00:00:00+03:00,out,False,920852,False,7,1388,1506,118
167445,2019-11-26 00:00:00+03:00,in,False,920838,False,2,76,98,22
167445,2019-11-26 00:00:00+03:00,out,False,920706,False,1,27,70,43
167445,2019-11-26 00:00:00+03:00,out,False,920838,True,2,0,120,120
167445,2019-11-26 00:00:00+03:00,in,False,920726,True,1,1,30,29
167445,2019-11-26 00:00:00+03:00,in,False,920838,False,2,76,98,22
167445,2019-11-26 00:00:00+03:00,out,False,920838,False,7,2246,2376,130
167445,2019-11-26 00:00:00+03:00,out,False,920726,False,6,646,712,66
167445,2019-11-27 00:00:00+03:00,in,False,943066,False,1,56,74,18
167445,2019-11-27 00:00:00+03:00,out,False,920838,False,4,1297,1350,53
167445,2019-11-27 00:00:00+03:00,in,False,920732,False,5,633,734,101
167445,2019-11-27 00:00:00+03:00,in,False,921062,False,8,565,673,108
167445,2019-11-27 00:00:00+03:00,out,False,943066,False,1,110,127,17
167445,2019-11-27 00:00:00+03:00,out,False,920726,True,1,0,28,28
167445,2019-11-27 00:00:00+03:00,out,False,920728,False,2,273,304,31
167445,2019-11-27 00:00:00+03:00,out,True,920728,True,2,0,0,0
167445,2019-11-27 00:00:00+03:00,out,False,920852,True,7,0,102,102
167445,2019-11-27 00:00:00+03:00,out,False,920732,False,10,1012,1148,136
167445,2019-11-27 00:00:00+03:00,out,False,920728,True,13,0,151,151
167445,2019-11-27 00:00:00+03:00,in,False,920852,False,5,502,552,50
167445,2019-11-27 00:00:00+03:00,in,False,920728,False,12,1937,2158,221
167445,2019-11-27 00:00:00+03:00,in,False,-1,True,35,0,1003,1003
167445,2019-11-27 00:00:00+03:00,in,False,920726,False,6,527,585,58
167445,2019-11-27 00:00:00+03:00,out,False,920732,True,3,0,30,30
167445,2019-11-27 00:00:00+03:00,out,False,920852,False,13,1995,2195,200
167445,2019-11-27 00:00:00+03:00,out,False,920732,False,10,1012,1148,136
167445,2019-11-27 00:00:00+03:00,out,False,920726,True,1,0,28,28
167445,2019-11-28 00:00:00+03:00,in,False,943066,False,10,1589,1691,102
167445,2019-11-28 00:00:00+03:00,out,False,943066,True,4,0,110,110
167445,2019-11-28 00:00:00+03:00,in,False,921062,False,3,365,388,23
167445,2019-11-28 00:00:00+03:00,out,False,920838,True,2,0,20,20
167445,2019-11-28 00:00:00+03:00,out,False,943066,False,4,152,225,73
167445,2019-11-28 00:00:00+03:00,out,False,920732,True,2,0,62,62
167445,2019-11-28 00:00:00+03:00,in,False,-1,True,12,0,460,460
167445,2019-11-28 00:00:00+03:00,out,False,920726,False,1,46,58,12
167445,2019-11-28 00:00:00+03:00,in,False,920852,False,6,723,788,65
167445,2019-11-28 00:00:00+03:00,in,False,920732,False,8,880,950,70
167445,2019-11-28 00:00:00+03:00,in,False,920838,False,9,1059,1155,96
167445,2019-11-28 00:00:00+03:00,in,False,920726,False,5,928,974,46
167445,2019-11-28 00:00:00+03:00,out,False,920852,True,6,0,81,81
167445,2019-11-28 00:00:00+03:00,in,False,920902,False,1,30,38,8
167445,2019-11-28 00:00:00+03:00,out,False,920838,False,5,649,693,44
167445,2019-11-28 00:00:00+03:00,in,False,920728,False,6,838,987,149
167445,2019-11-28 00:00:00+03:00,out,False,920852,False,9,1034,1154,120
167445,2019-11-28 00:00:00+03:00,out,False,920728,False,1,86,98,12
167445,2019-11-28 00:00:00+03:00,out,False,920732,False,7,1842,1953,111
167445,2019-11-28 00:00:00+03:00,in,False,943066,False,10,1589,1691,102
167445,2019-11-28 00:00:00+03:00,out,False,920728,False,1,86,98,12
167451,2019-09-18 00:00:00+03:00,in,False,914170,False,1,71,92,21
167451,2019-09-19 00:00:00+03:00,in,False,-1,True,2,0,3,3
167451,2019-09-19 00:00:00+03:00,in,False,-1,True,2,0,3,3
167451,2019-09-20 00:00:00+03:00,in,False,-1,True,10,0,87,87
167451,2019-09-21 00:00:00+03:00,in,False,-1,True,2,0,43,43
167451,2019-09-21 00:00:00+03:00,in,False,914172,False,1,25,31,6
167451,2019-09-21 00:00:00+03:00,in,False,914172,False,1,25,31,6
167451,2019-09-22 00:00:00+03:00,out,False,914170,True,1,0,1,1
167451,2019-09-25 00:00:00+03:00,in,False,-1,True,1,0,2,2
167451,2019-10-28 00:00:00+03:00,in,False,-1,True,1,0,2,2
167451,2019-10-28 00:00:00+03:00,in,False,-1,True,1,0,2,2
167451,2019-10-29 00:00:00+03:00,in,False,914170,False,2,51,79,28
167451,2019-10-30 00:00:00+03:00,in,False,-1,True,2,0,5,5
167451,2019-11-01 00:00:00+03:00,in,False,914170,False,3,1389,1423,34
167451,2019-11-01 00:00:00+03:00,in,False,-1,True,1,0,9,9
167451,2019-11-01 00:00:00+03:00,out,False,914170,True,2,0,34,34
167451,2019-11-01 00:00:00+03:00,out,False,914170,False,1,331,338,7
167451,2019-11-01 00:00:00+03:00,in,False,914170,False,3,1389,1423,34
167451,2019-11-02 00:00:00+03:00,in,False,914170,False,5,586,633,47
167451,2019-11-04 00:00:00+03:00,in,False,914170,False,1,17,30,13
167451,2019-11-05 00:00:00+03:00,in,False,-1,True,4,0,6,6
167451,2019-11-18 00:00:00+03:00,in,False,-1,True,1,0,4,4
167451,2019-11-18 00:00:00+03:00,in,False,914172,False,5,88,151,63
167451,2019-11-18 00:00:00+03:00,in,False,914172,False,5,88,151,63
167451,2019-11-20 00:00:00+03:00,in,False,-1,True,4,0,7,7
167451,2019-11-21 00:00:00+03:00,out,False,951290,True,4,0,192,192
167451,2019-11-21 00:00:00+03:00,in,False,-1,True,1,0,1,1
167451,2019-11-22 00:00:00+03:00,in,False,-1,True,2,0,2,2
167451,2019-11-22 00:00:00+03:00,out,False,914168,False,2,325,346,21
167451,2019-11-22 00:00:00+03:00,out,False,951290,True,2,0,122,122
167451,2019-11-22 00:00:00+03:00,out,False,951290,False,2,411,431,20
167451,2019-11-24 00:00:00+03:00,out,False,951290,True,1,0,62,62
167451,2019-11-24 00:00:00+03:00,in,False,-1,True,3,0,3,3
167451,2019-11-24 00:00:00+03:00,out,False,951290,False,3,167,231,64
167451,2019-11-25 00:00:00+03:00,out,False,951290,True,1,0,42,42
167451,2019-11-25 00:00:00+03:00,in,False,-1,True,15,0,27,27
167451,2019-11-25 00:00:00+03:00,out,False,951290,False,4,479,513,34
167451,2019-11-25 00:00:00+03:00,in,False,-1,True,15,0,27,27
167451,2019-11-26 00:00:00+03:00,out,False,951290,True,1,0,60,60
167451,2019-11-26 00:00:00+03:00,out,False,914168,False,2,310,371,61
167451,2019-11-26 00:00:00+03:00,in,False,-1,True,3,0,25,25
167451,2019-11-26 00:00:00+03:00,out,False,951290,False,1,6,9,3
167451,2019-11-27 00:00:00+03:00,in,False,951290,False,1,502,519,17
167451,2019-11-27 00:00:00+03:00,out,False,951290,False,1,23,33,10
167451,2019-11-27 00:00:00+03:00,in,False,914168,False,1,460,471,11
167451,2019-11-27 00:00:00+03:00,in,False,-1,True,7,0,22,22
167451,2019-11-27 00:00:00+03:00,out,False,914168,False,1,3,43,40
167451,2019-11-27 00:00:00+03:00,in,False,-1,True,7,0,22,22
167451,2019-11-28 00:00:00+03:00,out,False,914168,True,2,0,124,124
167451,2019-11-28 00:00:00+03:00,out,False,914168,False,3,89,163,74
167455,2019-09-24 00:00:00+03:00,in,False,-1,True,1,0,2,2
167455,2019-09-24 00:00:00+03:00,in,False,-1,True,1,0,2,2
167455,2019-09-27 00:00:00+03:00,out,False,918390,True,1,0,10,10
167455,2019-09-28 00:00:00+03:00,out,False,918390,False,2,343,373,30
167455,2019-09-29 00:00:00+03:00,out,False,918390,False,3,1802,1844,42
167455,2019-09-30 00:00:00+03:00,out,False,918390,False,6,1200,1289,89
167455,2019-09-30 00:00:00+03:00,out,False,918390,True,1,0,20,20
167455,2019-10-01 00:00:00+03:00,out,False,918390,False,5,3213,3292,79
167455,2019-10-02 00:00:00+03:00,out,False,918390,False,2,2195,2227,32
167455,2019-10-02 00:00:00+03:00,out,False,918390,False,2,2195,2227,32
167455,2019-10-03 00:00:00+03:00,out,False,918390,False,2,1379,1411,32
167455,2019-10-04 00:00:00+03:00,out,False,918390,False,5,2380,2444,64
167455,2019-10-05 00:00:00+03:00,out,False,918390,True,4,0,185,185
167455,2019-10-05 00:00:00+03:00,out,False,918390,False,1,141,154,13
167455,2019-10-06 00:00:00+03:00,out,False,918390,False,3,1846,1895,49
167455,2019-10-07 00:00:00+03:00,out,False,918390,False,4,2574,2622,48
167455,2019-10-08 00:00:00+03:00,out,False,918390,False,4,2528,2606,78
167455,2019-10-09 00:00:00+03:00,out,False,918390,False,3,1653,1706,53
167455,2019-10-10 00:00:00+03:00,out,False,918390,False,5,2407,2475,68
167455,2019-10-11 00:00:00+03:00,out,False,918390,False,2,966,993,27
167455,2019-10-12 00:00:00+03:00,out,False,918390,False,2,148,184,36
167455,2019-10-13 00:00:00+03:00,out,False,918390,False,3,1517,1578,61
167455,2019-10-14 00:00:00+03:00,out,False,918390,False,4,2288,2354,66
167455,2019-10-15 00:00:00+03:00,out,False,918390,False,5,3771,3852,81
167455,2019-10-16 00:00:00+03:00,out,False,918390,False,6,2694,2801,107
167455,2019-10-17 00:00:00+03:00,out,False,918390,True,6,0,287,287
167455,2019-10-17 00:00:00+03:00,out,False,918390,False,5,1089,1161,72
167455,2019-10-18 00:00:00+03:00,out,False,918390,False,3,2759,2796,37
167455,2019-10-19 00:00:00+03:00,out,False,918390,False,6,3417,3490,73
167455,2019-10-19 00:00:00+03:00,in,False,-1,True,1,0,5,5
167455,2019-10-19 00:00:00+03:00,out,False,918390,True,13,0,56,56
167455,2019-10-20 00:00:00+03:00,out,False,918390,False,5,969,1033,64
167455,2019-10-21 00:00:00+03:00,out,False,918390,False,3,2289,2340,51
167455,2019-10-21 00:00:00+03:00,out,False,918390,True,1,0,17,17
167455,2019-10-22 00:00:00+03:00,out,False,918390,False,4,2507,2570,63
167455,2019-10-22 00:00:00+03:00,out,False,918390,False,4,2507,2570,63
167455,2019-10-23 00:00:00+03:00,out,False,918390,False,5,3187,3255,68
167455,2019-10-23 00:00:00+03:00,out,False,918390,False,5,3187,3255,68
167455,2019-10-24 00:00:00+03:00,out,False,918390,False,2,1869,1895,26
167455,2019-10-25 00:00:00+03:00,out,False,918390,False,1,107,120,13
167455,2019-10-26 00:00:00+03:00,out,False,918390,False,3,1608,1654,46
167455,2019-10-27 00:00:00+03:00,out,False,918390,False,2,639,670,31
167455,2019-10-28 00:00:00+03:00,out,False,918390,False,3,530,577,47
167455,2019-10-29 00:00:00+03:00,out,False,918390,False,3,1095,1140,45
167455,2019-10-30 00:00:00+03:00,out,False,918390,False,2,1040,1065,25
167455,2019-10-31 00:00:00+03:00,out,False,918390,False,2,1080,1108,28
167455,2019-11-01 00:00:00+03:00,out,False,918390,False,8,3361,3463,102
167455,2019-11-02 00:00:00+03:00,out,False,918390,False,3,889,946,57
167455,2019-11-03 00:00:00+03:00,out,False,918390,False,1,605,623,18
167455,2019-11-04 00:00:00+03:00,out,False,918390,False,1,217,230,13
167455,2019-11-05 00:00:00+03:00,out,False,918390,False,3,1250,1295,45
167455,2019-11-07 00:00:00+03:00,out,False,918390,False,5,1741,1825,84
167455,2019-11-08 00:00:00+03:00,out,False,918390,False,6,3589,3671,82
167455,2019-11-09 00:00:00+03:00,out,False,918390,False,3,849,889,40
167455,2019-11-10 00:00:00+03:00,out,False,918390,False,6,3756,3845,89
167455,2019-11-11 00:00:00+03:00,out,False,918390,False,4,3377,3445,68
167455,2019-11-12 00:00:00+03:00,out,False,918390,False,1,1629,1646,17
167455,2019-11-13 00:00:00+03:00,out,False,918390,False,3,2761,2800,39
167455,2019-11-14 00:00:00+03:00,out,False,918390,False,2,1555,1583,28
167455,2019-11-15 00:00:00+03:00,out,False,918390,False,7,4248,4365,117
167455,2019-11-16 00:00:00+03:00,out,False,918390,False,2,1451,1484,33
167455,2019-11-17 00:00:00+03:00,out,False,918390,False,2,1163,1198,35
167455,2019-11-17 00:00:00+03:00,out,False,918390,True,1,0,17,17
167455,2019-11-17 00:00:00+03:00,out,False,918390,True,1,0,17,17
167455,2019-11-18 00:00:00+03:00,out,False,918390,False,4,4680,4729,49
167455,2019-11-18 00:00:00+03:00,out,False,918390,True,1,0,6,6
167455,2019-11-19 00:00:00+03:00,out,False,918390,False,3,1522,1578,56
167455,2019-11-20 00:00:00+03:00,out,False,918390,False,4,4175,4230,55
167455,2019-11-20 00:00:00+03:00,out,False,918390,True,1,0,9,9
167455,2019-11-21 00:00:00+03:00,out,False,918390,False,2,2354,2386,32
167455,2019-11-22 00:00:00+03:00,out,False,918390,False,6,3360,3452,92
167455,2019-11-23 00:00:00+03:00,out,False,918390,False,5,2635,2700,65
167455,2019-11-24 00:00:00+03:00,out,False,918390,False,1,1355,1375,20
167455,2019-11-25 00:00:00+03:00,out,False,918390,False,4,2225,2276,51
167455,2019-11-25 00:00:00+03:00,out,False,918390,False,4,2225,2276,51
167455,2019-11-26 00:00:00+03:00,out,False,918390,False,3,1451,1497,46
167455,2019-11-27 00:00:00+03:00,out,False,918390,True,1,0,4,4
167455,2019-11-27 00:00:00+03:00,out,False,918390,False,2,225,260,35
167455,2019-11-28 00:00:00+03:00,out,False,918390,True,1,0,8,8
167455,2019-11-28 00:00:00+03:00,out,False,918390,False,8,2365,2484,119
167456,2019-09-26 00:00:00+03:00,in,False,921102,False,1,178,192,14
167456,2019-09-26 00:00:00+03:00,in,False,-1,True,1,0,1,1
167456,2019-09-27 00:00:00+03:00,in,False,921104,False,1,89,119,30
167456,2019-09-30 00:00:00+03:00,out,True,921104,True,3,0,2,2
167456,2019-09-30 00:00:00+03:00,in,False,921102,False,3,80,102,22
167456,2019-09-30 00:00:00+03:00,out,True,921102,False,1,63,72,9
167456,2019-09-30 00:00:00+03:00,out,True,921102,True,4,0,1,1
167456,2019-09-30 00:00:00+03:00,in,False,921104,False,2,152,178,26
167456,2019-09-30 00:00:00+03:00,out,True,921104,False,3,145,186,41
167456,2019-10-01 00:00:00+03:00,in,False,-1,True,2,0,12,12
167456,2019-10-03 00:00:00+03:00,out,False,921102,False,1,98,105,7
167456,2019-10-03 00:00:00+03:00,out,False,921104,True,3,0,23,23
167456,2019-10-10 00:00:00+03:00,in,False,921102,False,1,31,52,21
167456,2019-10-25 00:00:00+03:00,out,True,921102,True,2,0,0,0
167456,2019-10-25 00:00:00+03:00,out,True,921102,True,2,0,0,0
167456,2019-10-27 00:00:00+03:00,out,True,921102,False,2,72,88,16
167456,2019-10-27 00:00:00+03:00,in,False,921104,False,2,56,102,46
167456,2019-10-27 00:00:00+03:00,in,False,-1,True,4,0,109,109
167456,2019-10-28 00:00:00+03:00,out,False,921102,True,1,0,6,6
167456,2019-10-28 00:00:00+03:00,in,False,-1,True,1,0,14,14
167456,2019-11-02 00:00:00+03:00,in,False,921102,False,1,14,29,15
167456,2019-11-07 00:00:00+03:00,in,False,921102,False,1,205,246,41
167456,2019-11-08 00:00:00+03:00,in,False,-1,True,1,0,43,43
167456,2019-11-08 00:00:00+03:00,out,False,921102,False,1,9,12,3
167456,2019-11-14 00:00:00+03:00,in,False,921104,False,1,187,208,21
167456,2019-11-19 00:00:00+03:00,in,False,921102,False,1,219,237,18
167456,2019-11-19 00:00:00+03:00,out,False,921102,True,1,0,8,8
167456,2019-11-19 00:00:00+03:00,in,False,-1,True,3,0,65,65
167456,2019-11-19 00:00:00+03:00,out,False,921102,False,1,34,42,8
167456,2019-11-20 00:00:00+03:00,in,False,921102,False,3,515,589,74
167456,2019-11-20 00:00:00+03:00,in,False,-1,True,1,0,43,43
167456,2019-11-20 00:00:00+03:00,in,False,-1,True,1,0,43,43
167456,2019-11-21 00:00:00+03:00,in,False,921102,False,1,189,216,27
167456,2019-11-25 00:00:00+03:00,out,False,921102,True,1,0,7,7
167456,2019-11-27 00:00:00+03:00,in,False,921102,False,1,37,69,32
167466,2019-09-27 00:00:00+03:00,in,False,921814,False,11,1129,1208,79
167466,2019-09-27 00:00:00+03:00,out,True,921814,False,1,2,3,1
167466,2019-09-27 00:00:00+03:00,out,False,921814,False,8,248,257,9
167466,2019-09-27 00:00:00+03:00,in,False,921814,True,4,0,20,20
167466,2019-09-27 00:00:00+03:00,in,False,-1,True,26,0,117,117
167466,2019-09-27 00:00:00+03:00,in,False,-1,True,26,0,117,117
167466,2019-09-28 00:00:00+03:00,in,False,921814,False,10,781,850,69
167466,2019-09-28 00:00:00+03:00,out,False,921814,False,11,32,52,20
167466,2019-09-28 00:00:00+03:00,in,False,-1,True,7,0,818,818
167466,2019-09-29 00:00:00+03:00,out,False,921814,False,4,12,17,5
167466,2019-09-29 00:00:00+03:00,out,True,921814,False,1,2,2,0
167466,2019-09-29 00:00:00+03:00,in,False,921814,False,7,981,1025,44
167466,2019-09-30 00:00:00+03:00,out,False,921818,True,13,0,296,296
167466,2019-09-30 00:00:00+03:00,in,False,921818,False,20,1626,1772,146
167466,2019-09-30 00:00:00+03:00,out,True,921814,False,1,14,38,24
167466,2019-09-30 00:00:00+03:00,out,False,921818,False,31,1024,1412,388
167466,2019-09-30 00:00:00+03:00,out,False,921814,False,3,13,25,12
167466,2019-09-30 00:00:00+03:00,out,False,921814,True,1,0,13,13
167466,2019-09-30 00:00:00+03:00,in,False,-1,True,15,0,215,215
167466,2019-09-30 00:00:00+03:00,out,True,921814,True,1,0,5,5
167466,2019-09-30 00:00:00+03:00,in,False,921814,False,10,831,902,71
167466,2019-09-30 00:00:00+03:00,in,False,921814,False,10,831,902,71
167466,2019-10-01 00:00:00+03:00,in,False,-1,True,2,0,74,74
167466,2019-10-01 00:00:00+03:00,out,True,921818,True,2,0,5,5
167466,2019-10-01 00:00:00+03:00,out,False,921818,True,11,0,243,243
167466,2019-10-01 00:00:00+03:00,out,False,921818,False,26,1197,1598,401
167466,2019-10-01 00:00:00+03:00,in,False,921818,False,26,2427,2640,213
167466,2019-10-02 00:00:00+03:00,out,False,921818,False,26,1379,1694,315
167466,2019-10-02 00:00:00+03:00,in,False,-1,True,6,0,140,140
167466,2019-10-02 00:00:00+03:00,out,False,921818,True,4,0,82,82
167466,2019-10-02 00:00:00+03:00,in,False,921818,False,24,2302,2467,165
167466,2019-10-02 00:00:00+03:00,out,False,921818,True,4,0,82,82
167466,2019-10-03 00:00:00+03:00,in,False,-1,True,1,0,20,20
167466,2019-10-03 00:00:00+03:00,out,False,921818,True,16,0,423,423
167466,2019-10-03 00:00:00+03:00,in,False,921818,False,27,2269,2508,239
167466,2019-10-03 00:00:00+03:00,out,True,921814,True,1,0,2,2
167466,2019-10-03 00:00:00+03:00,out,False,921818,False,20,789,1120,331
167466,2019-10-03 00:00:00+03:00,out,False,921814,True,1,0,14,14
167466,2019-10-03 00:00:00+03:00,out,False,921818,False,20,789,1120,331
167466,2019-10-04 00:00:00+03:00,out,False,921818,True,8,0,135,135
167466,2019-10-04 00:00:00+03:00,in,False,-1,True,4,0,5,5
167466,2019-10-04 00:00:00+03:00,in,False,921818,False,26,2741,2987,246
167466,2019-10-04 00:00:00+03:00,out,False,921818,False,14,1206,1354,148
167466,2019-10-05 00:00:00+03:00,in,False,921818,False,16,2291,2407,116
167466,2019-10-05 00:00:00+03:00,out,False,921818,False,12,263,456,193
167466,2019-10-05 00:00:00+03:00,out,False,921818,True,10,0,250,250
167466,2019-10-05 00:00:00+03:00,in,False,-1,True,6,0,186,186
167466,2019-10-06 00:00:00+03:00,in,False,921818,False,8,584,648,64
167466,2019-10-06 00:00:00+03:00,in,False,-1,True,3,0,70,70
167466,2019-10-06 00:00:00+03:00,out,False,921818,False,24,620,948,328
167466,2019-10-06 00:00:00+03:00,out,False,921818,True,7,0,173,173
167466,2019-10-07 00:00:00+03:00,in,False,921818,False,48,4174,4871,697
167466,2019-10-07 00:00:00+03:00,out,False,921818,False,28,992,1394,402
167466,2019-10-07 00:00:00+03:00,out,False,921818,True,16,0,369,369
167466,2019-10-07 00:00:00+03:00,in,False,-1,True,9,0,416,416
167466,2019-10-07 00:00:00+03:00,out,False,921818,False,28,992,1394,402
167466,2019-10-08 00:00:00+03:00,out,False,921818,True,10,0,160,160
167466,2019-10-08 00:00:00+03:00,out,False,921818,False,30,912,1317,405
167466,2019-10-08 00:00:00+03:00,in,False,921818,False,43,3291,3719,428
167466,2019-10-08 00:00:00+03:00,in,False,-1,True,1,0,21,21
167466,2019-10-09 00:00:00+03:00,out,False,921818,True,17,0,382,382
167466,2019-10-09 00:00:00+03:00,in,False,-1,True,4,0,111,111
167466,2019-10-09 00:00:00+03:00,in,False,921818,True,1,0,30,30
167466,2019-10-09 00:00:00+03:00,out,False,921818,False,26,1083,1507,424
167466,2019-10-09 00:00:00+03:00,in,False,921818,False,39,3267,3553,286
167466,2019-10-10 00:00:00+03:00,out,False,921818,True,6,0,56,56
167466,2019-10-10 00:00:00+03:00,out,False,921818,False,24,733,1113,380
167466,2019-10-10 00:00:00+03:00,in,False,921818,False,28,2518,2844,326
167466,2019-10-10 00:00:00+03:00,in,False,-1,True,2,0,96,96
167466,2019-10-11 00:00:00+03:00,out,False,921818,True,6,0,184,184
167466,2019-10-11 00:00:00+03:00,out,False,921818,False,10,248,412,164
167466,2019-10-11 00:00:00+03:00,in,False,921818,False,26,2411,2638,227
167466,2019-10-11 00:00:00+03:00,in,False,921818,False,26,2411,2638,227
167466,2019-10-12 00:00:00+03:00,out,False,921818,False,5,194,265,71
167466,2019-10-12 00:00:00+03:00,out,False,921818,True,1,0,43,43
167466,2019-10-12 00:00:00+03:00,in,False,-1,True,2,0,61,61
167466,2019-10-12 00:00:00+03:00,in,False,921818,False,12,1179,1283,104
167466,2019-10-12 00:00:00+03:00,in,False,-1,True,2,0,61,61
167466,2019-10-13 00:00:00+03:00,out,False,921818,True,5,0,110,110
167466,2019-10-13 00:00:00+03:00,in,False,-1,True,6,0,283,283
167466,2019-10-13 00:00:00+03:00,in,False,921818,False,14,1845,1958,113
167466,2019-10-13 00:00:00+03:00,out,False,921818,False,36,1446,2021,575
167466,2019-10-14 00:00:00+03:00,in,False,921818,False,44,3985,4348,363
167466,2019-10-14 00:00:00+03:00,out,False,921818,False,31,1250,1657,407
167466,2019-10-14 00:00:00+03:00,out,False,921818,True,7,0,135,135
167466,2019-10-14 00:00:00+03:00,in,False,-1,True,5,0,101,101
167466,2019-10-14 00:00:00+03:00,out,False,921818,False,31,1250,1657,407
167466,2019-10-14 00:00:00+03:00,in,False,-1,True,5,0,101,101
167466,2019-10-15 00:00:00+03:00,out,False,921818,True,10,0,210,210
167466,2019-10-15 00:00:00+03:00,in,False,-1,True,1,0,4,4
167466,2019-10-15 00:00:00+03:00,in,False,921818,False,33,3321,3563,242
167466,2019-10-15 00:00:00+03:00,in,False,921818,True,1,0,9,9
167466,2019-10-15 00:00:00+03:00,out,False,921818,False,22,528,863,335
167466,2019-10-16 00:00:00+03:00,in,False,-1,True,1,0,38,38
167466,2019-10-16 00:00:00+03:00,in,False,921818,True,1,0,6,6
167466,2019-10-16 00:00:00+03:00,in,False,921818,False,36,3290,3630,340
167466,2019-10-16 00:00:00+03:00,out,False,921818,False,25,614,989,375
167466,2019-10-16 00:00:00+03:00,out,False,921818,True,11,0,137,137
167466,2019-10-16 00:00:00+03:00,out,True,921818,True,9,0,18,18
167466,2019-10-16 00:00:00+03:00,in,False,921818,False,36,3290,3630,340
167466,2019-10-17 00:00:00+03:00,in,False,-1,True,8,0,284,284
167466,2019-10-17 00:00:00+03:00,in,False,921818,False,45,5193,5640,447
167466,2019-10-17 00:00:00+03:00,out,False,921818,False,40,1480,2046,566
167466,2019-10-17 00:00:00+03:00,out,False,921818,True,15,0,286,286
167466,2019-10-18 00:00:00+03:00,out,False,921818,True,3,0,55,55
167466,2019-10-18 00:00:00+03:00,in,False,921818,False,39,3520,3802,282
167466,2019-10-18 00:00:00+03:00,out,False,921818,False,4,191,235,44
167466,2019-10-18 00:00:00+03:00,in,False,-1,True,2,0,52,52
167466,2019-10-19 00:00:00+03:00,in,False,-1,True,7,0,239,239
167466,2019-10-19 00:00:00+03:00,out,False,921818,False,22,877,1246,369
167466,2019-10-19 00:00:00+03:00,out,False,921818,True,6,0,130,130
167466,2019-10-19 00:00:00+03:00,in,False,921818,False,13,1159,1280,121
167466,2019-10-20 00:00:00+03:00,in,False,921818,False,13,798,942,144
167466,2019-10-20 00:00:00+03:00,out,False,921818,False,24,671,1018,347
167466,2019-10-20 00:00:00+03:00,in,False,-1,True,6,0,187,187
167466,2019-10-20 00:00:00+03:00,out,False,921818,True,9,0,264,264
167466,2019-10-21 00:00:00+03:00,in,False,921818,True,1,1,6,5
167466,2019-10-21 00:00:00+03:00,in,False,921818,False,51,4407,4836,429
167466,2019-10-21 00:00:00+03:00,out,False,921818,True,13,0,307,307
167466,2019-10-21 00:00:00+03:00,out,False,921818,False,48,1851,2600,749
167466,2019-10-21 00:00:00+03:00,in,False,-1,True,8,0,309,309
167466,2019-10-21 00:00:00+03:00,out,False,921818,True,13,0,307,307
167466,2019-10-21 00:00:00+03:00,in,False,921818,False,51,4407,4836,429
167466,2019-10-22 00:00:00+03:00,out,False,921818,False,37,1248,1817,569
167466,2019-10-22 00:00:00+03:00,out,False,921818,True,15,0,321,321
167466,2019-10-22 00:00:00+03:00,in,False,921818,False,42,4018,4345,327
167466,2019-10-22 00:00:00+03:00,in,False,921818,True,1,0,7,7
167466,2019-10-22 00:00:00+03:00,in,False,-1,True,9,0,318,318
167466,2019-10-23 00:00:00+03:00,out,False,921818,True,12,0,173,173
167466,2019-10-23 00:00:00+03:00,out,False,921818,False,37,1061,1620,559
167466,2019-10-23 00:00:00+03:00,in,False,-1,True,6,0,183,183
167466,2019-10-23 00:00:00+03:00,in,False,921818,False,39,3228,3559,331
167466,2019-10-23 00:00:00+03:00,out,False,921818,True,12,0,173,173
167466,2019-10-24 00:00:00+03:00,in,False,-1,True,4,0,96,96
167466,2019-10-24 00:00:00+03:00,out,False,921818,True,14,0,364,364
167466,2019-10-24 00:00:00+03:00,out,False,921818,False,33,628,1078,450
167466,2019-10-24 00:00:00+03:00,in,False,921818,False,41,4593,4883,290
167466,2019-10-24 00:00:00+03:00,out,False,921818,True,14,0,364,364
167466,2019-10-25 00:00:00+03:00,out,True,921818,True,2,0,4,4
167466,2019-10-25 00:00:00+03:00,out,False,921818,False,29,1356,1783,427
167466,2019-10-25 00:00:00+03:00,in,False,921818,False,33,3625,3898,273
167466,2019-10-25 00:00:00+03:00,in,False,-1,True,8,0,297,297
167466,2019-10-25 00:00:00+03:00,out,False,921818,True,10,0,199,199
167466,2019-10-26 00:00:00+03:00,in,False,921818,False,10,838,906,68
167466,2019-10-26 00:00:00+03:00,out,False,921818,False,13,380,619,239
167466,2019-10-26 00:00:00+03:00,in,False,-1,True,8,0,201,201
167466,2019-10-26 00:00:00+03:00,out,False,921818,True,1,0,31,31
167466,2019-10-27 00:00:00+03:00,in,False,-1,True,3,0,70,70
167466,2019-10-27 00:00:00+03:00,out,False,921818,True,12,0,293,293
167466,2019-10-27 00:00:00+03:00,out,False,921818,False,28,571,1031,460
167466,2019-10-27 00:00:00+03:00,in,False,921818,False,19,1024,1195,171
167466,2019-10-28 00:00:00+03:00,out,False,921818,False,36,1225,1783,558
167466,2019-10-28 00:00:00+03:00,out,False,921818,True,10,0,197,197
167466,2019-10-28 00:00:00+03:00,in,False,-1,True,6,0,133,133
167466,2019-10-28 00:00:00+03:00,in,False,921818,False,36,2826,3102,276
167466,2019-10-29 00:00:00+03:00,out,False,921818,False,33,912,1420,508
167466,2019-10-29 00:00:00+03:00,out,False,921818,True,12,0,142,142
167466,2019-10-29 00:00:00+03:00,in,False,-1,True,2,0,44,44
167466,2019-10-29 00:00:00+03:00,out,True,921814,True,1,0,2,2
167466,2019-10-29 00:00:00+03:00,in,False,921818,False,40,3141,3488,347
167466,2019-10-30 00:00:00+03:00,in,False,921818,False,42,3040,3369,329
167466,2019-10-30 00:00:00+03:00,in,False,-1,True,3,0,70,70
167466,2019-10-30 00:00:00+03:00,out,False,921818,False,30,1036,1490,454
167466,2019-10-30 00:00:00+03:00,out,False,921818,True,9,0,166,166
167466,2019-10-30 00:00:00+03:00,in,False,921818,False,42,3040,3369,329
167466,2019-10-31 00:00:00+03:00,out,False,921818,False,30,830,1198,368
167466,2019-10-31 00:00:00+03:00,in,False,921818,False,24,1530,1752,222
167466,2019-10-31 00:00:00+03:00,in,False,-1,True,2,0,40,40
167466,2019-10-31 00:00:00+03:00,out,True,921818,True,1,0,0,0
167466,2019-10-31 00:00:00+03:00,out,False,921818,True,10,0,236,236
167466,2019-10-31 00:00:00+03:00,out,False,921814,False,1,51,70,19
167466,2019-10-31 00:00:00+03:00,out,False,921814,True,1,0,6,6
167466,2019-10-31 00:00:00+03:00,out,False,921818,False,30,830,1198,368
167466,2019-10-31 00:00:00+03:00,out,False,921814,False,1,51,70,19
167466,2019-11-01 00:00:00+03:00,out,False,921818,True,2,0,32,32
167466,2019-11-01 00:00:00+03:00,out,False,921818,False,14,422,605,183
167466,2019-11-01 00:00:00+03:00,in,False,-1,True,2,0,49,49
167466,2019-11-01 00:00:00+03:00,in,False,921818,False,17,1605,1778,173
167466,2019-11-02 00:00:00+03:00,out,False,921818,True,2,0,44,44
167466,2019-11-02 00:00:00+03:00,out,False,921818,False,12,266,469,203
167466,2019-11-02 00:00:00+03:00,in,False,-1,True,6,0,174,174
167466,2019-11-02 00:00:00+03:00,in,False,921818,False,6,658,727,69
167466,2019-11-02 00:00:00+03:00,out,False,921818,True,2,0,44,44
167466,2019-11-03 00:00:00+03:00,in,False,921818,False,15,632,818,186
167466,2019-11-03 00:00:00+03:00,out,False,921818,True,7,0,188,188
167466,2019-11-03 00:00:00+03:00,in,False,-1,True,3,0,111,111
167466,2019-11-03 00:00:00+03:00,out,False,921818,False,26,632,1040,408
167466,2019-11-04 00:00:00+03:00,out,False,921818,True,11,0,321,321
167466,2019-11-04 00:00:00+03:00,out,False,921818,False,24,564,1010,446
167466,2019-11-04 00:00:00+03:00,in,False,-1,True,4,0,139,139
167466,2019-11-04 00:00:00+03:00,in,False,921818,False,21,1497,1773,276
167466,2019-11-05 00:00:00+03:00,out,False,921818,False,14,335,520,185
167466,2019-11-05 00:00:00+03:00,in,False,921818,False,33,2937,3379,442
167466,2019-11-05 00:00:00+03:00,in,False,-1,True,6,0,133,133
167466,2019-11-05 00:00:00+03:00,out,False,921818,True,6,0,144,144
167466,2019-11-06 00:00:00+03:00,in,False,921818,True,1,1,18,17
167466,2019-11-06 00:00:00+03:00,out,False,921818,False,36,892,1447,555
167466,2019-11-06 00:00:00+03:00,out,False,921818,True,11,0,175,175
167466,2019-11-06 00:00:00+03:00,out,True,921818,True,1,0,0,0
167466,2019-11-06 00:00:00+03:00,in,False,921818,False,43,2827,3382,555
167466,2019-11-06 00:00:00+03:00,in,False,-1,True,3,0,120,120
167466,2019-11-06 00:00:00+03:00,in,False,921818,True,1,1,18,17
167466,2019-11-07 00:00:00+03:00,out,False,921818,True,19,0,386,386
167466,2019-11-07 00:00:00+03:00,in,False,921818,False,41,2908,3350,442
167466,2019-11-07 00:00:00+03:00,in,False,-1,True,7,0,168,168
167466,2019-11-07 00:00:00+03:00,out,False,921818,False,26,701,1067,366
167466,2019-11-07 00:00:00+03:00,in,False,921818,True,1,0,27,27
167466,2019-11-08 00:00:00+03:00,out,False,921818,False,15,697,945,248
167466,2019-11-08 00:00:00+03:00,out,False,921818,True,4,0,50,50
167466,2019-11-08 00:00:00+03:00,in,False,921818,False,21,1991,2235,244
167466,2019-11-08 00:00:00+03:00,in,False,-1,True,2,0,36,36
167466,2019-11-08 00:00:00+03:00,in,False,-1,True,2,0,36,36
167466,2019-11-09 00:00:00+03:00,out,False,921818,False,12,286,475,189
167466,2019-11-09 00:00:00+03:00,in,False,921818,False,6,840,917,77
167466,2019-11-09 00:00:00+03:00,out,False,921818,True,2,0,58,58
167466,2019-11-09 00:00:00+03:00,in,False,-1,True,4,0,168,168
167466,2019-11-10 00:00:00+03:00,in,False,921818,False,14,1275,1394,119
167466,2019-11-10 00:00:00+03:00,out,False,921818,False,32,1288,1789,501
167466,2019-11-10 00:00:00+03:00,out,False,921818,True,11,0,371,371
167466,2019-11-10 00:00:00+03:00,in,False,-1,True,5,0,165,165
167466,2019-11-11 00:00:00+03:00,in,False,921818,False,46,3964,4480,516
167466,2019-11-11 00:00:00+03:00,out,False,921818,True,8,0,192,192
167466,2019-11-11 00:00:00+03:00,out,False,921818,False,38,954,1462,508
167466,2019-11-11 00:00:00+03:00,in,False,-1,True,3,0,75,75
167466,2019-11-11 00:00:00+03:00,out,False,921818,True,8,0,192,192
167466,2019-11-12 00:00:00+03:00,in,False,921818,False,36,2956,3367,411
167466,2019-11-12 00:00:00+03:00,out,False,921814,True,1,0,50,50
167466,2019-11-12 00:00:00+03:00,in,False,-1,True,6,0,229,229
167466,2019-11-12 00:00:00+03:00,out,False,921818,True,20,0,301,301
167466,2019-11-12 00:00:00+03:00,out,False,921818,False,24,645,1031,386
167466,2019-11-12 00:00:00+03:00,out,False,921814,True,1,0,50,50
167466,2019-11-13 00:00:00+03:00,in,False,921818,False,46,3034,3594,560
167466,2019-11-13 00:00:00+03:00,in,False,-1,True,6,0,170,170
167466,2019-11-13 00:00:00+03:00,out,False,921818,True,22,0,220,220
167466,2019-11-13 00:00:00+03:00,out,False,921818,False,24,734,1076,342
167466,2019-11-14 00:00:00+03:00,out,True,921818,True,2,0,4,4
167466,2019-11-14 00:00:00+03:00,out,False,921818,False,21,850,1198,348
167466,2019-11-14 00:00:00+03:00,out,False,921814,False,3,74,118,44
167466,2019-11-14 00:00:00+03:00,in,False,-1,True,8,0,180,180
167466,2019-11-14 00:00:00+03:00,out,False,921814,True,3,0,65,65
167466,2019-11-14 00:00:00+03:00,in,False,921818,False,46,3861,4487,626
167466,2019-11-14 00:00:00+03:00,out,False,921818,True,16,0,241,241
167466,2019-11-14 00:00:00+03:00,out,False,921814,False,3,74,118,44
167466,2019-11-15 00:00:00+03:00,in,False,921818,False,38,2380,2936,556
167466,2019-11-15 00:00:00+03:00,out,True,921818,True,1,0,2,2
167466,2019-11-15 00:00:00+03:00,out,False,921818,False,20,715,1017,302
167466,2019-11-15 00:00:00+03:00,in,False,-1,True,2,0,70,70
167466,2019-11-15 00:00:00+03:00,out,False,921818,True,5,0,147,147
167466,2019-11-16 00:00:00+03:00,out,False,921818,False,13,181,428,247
167466,2019-11-16 00:00:00+03:00,in,False,-1,True,7,0,212,212
167466,2019-11-16 00:00:00+03:00,in,False,921818,False,14,1077,1252,175
167466,2019-11-16 00:00:00+03:00,out,False,921818,True,5,0,136,136
167466,2019-11-17 00:00:00+03:00,out,False,921818,True,15,0,424,424
167466,2019-11-17 00:00:00+03:00,out,False,921818,False,25,477,904,427
167466,2019-11-17 00:00:00+03:00,in,False,-1,True,5,0,120,120
167466,2019-11-17 00:00:00+03:00,in,False,921818,False,17,1055,1216,161
167466,2019-11-18 00:00:00+03:00,out,False,921818,True,13,0,300,300
167466,2019-11-18 00:00:00+03:00,out,False,921818,False,30,633,1138,505
167466,2019-11-18 00:00:00+03:00,in,False,-1,True,10,0,300,300
167466,2019-11-18 00:00:00+03:00,in,False,921818,False,49,3763,4396,633
167466,2019-11-19 00:00:00+03:00,in,False,921818,False,40,2843,3369,526
167466,2019-11-19 00:00:00+03:00,in,False,-1,True,5,0,125,125
167466,2019-11-19 00:00:00+03:00,out,False,921818,True,8,0,174,174
167466,2019-11-19 00:00:00+03:00,out,False,921818,False,34,979,1478,499
167466,2019-11-19 00:00:00+03:00,in,False,921818,False,40,2843,3369,526
167466,2019-11-20 00:00:00+03:00,in,False,921818,False,40,2698,3184,486
167466,2019-11-20 00:00:00+03:00,out,False,921818,False,31,1197,1665,468
167466,2019-11-20 00:00:00+03:00,out,False,921818,True,8,0,224,224
167466,2019-11-20 00:00:00+03:00,in,False,-1,True,8,0,276,276
167466,2019-11-21 00:00:00+03:00,in,False,921818,True,1,1,25,24
167466,2019-11-21 00:00:00+03:00,in,False,-1,True,6,0,186,186
167466,2019-11-21 00:00:00+03:00,in,False,921818,False,36,3142,3568,426
167466,2019-11-21 00:00:00+03:00,out,False,921818,False,34,1156,1649,493
167466,2019-11-21 00:00:00+03:00,out,False,921818,True,5,0,95,95
167466,2019-11-22 00:00:00+03:00,in,False,921818,False,26,2290,2597,307
167466,2019-11-22 00:00:00+03:00,out,False,921818,True,4,0,79,79
167466,2019-11-22 00:00:00+03:00,out,False,921818,False,13,401,539,138
167466,2019-11-22 00:00:00+03:00,in,False,921818,True,2,0,31,31
167466,2019-11-22 00:00:00+03:00,in,False,-1,True,3,0,57,57
167466,2019-11-23 00:00:00+03:00,in,False,-1,True,6,0,212,212
167466,2019-11-23 00:00:00+03:00,in,False,921818,False,7,514,584,70
167466,2019-11-23 00:00:00+03:00,out,False,921818,False,1,21,41,20
167466,2019-11-24 00:00:00+03:00,out,False,921818,True,15,0,371,371
167466,2019-11-24 00:00:00+03:00,out,False,921818,False,37,961,1564,603
167466,2019-11-24 00:00:00+03:00,in,False,921818,False,12,845,994,149
167466,2019-11-24 00:00:00+03:00,in,False,-1,True,8,0,230,230
167466,2019-11-24 00:00:00+03:00,in,False,-1,True,8,0,230,230
167466,2019-11-25 00:00:00+03:00,in,False,921818,False,41,3311,3895,584
167466,2019-11-25 00:00:00+03:00,out,False,921818,True,6,0,124,124
167466,2019-11-25 00:00:00+03:00,out,False,921818,False,27,576,987,411
167466,2019-11-25 00:00:00+03:00,in,False,-1,True,4,0,68,68
167466,2019-11-25 00:00:00+03:00,out,False,921818,False,27,576,987,411
167466,2019-11-26 00:00:00+03:00,in,False,-1,True,7,0,220,220
167466,2019-11-26 00:00:00+03:00,in,False,921818,False,52,3637,4418,781
167466,2019-11-26 00:00:00+03:00,out,False,921818,False,31,957,1387,430
167466,2019-11-26 00:00:00+03:00,out,False,921818,True,11,0,255,255
167466,2019-11-26 00:00:00+03:00,out,False,921818,True,11,0,255,255
167466,2019-11-27 00:00:00+03:00,out,False,921818,True,11,0,243,243
167466,2019-11-27 00:00:00+03:00,out,True,921818,True,1,0,2,2
167466,2019-11-27 00:00:00+03:00,in,False,-1,True,2,0,95,95
167466,2019-11-27 00:00:00+03:00,out,False,921818,False,41,1111,1714,603
167466,2019-11-27 00:00:00+03:00,in,False,921818,False,40,2976,3457,481
167466,2019-11-28 00:00:00+03:00,in,False,921818,False,37,2385,2761,376
167466,2019-11-28 00:00:00+03:00,out,False,921818,True,6,0,124,124
167466,2019-11-28 00:00:00+03:00,in,False,-1,True,4,0,89,89
167466,2019-11-28 00:00:00+03:00,out,False,921818,False,36,972,1480,508
167471,2019-09-24 00:00:00+03:00,in,False,-1,True,1,0,2,2
167471,2019-10-09 00:00:00+03:00,in,False,-1,True,1,0,2,2
167471,2019-10-23 00:00:00+03:00,in,False,-1,True,1,0,10,10
167471,2019-10-23 00:00:00+03:00,out,True,944644,True,2,0,0,0
167471,2019-10-23 00:00:00+03:00,out,True,944648,True,2,0,0,0
167471,2019-10-23 00:00:00+03:00,out,False,944648,True,1,0,0,0
167471,2019-10-23 00:00:00+03:00,in,False,944644,False,2,52,151,99
167471,2019-10-23 00:00:00+03:00,out,True,944646,True,1,0,0,0
167471,2019-10-23 00:00:00+03:00,out,False,944648,True,1,0,0,0
167471,2019-10-23 00:00:00+03:00,out,True,944648,True,2,0,0,0
167471,2019-10-25 00:00:00+03:00,in,False,-1,True,2,0,4,4
167471,2019-10-25 00:00:00+03:00,out,False,944644,True,1,0,0,0
167471,2019-10-28 00:00:00+03:00,out,True,944646,True,1,0,0,0
167471,2019-10-28 00:00:00+03:00,in,False,-1,True,2,0,4,4
167471,2019-10-28 00:00:00+03:00,out,False,944646,True,1,0,0,0
167471,2019-10-28 00:00:00+03:00,out,True,944646,True,1,0,0,0
167471,2019-10-30 00:00:00+03:00,out,False,944646,True,1,0,0,0
167471,2019-10-31 00:00:00+03:00,out,False,944646,True,3,0,22,22
167471,2019-10-31 00:00:00+03:00,in,False,944648,False,2,26,68,42
167471,2019-10-31 00:00:00+03:00,out,False,944644,True,1,0,22,22
167471,2019-10-31 00:00:00+03:00,in,False,-1,True,6,0,190,190
167471,2019-10-31 00:00:00+03:00,out,False,944648,True,1,0,1,1
167471,2019-10-31 00:00:00+03:00,in,False,944646,False,1,27,37,10
167471,2019-11-01 00:00:00+03:00,out,False,944646,True,1,0,8,8
167471,2019-11-01 00:00:00+03:00,out,False,944646,False,1,138,139,1
167471,2019-11-01 00:00:00+03:00,in,False,944646,False,3,246,276,30
167471,2019-11-01 00:00:00+03:00,in,False,-1,True,2,0,72,72
167471,2019-11-05 00:00:00+03:00,out,False,944644,False,7,598,741,143
167471,2019-11-05 00:00:00+03:00,out,True,944644,True,1,0,0,0
167471,2019-11-05 00:00:00+03:00,out,False,944644,True,1,0,54,54
167471,2019-11-05 00:00:00+03:00,in,False,-1,True,1,0,31,31
167471,2019-11-05 00:00:00+03:00,out,False,944646,False,3,201,243,42
167471,2019-11-05 00:00:00+03:00,out,True,944648,False,1,94,100,6
167471,2019-11-05 00:00:00+03:00,in,False,944646,False,1,100,108,8
167471,2019-11-05 00:00:00+03:00,out,True,944648,True,2,0,46,46
167471,2019-11-05 00:00:00+03:00,out,False,944646,True,1,0,42,42
167471,2019-11-05 00:00:00+03:00,out,False,944646,True,1,0,42,42
167471,2019-11-06 00:00:00+03:00,out,False,952656,False,4,54,83,29
167471,2019-11-06 00:00:00+03:00,out,False,944644,True,1,0,40,40
167471,2019-11-06 00:00:00+03:00,out,False,-1,True,1,0,1,1
167471,2019-11-06 00:00:00+03:00,out,False,944646,False,9,712,800,88
167471,2019-11-06 00:00:00+03:00,out,False,944646,True,2,0,43,43
167471,2019-11-06 00:00:00+03:00,out,True,944646,False,1,18,21,3
167471,2019-11-06 00:00:00+03:00,out,True,952656,False,2,163,176,13
167471,2019-11-06 00:00:00+03:00,in,False,944646,False,2,213,233,20
167471,2019-11-06 00:00:00+03:00,out,False,952656,True,1,0,8,8
167471,2019-11-07 00:00:00+03:00,out,True,952656,False,1,12,18,6
167471,2019-11-07 00:00:00+03:00,out,False,944646,True,3,0,23,23
167471,2019-11-07 00:00:00+03:00,in,False,944646,False,3,394,419,25
167471,2019-11-07 00:00:00+03:00,in,False,944644,False,1,139,165,26
167471,2019-11-07 00:00:00+03:00,in,False,-1,True,4,0,156,156
167471,2019-11-07 00:00:00+03:00,out,False,944644,False,2,185,227,42
167471,2019-11-07 00:00:00+03:00,out,False,944646,False,10,870,1009,139
167471,2019-11-08 00:00:00+03:00,out,False,952656,True,1,0,50,50
167471,2019-11-08 00:00:00+03:00,in,False,944646,False,3,339,365,26
167471,2019-11-08 00:00:00+03:00,out,False,944646,True,2,0,15,15
167471,2019-11-08 00:00:00+03:00,out,False,944646,False,9,616,740,124
167471,2019-11-08 00:00:00+03:00,out,False,944646,False,9,616,740,124
167471,2019-11-09 00:00:00+03:00,in,False,944646,False,1,398,410,12
167471,2019-11-11 00:00:00+03:00,out,False,944646,True,1,0,39,39
167471,2019-11-11 00:00:00+03:00,out,False,952656,True,3,0,18,18
167471,2019-11-11 00:00:00+03:00,in,False,944646,False,6,894,940,46
167471,2019-11-11 00:00:00+03:00,out,False,944644,False,2,280,301,21
167471,2019-11-11 00:00:00+03:00,out,False,944646,False,13,654,846,192
167471,2019-11-11 00:00:00+03:00,in,False,-1,True,3,0,109,109
167471,2019-11-11 00:00:00+03:00,out,False,952656,False,1,284,286,2
167471,2019-11-11 00:00:00+03:00,out,False,952656,True,3,0,18,18
167471,2019-11-11 00:00:00+03:00,in,False,944646,False,6,894,940,46
167471,2019-11-12 00:00:00+03:00,out,False,944646,True,7,0,223,223
167471,2019-11-12 00:00:00+03:00,out,False,944646,False,15,910,1079,169
167471,2019-11-12 00:00:00+03:00,in,False,944646,False,12,963,1064,101
167471,2019-11-12 00:00:00+03:00,in,False,-1,True,1,0,22,22
167471,2019-11-12 00:00:00+03:00,out,True,952656,False,1,36,47,11
167471,2019-11-12 00:00:00+03:00,out,True,944648,False,3,118,136,18
167471,2019-11-12 00:00:00+03:00,out,False,944644,False,3,102,130,28
167471,2019-11-12 00:00:00+03:00,in,False,944644,False,2,117,152,35
167471,2019-11-13 00:00:00+03:00,out,True,952656,False,1,11,17,6
167471,2019-11-13 00:00:00+03:00,out,False,944644,True,1,0,43,43
167471,2019-11-13 00:00:00+03:00,in,False,944646,False,14,1151,1259,108
167471,2019-11-13 00:00:00+03:00,out,False,944644,False,7,208,298,90
167471,2019-11-13 00:00:00+03:00,in,False,944644,False,1,166,189,23
167471,2019-11-13 00:00:00+03:00,out,True,944648,False,1,19,28,9
167471,2019-11-13 00:00:00+03:00,out,False,944646,True,4,0,122,122
167471,2019-11-13 00:00:00+03:00,out,False,944646,False,21,2089,2318,229
167471,2019-11-13 00:00:00+03:00,in,False,-1,True,2,0,3,3
167471,2019-11-14 00:00:00+03:00,out,False,944646,False,11,585,756,171
167471,2019-11-14 00:00:00+03:00,out,False,944644,False,9,554,715,161
167471,2019-11-14 00:00:00+03:00,out,False,944646,True,3,0,103,103
167471,2019-11-14 00:00:00+03:00,in,False,944646,False,16,1647,1770,123
167471,2019-11-14 00:00:00+03:00,in,False,944644,False,1,148,169,21
167471,2019-11-14 00:00:00+03:00,out,False,944644,True,2,0,61,61
167471,2019-11-14 00:00:00+03:00,in,False,944646,False,16,1647,1770,123
167471,2019-11-15 00:00:00+03:00,in,False,944646,False,7,391,451,60
167471,2019-11-15 00:00:00+03:00,in,False,944648,False,1,91,124,33
167471,2019-11-15 00:00:00+03:00,out,False,944644,True,4,0,96,96
167471,2019-11-15 00:00:00+03:00,out,False,944644,False,11,702,857,155
167471,2019-11-15 00:00:00+03:00,out,False,944646,False,4,234,276,42
167471,2019-11-15 00:00:00+03:00,in,False,-1,True,1,0,6,6
167471,2019-11-15 00:00:00+03:00,out,True,944648,False,2,302,314,12
167471,2019-11-15 00:00:00+03:00,out,True,944648,True,1,0,28,28
167471,2019-11-16 00:00:00+03:00,out,False,944646,True,6,0,168,168
167471,2019-11-16 00:00:00+03:00,in,False,944644,False,3,232,302,70
167471,2019-11-16 00:00:00+03:00,out,False,944646,False,7,472,554,82
167471,2019-11-16 00:00:00+03:00,in,False,944646,False,7,670,717,47
167471,2019-11-16 00:00:00+03:00,in,False,944644,False,3,232,302,70
167471,2019-11-18 00:00:00+03:00,in,False,944644,False,2,129,180,51
167471,2019-11-18 00:00:00+03:00,out,True,952656,False,1,12,18,6
167471,2019-11-18 00:00:00+03:00,out,False,944646,True,4,0,49,49
167471,2019-11-18 00:00:00+03:00,out,False,952656,False,3,453,469,16
167471,2019-11-18 00:00:00+03:00,out,True,944644,False,1,41,44,3
167471,2019-11-18 00:00:00+03:00,in,False,-1,True,1,0,47,47
167471,2019-11-18 00:00:00+03:00,out,False,944644,False,3,294,327,33
167471,2019-11-18 00:00:00+03:00,in,False,952656,False,1,84,92,8
167471,2019-11-18 00:00:00+03:00,out,False,944646,False,10,748,890,142
167471,2019-11-18 00:00:00+03:00,in,False,944646,False,7,804,851,47
167471,2019-11-18 00:00:00+03:00,in,False,-1,True,1,0,47,47
167471,2019-11-19 00:00:00+03:00,out,False,944646,False,18,1112,1340,228
167471,2019-11-19 00:00:00+03:00,in,False,-1,True,3,0,116,116
167471,2019-11-19 00:00:00+03:00,out,False,944646,True,9,0,192,192
167471,2019-11-19 00:00:00+03:00,in,False,952656,False,1,65,72,7
167471,2019-11-19 00:00:00+03:00,out,False,944644,True,2,0,81,81
167471,2019-11-19 00:00:00+03:00,in,False,944646,False,20,2156,2304,148
167471,2019-11-19 00:00:00+03:00,out,True,952656,True,2,0,82,82
167471,2019-11-19 00:00:00+03:00,out,True,944648,False,1,14,31,17
167471,2019-11-19 00:00:00+03:00,out,False,944644,False,6,404,472,68
167471,2019-11-19 00:00:00+03:00,in,False,944644,False,4,536,609,73
167471,2019-11-20 00:00:00+03:00,out,False,944644,True,4,0,138,138
167471,2019-11-20 00:00:00+03:00,in,False,944646,False,9,1041,1114,73
167471,2019-11-20 00:00:00+03:00,out,False,944644,False,3,300,325,25
167471,2019-11-20 00:00:00+03:00,out,True,944648,False,1,47,57,10
167471,2019-11-20 00:00:00+03:00,in,False,-1,True,3,0,119,119
167471,2019-11-20 00:00:00+03:00,in,False,944648,False,2,152,275,123
167471,2019-11-20 00:00:00+03:00,out,False,952656,True,1,0,11,11
167471,2019-11-20 00:00:00+03:00,out,False,944646,True,2,0,70,70
167471,2019-11-20 00:00:00+03:00,out,False,944646,False,10,587,742,155
167471,2019-11-20 00:00:00+03:00,in,False,944644,False,2,178,210,32
167471,2019-11-21 00:00:00+03:00,out,False,952656,False,2,402,415,13
167471,2019-11-21 00:00:00+03:00,in,False,944644,False,1,220,241,21
167471,2019-11-21 00:00:00+03:00,in,False,-1,True,1,0,22,22
167471,2019-11-21 00:00:00+03:00,in,False,944646,False,20,2827,2987,160
167471,2019-11-21 00:00:00+03:00,out,False,944648,False,1,105,116,11
167471,2019-11-21 00:00:00+03:00,out,True,952656,False,1,44,55,11
167471,2019-11-21 00:00:00+03:00,out,False,944646,True,4,0,63,63
167471,2019-11-21 00:00:00+03:00,out,False,944644,False,11,1037,1159,122
167471,2019-11-21 00:00:00+03:00,out,True,944644,False,1,24,26,2
167471,2019-11-21 00:00:00+03:00,out,False,944648,True,1,0,0,0
167471,2019-11-21 00:00:00+03:00,out,False,944646,False,12,501,689,188
167471,2019-11-21 00:00:00+03:00,out,True,944648,False,2,46,80,34
167471,2019-11-22 00:00:00+03:00,out,False,944646,False,12,686,819,133
167471,2019-11-22 00:00:00+03:00,in,False,944646,True,1,0,10,10
167471,2019-11-22 00:00:00+03:00,in,False,944644,False,1,159,181,22
167471,2019-11-22 00:00:00+03:00,out,False,944648,False,3,266,324,58
167471,2019-11-22 00:00:00+03:00,out,False,944646,True,1,0,22,22
167471,2019-11-22 00:00:00+03:00,out,False,944644,False,16,1467,1690,223
167471,2019-11-22 00:00:00+03:00,out,True,944648,True,1,0,0,0
167471,2019-11-22 00:00:00+03:00,in,False,-1,True,3,0,106,106
167471,2019-11-22 00:00:00+03:00,in,False,944646,False,18,1960,2101,141
167471,2019-11-22 00:00:00+03:00,out,True,944644,False,1,39,42,3
167471,2019-11-22 00:00:00+03:00,out,False,944644,True,3,0,118,118
167471,2019-11-22 00:00:00+03:00,out,False,944648,True,3,0,18,18
167471,2019-11-22 00:00:00+03:00,out,False,944648,True,3,0,18,18
167471,2019-11-23 00:00:00+03:00,out,False,944646,False,6,300,377,77
167471,2019-11-23 00:00:00+03:00,in,False,944646,False,4,238,271,33
167471,2019-11-23 00:00:00+03:00,out,False,944646,True,2,0,31,31
167471,2019-11-24 00:00:00+03:00,in,False,-1,True,2,0,121,121
167471,2019-11-25 00:00:00+03:00,out,False,944644,False,1,11,25,14
167471,2019-11-25 00:00:00+03:00,in,False,952656,False,1,396,405,9
167471,2019-11-25 00:00:00+03:00,out,True,944646,True,1,0,24,24
167471,2019-11-25 00:00:00+03:00,out,False,944646,False,29,2129,2517,388
167471,2019-11-25 00:00:00+03:00,in,False,-1,True,1,0,91,91
167471,2019-11-25 00:00:00+03:00,in,False,944644,False,3,505,572,67
167471,2019-11-25 00:00:00+03:00,out,True,952656,False,1,16,23,7
167471,2019-11-25 00:00:00+03:00,out,False,944646,True,1,0,55,55
167471,2019-11-25 00:00:00+03:00,in,False,944646,False,15,1911,2033,122
167471,2019-11-25 00:00:00+03:00,in,False,944646,False,15,1911,2033,122
167471,2019-11-26 00:00:00+03:00,out,False,944646,True,6,0,202,202
167471,2019-11-26 00:00:00+03:00,out,False,944644,False,3,81,136,55
167471,2019-11-26 00:00:00+03:00,out,False,952656,False,3,325,396,71
167471,2019-11-26 00:00:00+03:00,out,False,944648,False,1,124,126,2
167471,2019-11-26 00:00:00+03:00,out,False,944648,True,1,0,60,60
167471,2019-11-26 00:00:00+03:00,in,False,-1,True,1,0,22,22
167471,2019-11-26 00:00:00+03:00,out,True,944648,True,1,0,0,0
167471,2019-11-26 00:00:00+03:00,out,True,952656,False,2,27,43,16
167471,2019-11-26 00:00:00+03:00,out,True,944648,False,6,914,969,55
167471,2019-11-26 00:00:00+03:00,out,False,944646,False,18,882,1142,260
167471,2019-11-26 00:00:00+03:00,out,True,944644,True,1,0,19,19
167471,2019-11-26 00:00:00+03:00,in,False,952656,False,1,264,270,6
167471,2019-11-26 00:00:00+03:00,in,False,944646,False,12,1107,1197,90
167471,2019-11-26 00:00:00+03:00,out,False,944644,True,2,0,60,60
167471,2019-11-27 00:00:00+03:00,out,False,944644,False,9,319,441,122
167471,2019-11-27 00:00:00+03:00,out,False,944646,False,11,627,761,134
167471,2019-11-27 00:00:00+03:00,out,True,944644,False,2,29,36,7
167471,2019-11-27 00:00:00+03:00,in,False,944644,False,1,28,50,22
167471,2019-11-27 00:00:00+03:00,out,False,944646,True,5,0,57,57
167471,2019-11-27 00:00:00+03:00,out,True,944648,False,5,339,386,47
167471,2019-11-27 00:00:00+03:00,in,False,944646,False,13,701,805,104
167471,2019-11-27 00:00:00+03:00,out,False,944644,True,2,0,78,78
167471,2019-11-27 00:00:00+03:00,in,False,944644,False,1,28,50,22
167471,2019-11-27 00:00:00+03:00,out,False,944646,True,5,0,57,57
167471,2019-11-27 00:00:00+03:00,out,False,944644,True,2,0,78,78
167471,2019-11-28 00:00:00+03:00,out,False,944644,True,3,0,100,100
167471,2019-11-28 00:00:00+03:00,out,False,952656,False,2,359,366,7
167471,2019-11-28 00:00:00+03:00,in,False,944644,False,2,206,279,73
167471,2019-11-28 00:00:00+03:00,in,False,-1,True,10,0,239,239
167471,2019-11-28 00:00:00+03:00,in,False,944646,False,24,2831,3342,511
167471,2019-11-28 00:00:00+03:00,out,False,944644,False,16,1007,1265,258
167471,2019-11-28 00:00:00+03:00,out,False,952656,True,4,0,42,42
167471,2019-11-28 00:00:00+03:00,out,True,952656,False,1,14,18,4
167471,2019-11-28 00:00:00+03:00,out,False,944646,False,19,627,915,288
167471,2019-11-28 00:00:00+03:00,out,False,944646,True,12,0,293,293
167471,2019-11-28 00:00:00+03:00,in,False,944646,False,24,2831,3342,511
167471,2019-11-28 00:00:00+03:00,out,False,944646,False,19,627,915,288
167474,2019-09-23 00:00:00+03:00,in,False,913780,False,1,16,37,21
167474,2019-09-23 00:00:00+03:00,in,False,-1,True,28,0,0,0
167474,2019-10-15 00:00:00+03:00,in,False,-1,True,1,0,24,24
167474,2019-10-18 00:00:00+03:00,in,False,-1,True,1,0,23,23
167474,2019-10-22 00:00:00+03:00,in,False,-1,True,7,0,92,92
167474,2019-10-27 00:00:00+03:00,in,False,913780,False,1,12,31,19
167474,2019-10-28 00:00:00+03:00,in,False,913780,False,3,234,283,49
167475,2019-09-19 00:00:00+03:00,out,True,914816,True,1,0,46,46
167475,2019-09-19 00:00:00+03:00,in,False,-1,True,1,0,35,35
167475,2019-09-19 00:00:00+03:00,out,True,914636,False,1,139,162,23
167475,2019-09-19 00:00:00+03:00,in,True,914636,False,1,105,113,8
167475,2019-09-19 00:00:00+03:00,out,False,914816,False,1,315,316,1
167475,2019-09-22 00:00:00+03:00,in,False,-1,True,1,0,6,6
167475,2019-09-23 00:00:00+03:00,out,False,914816,False,1,380,396,16
167475,2019-09-23 00:00:00+03:00,out,True,914636,False,1,282,300,18
167475,2019-09-25 00:00:00+03:00,out,False,914636,True,2,0,16,16
167475,2019-09-25 00:00:00+03:00,out,False,914636,False,1,116,125,9
167475,2019-10-01 00:00:00+03:00,out,False,914816,True,1,0,43,43
167475,2019-10-02 00:00:00+03:00,in,False,914842,False,1,422,455,33
167475,2019-10-02 00:00:00+03:00,out,False,914636,False,4,660,705,45
167475,2019-10-02 00:00:00+03:00,out,False,914636,True,3,0,71,71
167475,2019-10-02 00:00:00+03:00,in,False,914636,False,2,224,244,20
167475,2019-10-07 00:00:00+03:00,out,False,914636,True,1,0,2,2
167475,2019-10-07 00:00:00+03:00,out,False,914636,False,1,32,59,27
167475,2019-10-08 00:00:00+03:00,out,False,914636,False,1,420,431,11
167475,2019-10-09 00:00:00+03:00,out,True,914816,True,1,0,18,18
167475,2019-10-09 00:00:00+03:00,out,False,914816,False,1,848,849,1
167475,2019-10-09 00:00:00+03:00,out,True,930660,False,2,18,39,21
167475,2019-10-09 00:00:00+03:00,out,True,914816,False,1,9,23,14
167475,2019-10-09 00:00:00+03:00,out,True,930660,True,5,0,46,46
167475,2019-10-10 00:00:00+03:00,out,False,930662,False,3,151,199,48
167475,2019-10-10 00:00:00+03:00,out,True,930660,True,1,0,18,18
167475,2019-10-10 00:00:00+03:00,out,False,930660,True,1,0,19,19
167475,2019-10-11 00:00:00+03:00,out,False,930662,False,1,7,27,20
167475,2019-10-15 00:00:00+03:00,out,False,930662,False,8,541,630,89
167475,2019-10-16 00:00:00+03:00,out,False,930662,True,1,0,20,20
167475,2019-10-16 00:00:00+03:00,in,False,914842,False,1,44,54,10
167475,2019-10-16 00:00:00+03:00,out,False,930662,False,3,188,220,32
167475,2019-10-23 00:00:00+03:00,out,False,930662,False,1,333,346,13
167475,2019-10-28 00:00:00+03:00,in,False,914842,False,1,300,317,17
167475,2019-10-28 00:00:00+03:00,out,False,930662,False,1,107,118,11
167475,2019-10-31 00:00:00+03:00,out,False,930662,True,1,0,41,41
167475,2019-11-08 00:00:00+03:00,in,False,914842,False,1,93,108,15
167475,2019-11-13 00:00:00+03:00,out,False,930662,False,1,1,21,20
167475,2019-11-18 00:00:00+03:00,in,False,914842,False,1,255,272,17
167475,2019-11-18 00:00:00+03:00,out,False,930662,False,1,129,141,12
167475,2019-11-20 00:00:00+03:00,out,False,930660,False,2,595,619,24
167475,2019-11-21 00:00:00+03:00,in,False,930660,False,2,660,673,13
167475,2019-11-21 00:00:00+03:00,in,False,-1,True,1,0,26,26
167475,2019-11-21 00:00:00+03:00,out,False,930662,False,2,25,54,29
167475,2019-11-21 00:00:00+03:00,in,False,914842,False,1,624,645,21
167475,2019-11-21 00:00:00+03:00,out,False,930660,True,3,0,160,160
167475,2019-11-21 00:00:00+03:00,out,False,930660,False,1,416,416,0
167475,2019-11-21 00:00:00+03:00,out,False,930660,False,1,416,416,0
167475,2019-11-22 00:00:00+03:00,in,False,930660,False,2,769,782,13
167475,2019-11-22 00:00:00+03:00,out,False,930660,True,1,0,6,6
167475,2019-11-26 00:00:00+03:00,out,False,930660,False,1,240,243,3
167475,2019-11-27 00:00:00+03:00,out,False,930660,False,2,682,689,7
167479,2019-09-19 00:00:00+03:00,in,False,-1,True,3,0,42,42
167479,2019-09-19 00:00:00+03:00,in,False,915556,False,2,17,44,27
167479,2019-09-20 00:00:00+03:00,in,False,-1,True,1,0,5,5
167479,2019-09-21 00:00:00+03:00,in,False,-1,True,4,0,43,43
167479,2019-09-21 00:00:00+03:00,out,False,915556,False,2,1279,1313,34
167479,2019-09-21 00:00:00+03:00,out,True,915556,True,1,0,0,0
167479,2019-09-22 00:00:00+03:00,out,False,915556,False,1,907,921,14
167479,2019-09-22 00:00:00+03:00,out,False,915556,True,2,0,23,23
167479,2019-09-23 00:00:00+03:00,out,False,915556,True,6,0,111,111
167479,2019-09-23 00:00:00+03:00,in,False,-1,True,7,0,46,46
167479,2019-09-23 00:00:00+03:00,in,False,915556,False,5,3029,3071,42
167479,2019-09-23 00:00:00+03:00,out,False,915556,False,8,1488,1630,142
167479,2019-09-23 00:00:00+03:00,in,False,915556,False,5,3029,3071,42
167479,2019-09-24 00:00:00+03:00,out,True,915556,True,2,0,4,4
167479,2019-09-24 00:00:00+03:00,out,False,915556,True,12,0,195,195
167479,2019-09-24 00:00:00+03:00,in,False,915556,False,2,518,537,19
167479,2019-09-24 00:00:00+03:00,out,False,915556,False,14,2497,2710,213
167479,2019-09-24 00:00:00+03:00,in,False,-1,True,6,0,93,93
167479,2019-09-25 00:00:00+03:00,out,False,915556,False,12,964,1097,133
167479,2019-09-25 00:00:00+03:00,in,False,915556,False,2,900,919,19
167479,2019-09-25 00:00:00+03:00,in,False,-1,True,5,0,65,65
167479,2019-09-25 00:00:00+03:00,out,False,915556,True,2,0,50,50
167479,2019-09-25 00:00:00+03:00,out,False,915556,False,12,964,1097,133
167479,2019-09-26 00:00:00+03:00,out,False,915556,True,10,0,211,211
167479,2019-09-26 00:00:00+03:00,out,False,915556,False,9,975,1150,175
167479,2019-09-26 00:00:00+03:00,out,True,915556,True,1,0,0,0
167479,2019-09-26 00:00:00+03:00,in,False,915556,False,4,1189,1223,34
167479,2019-09-27 00:00:00+03:00,out,False,915556,False,9,2105,2262,157
167479,2019-09-27 00:00:00+03:00,in,False,-1,True,20,0,131,131
167479,2019-09-27 00:00:00+03:00,out,False,915556,True,13,0,198,198
167479,2019-09-27 00:00:00+03:00,in,False,915556,False,2,1074,1095,21
167479,2019-09-28 00:00:00+03:00,in,False,-1,True,2,0,12,12
167479,2019-09-28 00:00:00+03:00,out,False,915556,True,5,0,145,145
167479,2019-09-28 00:00:00+03:00,in,False,915556,False,1,97,106,9
167479,2019-09-28 00:00:00+03:00,out,False,915556,False,8,2262,2382,120
167479,2019-09-29 00:00:00+03:00,in,False,-1,True,2,0,23,23
167479,2019-09-29 00:00:00+03:00,out,False,915556,False,5,950,1061,111
167479,2019-09-29 00:00:00+03:00,in,False,915556,False,1,181,184,3
167479,2019-09-29 00:00:00+03:00,out,False,915556,True,11,0,342,342
167479,2019-09-29 00:00:00+03:00,in,False,-1,True,2,0,23,23
167479,2019-09-30 00:00:00+03:00,in,False,915556,False,2,1268,1284,16
167479,2019-09-30 00:00:00+03:00,out,False,915556,False,12,1602,1802,200
167479,2019-09-30 00:00:00+03:00,out,False,915556,True,26,0,587,587
167479,2019-09-30 00:00:00+03:00,in,False,-1,True,8,0,20,20
167479,2019-09-30 00:00:00+03:00,in,False,-1,True,8,0,20,20
167479,2019-10-01 00:00:00+03:00,in,False,915556,False,1,478,483,5
167479,2019-10-01 00:00:00+03:00,out,False,915556,False,7,475,584,109
167479,2019-10-01 00:00:00+03:00,out,False,915556,True,16,0,350,350
167479,2019-10-01 00:00:00+03:00,in,False,-1,True,5,0,21,21
167479,2019-10-02 00:00:00+03:00,in,False,-1,True,3,0,21,21
167479,2019-10-02 00:00:00+03:00,in,False,915556,False,3,922,940,18
167479,2019-10-02 00:00:00+03:00,out,False,915556,False,8,1730,1841,111
167479,2019-10-02 00:00:00+03:00,out,False,915556,True,12,0,271,271
167479,2019-10-03 00:00:00+03:00,in,False,915556,False,3,567,582,15
167479,2019-10-03 00:00:00+03:00,out,False,915556,True,18,0,500,500
167479,2019-10-03 00:00:00+03:00,in,False,-1,True,3,0,20,20
167479,2019-10-03 00:00:00+03:00,out,False,915556,False,8,330,523,193
167479,2019-10-03 00:00:00+03:00,out,False,915556,False,8,330,523,193
167479,2019-10-04 00:00:00+03:00,in,False,915556,False,2,356,366,10
167479,2019-10-04 00:00:00+03:00,in,False,-1,True,11,0,12,12
167479,2019-10-04 00:00:00+03:00,out,False,915556,True,10,0,305,305
167479,2019-10-04 00:00:00+03:00,out,False,915556,False,12,2114,2377,263
167479,2019-10-04 00:00:00+03:00,out,False,915556,False,12,2114,2377,263
167479,2019-10-05 00:00:00+03:00,out,False,915556,True,14,0,356,356
167479,2019-10-05 00:00:00+03:00,out,False,915556,False,5,523,597,74
167479,2019-10-05 00:00:00+03:00,in,False,915556,False,1,21,28,7
167479,2019-10-06 00:00:00+03:00,out,False,915556,False,5,447,509,62
167479,2019-10-06 00:00:00+03:00,out,False,915556,True,8,0,170,170
167479,2019-10-06 00:00:00+03:00,in,False,-1,True,2,0,44,44
167479,2019-10-06 00:00:00+03:00,in,False,915556,False,1,3,7,4
167479,2019-10-07 00:00:00+03:00,in,False,915556,False,6,298,344,46
167479,2019-10-07 00:00:00+03:00,out,False,915556,True,13,0,390,390
167479,2019-10-07 00:00:00+03:00,out,False,915556,False,8,787,951,164
167479,2019-10-07 00:00:00+03:00,in,False,-1,True,8,0,72,72
167479,2019-10-08 00:00:00+03:00,in,False,-1,True,3,0,20,20
167479,2019-10-08 00:00:00+03:00,in,False,915556,False,2,1142,1158,16
167479,2019-10-08 00:00:00+03:00,out,False,915556,False,9,967,1116,149
167479,2019-10-08 00:00:00+03:00,out,False,915556,True,6,0,156,156
167479,2019-10-08 00:00:00+03:00,out,False,915556,True,6,0,156,156
167479,2019-10-09 00:00:00+03:00,in,False,915556,False,1,19,33,14
167479,2019-10-09 00:00:00+03:00,out,False,915556,True,14,0,298,298
167479,2019-10-09 00:00:00+03:00,in,False,-1,True,14,0,253,253
167479,2019-10-09 00:00:00+03:00,out,False,915556,False,21,4231,4557,326
167479,2019-10-10 00:00:00+03:00,in,False,915556,False,2,75,100,25
167479,2019-10-10 00:00:00+03:00,out,True,915556,False,1,14,20,6
167479,2019-10-10 00:00:00+03:00,in,False,-1,True,4,0,26,26
167479,2019-10-10 00:00:00+03:00,out,False,915556,True,21,0,593,593
167479,2019-10-10 00:00:00+03:00,out,False,915556,False,8,1536,1652,116
167479,2019-10-10 00:00:00+03:00,out,False,-1,True,1,0,0,0
167479,2019-10-10 00:00:00+03:00,in,False,915556,False,2,75,100,25
167479,2019-10-11 00:00:00+03:00,out,False,915556,False,9,2574,2776,202
167479,2019-10-11 00:00:00+03:00,out,False,915556,True,23,0,392,392
167479,2019-10-11 00:00:00+03:00,in,False,915556,False,4,1384,1414,30
167479,2019-10-12 00:00:00+03:00,in,False,-1,True,2,0,56,56
167479,2019-10-12 00:00:00+03:00,out,False,915556,False,10,2842,3028,186
167479,2019-10-12 00:00:00+03:00,in,False,915556,False,2,316,326,10
167479,2019-10-12 00:00:00+03:00,out,False,915556,True,17,0,457,457
167479,2019-10-13 00:00:00+03:00,out,False,915556,True,1,0,38,38
167479,2019-10-13 00:00:00+03:00,in,False,-1,True,3,0,65,65
167479,2019-10-13 00:00:00+03:00,out,False,915556,False,1,456,473,17
167479,2019-10-14 00:00:00+03:00,out,False,915556,False,8,1715,1873,158
167479,2019-10-14 00:00:00+03:00,in,False,-1,True,3,0,40,40
167479,2019-10-14 00:00:00+03:00,out,False,915556,True,12,0,419,419
167479,2019-10-14 00:00:00+03:00,in,False,915556,False,2,751,771,20
167479,2019-10-15 00:00:00+03:00,out,False,915556,False,10,845,981,136
167479,2019-10-15 00:00:00+03:00,out,False,915556,True,10,0,243,243
167479,2019-10-15 00:00:00+03:00,in,False,915556,False,3,590,604,14
167479,2019-10-15 00:00:00+03:00,in,False,-1,True,5,0,45,45
167479,2019-10-16 00:00:00+03:00,out,False,915556,False,12,3508,3711,203
167479,2019-10-16 00:00:00+03:00,out,False,915556,True,10,0,230,230
167479,2019-10-16 00:00:00+03:00,in,False,-1,True,1,0,12,12
167479,2019-10-16 00:00:00+03:00,in,False,915556,False,2,74,89,15
167479,2019-10-16 00:00:00+03:00,out,False,915556,False,12,3508,3711,203
167479,2019-10-17 00:00:00+03:00,in,False,-1,True,2,0,16,16
167479,2019-10-17 00:00:00+03:00,in,False,915556,False,5,1961,1989,28
167479,2019-10-17 00:00:00+03:00,out,False,915556,True,11,0,229,229
167479,2019-10-17 00:00:00+03:00,out,False,915556,False,10,906,1063,157
167479,2019-10-18 00:00:00+03:00,in,False,915556,False,4,648,671,23
167479,2019-10-18 00:00:00+03:00,in,False,-1,True,27,0,285,285
167479,2019-10-18 00:00:00+03:00,out,False,915558,True,3,0,12,12
167479,2019-10-18 00:00:00+03:00,in,False,915556,True,1,0,5,5
167479,2019-10-18 00:00:00+03:00,out,False,915556,False,15,1178,1418,240
167479,2019-10-18 00:00:00+03:00,out,False,915558,False,15,1917,2086,169
167479,2019-10-18 00:00:00+03:00,out,False,915556,True,21,0,407,407
167479,2019-10-18 00:00:00+03:00,in,False,-1,True,27,0,285,285
167479,2019-10-19 00:00:00+03:00,in,False,-1,True,7,0,79,79
167479,2019-10-19 00:00:00+03:00,in,False,915556,False,4,251,284,33
167479,2019-10-19 00:00:00+03:00,out,False,915556,False,3,583,626,43
167479,2019-10-19 00:00:00+03:00,out,False,915556,True,9,0,230,230
167479,2019-10-19 00:00:00+03:00,out,False,915556,True,9,0,230,230
167479,2019-10-20 00:00:00+03:00,out,False,915556,False,2,503,546,43
167479,2019-10-20 00:00:00+03:00,in,False,-1,True,3,0,59,59
167479,2019-10-20 00:00:00+03:00,out,False,915556,True,3,0,73,73
167479,2019-10-20 00:00:00+03:00,in,False,-1,True,3,0,59,59
167479,2019-10-21 00:00:00+03:00,out,False,915556,False,3,31,71,40
167479,2019-10-21 00:00:00+03:00,out,False,915558,True,1,0,14,14
167479,2019-10-21 00:00:00+03:00,in,False,915556,False,5,452,484,32
167479,2019-10-21 00:00:00+03:00,out,False,915556,True,8,0,230,230
167479,2019-10-21 00:00:00+03:00,out,False,915558,False,4,515,549,34
167479,2019-10-21 00:00:00+03:00,in,False,-1,True,2,0,13,13
167479,2019-10-22 00:00:00+03:00,out,False,915556,True,26,0,747,747
167479,2019-10-22 00:00:00+03:00,in,False,915556,False,5,142,163,21
167479,2019-10-22 00:00:00+03:00,out,False,915556,False,16,1649,1975,326
167479,2019-10-22 00:00:00+03:00,in,False,-1,True,4,0,37,37
167479,2019-10-23 00:00:00+03:00,in,False,-1,True,1,0,6,6
167479,2019-10-23 00:00:00+03:00,out,False,915558,False,7,1412,1468,56
167479,2019-10-23 00:00:00+03:00,out,False,915556,False,18,2773,3162,389
167479,2019-10-23 00:00:00+03:00,out,False,915556,True,10,0,346,346
167479,2019-10-23 00:00:00+03:00,out,False,915558,True,2,0,27,27
167479,2019-10-23 00:00:00+03:00,in,False,915556,False,10,794,841,47
167479,2019-10-24 00:00:00+03:00,out,False,915558,True,9,0,248,248
167479,2019-10-24 00:00:00+03:00,out,False,915556,True,10,0,368,368
167479,2019-10-24 00:00:00+03:00,in,False,915556,False,2,426,450,24
167479,2019-10-24 00:00:00+03:00,out,False,915558,False,8,777,881,104
167479,2019-10-24 00:00:00+03:00,out,False,915556,False,9,763,1004,241
167479,2019-10-24 00:00:00+03:00,in,False,-1,True,5,0,7,7
167479,2019-10-25 00:00:00+03:00,in,False,915556,False,3,152,178,26
167479,2019-10-25 00:00:00+03:00,out,False,915556,True,15,0,446,446
167479,2019-10-25 00:00:00+03:00,out,False,915556,False,14,4833,5088,255
167479,2019-10-25 00:00:00+03:00,in,False,-1,True,1,0,2,2
167479,2019-10-25 00:00:00+03:00,in,False,915556,False,3,152,178,26
167479,2019-10-26 00:00:00+03:00,in,False,-1,True,7,0,106,106
167479,2019-10-26 00:00:00+03:00,in,False,915556,False,2,113,126,13
167479,2019-10-26 00:00:00+03:00,in,False,915556,True,1,0,7,7
167479,2019-10-26 00:00:00+03:00,out,False,915556,True,13,0,412,412
167479,2019-10-26 00:00:00+03:00,out,False,915556,False,13,1415,1579,164
167479,2019-10-27 00:00:00+03:00,out,False,915556,False,5,1133,1234,101
167479,2019-10-27 00:00:00+03:00,in,False,-1,True,7,0,96,96
167479,2019-10-27 00:00:00+03:00,out,False,915556,True,9,0,270,270
167479,2019-10-28 00:00:00+03:00,in,False,915556,False,8,1046,1081,35
167479,2019-10-28 00:00:00+03:00,out,False,915556,False,25,6886,7387,501
167479,2019-10-28 00:00:00+03:00,in,False,-1,True,29,0,178,178
167479,2019-10-28 00:00:00+03:00,out,False,915556,True,23,0,818,818
167479,2019-10-29 00:00:00+03:00,in,False,-1,True,11,0,115,115
167479,2019-10-29 00:00:00+03:00,in,False,915556,False,6,430,464,34
167479,2019-10-29 00:00:00+03:00,out,False,915556,True,13,0,429,429
167479,2019-10-29 00:00:00+03:00,out,False,915556,False,7,1164,1288,124
167479,2019-10-30 00:00:00+03:00,out,False,915556,True,13,0,413,413
167479,2019-10-30 00:00:00+03:00,in,False,915556,False,7,565,606,41
167479,2019-10-30 00:00:00+03:00,out,False,915556,False,12,2116,2376,260
167479,2019-10-30 00:00:00+03:00,in,False,-1,True,10,0,48,48
167479,2019-10-31 00:00:00+03:00,out,False,915556,True,19,0,703,703
167479,2019-10-31 00:00:00+03:00,out,False,915556,False,12,1807,2037,230
167479,2019-10-31 00:00:00+03:00,in,False,915556,False,11,832,889,57
167479,2019-10-31 00:00:00+03:00,in,False,-1,True,1,0,7,7
167479,2019-11-01 00:00:00+03:00,out,False,915556,False,20,4467,4885,418
167479,2019-11-01 00:00:00+03:00,out,False,915556,True,20,0,646,646
167479,2019-11-01 00:00:00+03:00,in,False,-1,True,2,0,4,4
167479,2019-11-01 00:00:00+03:00,in,False,915556,False,5,844,881,37
167479,2019-11-02 00:00:00+03:00,out,False,915556,False,14,1850,2120,270
167479,2019-11-02 00:00:00+03:00,out,False,915556,True,19,0,562,562
167479,2019-11-02 00:00:00+03:00,in,False,-1,True,1,0,19,19
167479,2019-11-03 00:00:00+03:00,in,False,-1,True,2,0,61,61
167479,2019-11-04 00:00:00+03:00,in,False,-1,True,2,0,4,4
167479,2019-11-04 00:00:00+03:00,out,False,915556,False,34,6030,6845,815
167479,2019-11-04 00:00:00+03:00,out,False,915556,True,59,0,1928,1928
167479,2019-11-04 00:00:00+03:00,in,False,915556,False,1,244,252,8
167479,2019-11-04 00:00:00+03:00,in,False,915556,False,1,244,252,8
167479,2019-11-05 00:00:00+03:00,out,False,915556,False,35,6204,6869,665
167479,2019-11-05 00:00:00+03:00,in,False,915556,False,2,61,74,13
167479,2019-11-05 00:00:00+03:00,out,False,915556,True,50,0,1483,1483
167479,2019-11-05 00:00:00+03:00,in,False,-1,True,2,0,4,4
167479,2019-11-06 00:00:00+03:00,in,False,-1,True,1,0,2,2
167479,2019-11-06 00:00:00+03:00,in,False,915556,False,4,114,128,14
167479,2019-11-06 00:00:00+03:00,out,False,915556,True,32,0,952,952
167479,2019-11-06 00:00:00+03:00,out,False,915556,False,10,676,838,162
167479,2019-11-07 00:00:00+03:00,out,False,915556,False,9,2700,2865,165
167479,2019-11-07 00:00:00+03:00,out,False,915556,True,40,0,1487,1487
167479,2019-11-07 00:00:00+03:00,in,False,-1,True,1,0,12,12
167479,2019-11-07 00:00:00+03:00,in,False,915556,False,1,37,44,7
167479,2019-11-08 00:00:00+03:00,out,False,915556,False,29,2888,3601,713
167479,2019-11-08 00:00:00+03:00,in,False,915556,False,1,189,193,4
167479,2019-11-08 00:00:00+03:00,out,False,915556,True,42,0,1434,1434
167479,2019-11-09 00:00:00+03:00,out,False,915556,False,15,3954,4251,297
167479,2019-11-09 00:00:00+03:00,out,False,915556,True,19,0,658,658
167479,2019-11-11 00:00:00+03:00,out,False,915556,True,28,0,902,902
167479,2019-11-11 00:00:00+03:00,out,False,915556,False,27,3758,4312,554
167479,2019-11-12 00:00:00+03:00,in,False,915556,False,3,1145,1159,14
167479,2019-11-12 00:00:00+03:00,out,False,915556,False,20,2288,2709,421
167479,2019-11-12 00:00:00+03:00,in,False,-1,True,2,0,31,31
167479,2019-11-12 00:00:00+03:00,out,False,915556,True,35,0,1237,1237
167479,2019-11-13 00:00:00+03:00,out,False,915558,False,7,1127,1202,75
167479,2019-11-13 00:00:00+03:00,out,False,915556,False,19,7251,7581,330
167479,2019-11-13 00:00:00+03:00,out,False,915558,True,2,0,34,34
167479,2019-11-13 00:00:00+03:00,out,False,915556,True,23,0,854,854
167479,2019-11-13 00:00:00+03:00,in,False,-1,True,8,0,228,228
167479,2019-11-13 00:00:00+03:00,in,False,915556,False,2,203,212,9
167479,2019-11-14 00:00:00+03:00,out,False,915556,False,16,2493,2827,334
167479,2019-11-14 00:00:00+03:00,in,False,915556,False,1,1463,1466,3
167479,2019-11-14 00:00:00+03:00,out,False,915556,True,22,0,775,775
167479,2019-11-14 00:00:00+03:00,in,False,-1,True,3,0,64,64
167479,2019-11-15 00:00:00+03:00,in,False,-1,True,2,0,10,10
167479,2019-11-15 00:00:00+03:00,out,False,915558,False,9,1886,1951,65
167479,2019-11-15 00:00:00+03:00,out,False,915556,False,14,3285,3589,304
167479,2019-11-15 00:00:00+03:00,in,False,915556,False,1,38,45,7
167479,2019-11-15 00:00:00+03:00,out,False,915556,True,27,0,893,893
167479,2019-11-15 00:00:00+03:00,out,False,915558,True,5,0,128,128
167479,2019-11-16 00:00:00+03:00,in,False,915556,False,2,2,16,14
167479,2019-11-16 00:00:00+03:00,out,False,915556,True,19,0,621,621
167479,2019-11-16 00:00:00+03:00,in,False,-1,True,9,0,150,150
167479,2019-11-16 00:00:00+03:00,out,False,915556,False,17,4051,4378,327
167479,2019-11-16 00:00:00+03:00,in,False,-1,True,9,0,150,150
167479,2019-11-17 00:00:00+03:00,in,False,915556,False,2,469,493,24
167479,2019-11-17 00:00:00+03:00,out,False,915556,False,4,1927,1975,48
167479,2019-11-17 00:00:00+03:00,out,False,915556,True,3,0,115,115
167479,2019-11-17 00:00:00+03:00,in,False,-1,True,1,0,1,1
167479,2019-11-17 00:00:00+03:00,out,False,915556,False,4,1927,1975,48
167479,2019-11-18 00:00:00+03:00,in,False,-1,True,6,0,74,74
167479,2019-11-18 00:00:00+03:00,out,False,915556,False,16,1370,1682,312
167479,2019-11-18 00:00:00+03:00,out,False,915556,True,19,0,598,598
167479,2019-11-18 00:00:00+03:00,in,False,915556,False,4,216,241,25
167479,2019-11-19 00:00:00+03:00,in,False,-1,True,10,0,110,110
167479,2019-11-19 00:00:00+03:00,in,False,915556,False,5,1373,1425,52
167479,2019-11-19 00:00:00+03:00,out,False,915556,False,16,5890,6185,295
167479,2019-11-19 00:00:00+03:00,out,False,915556,True,22,0,760,760
167479,2019-11-19 00:00:00+03:00,out,False,915556,False,16,5890,6185,295
167479,2019-11-20 00:00:00+03:00,in,False,915556,False,1,67,71,4
167479,2019-11-20 00:00:00+03:00,in,False,-1,True,4,0,9,9
167479,2019-11-20 00:00:00+03:00,out,False,915556,True,37,0,1171,1171
167479,2019-11-20 00:00:00+03:00,out,False,915558,False,1,669,696,27
167479,2019-11-20 00:00:00+03:00,out,False,915556,False,25,4755,5305,550
167479,2019-11-21 00:00:00+03:00,out,False,915558,True,11,0,379,379
167479,2019-11-21 00:00:00+03:00,out,False,915556,True,38,0,1231,1231
167479,2019-11-21 00:00:00+03:00,in,False,-1,True,3,0,5,5
167479,2019-11-21 00:00:00+03:00,out,False,915558,False,8,993,1031,38
167479,2019-11-21 00:00:00+03:00,in,False,915556,False,6,321,363,42
167479,2019-11-21 00:00:00+03:00,out,False,915556,False,36,5218,5828,610
167479,2019-11-21 00:00:00+03:00,out,True,915558,True,1,0,0,0
167479,2019-11-21 00:00:00+03:00,out,False,915556,False,36,5218,5828,610
167479,2019-11-22 00:00:00+03:00,in,False,915556,False,4,311,328,17
167479,2019-11-22 00:00:00+03:00,in,False,-1,True,7,0,66,66
167479,2019-11-22 00:00:00+03:00,out,False,915556,True,17,0,536,536
167479,2019-11-22 00:00:00+03:00,in,False,915556,True,1,0,10,10
167479,2019-11-22 00:00:00+03:00,out,False,915558,True,1,0,28,28
167479,2019-11-22 00:00:00+03:00,out,False,915558,False,1,30,44,14
167479,2019-11-22 00:00:00+03:00,out,False,915556,False,16,2676,2997,321
167479,2019-11-23 00:00:00+03:00,out,False,915556,True,16,0,532,532
167479,2019-11-23 00:00:00+03:00,in,False,-1,True,3,0,85,85
167479,2019-11-23 00:00:00+03:00,in,False,915556,False,4,1144,1170,26
167479,2019-11-23 00:00:00+03:00,out,False,915556,False,10,813,1018,205
167479,2019-11-25 00:00:00+03:00,out,False,915558,True,12,0,220,220
167479,2019-11-25 00:00:00+03:00,in,False,-1,True,4,0,10,10
167479,2019-11-25 00:00:00+03:00,out,False,915556,True,38,0,1208,1208
167479,2019-11-25 00:00:00+03:00,out,False,915556,False,30,5021,5640,619
167479,2019-11-25 00:00:00+03:00,out,False,915558,False,6,606,656,50
167479,2019-11-25 00:00:00+03:00,in,False,915556,False,2,622,634,12
167479,2019-11-26 00:00:00+03:00,in,False,915556,False,1,232,236,4
167479,2019-11-26 00:00:00+03:00,out,False,915556,True,36,0,1156,1156
167479,2019-11-26 00:00:00+03:00,out,False,915558,False,8,1679,1728,49
167479,2019-11-26 00:00:00+03:00,out,False,915556,False,19,4459,4787,328
167479,2019-11-26 00:00:00+03:00,in,False,-1,True,9,0,62,62
167479,2019-11-26 00:00:00+03:00,out,False,915558,True,3,0,121,121
167479,2019-11-27 00:00:00+03:00,out,False,915556,True,37,0,1201,1201
167479,2019-11-27 00:00:00+03:00,out,False,915556,False,11,1969,2218,249
167479,2019-11-28 00:00:00+03:00,out,False,915558,True,19,0,132,132
167479,2019-11-28 00:00:00+03:00,out,False,915556,False,16,1599,1920,321
167479,2019-11-28 00:00:00+03:00,out,False,915556,True,48,0,1233,1233
167479,2019-11-28 00:00:00+03:00,out,True,915556,True,1,0,0,0
167479,2019-11-28 00:00:00+03:00,out,False,915558,False,16,1033,1103,70
167479,2019-11-28 00:00:00+03:00,out,True,915558,True,2,0,0,0
167479,2019-11-28 00:00:00+03:00,in,False,915556,False,2,343,350,7
167487,2019-09-24 00:00:00+03:00,in,False,-1,True,1,0,2,2
167487,2019-09-25 00:00:00+03:00,in,False,914050,False,2,99,109,10
167487,2019-09-27 00:00:00+03:00,out,False,914050,False,6,1036,1103,67
167487,2019-09-27 00:00:00+03:00,in,False,914050,False,1,130,137,7
167487,2019-09-27 00:00:00+03:00,in,False,-1,True,1,0,30,30
167487,2019-09-27 00:00:00+03:00,out,False,914050,True,1,0,1,1
167487,2019-09-27 00:00:00+03:00,in,False,-1,True,1,0,30,30
167487,2019-09-29 00:00:00+03:00,out,False,914050,False,11,3088,3258,170
167487,2019-09-29 00:00:00+03:00,out,False,914050,True,11,0,309,309
167487,2019-09-29 00:00:00+03:00,out,False,914052,False,1,13,26,13
167487,2019-09-29 00:00:00+03:00,in,False,-1,True,1,0,17,17
167487,2019-09-29 00:00:00+03:00,out,False,914050,False,11,3088,3258,170
167487,2019-09-30 00:00:00+03:00,out,True,914050,True,1,0,3,3
167487,2019-09-30 00:00:00+03:00,out,False,914050,True,7,0,226,226
167487,2019-09-30 00:00:00+03:00,out,False,914050,False,18,4786,5093,307
167487,2019-09-30 00:00:00+03:00,in,False,-1,True,2,0,9,9
167487,2019-10-01 00:00:00+03:00,in,False,914050,False,1,37,51,14
167487,2019-10-01 00:00:00+03:00,out,False,914050,True,8,0,266,266
167487,2019-10-01 00:00:00+03:00,out,False,914050,False,8,1695,1800,105
167487,2019-10-01 00:00:00+03:00,out,False,914050,True,8,0,266,266
167487,2019-10-02 00:00:00+03:00,out,False,914050,False,19,3540,3832,292
167487,2019-10-02 00:00:00+03:00,out,False,914050,True,31,0,802,802
167487,2019-10-02 00:00:00+03:00,in,False,914050,False,1,27,43,16
167487,2019-10-02 00:00:00+03:00,in,False,-1,True,3,0,44,44
167487,2019-10-03 00:00:00+03:00,out,False,914050,True,18,0,510,510
167487,2019-10-03 00:00:00+03:00,in,False,-1,True,5,0,6,6
167487,2019-10-03 00:00:00+03:00,out,False,914050,False,22,5120,5446,326
167487,2019-10-04 00:00:00+03:00,out,False,914240,True,4,0,95,95
167487,2019-10-04 00:00:00+03:00,out,False,914240,False,9,961,1123,162
167487,2019-10-04 00:00:00+03:00,out,False,914050,True,14,0,532,532
167487,2019-10-04 00:00:00+03:00,in,False,914050,False,2,158,175,17
167487,2019-10-04 00:00:00+03:00,out,False,914050,False,10,2758,2909,151
167487,2019-10-04 00:00:00+03:00,out,False,914240,False,9,961,1123,162
167487,2019-10-05 00:00:00+03:00,out,False,914050,True,16,0,611,611
167487,2019-10-05 00:00:00+03:00,out,False,914050,False,15,2899,3151,252
167487,2019-10-05 00:00:00+03:00,out,True,914050,True,1,0,1,1
167487,2019-10-06 00:00:00+03:00,out,False,914050,True,18,0,724,724
167487,2019-10-06 00:00:00+03:00,out,False,914050,False,10,3064,3259,195
167487,2019-10-07 00:00:00+03:00,out,True,914050,True,1,0,0,0
167487,2019-10-07 00:00:00+03:00,out,False,914050,False,11,3728,3944,216
167487,2019-10-07 00:00:00+03:00,in,False,-1,True,2,0,60,60
167487,2019-10-07 00:00:00+03:00,out,False,914050,True,18,0,627,627
167487,2019-10-07 00:00:00+03:00,out,False,914050,True,18,0,627,627
167487,2019-10-09 00:00:00+03:00,out,False,914050,True,12,0,435,435
167487,2019-10-09 00:00:00+03:00,out,False,914050,False,14,2179,2434,255
167487,2019-10-10 00:00:00+03:00,out,False,914052,True,1,0,7,7
167487,2019-10-12 00:00:00+03:00,out,False,914240,False,1,162,190,28
167487,2019-10-12 00:00:00+03:00,out,False,914240,True,1,0,54,54
167487,2019-10-12 00:00:00+03:00,out,False,914052,True,2,0,13,13
167487,2019-10-12 00:00:00+03:00,out,False,914240,False,1,162,190,28
167487,2019-10-13 00:00:00+03:00,out,False,914240,False,11,570,732,162
167487,2019-10-13 00:00:00+03:00,out,False,914240,True,9,0,101,101
167487,2019-10-14 00:00:00+03:00,out,False,914240,False,5,519,628,109
167487,2019-10-14 00:00:00+03:00,out,False,914240,True,6,0,108,108
167487,2019-10-15 00:00:00+03:00,out,False,914052,True,1,0,15,15
167487,2019-10-15 00:00:00+03:00,out,False,914050,True,1,0,6,6
167487,2019-10-16 00:00:00+03:00,in,False,-1,True,4,0,3,3
167487,2019-10-16 00:00:00+03:00,out,False,914052,False,19,712,1036,324
167487,2019-10-16 00:00:00+03:00,out,False,914052,True,29,0,747,747
167487,2019-10-17 00:00:00+03:00,in,False,-1,True,2,0,1,1
167487,2019-10-17 00:00:00+03:00,out,False,914052,True,3,0,32,32
167487,2019-10-17 00:00:00+03:00,out,False,914052,False,3,112,146,34
167487,2019-10-18 00:00:00+03:00,out,False,914052,False,13,1094,1239,145
167487,2019-10-18 00:00:00+03:00,in,False,-1,True,6,0,4,4
167487,2019-10-18 00:00:00+03:00,out,False,914052,True,21,0,404,404
167487,2019-10-19 00:00:00+03:00,out,False,914052,True,10,0,146,146
167487,2019-10-19 00:00:00+03:00,out,False,914050,False,12,2242,2471,229
167487,2019-10-19 00:00:00+03:00,out,False,914050,True,8,0,278,278
167487,2019-10-19 00:00:00+03:00,out,False,914052,False,3,8,73,65
167487,2019-10-19 00:00:00+03:00,in,False,940968,False,2,328,382,54
167487,2019-10-19 00:00:00+03:00,in,False,914050,False,1,28,35,7
167487,2019-10-20 00:00:00+03:00,out,False,914052,False,15,1408,1644,236
167487,2019-10-20 00:00:00+03:00,out,False,914052,True,21,0,520,520
167487,2019-10-20 00:00:00+03:00,in,False,940968,False,1,17,34,17
167487,2019-10-21 00:00:00+03:00,out,False,914052,False,28,560,981,421
167487,2019-10-21 00:00:00+03:00,in,False,-1,True,2,0,32,32
167487,2019-10-21 00:00:00+03:00,out,False,914052,True,52,0,943,943
167487,2019-10-21 00:00:00+03:00,out,False,914052,True,52,0,943,943
167487,2019-10-22 00:00:00+03:00,out,False,914052,True,31,0,298,298
167487,2019-10-22 00:00:00+03:00,out,False,914052,False,6,35,127,92
167487,2019-10-23 00:00:00+03:00,out,False,914052,True,7,0,85,85
167487,2019-10-23 00:00:00+03:00,out,False,914052,False,2,23,67,44
167487,2019-10-24 00:00:00+03:00,out,False,914052,True,25,0,684,684
167487,2019-10-24 00:00:00+03:00,out,False,914052,False,19,2302,2624,322
167487,2019-10-24 00:00:00+03:00,in,False,940968,False,1,56,77,21
167487,2019-10-25 00:00:00+03:00,out,False,914052,False,7,452,584,132
167487,2019-10-25 00:00:00+03:00,out,False,914052,True,21,0,333,333
167487,2019-10-25 00:00:00+03:00,in,False,-1,True,2,0,43,43
167487,2019-10-26 00:00:00+03:00,out,False,914052,True,6,0,79,79
167487,2019-10-27 00:00:00+03:00,out,False,914052,True,23,0,634,634
167487,2019-10-27 00:00:00+03:00,out,False,914052,False,15,1449,1741,292
167487,2019-10-28 00:00:00+03:00,out,False,914052,False,22,1281,1709,428
167487,2019-10-28 00:00:00+03:00,out,False,914052,True,42,0,961,961
167487,2019-10-29 00:00:00+03:00,out,False,914052,True,43,0,845,845
167487,2019-10-29 00:00:00+03:00,in,False,-1,True,1,0,1,1
167487,2019-10-29 00:00:00+03:00,out,False,914052,False,11,629,804,175
167487,2019-10-30 00:00:00+03:00,out,False,914052,False,21,2065,2355,290
167487,2019-10-30 00:00:00+03:00,out,False,914052,True,39,0,748,748
167487,2019-10-30 00:00:00+03:00,out,False,914052,False,21,2065,2355,290
167487,2019-10-31 00:00:00+03:00,out,False,914052,False,28,1482,1848,366
167487,2019-10-31 00:00:00+03:00,out,False,914052,True,52,0,852,852
167487,2019-11-01 00:00:00+03:00,in,False,-1,True,1,0,46,46
167487,2019-11-01 00:00:00+03:00,out,False,914052,True,22,0,368,368
167487,2019-11-01 00:00:00+03:00,out,False,914052,False,10,243,419,176
167487,2019-11-02 00:00:00+03:00,out,False,914052,False,6,242,337,95
167487,2019-11-02 00:00:00+03:00,in,False,940968,False,1,727,735,8
167487,2019-11-02 00:00:00+03:00,out,False,914052,True,19,0,453,453
167487,2019-11-04 00:00:00+03:00,in,False,940968,False,1,394,402,8
167487,2019-11-04 00:00:00+03:00,in,False,-1,True,1,0,3,3
167487,2019-11-04 00:00:00+03:00,out,False,914052,False,8,736,846,110
167487,2019-11-04 00:00:00+03:00,out,False,914052,True,17,0,253,253
167487,2019-11-05 00:00:00+03:00,out,False,914052,False,5,619,674,55
167487,2019-11-05 00:00:00+03:00,out,False,914052,True,34,0,473,473
167487,2019-11-06 00:00:00+03:00,out,False,914052,True,3,0,33,33
167487,2019-11-06 00:00:00+03:00,in,False,940968,False,1,60,75,15
167487,2019-11-06 00:00:00+03:00,out,False,914052,False,11,338,474,136
167487,2019-11-07 00:00:00+03:00,in,False,940968,False,1,860,871,11
167487,2019-11-07 00:00:00+03:00,out,False,914052,True,30,0,584,584
167487,2019-11-07 00:00:00+03:00,out,False,914052,False,19,635,976,341
167487,2019-11-08 00:00:00+03:00,out,False,914052,True,26,0,370,370
167487,2019-11-08 00:00:00+03:00,out,False,914052,False,11,555,798,243
167487,2019-11-09 00:00:00+03:00,out,False,914052,False,5,478,558,80
167487,2019-11-09 00:00:00+03:00,out,False,914052,True,10,0,156,156
167487,2019-11-09 00:00:00+03:00,in,False,914050,False,1,88,97,9
167487,2019-11-10 00:00:00+03:00,out,False,914052,False,25,797,1176,379
167487,2019-11-10 00:00:00+03:00,in,False,-1,True,1,0,1,1
167487,2019-11-10 00:00:00+03:00,out,False,914052,True,19,0,469,469
167487,2019-11-10 00:00:00+03:00,in,False,-1,True,1,0,1,1
167487,2019-11-11 00:00:00+03:00,out,False,914052,False,11,227,355,128
167487,2019-11-11 00:00:00+03:00,out,False,914050,False,12,1556,1731,175
167487,2019-11-11 00:00:00+03:00,out,False,914052,True,16,0,299,299
167487,2019-11-11 00:00:00+03:00,in,False,914050,False,1,27,33,6
167487,2019-11-11 00:00:00+03:00,out,False,914050,True,10,0,232,232
167487,2019-11-11 00:00:00+03:00,in,False,940968,False,1,1,20,19
167487,2019-11-12 00:00:00+03:00,in,False,940968,False,3,45,99,54
167487,2019-11-12 00:00:00+03:00,out,False,914052,True,26,0,474,474
167487,2019-11-12 00:00:00+03:00,out,False,914052,False,18,810,1122,312
167487,2019-11-13 00:00:00+03:00,out,False,914052,False,10,158,283,125
167487,2019-11-13 00:00:00+03:00,out,False,914052,True,31,0,567,567
167487,2019-11-13 00:00:00+03:00,out,False,914050,True,1,0,30,30
167487,2019-11-14 00:00:00+03:00,in,False,940968,False,1,36,51,15
167487,2019-11-14 00:00:00+03:00,out,False,914052,True,21,0,295,295
167487,2019-11-14 00:00:00+03:00,in,False,914050,False,1,19,29,10
167487,2019-11-14 00:00:00+03:00,out,False,914050,True,2,0,14,14
167487,2019-11-14 00:00:00+03:00,out,False,914052,False,8,845,975,130
167487,2019-11-14 00:00:00+03:00,in,False,-1,True,1,0,5,5
167487,2019-11-15 00:00:00+03:00,out,False,914052,True,1,0,17,17
167487,2019-11-15 00:00:00+03:00,out,False,914052,True,1,0,17,17
167487,2019-11-16 00:00:00+03:00,out,False,914050,True,4,0,35,35
167487,2019-11-16 00:00:00+03:00,in,False,-1,True,1,0,18,18
167487,2019-11-16 00:00:00+03:00,out,False,914050,False,3,51,72,21
167487,2019-11-16 00:00:00+03:00,out,False,914052,True,1,0,45,45
167487,2019-11-16 00:00:00+03:00,out,False,914052,False,1,7,20,13
167487,2019-11-16 00:00:00+03:00,in,False,-1,True,1,0,18,18
167487,2019-11-17 00:00:00+03:00,out,False,914052,False,3,477,529,52
167487,2019-11-17 00:00:00+03:00,out,False,914052,True,11,0,164,164
167487,2019-11-17 00:00:00+03:00,in,False,-1,True,1,0,4,4
167487,2019-11-17 00:00:00+03:00,out,False,914052,True,11,0,164,164
167487,2019-11-18 00:00:00+03:00,out,False,914052,True,13,0,128,128
167487,2019-11-18 00:00:00+03:00,out,False,914052,False,7,181,256,75
167487,2019-11-19 00:00:00+03:00,out,False,914050,False,8,546,656,110
167487,2019-11-19 00:00:00+03:00,out,False,914052,False,4,67,142,75
167487,2019-11-19 00:00:00+03:00,out,False,914050,True,5,0,113,113
167487,2019-11-19 00:00:00+03:00,out,False,914052,True,11,0,153,153
167487,2019-11-20 00:00:00+03:00,out,False,914052,False,7,410,497,87
167487,2019-11-20 00:00:00+03:00,in,False,914050,False,1,817,823,6
167487,2019-11-20 00:00:00+03:00,out,False,914052,True,23,0,388,388
167487,2019-11-21 00:00:00+03:00,out,False,914052,False,9,664,797,133
167487,2019-11-21 00:00:00+03:00,in,False,940968,False,1,6,20,14
167487,2019-11-21 00:00:00+03:00,out,False,914052,True,40,0,463,463
167487,2019-11-21 00:00:00+03:00,out,False,914052,False,9,664,797,133
167487,2019-11-22 00:00:00+03:00,out,False,914052,True,40,0,470,470
167487,2019-11-22 00:00:00+03:00,in,False,-1,True,2,0,27,27
167487,2019-11-22 00:00:00+03:00,out,False,914052,False,6,642,728,86
167487,2019-11-22 00:00:00+03:00,out,False,914050,True,2,0,26,26
167487,2019-11-24 00:00:00+03:00,out,False,914052,False,3,57,98,41
167487,2019-11-24 00:00:00+03:00,out,False,914052,True,7,0,69,69
167487,2019-11-25 00:00:00+03:00,out,False,914050,False,4,1149,1207,58
167487,2019-11-25 00:00:00+03:00,out,False,914052,True,38,0,434,434
167487,2019-11-25 00:00:00+03:00,out,False,914052,False,13,432,636,204
167487,2019-11-25 00:00:00+03:00,out,False,914050,True,12,0,275,275
167487,2019-11-25 00:00:00+03:00,in,False,940968,False,3,1025,1079,54
167487,2019-11-26 00:00:00+03:00,out,False,914052,True,12,0,160,160
167487,2019-11-26 00:00:00+03:00,in,False,940968,False,1,220,243,23
167487,2019-11-26 00:00:00+03:00,out,False,914052,False,6,24,161,137
167487,2019-11-26 00:00:00+03:00,out,False,914052,False,6,24,161,137
167487,2019-11-27 00:00:00+03:00,out,False,914052,False,3,87,124,37
167487,2019-11-27 00:00:00+03:00,out,False,914052,True,6,0,103,103
167487,2019-11-27 00:00:00+03:00,out,False,914050,False,2,245,294,49
167487,2019-11-27 00:00:00+03:00,out,False,914050,False,2,245,294,49
167487,2019-11-28 00:00:00+03:00,out,False,914052,True,25,0,413,413
167487,2019-11-28 00:00:00+03:00,out,False,914052,False,15,1463,1713,250
167497,2019-09-18 00:00:00+03:00,in,False,914426,False,1,157,166,9
167497,2019-09-19 00:00:00+03:00,in,False,914848,False,1,27,41,14
167497,2019-09-20 00:00:00+03:00,in,False,915958,False,1,18,28,10
167497,2019-09-20 00:00:00+03:00,in,False,-1,True,2,0,19,19
167497,2019-09-20 00:00:00+03:00,in,False,914870,False,1,44,56,12
167497,2019-09-23 00:00:00+03:00,in,False,917252,False,1,37,54,17
167497,2019-09-23 00:00:00+03:00,in,False,917252,False,1,37,54,17
167497,2019-10-01 00:00:00+03:00,in,False,914870,False,1,16,26,10
167497,2019-10-01 00:00:00+03:00,in,False,-1,True,11,0,76,76
167497,2019-10-02 00:00:00+03:00,in,False,-1,True,6,0,62,62
167497,2019-10-03 00:00:00+03:00,in,False,-1,True,4,0,37,37
167497,2019-10-03 00:00:00+03:00,out,False,920928,False,4,37,38,1
167497,2019-10-04 00:00:00+03:00,in,False,915958,False,1,16,32,16
167497,2019-10-04 00:00:00+03:00,out,True,920928,False,1,20,27,7
167497,2019-10-04 00:00:00+03:00,out,False,914848,False,3,228,280,52
167497,2019-10-04 00:00:00+03:00,in,False,914426,False,1,21,33,12
167497,2019-10-04 00:00:00+03:00,out,False,924948,False,3,56,114,58
167497,2019-10-04 00:00:00+03:00,in,False,917378,False,1,18,30,12
167497,2019-10-04 00:00:00+03:00,out,False,914426,True,1,0,28,28
167497,2019-10-04 00:00:00+03:00,out,True,918958,False,1,10,21,11
167497,2019-10-04 00:00:00+03:00,out,False,915958,False,4,31,35,4
167497,2019-10-04 00:00:00+03:00,in,False,914848,False,1,11,34,23
167497,2019-10-04 00:00:00+03:00,out,False,915958,True,1,0,13,13
167497,2019-10-04 00:00:00+03:00,out,False,922114,False,1,38,48,10
167497,2019-10-04 00:00:00+03:00,out,True,915958,False,1,6,14,8
167497,2019-10-04 00:00:00+03:00,out,False,917252,False,1,109,116,7
167497,2019-10-04 00:00:00+03:00,out,True,917252,True,2,0,0,0
167497,2019-10-04 00:00:00+03:00,out,False,914426,False,3,115,171,56
167497,2019-10-04 00:00:00+03:00,in,False,-1,True,28,0,308,308
167497,2019-10-04 00:00:00+03:00,out,True,917252,False,1,12,17,5
167497,2019-10-04 00:00:00+03:00,out,True,918958,True,6,0,61,61
167497,2019-10-04 00:00:00+03:00,out,False,920928,False,2,42,44,2
167497,2019-10-04 00:00:00+03:00,out,False,918958,True,1,0,12,12
167497,2019-10-04 00:00:00+03:00,in,False,914870,False,2,39,65,26
167497,2019-10-04 00:00:00+03:00,out,False,924948,True,2,0,37,37
167497,2019-10-04 00:00:00+03:00,out,True,920928,True,1,0,1,1
167497,2019-10-04 00:00:00+03:00,out,True,917252,True,2,0,0,0
167497,2019-10-04 00:00:00+03:00,out,False,915958,False,4,31,35,4
167497,2019-10-04 00:00:00+03:00,out,True,920928,False,1,20,27,7
167497,2019-10-04 00:00:00+03:00,out,False,922114,False,1,38,48,10
167497,2019-10-05 00:00:00+03:00,out,False,917378,True,5,0,122,122
167497,2019-10-05 00:00:00+03:00,out,False,924948,False,1,30,45,15
167497,2019-10-05 00:00:00+03:00,out,False,914870,True,3,0,32,32
167497,2019-10-05 00:00:00+03:00,out,True,914870,True,1,0,0,0
167497,2019-10-05 00:00:00+03:00,out,False,917252,False,1,32,42,10
167497,2019-10-05 00:00:00+03:00,in,False,-1,True,6,0,49,49
167497,2019-10-05 00:00:00+03:00,out,True,924948,False,1,4,17,13
167497,2019-10-06 00:00:00+03:00,out,False,917446,False,1,62,74,12
167497,2019-10-06 00:00:00+03:00,in,False,917378,False,1,106,119,13
167497,2019-10-06 00:00:00+03:00,in,False,917378,False,1,106,119,13
167497,2019-10-07 00:00:00+03:00,out,True,917378,True,1,0,4,4
167497,2019-10-07 00:00:00+03:00,out,False,922114,False,3,170,173,3
167497,2019-10-07 00:00:00+03:00,out,False,917446,False,4,496,542,46
167497,2019-10-07 00:00:00+03:00,in,False,917252,False,4,436,558,122
167497,2019-10-07 00:00:00+03:00,out,False,917252,False,2,166,192,26
167497,2019-10-07 00:00:00+03:00,in,False,-1,True,3,0,112,112
167497,2019-10-07 00:00:00+03:00,out,False,917378,False,5,221,293,72
167497,2019-10-07 00:00:00+03:00,out,False,917446,True,3,0,131,131
167497,2019-10-08 00:00:00+03:00,out,False,917378,False,1,83,99,16
167497,2019-10-08 00:00:00+03:00,in,False,918956,False,1,24,63,39
167497,2019-10-08 00:00:00+03:00,in,False,914870,False,1,176,212,36
167497,2019-10-08 00:00:00+03:00,out,True,922114,False,2,371,397,26
167497,2019-10-08 00:00:00+03:00,in,False,-1,True,9,0,204,204
167497,2019-10-08 00:00:00+03:00,out,False,915958,False,4,581,636,55
167497,2019-10-08 00:00:00+03:00,out,False,917252,False,1,17,32,15
167497,2019-10-08 00:00:00+03:00,out,True,915958,True,1,0,28,28
167497,2019-10-08 00:00:00+03:00,out,True,920928,True,1,0,45,45
167497,2019-10-08 00:00:00+03:00,in,False,920930,False,1,21,83,62
167497,2019-10-08 00:00:00+03:00,out,True,917378,True,1,0,3,3
167497,2019-10-08 00:00:00+03:00,in,False,918958,False,1,32,69,37
167497,2019-10-08 00:00:00+03:00,in,False,918958,False,1,32,69,37
167497,2019-10-09 00:00:00+03:00,out,False,914848,True,1,0,33,33
167497,2019-10-09 00:00:00+03:00,out,True,922114,False,3,348,378,30
167497,2019-10-09 00:00:00+03:00,in,False,917252,False,1,105,215,110
167497,2019-10-09 00:00:00+03:00,in,False,-1,True,2,0,105,105
167497,2019-10-09 00:00:00+03:00,out,False,917252,True,2,0,58,58
167497,2019-10-09 00:00:00+03:00,out,False,921116,True,1,0,62,62
167497,2019-10-09 00:00:00+03:00,in,False,915958,False,2,921,972,51
167497,2019-10-09 00:00:00+03:00,out,False,921116,False,2,355,372,17
167497,2019-10-09 00:00:00+03:00,out,False,914848,False,1,8,11,3
167497,2019-10-09 00:00:00+03:00,in,False,918956,False,1,10,40,30
167497,2019-10-09 00:00:00+03:00,out,False,917252,False,1,32,57,25
167497,2019-10-09 00:00:00+03:00,out,False,921116,False,2,355,372,17
167497,2019-10-10 00:00:00+03:00,out,False,917446,True,1,0,52,52
167497,2019-10-10 00:00:00+03:00,out,False,932836,True,2,0,19,19
167497,2019-10-10 00:00:00+03:00,out,False,932836,False,2,64,98,34
167497,2019-10-10 00:00:00+03:00,in,False,-1,True,1,0,9,9
167497,2019-10-10 00:00:00+03:00,out,False,917378,True,1,0,32,32
167497,2019-10-10 00:00:00+03:00,out,False,917446,False,1,96,108,12
167497,2019-10-10 00:00:00+03:00,out,True,920928,True,3,0,163,163
167497,2019-10-10 00:00:00+03:00,out,True,932836,True,1,0,14,14
167497,2019-10-10 00:00:00+03:00,in,False,914426,False,1,256,304,48
167497,2019-10-10 00:00:00+03:00,out,True,920928,False,1,77,103,26
167497,2019-10-10 00:00:00+03:00,out,False,932836,False,2,64,98,34
167497,2019-10-11 00:00:00+03:00,out,True,922114,True,1,0,12,12
167497,2019-10-11 00:00:00+03:00,out,False,932836,False,1,14,36,22
167497,2019-10-11 00:00:00+03:00,out,False,914848,True,5,0,145,145
167497,2019-10-11 00:00:00+03:00,out,False,918956,True,4,0,61,61
167497,2019-10-11 00:00:00+03:00,out,False,914848,False,5,690,746,56
167497,2019-10-11 00:00:00+03:00,out,False,917446,False,1,28,37,9
167497,2019-10-11 00:00:00+03:00,out,True,920928,False,1,34,41,7
167497,2019-10-11 00:00:00+03:00,in,False,922114,False,1,14,75,61
167497,2019-10-11 00:00:00+03:00,out,False,915958,False,5,912,1028,116
167497,2019-10-11 00:00:00+03:00,in,False,-1,True,5,0,208,208
167497,2019-10-11 00:00:00+03:00,out,True,920928,True,1,0,12,12
167497,2019-10-11 00:00:00+03:00,out,False,922114,False,1,79,81,2
167497,2019-10-11 00:00:00+03:00,out,False,918956,False,1,123,137,14
167497,2019-10-11 00:00:00+03:00,out,False,915958,True,1,0,28,28
167497,2019-10-11 00:00:00+03:00,in,False,915958,False,1,313,342,29
167497,2019-10-11 00:00:00+03:00,out,False,914848,True,5,0,145,145
167497,2019-10-12 00:00:00+03:00,out,False,915958,True,1,0,28,28
167497,2019-10-12 00:00:00+03:00,out,False,917446,True,2,0,63,63
167497,2019-10-12 00:00:00+03:00,out,False,918956,True,1,0,43,43
167497,2019-10-12 00:00:00+03:00,out,False,915958,False,1,1096,1103,7
167497,2019-10-12 00:00:00+03:00,out,False,918956,False,2,34,49,15
167497,2019-10-12 00:00:00+03:00,in,False,-1,True,2,0,110,110
167497,2019-10-12 00:00:00+03:00,in,False,915958,False,4,460,531,71
167497,2019-10-12 00:00:00+03:00,out,False,917446,False,1,102,107,5
167497,2019-10-12 00:00:00+03:00,out,False,917252,True,1,0,18,18
167497,2019-10-13 00:00:00+03:00,out,False,918956,True,1,0,51,51
167497,2019-10-13 00:00:00+03:00,in,False,-1,True,1,0,13,13
167497,2019-10-13 00:00:00+03:00,in,False,915958,False,2,327,373,46
167497,2019-10-13 00:00:00+03:00,out,False,924958,False,3,86,105,19
167497,2019-10-13 00:00:00+03:00,out,False,918956,False,6,268,333,65
167497,2019-10-13 00:00:00+03:00,in,False,-1,True,1,0,13,13
167497,2019-10-14 00:00:00+03:00,out,False,918956,True,1,0,60,60
167497,2019-10-14 00:00:00+03:00,out,False,932836,True,1,0,31,31
167497,2019-10-14 00:00:00+03:00,out,False,924930,True,2,0,26,26
167497,2019-10-14 00:00:00+03:00,out,True,924928,True,1,0,45,45
167497,2019-10-14 00:00:00+03:00,out,False,924928,False,1,62,63,1
167497,2019-10-14 00:00:00+03:00,in,False,924930,False,1,54,86,32
167497,2019-10-14 00:00:00+03:00,out,False,924930,False,4,46,135,89
167497,2019-10-14 00:00:00+03:00,out,True,924930,False,1,12,39,27
167497,2019-10-14 00:00:00+03:00,out,False,924958,False,2,176,204,28
167497,2019-10-14 00:00:00+03:00,out,False,917446,False,1,5,38,33
167497,2019-10-14 00:00:00+03:00,out,True,924956,False,2,158,193,35
167497,2019-10-14 00:00:00+03:00,in,False,-1,True,7,0,206,206
167497,2019-10-14 00:00:00+03:00,out,False,932836,False,1,19,30,11
167497,2019-10-14 00:00:00+03:00,out,False,924940,False,1,60,72,12
167497,2019-10-14 00:00:00+03:00,out,False,918956,False,1,63,71,8
167497,2019-10-15 00:00:00+03:00,out,False,924960,True,2,0,55,55
167497,2019-10-15 00:00:00+03:00,out,False,932836,False,2,52,77,25
167497,2019-10-15 00:00:00+03:00,out,False,924950,True,1,0,38,38
167497,2019-10-15 00:00:00+03:00,out,False,924960,False,2,148,221,73
167497,2019-10-15 00:00:00+03:00,out,False,921116,False,3,346,388,42
167497,2019-10-15 00:00:00+03:00,out,True,924928,False,2,153,165,12
167497,2019-10-15 00:00:00+03:00,out,True,924932,False,1,22,33,11
167497,2019-10-15 00:00:00+03:00,out,False,932836,True,1,0,33,33
167497,2019-10-15 00:00:00+03:00,in,False,924952,False,3,663,717,54
167497,2019-10-15 00:00:00+03:00,in,False,924960,False,1,58,104,46
167497,2019-10-15 00:00:00+03:00,out,False,924956,False,3,468,509,41
167497,2019-10-15 00:00:00+03:00,out,True,924952,False,1,100,120,20
167497,2019-10-15 00:00:00+03:00,out,False,924956,True,2,0,19,19
167497,2019-10-15 00:00:00+03:00,out,False,924952,False,3,96,168,72
167497,2019-10-15 00:00:00+03:00,out,False,924952,True,2,0,73,73
167497,2019-10-15 00:00:00+03:00,in,False,-1,True,6,0,158,158
167497,2019-10-15 00:00:00+03:00,out,True,924952,True,3,0,126,126
167497,2019-10-15 00:00:00+03:00,out,False,924956,False,3,468,509,41
167497,2019-10-16 00:00:00+03:00,out,True,921116,False,1,25,30,5
167497,2019-10-16 00:00:00+03:00,out,False,924948,False,1,16,23,7
167497,2019-10-16 00:00:00+03:00,out,False,924946,False,1,309,317,8
167497,2019-10-16 00:00:00+03:00,out,False,924956,True,7,0,95,95
167497,2019-10-16 00:00:00+03:00,out,False,924954,False,4,265,352,87
167497,2019-10-16 00:00:00+03:00,out,True,924928,True,2,0,85,85
167497,2019-10-16 00:00:00+03:00,out,True,924932,False,1,26,41,15
167497,2019-10-16 00:00:00+03:00,out,False,924956,False,7,592,677,85
167497,2019-10-16 00:00:00+03:00,out,True,924932,True,2,0,38,38
167497,2019-10-16 00:00:00+03:00,out,False,924960,False,1,111,122,11
167497,2019-10-16 00:00:00+03:00,out,False,921116,False,2,216,231,15
167497,2019-10-16 00:00:00+03:00,out,False,932836,True,1,0,30,30
167497,2019-10-16 00:00:00+03:00,out,False,924952,False,8,753,860,107
167497,2019-10-16 00:00:00+03:00,out,False,924950,True,4,0,141,141
167497,2019-10-16 00:00:00+03:00,out,False,924954,True,3,0,31,31
167497,2019-10-16 00:00:00+03:00,out,False,924952,True,1,0,51,51
167497,2019-10-16 00:00:00+03:00,out,True,924960,True,1,0,37,37
167497,2019-10-16 00:00:00+03:00,out,False,924950,False,9,896,1001,105
167497,2019-10-16 00:00:00+03:00,out,False,932836,False,7,792,889,97
167497,2019-10-16 00:00:00+03:00,in,False,924952,False,2,733,772,39
167497,2019-10-16 00:00:00+03:00,out,True,924928,False,5,427,492,65
167497,2019-10-16 00:00:00+03:00,in,False,-1,True,8,0,445,445
167497,2019-10-16 00:00:00+03:00,out,True,924928,False,5,427,492,65
167497,2019-10-16 00:00:00+03:00,out,False,924946,False,1,309,317,8
167497,2019-10-17 00:00:00+03:00,out,True,924928,True,1,0,0,0
167497,2019-10-17 00:00:00+03:00,out,False,932836,True,5,0,69,69
167497,2019-10-17 00:00:00+03:00,out,False,932836,False,5,478,545,67
167497,2019-10-17 00:00:00+03:00,out,False,924950,False,22,3909,4247,338
167497,2019-10-17 00:00:00+03:00,out,False,924934,False,3,67,99,32
167497,2019-10-17 00:00:00+03:00,in,False,-1,True,2,0,85,85
167497,2019-10-17 00:00:00+03:00,out,True,924958,True,1,0,35,35
167497,2019-10-17 00:00:00+03:00,out,False,924950,True,6,0,182,182
167497,2019-10-17 00:00:00+03:00,out,False,924934,True,1,0,3,3
167497,2019-10-17 00:00:00+03:00,in,False,924950,False,1,74,105,31
167497,2019-10-17 00:00:00+03:00,out,False,924930,False,10,1050,1289,239
167497,2019-10-17 00:00:00+03:00,out,False,924928,True,1,0,11,11
167497,2019-10-17 00:00:00+03:00,out,False,924958,False,5,805,867,62
167497,2019-10-17 00:00:00+03:00,out,False,924930,True,5,0,192,192
167497,2019-10-17 00:00:00+03:00,in,False,924956,False,3,152,252,100
167497,2019-10-17 00:00:00+03:00,out,False,924960,False,2,401,436,35
167497,2019-10-17 00:00:00+03:00,out,False,924948,True,2,0,24,24
167497,2019-10-17 00:00:00+03:00,out,False,924946,False,1,27,43,16
167497,2019-10-17 00:00:00+03:00,out,True,924950,True,1,0,20,20
167497,2019-10-17 00:00:00+03:00,out,False,924928,False,2,1051,1065,14
167497,2019-10-17 00:00:00+03:00,out,False,924960,True,1,0,12,12
167497,2019-10-17 00:00:00+03:00,out,True,924956,True,1,0,24,24
167497,2019-10-17 00:00:00+03:00,out,True,924950,False,2,249,283,34
167497,2019-10-17 00:00:00+03:00,out,False,924956,False,7,1104,1186,82
167497,2019-10-17 00:00:00+03:00,in,False,-1,True,1,0,130,130
167497,2019-10-17 00:00:00+03:00,out,False,924958,True,4,0,8,8
167497,2019-10-17 00:00:00+03:00,out,True,924948,True,1,0,0,0
167497,2019-10-17 00:00:00+03:00,out,False,924956,True,1,0,42,42
167497,2019-10-17 00:00:00+03:00,out,True,924928,False,2,63,93,30
167497,2019-10-17 00:00:00+03:00,out,False,924928,True,1,0,11,11
167497,2019-10-17 00:00:00+03:00,out,False,924934,False,3,67,99,32
167497,2019-10-18 00:00:00+03:00,out,True,924934,False,1,71,87,16
167497,2019-10-18 00:00:00+03:00,out,False,924930,False,2,305,324,19
167497,2019-10-18 00:00:00+03:00,out,False,924930,True,1,0,27,27
167497,2019-10-18 00:00:00+03:00,in,False,924956,False,1,22,63,41
167497,2019-10-18 00:00:00+03:00,out,False,932856,False,3,674,680,6
167497,2019-10-18 00:00:00+03:00,out,False,924956,False,2,179,197,18
167497,2019-10-18 00:00:00+03:00,out,False,924956,True,2,0,18,18
167497,2019-10-18 00:00:00+03:00,out,False,924960,False,4,669,728,59
167497,2019-10-18 00:00:00+03:00,out,False,924940,True,2,0,53,53
167497,2019-10-18 00:00:00+03:00,out,False,924960,True,1,0,12,12
167497,2019-10-18 00:00:00+03:00,out,True,924950,False,1,151,163,12
167497,2019-10-18 00:00:00+03:00,out,False,924940,False,2,157,184,27
167497,2019-10-18 00:00:00+03:00,out,False,924950,True,1,0,40,40
167497,2019-10-18 00:00:00+03:00,out,False,924950,False,7,887,958,71
167497,2019-10-18 00:00:00+03:00,out,True,924940,True,1,0,0,0
167497,2019-10-18 00:00:00+03:00,out,True,924932,False,1,49,71,22
167497,2019-10-18 00:00:00+03:00,out,True,924928,False,5,273,346,73
167497,2019-10-18 00:00:00+03:00,out,False,924952,False,1,215,223,8
167497,2019-10-18 00:00:00+03:00,in,False,-1,True,2,0,17,17
167497,2019-10-18 00:00:00+03:00,out,False,924956,True,2,0,18,18
167497,2019-10-18 00:00:00+03:00,out,False,924930,False,2,305,324,19
167497,2019-10-18 00:00:00+03:00,out,True,924950,False,1,151,163,12
167497,2019-10-19 00:00:00+03:00,in,False,-1,True,1,0,7,7
167497,2019-10-19 00:00:00+03:00,out,False,924948,True,2,0,120,120
167497,2019-10-19 00:00:00+03:00,out,False,924960,False,1,28,52,24
167497,2019-10-19 00:00:00+03:00,out,False,921116,False,1,54,63,9
167497,2019-10-20 00:00:00+03:00,out,False,924960,True,1,0,29,29
167497,2019-10-20 00:00:00+03:00,out,False,924950,True,1,0,60,60
167497,2019-10-20 00:00:00+03:00,out,True,924960,False,1,60,77,17
167497,2019-10-20 00:00:00+03:00,in,False,-1,True,1,0,8,8
167497,2019-10-20 00:00:00+03:00,out,False,924948,True,2,0,75,75
167497,2019-10-20 00:00:00+03:00,out,False,932836,False,1,30,47,17
167497,2019-10-20 00:00:00+03:00,out,False,924950,False,4,1036,1090,54
167497,2019-10-20 00:00:00+03:00,out,False,924948,False,2,154,169,15
167497,2019-10-20 00:00:00+03:00,out,False,924948,True,2,0,75,75
167497,2019-10-21 00:00:00+03:00,out,False,924960,False,9,1213,1325,112
167497,2019-10-21 00:00:00+03:00,out,False,924930,False,1,171,198,27
167497,2019-10-21 00:00:00+03:00,out,False,932836,False,8,615,737,122
167497,2019-10-21 00:00:00+03:00,out,False,921116,False,2,290,312,22
167497,2019-10-21 00:00:00+03:00,out,False,924960,True,2,0,45,45
167497,2019-10-21 00:00:00+03:00,out,False,924948,True,2,0,62,62
167497,2019-10-21 00:00:00+03:00,out,False,924950,False,3,128,168,40
167497,2019-10-21 00:00:00+03:00,in,False,924950,False,1,172,195,23
167497,2019-10-21 00:00:00+03:00,out,False,924958,False,5,344,439,95
167497,2019-10-21 00:00:00+03:00,in,False,-1,True,4,0,149,149
167497,2019-10-21 00:00:00+03:00,out,False,924958,True,2,0,75,75
167497,2019-10-21 00:00:00+03:00,out,False,924954,True,2,0,35,35
167497,2019-10-21 00:00:00+03:00,out,False,924952,False,3,817,860,43
167497,2019-10-21 00:00:00+03:00,out,False,924948,False,2,379,426,47
167497,2019-10-21 00:00:00+03:00,out,False,924954,False,2,364,385,21
167497,2019-10-21 00:00:00+03:00,out,False,921116,True,1,0,9,9
167497,2019-10-21 00:00:00+03:00,out,False,932836,True,2,0,60,60
167497,2019-10-21 00:00:00+03:00,out,False,924950,False,3,128,168,40
167497,2019-10-22 00:00:00+03:00,out,True,924952,False,3,457,498,41
167497,2019-10-22 00:00:00+03:00,out,False,924958,False,1,65,75,10
167497,2019-10-22 00:00:00+03:00,out,False,924960,False,2,928,954,26
167497,2019-10-22 00:00:00+03:00,in,False,924958,False,1,91,114,23
167497,2019-10-22 00:00:00+03:00,out,False,924934,True,3,0,84,84
167497,2019-10-22 00:00:00+03:00,out,False,932836,False,7,987,1082,95
167497,2019-10-22 00:00:00+03:00,out,False,924934,False,2,86,123,37
167497,2019-10-22 00:00:00+03:00,out,True,924934,False,3,68,92,24
167497,2019-10-22 00:00:00+03:00,out,True,924932,False,3,61,95,34
167497,2019-10-22 00:00:00+03:00,in,False,924960,False,1,131,156,25
167497,2019-10-22 00:00:00+03:00,in,False,-1,True,9,0,372,372
167497,2019-10-22 00:00:00+03:00,out,False,924952,True,4,0,18,18
167497,2019-10-22 00:00:00+03:00,out,False,924960,True,1,0,7,7
167497,2019-10-22 00:00:00+03:00,in,False,924956,False,2,76,132,56
167497,2019-10-22 00:00:00+03:00,out,False,932836,True,2,0,48,48
167497,2019-10-22 00:00:00+03:00,in,False,924932,False,1,25,46,21
167497,2019-10-22 00:00:00+03:00,out,False,924948,False,1,31,52,21
167497,2019-10-22 00:00:00+03:00,out,True,924952,True,2,0,70,70
167497,2019-10-22 00:00:00+03:00,out,False,932856,True,1,0,10,10
167497,2019-10-22 00:00:00+03:00,out,True,924934,True,2,0,13,13
167497,2019-10-22 00:00:00+03:00,out,False,924958,True,1,0,20,20
167497,2019-10-22 00:00:00+03:00,out,False,924952,False,6,543,601,58
167497,2019-10-22 00:00:00+03:00,out,False,924950,False,1,272,274,2
167497,2019-10-22 00:00:00+03:00,out,False,921116,False,11,1310,1484,174
167497,2019-10-22 00:00:00+03:00,out,False,921116,True,2,0,85,85
167497,2019-10-22 00:00:00+03:00,out,False,924940,False,2,21,60,39
167497,2019-10-22 00:00:00+03:00,out,False,924940,False,2,21,60,39
167497,2019-10-22 00:00:00+03:00,out,False,921116,True,2,0,85,85
167497,2019-10-22 00:00:00+03:00,out,False,921116,False,11,1310,1484,174
167497,2019-10-22 00:00:00+03:00,out,False,924958,True,1,0,20,20
167497,2019-10-23 00:00:00+03:00,out,False,924950,False,5,764,838,74
167497,2019-10-23 00:00:00+03:00,out,True,924950,False,1,38,48,10
167497,2019-10-23 00:00:00+03:00,out,False,924934,False,1,34,62,28
167497,2019-10-23 00:00:00+03:00,out,False,921116,False,2,314,354,40
167497,2019-10-23 00:00:00+03:00,in,False,924932,False,1,114,139,25
167497,2019-10-23 00:00:00+03:00,in,False,924958,False,1,49,71,22
167497,2019-10-23 00:00:00+03:00,out,True,924934,False,2,52,67,15
167497,2019-10-23 00:00:00+03:00,out,False,924934,True,2,0,34,34
167497,2019-10-23 00:00:00+03:00,out,False,924960,True,2,0,64,64
167497,2019-10-23 00:00:00+03:00,out,False,924958,False,3,152,200,48
167497,2019-10-23 00:00:00+03:00,out,True,924950,True,1,0,44,44
167497,2019-10-23 00:00:00+03:00,in,False,924950,False,2,779,816,37
167497,2019-10-23 00:00:00+03:00,in,False,-1,True,10,0,323,323
167497,2019-10-23 00:00:00+03:00,out,True,924958,False,1,44,52,8
167497,2019-10-23 00:00:00+03:00,out,False,924960,False,9,389,511,122
167497,2019-10-23 00:00:00+03:00,out,True,924932,False,1,49,81,32
167497,2019-10-23 00:00:00+03:00,out,True,924934,True,1,0,44,44
167497,2019-10-23 00:00:00+03:00,in,False,-1,True,1,0,41,41
167497,2019-10-23 00:00:00+03:00,in,False,924928,False,1,144,268,124
167497,2019-10-23 00:00:00+03:00,out,False,924950,True,1,0,41,41
167497,2019-10-23 00:00:00+03:00,in,False,924960,False,1,88,113,25
167497,2019-10-23 00:00:00+03:00,in,False,924928,False,1,144,268,124
167497,2019-10-23 00:00:00+03:00,out,False,924934,True,2,0,34,34
167497,2019-10-23 00:00:00+03:00,out,True,924958,False,1,44,52,8
167497,2019-10-24 00:00:00+03:00,in,True,924958,False,1,19,73,54
167497,2019-10-24 00:00:00+03:00,out,False,924950,True,1,0,21,21
167497,2019-10-24 00:00:00+03:00,out,True,924928,True,1,0,7,7
167497,2019-10-24 00:00:00+03:00,out,False,924954,False,6,512,565,53
167497,2019-10-24 00:00:00+03:00,in,False,-1,True,12,0,325,325
167497,2019-10-24 00:00:00+03:00,out,False,924958,True,3,0,114,114
167497,2019-10-24 00:00:00+03:00,out,False,924940,True,1,0,23,23
167497,2019-10-24 00:00:00+03:00,out,True,924958,False,1,97,105,8
167497,2019-10-24 00:00:00+03:00,out,True,924928,False,4,470,502,32
167497,2019-10-24 00:00:00+03:00,out,False,932836,True,1,0,10,10
167497,2019-10-24 00:00:00+03:00,out,True,924952,True,2,0,51,51
167497,2019-10-24 00:00:00+03:00,in,False,924948,False,1,7,20,13
167497,2019-10-24 00:00:00+03:00,out,False,924954,True,1,0,21,21
167497,2019-10-24 00:00:00+03:00,out,True,924954,True,1,0,0,0
167497,2019-10-24 00:00:00+03:00,out,False,924930,True,3,0,53,53
167497,2019-10-24 00:00:00+03:00,out,False,924952,False,1,49,64,15
167497,2019-10-24 00:00:00+03:00,out,True,924960,False,2,155,182,27
167497,2019-10-24 00:00:00+03:00,out,False,924930,False,7,523,618,95
167497,2019-10-24 00:00:00+03:00,out,False,924958,False,12,578,775,197
167497,2019-10-24 00:00:00+03:00,out,False,924928,False,1,118,136,18
167497,2019-10-24 00:00:00+03:00,in,False,-1,True,1,0,103,103
167497,2019-10-24 00:00:00+03:00,out,False,924948,False,2,121,137,16
167497,2019-10-24 00:00:00+03:00,out,False,924950,False,4,374,450,76
167497,2019-10-24 00:00:00+03:00,out,False,924940,False,2,22,46,24
167497,2019-10-24 00:00:00+03:00,in,False,924946,False,1,4,28,24
167497,2019-10-24 00:00:00+03:00,out,False,932836,True,1,0,10,10
167497,2019-10-24 00:00:00+03:00,in,False,924946,False,1,4,28,24
167497,2019-10-24 00:00:00+03:00,out,True,924928,False,4,470,502,32
167497,2019-10-24 00:00:00+03:00,out,True,924960,False,2,155,182,27
167497,2019-10-25 00:00:00+03:00,out,True,924948,True,1,0,50,50
167497,2019-10-25 00:00:00+03:00,out,True,924928,False,1,13,23,10
167497,2019-10-25 00:00:00+03:00,out,False,924960,False,3,165,205,40
167497,2019-10-25 00:00:00+03:00,out,False,924958,False,1,223,236,13
167497,2019-10-25 00:00:00+03:00,in,False,924950,False,4,349,463,114
167497,2019-10-25 00:00:00+03:00,out,False,924952,False,3,172,207,35
167497,2019-10-25 00:00:00+03:00,out,False,924934,False,1,63,69,6
167497,2019-10-25 00:00:00+03:00,out,False,924960,True,1,0,36,36
167497,2019-10-25 00:00:00+03:00,out,False,924930,False,5,330,392,62
167497,2019-10-25 00:00:00+03:00,out,True,924948,False,3,108,138,30
167497,2019-10-25 00:00:00+03:00,in,False,924930,True,1,0,9,9
167497,2019-10-25 00:00:00+03:00,out,False,924950,True,4,0,128,128
167497,2019-10-25 00:00:00+03:00,in,False,924952,False,3,80,164,84
167497,2019-10-25 00:00:00+03:00,out,False,924950,False,6,630,738,108
167497,2019-10-25 00:00:00+03:00,out,True,924958,False,1,10,18,8
167497,2019-10-25 00:00:00+03:00,out,True,924932,False,1,186,210,24
167497,2019-10-25 00:00:00+03:00,in,False,924956,False,1,9,56,47
167497,2019-10-25 00:00:00+03:00,in,False,-1,True,12,0,273,273
167497,2019-10-25 00:00:00+03:00,out,True,924930,True,1,0,28,28
167497,2019-10-25 00:00:00+03:00,out,True,924930,False,3,121,179,58
167497,2019-10-25 00:00:00+03:00,out,False,932836,False,5,410,503,93
167497,2019-10-25 00:00:00+03:00,out,False,924934,True,3,0,75,75
167497,2019-10-25 00:00:00+03:00,out,False,932836,True,1,0,0,0
167497,2019-10-25 00:00:00+03:00,in,False,924930,False,4,121,240,119
167497,2019-10-25 00:00:00+03:00,out,True,924960,False,1,25,30,5
167497,2019-10-25 00:00:00+03:00,out,False,924928,False,1,135,141,6
167497,2019-10-25 00:00:00+03:00,out,False,924940,False,4,611,665,54
167497,2019-10-25 00:00:00+03:00,in,False,924960,False,1,75,99,24
167497,2019-10-25 00:00:00+03:00,out,True,924952,True,1,0,3,3
167497,2019-10-25 00:00:00+03:00,in,False,924952,False,3,80,164,84
167497,2019-10-25 00:00:00+03:00,out,False,924950,True,4,0,128,128
167497,2019-10-26 00:00:00+03:00,out,False,924930,True,1,0,16,16
167497,2019-10-26 00:00:00+03:00,out,False,924954,False,1,23,34,11
167497,2019-10-26 00:00:00+03:00,out,False,924954,True,3,0,76,76
167497,2019-10-26 00:00:00+03:00,out,False,924950,False,2,49,79,30
167497,2019-10-26 00:00:00+03:00,in,False,-1,True,1,0,47,47
167497,2019-10-26 00:00:00+03:00,out,False,924948,True,7,0,106,106
167497,2019-10-26 00:00:00+03:00,out,False,924960,True,1,0,3,3
167497,2019-10-26 00:00:00+03:00,out,False,924950,True,1,0,14,14
167497,2019-10-26 00:00:00+03:00,in,False,924960,False,1,198,259,61
167497,2019-10-26 00:00:00+03:00,out,False,932836,False,8,265,336,71
167497,2019-10-26 00:00:00+03:00,out,False,924960,False,1,19,33,14
167497,2019-10-26 00:00:00+03:00,out,False,924952,False,2,100,148,48
167497,2019-10-26 00:00:00+03:00,out,False,924930,False,1,75,85,10
167497,2019-10-26 00:00:00+03:00,out,False,924948,False,3,146,180,34
167497,2019-10-26 00:00:00+03:00,out,False,924952,True,1,0,15,15
167497,2019-10-26 00:00:00+03:00,out,False,924930,False,1,75,85,10
167497,2019-10-27 00:00:00+03:00,out,False,924930,False,2,122,158,36
167497,2019-10-27 00:00:00+03:00,out,False,924940,True,2,0,46,46
167497,2019-10-27 00:00:00+03:00,out,False,924930,True,1,0,2,2
167497,2019-10-27 00:00:00+03:00,out,True,924954,True,1,0,0,0
167497,2019-10-27 00:00:00+03:00,out,False,924940,False,4,501,551,50
167497,2019-10-27 00:00:00+03:00,out,False,932836,True,1,0,36,36
167497,2019-10-27 00:00:00+03:00,out,False,924960,False,2,159,204,45
167497,2019-10-27 00:00:00+03:00,out,False,924960,True,2,0,40,40
167497,2019-10-27 00:00:00+03:00,out,False,924950,False,1,36,56,20
167497,2019-10-27 00:00:00+03:00,out,False,924930,False,2,122,158,36
167497,2019-10-28 00:00:00+03:00,out,False,924940,True,2,0,40,40
167497,2019-10-28 00:00:00+03:00,out,True,924930,False,1,35,45,10
167497,2019-10-28 00:00:00+03:00,out,False,932836,False,6,844,920,76
167497,2019-10-28 00:00:00+03:00,out,False,924948,False,5,316,404,88
167497,2019-10-28 00:00:00+03:00,out,False,924950,True,2,0,44,44
167497,2019-10-28 00:00:00+03:00,out,False,924960,False,3,291,336,45
167497,2019-10-28 00:00:00+03:00,out,True,924934,False,6,714,852,138
167497,2019-10-28 00:00:00+03:00,out,False,924958,True,4,0,74,74
167497,2019-10-28 00:00:00+03:00,out,False,924940,False,3,165,210,45
167497,2019-10-28 00:00:00+03:00,out,False,924954,False,3,827,887,60
167497,2019-10-28 00:00:00+03:00,in,False,924940,False,1,46,57,11
167497,2019-10-28 00:00:00+03:00,in,False,924928,False,3,101,155,54
167497,2019-10-28 00:00:00+03:00,out,False,924934,False,2,553,569,16
167497,2019-10-28 00:00:00+03:00,out,True,924958,False,1,34,42,8
167497,2019-10-28 00:00:00+03:00,out,False,924958,False,4,337,398,61
167497,2019-10-28 00:00:00+03:00,out,True,924940,False,2,439,475,36
167497,2019-10-28 00:00:00+03:00,out,False,932836,True,6,0,122,122
167497,2019-10-28 00:00:00+03:00,out,True,924950,False,1,422,433,11
167497,2019-10-28 00:00:00+03:00,in,False,924958,False,4,764,815,51
167497,2019-10-28 00:00:00+03:00,out,True,924928,False,2,64,72,8
167497,2019-10-28 00:00:00+03:00,in,False,-1,True,4,0,100,100
167497,2019-10-28 00:00:00+03:00,out,False,924960,True,2,0,53,53
167497,2019-10-28 00:00:00+03:00,out,True,924950,True,4,0,191,191
167497,2019-10-28 00:00:00+03:00,out,True,924960,True,1,0,22,22
167497,2019-10-28 00:00:00+03:00,out,False,924950,False,11,2439,2559,120
167497,2019-10-28 00:00:00+03:00,in,False,924960,False,2,110,133,23
167497,2019-10-28 00:00:00+03:00,out,True,924958,True,2,0,44,44
167497,2019-10-28 00:00:00+03:00,out,False,924948,True,2,0,59,59
167497,2019-10-28 00:00:00+03:00,out,False,924930,False,7,588,701,113
167497,2019-10-28 00:00:00+03:00,out,False,921116,False,2,309,327,18
167497,2019-10-28 00:00:00+03:00,out,False,924930,True,2,0,87,87
167497,2019-10-28 00:00:00+03:00,out,True,924932,False,1,185,193,8
167497,2019-10-28 00:00:00+03:00,out,True,924960,False,1,24,54,30
167497,2019-10-28 00:00:00+03:00,out,True,924932,False,1,185,193,8
167497,2019-10-28 00:00:00+03:00,out,False,924950,True,2,0,44,44
167497,2019-10-28 00:00:00+03:00,out,False,924960,False,3,291,336,45
167497,2019-10-28 00:00:00+03:00,out,False,924930,False,7,588,701,113
167497,2019-10-28 00:00:00+03:00,out,False,924940,True,2,0,40,40
167497,2019-10-28 00:00:00+03:00,out,False,924958,False,4,337,398,61
167497,2019-10-29 00:00:00+03:00,out,True,924934,False,3,91,132,41
167497,2019-10-29 00:00:00+03:00,out,True,924930,False,1,129,136,7
167497,2019-10-29 00:00:00+03:00,out,False,924950,False,1,8,11,3
167497,2019-10-29 00:00:00+03:00,out,False,924950,True,2,0,66,66
167497,2019-10-29 00:00:00+03:00,out,False,924934,False,15,1714,1941,227
167497,2019-10-29 00:00:00+03:00,out,False,924958,True,3,0,89,89
167497,2019-10-29 00:00:00+03:00,out,False,924958,False,1,211,227,16
167497,2019-10-29 00:00:00+03:00,out,False,924934,True,4,0,78,78
167497,2019-10-29 00:00:00+03:00,out,False,932836,False,1,364,368,4
167497,2019-10-29 00:00:00+03:00,out,True,924960,False,2,110,132,22
167497,2019-10-29 00:00:00+03:00,in,False,-1,True,5,0,121,121
167497,2019-10-29 00:00:00+03:00,out,False,924946,True,1,0,44,44
167497,2019-10-29 00:00:00+03:00,in,False,924958,False,1,43,50,7
167497,2019-10-29 00:00:00+03:00,out,True,924928,False,1,329,338,9
167497,2019-10-29 00:00:00+03:00,in,False,924928,False,2,180,198,18
167497,2019-10-29 00:00:00+03:00,in,False,924960,False,1,11,18,7
167497,2019-10-29 00:00:00+03:00,out,False,924960,False,3,99,117,18
167497,2019-10-29 00:00:00+03:00,in,False,924956,False,1,31,64,33
167497,2019-10-29 00:00:00+03:00,in,False,924928,True,1,107,117,10
167497,2019-10-29 00:00:00+03:00,out,True,924950,False,1,24,39,15
167497,2019-10-29 00:00:00+03:00,in,True,924956,False,1,180,238,58
167497,2019-10-29 00:00:00+03:00,out,False,924952,False,1,13,48,35
167497,2019-10-29 00:00:00+03:00,out,False,924946,False,3,309,354,45
167497,2019-10-29 00:00:00+03:00,out,False,924930,False,4,449,519,70
167497,2019-10-29 00:00:00+03:00,out,True,924960,True,1,0,48,48
167497,2019-10-29 00:00:00+03:00,in,False,932836,False,1,41,74,33
167497,2019-10-29 00:00:00+03:00,out,False,924960,True,1,0,42,42
167497,2019-10-29 00:00:00+03:00,out,True,924934,True,2,0,29,29
167497,2019-10-29 00:00:00+03:00,in,False,-1,True,2,0,48,48
167497,2019-10-29 00:00:00+03:00,out,False,924946,False,3,309,354,45
167497,2019-10-29 00:00:00+03:00,out,False,924950,False,1,8,11,3
167497,2019-10-29 00:00:00+03:00,out,False,924934,False,15,1714,1941,227
167497,2019-10-30 00:00:00+03:00,out,False,921116,False,1,203,211,8
167497,2019-10-30 00:00:00+03:00,in,False,924956,False,1,65,74,9
167497,2019-10-30 00:00:00+03:00,out,False,924934,True,3,0,69,69
167497,2019-10-30 00:00:00+03:00,in,False,924946,False,3,679,789,110
167497,2019-10-30 00:00:00+03:00,out,False,924946,True,3,0,33,33
167497,2019-10-30 00:00:00+03:00,in,False,924930,False,3,582,674,92
167497,2019-10-30 00:00:00+03:00,out,True,921116,False,1,16,22,6
167497,2019-10-30 00:00:00+03:00,out,False,924960,True,3,0,79,79
167497,2019-10-30 00:00:00+03:00,out,True,924948,False,2,1250,1281,31
167497,2019-10-30 00:00:00+03:00,out,True,924934,False,8,536,699,163
167497,2019-10-30 00:00:00+03:00,out,False,924934,False,5,641,729,88
167497,2019-10-30 00:00:00+03:00,out,False,924960,False,2,159,196,37
167497,2019-10-30 00:00:00+03:00,out,True,924958,True,1,0,28,28
167497,2019-10-30 00:00:00+03:00,out,True,924928,False,3,55,94,39
167497,2019-10-30 00:00:00+03:00,in,True,924946,False,1,169,203,34
167497,2019-10-30 00:00:00+03:00,out,False,924950,False,2,116,142,26
167497,2019-10-30 00:00:00+03:00,out,True,924930,False,1,43,55,12
167497,2019-10-30 00:00:00+03:00,out,False,924958,True,4,0,139,139
167497,2019-10-30 00:00:00+03:00,out,True,924946,False,8,1851,1963,112
167497,2019-10-30 00:00:00+03:00,out,True,924960,False,1,74,93,19
167497,2019-10-30 00:00:00+03:00,in,False,-1,True,1,0,85,85
167497,2019-10-30 00:00:00+03:00,in,False,924928,False,1,71,116,45
167497,2019-10-30 00:00:00+03:00,out,True,924950,False,11,1485,1702,217
167497,2019-10-30 00:00:00+03:00,out,True,924946,True,3,0,64,64
167497,2019-10-30 00:00:00+03:00,out,False,924930,False,1,33,45,12
167497,2019-10-30 00:00:00+03:00,out,True,924956,False,1,15,28,13
167497,2019-10-30 00:00:00+03:00,in,False,924958,False,1,47,56,9
167497,2019-10-30 00:00:00+03:00,out,False,924958,False,7,366,478,112
167497,2019-10-30 00:00:00+03:00,out,False,921116,True,1,0,39,39
167497,2019-10-30 00:00:00+03:00,in,False,-1,True,2,0,12,12
167497,2019-10-30 00:00:00+03:00,out,False,924946,False,1,216,223,7
167497,2019-10-30 00:00:00+03:00,in,False,924960,False,3,141,190,49
167497,2019-10-30 00:00:00+03:00,out,False,924934,True,3,0,69,69
167497,2019-10-30 00:00:00+03:00,out,False,924958,True,4,0,139,139
167497,2019-10-30 00:00:00+03:00,out,False,924960,True,3,0,79,79
167497,2019-10-31 00:00:00+03:00,out,False,921116,False,5,177,235,58
167497,2019-10-31 00:00:00+03:00,in,False,-1,True,2,0,24,24
167497,2019-10-31 00:00:00+03:00,out,False,932836,False,10,1134,1270,136
167497,2019-10-31 00:00:00+03:00,in,False,-1,True,1,0,3,3
167497,2019-10-31 00:00:00+03:00,out,True,924940,True,1,0,19,19
167497,2019-10-31 00:00:00+03:00,out,False,924930,True,3,0,8,8
167497,2019-10-31 00:00:00+03:00,out,True,932836,False,1,304,315,11
167497,2019-10-31 00:00:00+03:00,in,False,932836,False,1,108,116,8
167497,2019-10-31 00:00:00+03:00,out,False,924934,False,6,551,658,107
167497,2019-10-31 00:00:00+03:00,out,True,924930,True,4,0,37,37
167497,2019-10-31 00:00:00+03:00,in,False,924930,False,2,607,644,37
167497,2019-10-31 00:00:00+03:00,out,False,950672,False,5,678,754,76
167497,2019-10-31 00:00:00+03:00,out,True,924930,False,1,165,179,14
167497,2019-10-31 00:00:00+03:00,out,True,924952,False,2,137,146,9
167497,2019-10-31 00:00:00+03:00,out,False,924928,True,2,0,11,11
167497,2019-10-31 00:00:00+03:00,out,True,924954,True,1,0,3,3
167497,2019-10-31 00:00:00+03:00,out,False,921116,True,4,0,89,89
167497,2019-10-31 00:00:00+03:00,out,False,924958,True,4,0,69,69
167497,2019-10-31 00:00:00+03:00,out,True,924934,False,5,427,506,79
167497,2019-10-31 00:00:00+03:00,out,False,924954,True,1,0,40,40
167497,2019-10-31 00:00:00+03:00,out,False,924940,True,1,0,13,13
167497,2019-10-31 00:00:00+03:00,in,False,924954,False,2,47,108,61
167497,2019-10-31 00:00:00+03:00,in,False,924928,False,1,57,67,10
167497,2019-10-31 00:00:00+03:00,out,True,924950,True,1,0,0,0
167497,2019-10-31 00:00:00+03:00,out,True,924948,True,1,0,18,18
167497,2019-10-31 00:00:00+03:00,out,True,924940,False,3,343,389,46
167497,2019-10-31 00:00:00+03:00,out,False,950672,True,3,0,59,59
167497,2019-10-31 00:00:00+03:00,out,False,924948,False,4,552,583,31
167497,2019-10-31 00:00:00+03:00,out,False,932836,True,2,0,67,67
167497,2019-10-31 00:00:00+03:00,out,True,924954,False,1,169,198,29
167497,2019-10-31 00:00:00+03:00,out,False,924940,False,2,102,140,38
167497,2019-10-31 00:00:00+03:00,out,True,924960,True,2,0,51,51
167497,2019-10-31 00:00:00+03:00,out,True,924960,False,2,107,135,28
167497,2019-10-31 00:00:00+03:00,out,False,924950,True,2,0,20,20
167497,2019-10-31 00:00:00+03:00,out,False,924958,False,12,972,1139,167
167497,2019-10-31 00:00:00+03:00,out,True,924934,True,1,0,62,62
167497,2019-10-31 00:00:00+03:00,out,False,924934,True,3,0,79,79
167497,2019-10-31 00:00:00+03:00,out,True,924948,False,1,1273,1290,17
167497,2019-10-31 00:00:00+03:00,out,False,924950,False,3,437,463,26
167497,2019-10-31 00:00:00+03:00,out,True,924934,True,1,0,62,62
167497,2019-10-31 00:00:00+03:00,in,False,932836,False,1,108,116,8
167497,2019-10-31 00:00:00+03:00,out,False,924940,False,2,102,140,38
167497,2019-11-01 00:00:00+03:00,out,True,924934,False,8,582,680,98
167497,2019-11-01 00:00:00+03:00,out,True,924946,False,2,542,575,33
167497,2019-11-01 00:00:00+03:00,out,False,950672,False,2,135,190,55
167497,2019-11-01 00:00:00+03:00,in,False,-1,True,4,0,29,29
167497,2019-11-01 00:00:00+03:00,out,False,924960,True,2,0,25,25
167497,2019-11-01 00:00:00+03:00,in,False,924952,False,1,100,128,28
167497,2019-11-01 00:00:00+03:00,out,False,924948,True,2,0,44,44
167497,2019-11-01 00:00:00+03:00,out,True,924946,True,3,0,100,100
167497,2019-11-01 00:00:00+03:00,out,False,921116,False,1,143,152,9
167497,2019-11-01 00:00:00+03:00,out,False,924930,False,1,185,210,25
167497,2019-11-01 00:00:00+03:00,out,True,924954,False,3,254,311,57
167497,2019-11-01 00:00:00+03:00,out,False,924930,True,2,0,60,60
167497,2019-11-01 00:00:00+03:00,out,True,924930,False,1,25,30,5
167497,2019-11-01 00:00:00+03:00,out,False,924960,False,3,48,69,21
167497,2019-11-01 00:00:00+03:00,out,True,924958,False,4,816,855,39
167497,2019-11-01 00:00:00+03:00,in,False,924948,False,1,338,367,29
167497,2019-11-01 00:00:00+03:00,out,True,924958,True,2,0,2,2
167497,2019-11-01 00:00:00+03:00,out,True,924960,True,3,0,82,82
167497,2019-11-01 00:00:00+03:00,out,False,924934,True,7,0,97,97
167497,2019-11-01 00:00:00+03:00,out,True,924934,True,3,0,143,143
167497,2019-11-01 00:00:00+03:00,in,False,924954,False,1,164,220,56
167497,2019-11-01 00:00:00+03:00,out,True,924960,False,2,119,143,24
167497,2019-11-01 00:00:00+03:00,out,False,924940,False,7,516,634,118
167497,2019-11-01 00:00:00+03:00,out,False,950672,True,1,0,30,30
167497,2019-11-01 00:00:00+03:00,out,True,950672,False,2,181,218,37
167497,2019-11-01 00:00:00+03:00,out,True,924950,False,10,1424,1568,144
167497,2019-11-01 00:00:00+03:00,out,False,924934,False,16,1487,1772,285
167497,2019-11-01 00:00:00+03:00,out,False,924950,False,1,38,56,18
167497,2019-11-01 00:00:00+03:00,out,False,924948,False,8,630,775,145
167497,2019-11-01 00:00:00+03:00,out,True,924950,True,1,0,27,27
167497,2019-11-01 00:00:00+03:00,in,False,-1,True,2,0,23,23
167497,2019-11-01 00:00:00+03:00,out,False,924940,True,6,0,129,129
167497,2019-11-01 00:00:00+03:00,out,False,924954,False,1,175,191,16
167497,2019-11-01 00:00:00+03:00,out,True,924954,True,1,0,28,28
167497,2019-11-01 00:00:00+03:00,in,False,924950,False,1,61,94,33
167497,2019-11-01 00:00:00+03:00,in,False,924948,False,1,338,367,29
167497,2019-11-01 00:00:00+03:00,in,False,924952,False,1,100,128,28
167497,2019-11-01 00:00:00+03:00,out,True,924958,True,2,0,2,2
167497,2019-11-01 00:00:00+03:00,out,False,924948,False,8,630,775,145
167497,2019-11-01 00:00:00+03:00,out,False,924940,False,7,516,634,118
167497,2019-11-01 00:00:00+03:00,out,False,924930,True,2,0,60,60
167497,2019-11-01 00:00:00+03:00,out,True,924946,True,3,0,100,100
167497,2019-11-02 00:00:00+03:00,out,False,924958,True,1,0,12,12
167497,2019-11-02 00:00:00+03:00,out,False,924948,False,4,238,309,71
167497,2019-11-02 00:00:00+03:00,out,False,924952,False,2,129,164,35
167497,2019-11-02 00:00:00+03:00,in,False,-1,True,1,0,7,7
167497,2019-11-02 00:00:00+03:00,out,False,932836,True,4,0,100,100
167497,2019-11-02 00:00:00+03:00,out,False,924946,True,1,0,8,8
167497,2019-11-02 00:00:00+03:00,in,False,924936,True,2,0,27,27
167497,2019-11-02 00:00:00+03:00,out,False,932836,False,1,16,29,13
167497,2019-11-03 00:00:00+03:00,out,True,932836,False,2,1340,1344,4
167497,2019-11-03 00:00:00+03:00,in,False,924960,False,1,29,81,52
167497,2019-11-03 00:00:00+03:00,out,True,924928,False,1,27,41,14
167497,2019-11-03 00:00:00+03:00,out,False,924952,False,1,56,64,8
167497,2019-11-03 00:00:00+03:00,in,False,924928,False,1,46,75,29
167497,2019-11-03 00:00:00+03:00,in,False,-1,True,2,0,73,73
167497,2019-11-03 00:00:00+03:00,out,False,932836,False,2,43,77,34
167497,2019-11-03 00:00:00+03:00,in,False,924936,False,1,15,68,53
167497,2019-11-04 00:00:00+03:00,in,False,-1,True,1,0,44,44
167497,2019-11-04 00:00:00+03:00,out,True,924950,True,1,0,0,0
167497,2019-11-04 00:00:00+03:00,out,True,932836,False,1,93,95,2
167497,2019-11-04 00:00:00+03:00,out,False,932836,False,1,49,107,58
167497,2019-11-04 00:00:00+03:00,in,False,-1,True,1,0,9,9
167497,2019-11-04 00:00:00+03:00,in,False,924950,False,1,225,237,12
167497,2019-11-04 00:00:00+03:00,out,False,924950,True,1,0,47,47
167497,2019-11-05 00:00:00+03:00,out,True,924958,False,3,266,310,44
167497,2019-11-05 00:00:00+03:00,out,True,921116,True,3,0,81,81
167497,2019-11-05 00:00:00+03:00,out,False,921116,False,3,364,400,36
167497,2019-11-05 00:00:00+03:00,out,False,924948,False,11,1844,1977,133
167497,2019-11-05 00:00:00+03:00,out,False,924934,False,24,2095,2447,352
167497,2019-11-05 00:00:00+03:00,out,True,924960,True,3,0,70,70
167497,2019-11-05 00:00:00+03:00,in,False,924958,False,1,106,115,9
167497,2019-11-05 00:00:00+03:00,out,False,924930,False,9,955,1091,136
167497,2019-11-05 00:00:00+03:00,out,False,924960,False,2,404,421,17
167497,2019-11-05 00:00:00+03:00,out,True,924948,False,5,1160,1212,52
167497,2019-11-05 00:00:00+03:00,out,False,924950,True,1,0,9,9
167497,2019-11-05 00:00:00+03:00,out,False,950672,False,1,32,48,16
167497,2019-11-05 00:00:00+03:00,out,True,924950,False,13,2172,2391,219
167497,2019-11-05 00:00:00+03:00,out,False,924950,False,5,481,548,67
167497,2019-11-05 00:00:00+03:00,out,False,924948,True,3,0,125,125
167497,2019-11-05 00:00:00+03:00,out,True,924958,True,7,0,52,52
167497,2019-11-05 00:00:00+03:00,out,True,924960,False,2,127,146,19
167497,2019-11-05 00:00:00+03:00,in,False,-1,True,6,0,54,54
167497,2019-11-05 00:00:00+03:00,out,True,924940,False,3,490,546,56
167497,2019-11-05 00:00:00+03:00,out,True,924950,True,4,0,152,152
167497,2019-11-05 00:00:00+03:00,in,False,924928,False,1,53,82,29
167497,2019-11-05 00:00:00+03:00,out,False,924934,True,10,0,376,376
167497,2019-11-05 00:00:00+03:00,out,False,921116,True,3,0,36,36
167497,2019-11-05 00:00:00+03:00,out,True,924934,False,12,1187,1377,190
167497,2019-11-05 00:00:00+03:00,out,True,924930,True,2,0,76,76
167497,2019-11-05 00:00:00+03:00,out,False,924940,False,1,224,236,12
167497,2019-11-05 00:00:00+03:00,out,True,924952,True,1,0,0,0
167497,2019-11-05 00:00:00+03:00,out,False,924960,True,3,0,15,15
167497,2019-11-05 00:00:00+03:00,out,False,924952,False,1,107,124,17
167497,2019-11-05 00:00:00+03:00,in,False,924952,False,3,738,797,59
167497,2019-11-05 00:00:00+03:00,out,False,924930,True,3,0,153,153
167497,2019-11-05 00:00:00+03:00,in,False,924948,False,2,398,438,40
167497,2019-11-05 00:00:00+03:00,out,False,924952,True,1,0,9,9
167497,2019-11-05 00:00:00+03:00,out,True,924934,True,1,0,8,8
167497,2019-11-05 00:00:00+03:00,in,False,-1,True,4,0,128,128
167497,2019-11-05 00:00:00+03:00,in,False,924960,False,1,173,200,27
167497,2019-11-05 00:00:00+03:00,out,True,921116,False,4,263,304,41
167497,2019-11-05 00:00:00+03:00,in,False,-1,True,4,0,128,128
167497,2019-11-05 00:00:00+03:00,out,False,924960,False,2,404,421,17
167497,2019-11-05 00:00:00+03:00,out,True,924930,True,2,0,76,76
167497,2019-11-05 00:00:00+03:00,out,False,924950,True,1,0,9,9
167497,2019-11-06 00:00:00+03:00,out,False,921116,True,3,0,63,63
167497,2019-11-06 00:00:00+03:00,out,True,924940,True,1,0,17,17
167497,2019-11-06 00:00:00+03:00,out,True,924958,False,2,28,36,8
167497,2019-11-06 00:00:00+03:00,out,True,924950,False,6,1136,1212,76
167497,2019-11-06 00:00:00+03:00,out,False,924960,False,1,51,57,6
167497,2019-11-06 00:00:00+03:00,out,True,924934,False,9,648,785,137
167497,2019-11-06 00:00:00+03:00,out,False,924934,False,6,811,887,76
167497,2019-11-06 00:00:00+03:00,out,True,921116,False,2,450,471,21
167497,2019-11-06 00:00:00+03:00,out,False,924940,False,9,580,668,88
167497,2019-11-06 00:00:00+03:00,in,False,924948,False,2,88,101,13
167497,2019-11-06 00:00:00+03:00,in,False,924928,False,1,335,346,11
167497,2019-11-06 00:00:00+03:00,out,True,924930,False,3,181,234,53
167497,2019-11-06 00:00:00+03:00,out,True,924960,False,1,687,710,23
167497,2019-11-06 00:00:00+03:00,out,False,924948,True,1,0,47,47
167497,2019-11-06 00:00:00+03:00,out,False,924950,False,1,59,62,3
167497,2019-11-06 00:00:00+03:00,in,False,924936,False,1,264,271,7
167497,2019-11-06 00:00:00+03:00,out,True,924930,True,1,0,8,8
167497,2019-11-06 00:00:00+03:00,out,False,924958,False,6,1082,1158,76
167497,2019-11-06 00:00:00+03:00,out,False,924948,False,12,2738,2855,117
167497,2019-11-06 00:00:00+03:00,out,False,924930,False,9,1365,1468,103
167497,2019-11-06 00:00:00+03:00,in,False,924956,False,3,33,70,37
167497,2019-11-06 00:00:00+03:00,in,False,-1,True,6,0,84,84
167497,2019-11-06 00:00:00+03:00,in,False,-1,True,3,0,72,72
167497,2019-11-06 00:00:00+03:00,out,True,924932,False,1,89,106,17
167497,2019-11-06 00:00:00+03:00,out,True,924928,False,2,631,664,33
167497,2019-11-06 00:00:00+03:00,out,False,924934,True,9,0,205,205
167497,2019-11-06 00:00:00+03:00,out,False,924958,True,6,0,119,119
167497,2019-11-06 00:00:00+03:00,in,False,924950,False,2,165,250,85
167497,2019-11-06 00:00:00+03:00,out,False,924940,True,6,0,219,219
167497,2019-11-06 00:00:00+03:00,out,False,924930,True,5,0,115,115
167497,2019-11-06 00:00:00+03:00,out,False,921116,False,3,141,186,45
167497,2019-11-06 00:00:00+03:00,out,True,921116,True,1,0,21,21
167497,2019-11-06 00:00:00+03:00,out,True,924960,True,1,0,10,10
167497,2019-11-06 00:00:00+03:00,in,False,924956,False,3,33,70,37
167497,2019-11-07 00:00:00+03:00,in,True,924948,False,2,487,552,65
167497,2019-11-07 00:00:00+03:00,out,True,932836,True,1,0,36,36
167497,2019-11-07 00:00:00+03:00,out,True,932836,False,6,1423,1526,103
167497,2019-11-07 00:00:00+03:00,out,False,924960,False,1,127,139,12
167497,2019-11-07 00:00:00+03:00,out,True,924948,True,1,0,29,29
167497,2019-11-07 00:00:00+03:00,out,False,924952,True,4,0,41,41
167497,2019-11-07 00:00:00+03:00,out,True,924960,False,4,446,479,33
167497,2019-11-07 00:00:00+03:00,out,True,924950,False,3,346,396,50
167497,2019-11-07 00:00:00+03:00,out,False,924958,True,1,0,8,8
167497,2019-11-07 00:00:00+03:00,in,False,-1,True,3,0,34,34
167497,2019-11-07 00:00:00+03:00,out,False,924948,True,3,0,74,74
167497,2019-11-07 00:00:00+03:00,in,True,924960,False,1,34,61,27
167497,2019-11-07 00:00:00+03:00,out,False,924940,True,8,0,131,131
167497,2019-11-07 00:00:00+03:00,out,True,924940,True,2,0,75,75
167497,2019-11-07 00:00:00+03:00,out,True,924960,True,4,0,100,100
167497,2019-11-07 00:00:00+03:00,out,False,924948,False,1,91,104,13
167497,2019-11-07 00:00:00+03:00,out,False,924958,False,1,123,132,9
167497,2019-11-07 00:00:00+03:00,out,False,924960,True,2,0,9,9
167497,2019-11-07 00:00:00+03:00,out,False,921116,False,1,183,195,12
167497,2019-11-07 00:00:00+03:00,out,False,924952,False,3,110,148,38
167497,2019-11-07 00:00:00+03:00,out,True,924950,True,1,0,2,2
167497,2019-11-07 00:00:00+03:00,out,False,932836,False,3,343,387,44
167497,2019-11-07 00:00:00+03:00,out,True,924948,False,1,175,187,12
167497,2019-11-07 00:00:00+03:00,out,True,924952,False,1,238,247,9
167497,2019-11-07 00:00:00+03:00,out,False,924934,True,7,0,149,149
167497,2019-11-07 00:00:00+03:00,out,True,924934,False,4,484,547,63
167497,2019-11-07 00:00:00+03:00,out,True,921116,False,1,35,39,4
167497,2019-11-07 00:00:00+03:00,out,True,924928,False,1,112,127,15
167497,2019-11-07 00:00:00+03:00,in,False,-1,True,2,0,90,90
167497,2019-11-07 00:00:00+03:00,out,False,924940,False,3,569,617,48
167497,2019-11-07 00:00:00+03:00,in,False,924952,False,1,300,338,38
167497,2019-11-07 00:00:00+03:00,in,False,924936,False,2,78,106,28
167497,2019-11-07 00:00:00+03:00,out,False,924930,False,4,532,592,60
167497,2019-11-07 00:00:00+03:00,in,False,924960,False,1,70,84,14
167497,2019-11-07 00:00:00+03:00,out,False,924930,True,3,0,113,113
167497,2019-11-07 00:00:00+03:00,out,True,924940,False,7,2147,2265,118
167497,2019-11-07 00:00:00+03:00,out,False,924934,False,7,982,1055,73
167497,2019-11-07 00:00:00+03:00,out,True,924934,True,3,0,97,97
167497,2019-11-07 00:00:00+03:00,out,True,921116,True,1,0,2,2
167497,2019-11-07 00:00:00+03:00,in,False,924960,True,1,0,9,9
167497,2019-11-07 00:00:00+03:00,in,False,924950,False,3,147,203,56
167497,2019-11-07 00:00:00+03:00,in,False,924956,False,3,301,355,54
167497,2019-11-07 00:00:00+03:00,out,True,932836,False,6,1423,1526,103
167497,2019-11-07 00:00:00+03:00,out,False,924958,True,1,0,8,8
167497,2019-11-07 00:00:00+03:00,in,False,924950,False,3,147,203,56
167497,2019-11-07 00:00:00+03:00,out,False,921116,False,1,183,195,12
167497,2019-11-07 00:00:00+03:00,out,False,924940,False,3,569,617,48
167497,2019-11-07 00:00:00+03:00,out,True,924950,False,3,346,396,50
167497,2019-11-08 00:00:00+03:00,in,False,924928,False,3,102,159,57
167497,2019-11-08 00:00:00+03:00,in,False,-1,True,1,0,42,42
167497,2019-11-08 00:00:00+03:00,out,False,924934,True,9,0,201,201
167497,2019-11-08 00:00:00+03:00,out,True,924930,False,6,3108,3316,208
167497,2019-11-08 00:00:00+03:00,out,False,924940,True,2,0,35,35
167497,2019-11-08 00:00:00+03:00,out,False,950672,False,9,1964,2070,106
167497,2019-11-08 00:00:00+03:00,out,False,924934,False,6,368,431,63
167497,2019-11-08 00:00:00+03:00,out,True,924928,False,1,82,106,24
167497,2019-11-08 00:00:00+03:00,in,False,932836,False,4,183,230,47
167497,2019-11-08 00:00:00+03:00,out,True,924948,False,1,75,89,14
167497,2019-11-08 00:00:00+03:00,out,True,924934,False,4,607,696,89
167497,2019-11-08 00:00:00+03:00,out,True,932836,True,1,0,4,4
167497,2019-11-08 00:00:00+03:00,out,True,924950,False,2,112,145,33
167497,2019-11-08 00:00:00+03:00,out,False,950672,True,3,0,19,19
167497,2019-11-08 00:00:00+03:00,out,False,924960,True,1,0,39,39
167497,2019-11-08 00:00:00+03:00,out,False,924948,False,2,107,142,35
167497,2019-11-08 00:00:00+03:00,out,True,924950,True,1,0,60,60
167497,2019-11-08 00:00:00+03:00,out,False,924950,False,1,78,88,10
167497,2019-11-08 00:00:00+03:00,out,True,924960,False,1,84,88,4
167497,2019-11-08 00:00:00+03:00,out,False,932836,True,4,0,39,39
167497,2019-11-08 00:00:00+03:00,out,False,924948,True,2,0,29,29
167497,2019-11-08 00:00:00+03:00,out,False,924940,False,6,433,506,73
167497,2019-11-08 00:00:00+03:00,out,True,950672,True,4,0,113,113
167497,2019-11-08 00:00:00+03:00,in,False,-1,True,9,0,131,131
167497,2019-11-08 00:00:00+03:00,out,True,921116,True,1,0,60,60
167497,2019-11-08 00:00:00+03:00,out,True,924958,False,1,29,34,5
167497,2019-11-08 00:00:00+03:00,in,False,924958,False,2,78,120,42
167497,2019-11-08 00:00:00+03:00,out,False,924958,True,1,0,26,26
167497,2019-11-08 00:00:00+03:00,out,True,924952,False,1,1,34,33
167497,2019-11-08 00:00:00+03:00,out,True,950672,False,5,376,465,89
167497,2019-11-08 00:00:00+03:00,out,False,924960,False,2,437,453,16
167497,2019-11-08 00:00:00+03:00,out,False,932836,False,5,774,853,79
167497,2019-11-08 00:00:00+03:00,in,False,924956,False,2,607,625,18
167497,2019-11-08 00:00:00+03:00,out,True,924934,True,3,0,134,134
167497,2019-11-08 00:00:00+03:00,out,True,932836,False,6,922,1001,79
167497,2019-11-08 00:00:00+03:00,out,False,924958,False,1,196,209,13
167497,2019-11-08 00:00:00+03:00,in,False,924940,False,1,1,11,10
167497,2019-11-08 00:00:00+03:00,out,True,924934,False,4,607,696,89
167497,2019-11-08 00:00:00+03:00,out,True,924958,False,1,29,34,5
167497,2019-11-09 00:00:00+03:00,out,True,921116,False,1,179,181,2
167497,2019-11-09 00:00:00+03:00,out,True,924960,True,1,0,30,30
167497,2019-11-09 00:00:00+03:00,out,False,924950,True,2,0,45,45
167497,2019-11-09 00:00:00+03:00,out,False,932836,True,1,0,23,23
167497,2019-11-09 00:00:00+03:00,out,False,932836,False,6,294,359,65
167497,2019-11-09 00:00:00+03:00,out,False,921116,False,1,867,874,7
167497,2019-11-09 00:00:00+03:00,in,False,924954,False,2,288,343,55
167497,2019-11-09 00:00:00+03:00,in,False,-1,True,3,0,37,37
167497,2019-11-09 00:00:00+03:00,out,False,924956,True,1,0,8,8
167497,2019-11-09 00:00:00+03:00,out,False,924958,True,1,0,1,1
167497,2019-11-09 00:00:00+03:00,out,True,924950,False,2,143,164,21
167497,2019-11-09 00:00:00+03:00,in,False,924956,False,2,164,216,52
167497,2019-11-09 00:00:00+03:00,out,False,924950,False,3,184,211,27
167497,2019-11-09 00:00:00+03:00,out,False,924960,False,6,530,603,73
167497,2019-11-09 00:00:00+03:00,in,False,924948,False,1,109,132,23
167497,2019-11-09 00:00:00+03:00,out,False,924948,False,4,488,549,61
167497,2019-11-09 00:00:00+03:00,out,True,932836,False,2,454,477,23
167497,2019-11-09 00:00:00+03:00,out,False,924948,True,2,0,50,50
167497,2019-11-09 00:00:00+03:00,in,False,-1,True,3,0,37,37
167497,2019-11-10 00:00:00+03:00,out,False,924930,False,2,379,446,67
167497,2019-11-10 00:00:00+03:00,in,False,924956,False,1,114,122,8
167497,2019-11-10 00:00:00+03:00,out,True,924960,False,1,71,80,9
167497,2019-11-10 00:00:00+03:00,out,True,932836,False,2,138,150,12
167497,2019-11-10 00:00:00+03:00,out,True,921116,False,1,64,90,26
167497,2019-11-10 00:00:00+03:00,out,True,924948,False,1,176,181,5
167497,2019-11-10 00:00:00+03:00,out,True,924950,False,1,277,297,20
167497,2019-11-10 00:00:00+03:00,in,False,-1,True,2,0,59,59
167497,2019-11-10 00:00:00+03:00,out,False,924948,False,6,565,652,87
167497,2019-11-10 00:00:00+03:00,out,True,924940,False,1,174,182,8
167497,2019-11-10 00:00:00+03:00,out,False,950672,False,1,16,36,20
167497,2019-11-10 00:00:00+03:00,out,False,924948,True,4,0,223,223
167497,2019-11-10 00:00:00+03:00,out,False,924948,True,4,0,223,223
167497,2019-11-10 00:00:00+03:00,out,True,924960,False,1,71,80,9
167497,2019-11-11 00:00:00+03:00,out,False,924930,False,4,467,533,66
167497,2019-11-11 00:00:00+03:00,in,False,924950,False,1,34,60,26
167497,2019-11-11 00:00:00+03:00,out,True,932836,False,4,291,316,25
167497,2019-11-11 00:00:00+03:00,out,False,924948,False,1,45,50,5
167497,2019-11-11 00:00:00+03:00,out,True,932836,True,1,0,0,0
167497,2019-11-11 00:00:00+03:00,in,False,924952,False,2,115,134,19
167497,2019-11-11 00:00:00+03:00,out,False,932836,False,2,35,73,38
167497,2019-11-11 00:00:00+03:00,out,True,924932,False,1,151,157,6
167497,2019-11-11 00:00:00+03:00,out,False,924928,True,1,0,25,25
167497,2019-11-11 00:00:00+03:00,out,True,924960,False,7,547,633,86
167497,2019-11-11 00:00:00+03:00,out,True,924934,True,2,0,1,1
167497,2019-11-11 00:00:00+03:00,out,True,924948,False,6,952,1102,150
167497,2019-11-11 00:00:00+03:00,out,False,921116,False,2,183,205,22
167497,2019-11-11 00:00:00+03:00,out,True,924940,False,2,266,278,12
167497,2019-11-11 00:00:00+03:00,out,False,924930,True,1,0,20,20
167497,2019-11-11 00:00:00+03:00,out,False,924940,False,5,238,321,83
167497,2019-11-11 00:00:00+03:00,out,True,924952,False,1,243,266,23
167497,2019-11-11 00:00:00+03:00,out,True,924928,False,1,37,66,29
167497,2019-11-11 00:00:00+03:00,in,False,924956,False,2,68,82,14
167497,2019-11-11 00:00:00+03:00,out,False,924934,False,20,2924,3184,260
167497,2019-11-11 00:00:00+03:00,out,True,924960,True,3,0,76,76
167497,2019-11-11 00:00:00+03:00,out,False,924960,False,1,98,106,8
167497,2019-11-11 00:00:00+03:00,out,False,924958,False,4,602,646,44
167497,2019-11-11 00:00:00+03:00,out,True,924950,False,1,1,12,11
167497,2019-11-11 00:00:00+03:00,out,True,950672,False,1,628,634,6
167497,2019-11-11 00:00:00+03:00,in,False,-1,True,2,0,117,117
167497,2019-11-11 00:00:00+03:00,out,True,924930,False,2,40,48,8
167497,2019-11-11 00:00:00+03:00,in,False,-1,True,4,0,150,150
167497,2019-11-11 00:00:00+03:00,out,True,950672,True,1,0,32,32
167497,2019-11-11 00:00:00+03:00,in,True,924960,False,1,28,54,26
167497,2019-11-11 00:00:00+03:00,in,True,924948,False,1,521,546,25
167497,2019-11-11 00:00:00+03:00,out,False,924948,True,1,0,54,54
167497,2019-11-11 00:00:00+03:00,out,False,924940,True,10,0,97,97
167497,2019-11-11 00:00:00+03:00,out,True,924934,False,11,613,731,118
167497,2019-11-11 00:00:00+03:00,out,False,924934,True,8,0,223,223
167497,2019-11-11 00:00:00+03:00,out,True,921116,False,2,106,122,16
167497,2019-11-11 00:00:00+03:00,out,False,924948,False,1,45,50,5
167497,2019-11-11 00:00:00+03:00,out,True,932836,True,1,0,0,0
167497,2019-11-12 00:00:00+03:00,out,False,921116,False,2,268,295,27
167497,2019-11-12 00:00:00+03:00,out,True,924928,False,1,36,64,28
167497,2019-11-12 00:00:00+03:00,out,False,924960,False,5,361,408,47
167497,2019-11-12 00:00:00+03:00,in,True,924928,False,8,1919,2126,207
167497,2019-11-12 00:00:00+03:00,in,True,924946,False,1,23,58,35
167497,2019-11-12 00:00:00+03:00,in,False,924946,False,1,147,159,12
167497,2019-11-12 00:00:00+03:00,out,False,924950,False,4,153,199,46
167497,2019-11-12 00:00:00+03:00,out,True,924952,False,1,89,94,5
167497,2019-11-12 00:00:00+03:00,out,True,924960,False,9,1062,1136,74
167497,2019-11-12 00:00:00+03:00,out,True,924932,False,1,32,40,8
167497,2019-11-12 00:00:00+03:00,in,False,932836,False,1,32,57,25
167497,2019-11-12 00:00:00+03:00,out,True,924954,False,1,41,50,9
167497,2019-11-12 00:00:00+03:00,out,False,924940,True,6,0,76,76
167497,2019-11-12 00:00:00+03:00,out,False,924934,True,3,0,124,124
167497,2019-11-12 00:00:00+03:00,in,False,924954,False,1,81,107,26
167497,2019-11-12 00:00:00+03:00,out,True,921116,False,3,581,596,15
167497,2019-11-12 00:00:00+03:00,in,False,924950,False,1,280,291,11
167497,2019-11-12 00:00:00+03:00,in,False,-1,True,7,0,192,192
167497,2019-11-12 00:00:00+03:00,out,False,924950,True,1,0,52,52
167497,2019-11-12 00:00:00+03:00,out,True,924930,True,1,0,30,30
167497,2019-11-12 00:00:00+03:00,out,True,924930,False,2,239,251,12
167497,2019-11-12 00:00:00+03:00,out,True,924954,True,2,0,30,30
167497,2019-11-12 00:00:00+03:00,out,True,924934,True,6,0,86,86
167497,2019-11-12 00:00:00+03:00,out,False,924954,False,2,64,79,15
167497,2019-11-12 00:00:00+03:00,in,True,924960,False,1,107,128,21
167497,2019-11-12 00:00:00+03:00,out,True,924946,False,5,637,706,69
167497,2019-11-12 00:00:00+03:00,out,False,924930,False,6,284,374,90
167497,2019-11-12 00:00:00+03:00,in,False,924936,False,1,59,82,23
167497,2019-11-12 00:00:00+03:00,out,False,932836,True,12,0,173,173
167497,2019-11-12 00:00:00+03:00,in,False,924956,False,1,64,69,5
167497,2019-11-12 00:00:00+03:00,out,False,924960,True,2,0,14,14
167497,2019-11-12 00:00:00+03:00,out,False,924940,False,3,694,740,46
167497,2019-11-12 00:00:00+03:00,in,True,924930,False,2,238,274,36
167497,2019-11-12 00:00:00+03:00,out,True,924934,False,7,376,469,93
167497,2019-11-12 00:00:00+03:00,in,False,924960,False,1,34,46,12
167497,2019-11-12 00:00:00+03:00,out,False,932836,False,18,1804,2062,258
167497,2019-11-12 00:00:00+03:00,out,True,932836,False,2,406,436,30
167497,2019-11-12 00:00:00+03:00,out,True,924960,True,5,0,39,39
167497,2019-11-12 00:00:00+03:00,in,False,-1,True,5,0,158,158
167497,2019-11-12 00:00:00+03:00,out,False,924934,False,4,466,529,63
167497,2019-11-12 00:00:00+03:00,out,False,924948,True,1,0,43,43
167497,2019-11-12 00:00:00+03:00,out,True,921116,True,1,0,22,22
167497,2019-11-12 00:00:00+03:00,out,True,921116,False,3,581,596,15
167497,2019-11-12 00:00:00+03:00,in,False,924950,False,1,280,291,11
167497,2019-11-12 00:00:00+03:00,out,True,924934,False,7,376,469,93
167497,2019-11-12 00:00:00+03:00,in,False,-1,True,7,0,192,192
167497,2019-11-13 00:00:00+03:00,out,True,924958,False,3,234,254,20
167497,2019-11-13 00:00:00+03:00,out,True,924960,True,1,0,27,27
167497,2019-11-13 00:00:00+03:00,out,False,932836,True,12,0,202,202
167497,2019-11-13 00:00:00+03:00,out,True,921116,True,1,0,28,28
167497,2019-11-13 00:00:00+03:00,out,False,924960,False,2,187,213,26
167497,2019-11-13 00:00:00+03:00,out,True,924950,True,1,0,0,0
167497,2019-11-13 00:00:00+03:00,out,False,950672,False,2,176,217,41
167497,2019-11-13 00:00:00+03:00,in,False,932836,False,1,109,115,6
167497,2019-11-13 00:00:00+03:00,out,True,924940,True,2,0,60,60
167497,2019-11-13 00:00:00+03:00,out,True,924930,False,3,226,266,40
167497,2019-11-13 00:00:00+03:00,in,False,924958,False,2,451,466,15
167497,2019-11-13 00:00:00+03:00,out,False,924932,False,1,392,417,25
167497,2019-11-13 00:00:00+03:00,out,False,924960,True,1,0,39,39
167497,2019-11-13 00:00:00+03:00,out,False,924940,True,1,0,3,3
167497,2019-11-13 00:00:00+03:00,out,False,924952,False,2,133,153,20
167497,2019-11-13 00:00:00+03:00,out,False,924950,False,11,1656,1749,93
167497,2019-11-13 00:00:00+03:00,out,False,924934,False,9,977,1091,114
167497,2019-11-13 00:00:00+03:00,out,True,924958,True,2,0,36,36
167497,2019-11-13 00:00:00+03:00,out,False,924958,True,2,0,10,10
167497,2019-11-13 00:00:00+03:00,out,False,921116,False,1,37,45,8
167497,2019-11-13 00:00:00+03:00,out,True,924934,True,2,0,60,60
167497,2019-11-13 00:00:00+03:00,out,True,924940,False,6,864,936,72
167497,2019-11-13 00:00:00+03:00,in,False,-1,True,3,0,20,20
167497,2019-11-13 00:00:00+03:00,out,False,950672,True,1,0,30,30
167497,2019-11-13 00:00:00+03:00,out,True,924960,False,4,274,313,39
167497,2019-11-13 00:00:00+03:00,out,True,921116,False,4,527,566,39
167497,2019-11-13 00:00:00+03:00,out,False,932836,False,6,674,738,64
167497,2019-11-13 00:00:00+03:00,out,True,924948,False,3,139,180,41
167497,2019-11-13 00:00:00+03:00,out,True,932836,False,2,142,157,15
167497,2019-11-13 00:00:00+03:00,out,False,924930,False,3,104,152,48
167497,2019-11-13 00:00:00+03:00,in,False,924954,False,1,93,100,7
167497,2019-11-13 00:00:00+03:00,out,True,924952,False,4,216,270,54
167497,2019-11-13 00:00:00+03:00,out,True,924932,True,1,0,0,0
167497,2019-11-13 00:00:00+03:00,out,False,924948,True,4,0,211,211
167497,2019-11-13 00:00:00+03:00,out,True,924952,True,3,0,46,46
167497,2019-11-13 00:00:00+03:00,out,True,924932,False,1,123,148,25
167497,2019-11-13 00:00:00+03:00,out,False,924948,False,4,214,263,49
167497,2019-11-13 00:00:00+03:00,out,True,924950,False,11,1093,1279,186
167497,2019-11-13 00:00:00+03:00,out,False,924940,False,1,144,154,10
167497,2019-11-13 00:00:00+03:00,in,False,924960,False,4,515,612,97
167497,2019-11-13 00:00:00+03:00,out,True,924934,False,7,815,890,75
167497,2019-11-13 00:00:00+03:00,out,False,924954,False,1,46,52,6
167497,2019-11-13 00:00:00+03:00,out,True,924940,False,6,864,936,72
167497,2019-11-13 00:00:00+03:00,out,True,921116,True,1,0,28,28
167497,2019-11-13 00:00:00+03:00,out,False,924952,False,2,133,153,20
167497,2019-11-13 00:00:00+03:00,in,False,-1,True,3,0,20,20
167497,2019-11-13 00:00:00+03:00,out,True,924930,False,3,226,266,40
167497,2019-11-13 00:00:00+03:00,out,True,924958,False,3,234,254,20
167497,2019-11-14 00:00:00+03:00,out,False,924950,False,5,366,439,73
167497,2019-11-14 00:00:00+03:00,out,True,921116,True,1,0,30,30
167497,2019-11-14 00:00:00+03:00,out,False,924960,True,3,0,90,90
167497,2019-11-14 00:00:00+03:00,out,False,924932,False,1,187,200,13
167497,2019-11-14 00:00:00+03:00,out,True,924934,True,3,0,47,47
167497,2019-11-14 00:00:00+03:00,out,False,924930,True,1,0,18,18
167497,2019-11-14 00:00:00+03:00,out,False,924930,False,2,1935,1958,23
167497,2019-11-14 00:00:00+03:00,out,False,932836,True,3,0,61,61
167497,2019-11-14 00:00:00+03:00,out,True,924950,True,2,0,84,84
167497,2019-11-14 00:00:00+03:00,in,False,924930,False,2,636,670,34
167497,2019-11-14 00:00:00+03:00,out,False,932836,False,9,484,632,148
167497,2019-11-14 00:00:00+03:00,out,False,924958,False,2,99,126,27
167497,2019-11-14 00:00:00+03:00,out,False,924954,False,2,56,76,20
167497,2019-11-14 00:00:00+03:00,out,True,924948,True,2,0,54,54
167497,2019-11-14 00:00:00+03:00,in,False,924948,True,1,0,7,7
167497,2019-11-14 00:00:00+03:00,out,True,921116,False,2,210,227,17
167497,2019-11-14 00:00:00+03:00,out,False,924952,False,1,133,143,10
167497,2019-11-14 00:00:00+03:00,in,False,-1,True,1,0,2,2
167497,2019-11-14 00:00:00+03:00,out,True,950672,False,1,84,108,24
167497,2019-11-14 00:00:00+03:00,out,True,924950,False,4,322,396,74
167497,2019-11-14 00:00:00+03:00,out,True,924960,True,2,0,35,35
167497,2019-11-14 00:00:00+03:00,in,False,924960,False,7,629,753,124
167497,2019-11-14 00:00:00+03:00,out,True,924940,True,1,0,30,30
167497,2019-11-14 00:00:00+03:00,out,True,924934,False,7,466,531,65
167497,2019-11-14 00:00:00+03:00,out,True,924932,False,5,363,438,75
167497,2019-11-14 00:00:00+03:00,out,False,924960,False,5,291,355,64
167497,2019-11-14 00:00:00+03:00,out,False,924948,False,4,341,385,44
167497,2019-11-14 00:00:00+03:00,out,False,924934,True,6,0,104,104
167497,2019-11-14 00:00:00+03:00,out,True,924958,False,1,13,16,3
167497,2019-11-14 00:00:00+03:00,out,True,924940,False,4,382,422,40
167497,2019-11-14 00:00:00+03:00,in,True,924956,False,1,676,694,18
167497,2019-11-14 00:00:00+03:00,out,True,932836,False,4,337,404,67
167497,2019-11-14 00:00:00+03:00,out,False,924950,True,1,0,60,60
167497,2019-11-14 00:00:00+03:00,in,False,-1,True,4,0,72,72
167497,2019-11-14 00:00:00+03:00,in,False,924928,False,3,172,385,213
167497,2019-11-14 00:00:00+03:00,out,False,924948,True,2,0,31,31
167497,2019-11-14 00:00:00+03:00,out,False,924934,False,13,740,928,188
167497,2019-11-14 00:00:00+03:00,out,True,924948,False,2,404,432,28
167497,2019-11-14 00:00:00+03:00,in,False,924952,False,2,72,104,32
167497,2019-11-14 00:00:00+03:00,out,True,950672,True,1,0,15,15
167497,2019-11-14 00:00:00+03:00,out,False,921116,True,1,0,23,23
167497,2019-11-14 00:00:00+03:00,in,False,924954,False,3,683,715,32
167497,2019-11-14 00:00:00+03:00,out,False,924948,True,2,0,31,31
167497,2019-11-14 00:00:00+03:00,out,False,924930,False,2,1935,1958,23
167497,2019-11-14 00:00:00+03:00,out,False,924954,False,2,56,76,20
167497,2019-11-14 00:00:00+03:00,out,False,932836,True,3,0,61,61
167497,2019-11-14 00:00:00+03:00,out,False,924932,False,1,187,200,13
167497,2019-11-15 00:00:00+03:00,out,False,924960,False,3,163,194,31
167497,2019-11-15 00:00:00+03:00,out,False,932836,False,6,562,618,56
167497,2019-11-15 00:00:00+03:00,in,False,932836,False,1,132,144,12
167497,2019-11-15 00:00:00+03:00,out,False,950672,False,2,177,210,33
167497,2019-11-15 00:00:00+03:00,in,False,924934,False,2,127,173,46
167497,2019-11-15 00:00:00+03:00,in,False,924950,False,1,108,137,29
167497,2019-11-15 00:00:00+03:00,out,True,932836,False,3,287,314,27
167497,2019-11-15 00:00:00+03:00,out,True,932836,True,1,0,1,1
167497,2019-11-15 00:00:00+03:00,out,False,924934,False,9,898,1037,139
167497,2019-11-15 00:00:00+03:00,out,True,950672,False,1,428,439,11
167497,2019-11-15 00:00:00+03:00,out,True,924930,False,9,640,724,84
167497,2019-11-15 00:00:00+03:00,in,False,924960,False,3,243,278,35
167497,2019-11-15 00:00:00+03:00,out,False,924934,True,1,0,6,6
167497,2019-11-15 00:00:00+03:00,out,True,924934,True,1,0,27,27
167497,2019-11-15 00:00:00+03:00,out,False,924950,False,2,25,91,66
167497,2019-11-15 00:00:00+03:00,in,False,924952,False,3,212,288,76
167497,2019-11-15 00:00:00+03:00,out,False,950672,True,3,0,85,85
167497,2019-11-15 00:00:00+03:00,out,True,924950,False,2,242,276,34
167497,2019-11-15 00:00:00+03:00,out,True,924946,True,1,0,13,13
167497,2019-11-15 00:00:00+03:00,out,False,924930,False,5,793,898,105
167497,2019-11-15 00:00:00+03:00,in,False,924958,False,1,27,34,7
167497,2019-11-15 00:00:00+03:00,out,False,932836,True,2,0,25,25
167497,2019-11-15 00:00:00+03:00,in,False,-1,True,2,0,12,12
167497,2019-11-15 00:00:00+03:00,out,True,924950,True,1,0,60,60
167497,2019-11-15 00:00:00+03:00,out,False,924960,True,2,0,11,11
167497,2019-11-15 00:00:00+03:00,out,True,924952,True,1,0,24,24
167497,2019-11-15 00:00:00+03:00,out,True,924960,False,2,125,138,13
167497,2019-11-15 00:00:00+03:00,out,True,924952,False,1,17,26,9
167497,2019-11-15 00:00:00+03:00,out,False,932836,False,6,562,618,56
167497,2019-11-15 00:00:00+03:00,out,True,924950,False,2,242,276,34
167497,2019-11-16 00:00:00+03:00,out,False,924930,False,1,28,51,23
167497,2019-11-16 00:00:00+03:00,out,False,924930,True,1,0,52,52
167497,2019-11-16 00:00:00+03:00,out,False,924958,False,1,2,10,8
167497,2019-11-16 00:00:00+03:00,out,False,924952,False,1,109,136,27
167497,2019-11-16 00:00:00+03:00,out,False,932836,False,2,513,535,22
167497,2019-11-16 00:00:00+03:00,in,False,924930,False,1,68,77,9
167497,2019-11-16 00:00:00+03:00,out,False,924952,True,1,0,13,13
167497,2019-11-16 00:00:00+03:00,out,False,932836,True,4,0,70,70
167497,2019-11-16 00:00:00+03:00,out,True,932836,False,1,39,52,13
167497,2019-11-16 00:00:00+03:00,out,False,924948,False,1,149,185,36
167497,2019-11-16 00:00:00+03:00,out,False,924958,False,1,2,10,8
167497,2019-11-17 00:00:00+03:00,in,False,924948,False,1,51,63,12
167497,2019-11-17 00:00:00+03:00,out,True,924958,False,1,7,14,7
167497,2019-11-17 00:00:00+03:00,in,False,-1,True,2,0,95,95
167497,2019-11-17 00:00:00+03:00,out,False,924950,False,3,178,216,38
167497,2019-11-17 00:00:00+03:00,out,False,924948,True,1,0,65,65
167497,2019-11-17 00:00:00+03:00,out,False,921116,False,2,53,74,21
167497,2019-11-17 00:00:00+03:00,in,False,-1,True,2,0,70,70
167497,2019-11-17 00:00:00+03:00,out,False,924940,False,2,61,85,24
167497,2019-11-17 00:00:00+03:00,out,False,924940,True,1,0,22,22
167497,2019-11-17 00:00:00+03:00,out,False,924948,False,4,607,682,75
167497,2019-11-17 00:00:00+03:00,in,False,924950,False,1,300,327,27
167497,2019-11-17 00:00:00+03:00,out,False,924960,False,1,12,28,16
167497,2019-11-17 00:00:00+03:00,in,False,924960,False,2,78,100,22
167497,2019-11-17 00:00:00+03:00,out,False,924958,True,1,0,1,1
167497,2019-11-17 00:00:00+03:00,out,True,924958,False,1,7,14,7
167497,2019-11-17 00:00:00+03:00,out,False,924960,False,1,12,28,16
167497,2019-11-18 00:00:00+03:00,out,True,924934,True,1,0,3,3
167497,2019-11-18 00:00:00+03:00,out,True,924958,False,1,141,145,4
167497,2019-11-18 00:00:00+03:00,out,False,932836,False,4,545,596,51
167497,2019-11-18 00:00:00+03:00,out,False,924958,True,3,0,41,41
167497,2019-11-18 00:00:00+03:00,in,False,924930,False,1,291,300,9
167497,2019-11-18 00:00:00+03:00,out,True,924930,False,2,653,709,56
167497,2019-11-18 00:00:00+03:00,out,False,932836,True,2,0,25,25
167497,2019-11-18 00:00:00+03:00,out,True,921116,False,2,287,299,12
167497,2019-11-18 00:00:00+03:00,in,False,924934,False,2,160,197,37
167497,2019-11-18 00:00:00+03:00,out,False,924950,True,1,0,9,9
167497,2019-11-18 00:00:00+03:00,out,True,924952,True,1,0,30,30
167497,2019-11-18 00:00:00+03:00,out,True,932836,False,4,333,403,70
167497,2019-11-18 00:00:00+03:00,out,False,924930,False,7,247,394,147
167497,2019-11-18 00:00:00+03:00,out,True,924960,False,1,25,30,5
167497,2019-11-18 00:00:00+03:00,out,True,924948,False,1,85,102,17
167497,2019-11-18 00:00:00+03:00,out,False,924960,False,5,742,779,37
167497,2019-11-18 00:00:00+03:00,out,False,924958,False,5,204,273,69
167497,2019-11-18 00:00:00+03:00,out,False,924948,False,12,626,870,244
167497,2019-11-18 00:00:00+03:00,out,True,924958,True,4,0,78,78
167497,2019-11-18 00:00:00+03:00,out,False,924960,True,1,0,32,32
167497,2019-11-18 00:00:00+03:00,in,False,-1,True,5,0,113,113
167497,2019-11-18 00:00:00+03:00,in,False,924928,False,2,137,280,143
167497,2019-11-18 00:00:00+03:00,out,True,924950,False,5,907,998,91
167497,2019-11-18 00:00:00+03:00,out,False,924934,False,16,1410,1638,228
167497,2019-11-18 00:00:00+03:00,in,False,924948,False,1,1,10,9
167497,2019-11-18 00:00:00+03:00,out,True,921116,True,1,0,25,25
167497,2019-11-18 00:00:00+03:00,out,False,924934,True,5,0,173,173
167497,2019-11-18 00:00:00+03:00,out,False,924952,False,1,30,38,8
167497,2019-11-18 00:00:00+03:00,out,False,924948,True,10,0,412,412
167497,2019-11-18 00:00:00+03:00,out,False,924940,False,3,499,526,27
167497,2019-11-18 00:00:00+03:00,out,False,924950,False,1,69,76,7
167497,2019-11-18 00:00:00+03:00,out,False,921116,False,3,299,347,48
167497,2019-11-18 00:00:00+03:00,in,False,924958,False,1,30,38,8
167497,2019-11-18 00:00:00+03:00,out,False,924932,False,1,152,155,3
167497,2019-11-18 00:00:00+03:00,out,False,924930,True,4,0,205,205
167497,2019-11-18 00:00:00+03:00,out,False,924940,True,1,0,25,25
167497,2019-11-18 00:00:00+03:00,out,True,924934,False,6,306,435,129
167497,2019-11-18 00:00:00+03:00,out,False,924960,True,1,0,32,32
167497,2019-11-18 00:00:00+03:00,in,False,924928,False,2,137,280,143
167497,2019-11-18 00:00:00+03:00,out,False,924932,False,1,152,155,3
167497,2019-11-18 00:00:00+03:00,out,False,924948,True,10,0,412,412
167497,2019-11-18 00:00:00+03:00,out,True,924960,False,1,25,30,5
167497,2019-11-18 00:00:00+03:00,out,True,924950,False,5,907,998,91
167497,2019-11-18 00:00:00+03:00,out,False,924958,False,5,204,273,69
167497,2019-11-19 00:00:00+03:00,out,False,924928,False,1,17,33,16
167497,2019-11-19 00:00:00+03:00,out,False,924958,False,2,64,98,34
167497,2019-11-19 00:00:00+03:00,out,True,932836,True,2,0,45,45
167497,2019-11-19 00:00:00+03:00,out,True,924946,False,1,2891,2904,13
167497,2019-11-19 00:00:00+03:00,out,False,924946,True,1,0,2,2
167497,2019-11-19 00:00:00+03:00,out,False,924948,False,2,242,285,43
167497,2019-11-19 00:00:00+03:00,out,False,932836,False,5,952,1010,58
167497,2019-11-19 00:00:00+03:00,out,True,950672,False,1,3,30,27
167497,2019-11-19 00:00:00+03:00,out,True,921116,True,1,0,25,25
167497,2019-11-19 00:00:00+03:00,out,True,924960,True,1,0,21,21
167497,2019-11-19 00:00:00+03:00,out,True,924952,False,3,475,507,32
167497,2019-11-19 00:00:00+03:00,out,False,924934,False,11,1841,1986,145
167497,2019-11-19 00:00:00+03:00,out,False,950672,False,1,55,68,13
167497,2019-11-19 00:00:00+03:00,out,True,924930,True,1,0,30,30
167497,2019-11-19 00:00:00+03:00,out,False,924950,False,2,93,158,65
167497,2019-11-19 00:00:00+03:00,in,True,924954,False,1,57,84,27
167497,2019-11-19 00:00:00+03:00,out,True,924934,False,7,462,548,86
167497,2019-11-19 00:00:00+03:00,in,False,924952,False,1,99,122,23
167497,2019-11-19 00:00:00+03:00,out,True,924958,True,1,0,18,18
167497,2019-11-19 00:00:00+03:00,out,True,932836,False,5,821,903,82
167497,2019-11-19 00:00:00+03:00,out,True,924932,False,1,35,64,29
167497,2019-11-19 00:00:00+03:00,out,False,924960,False,4,515,577,62
167497,2019-11-19 00:00:00+03:00,out,False,924958,True,2,0,60,60
167497,2019-11-19 00:00:00+03:00,in,False,924960,False,2,146,245,99
167497,2019-11-19 00:00:00+03:00,in,False,924932,False,1,120,128,8
167497,2019-11-19 00:00:00+03:00,out,True,924948,False,1,48,66,18
167497,2019-11-19 00:00:00+03:00,out,False,924950,True,1,0,34,34
167497,2019-11-19 00:00:00+03:00,out,False,924946,False,1,117,139,22
167497,2019-11-19 00:00:00+03:00,in,False,924940,False,1,553,593,40
167497,2019-11-19 00:00:00+03:00,out,True,924950,False,1,265,285,20
167497,2019-11-19 00:00:00+03:00,out,True,950672,True,2,0,26,26
167497,2019-11-19 00:00:00+03:00,in,False,924930,False,1,253,267,14
167497,2019-11-19 00:00:00+03:00,out,True,924958,False,2,182,236,54
167497,2019-11-19 00:00:00+03:00,in,False,-1,True,3,0,75,75
167497,2019-11-19 00:00:00+03:00,out,False,924934,True,3,0,60,60
167497,2019-11-19 00:00:00+03:00,out,True,924960,True,1,0,21,21
167497,2019-11-20 00:00:00+03:00,in,False,924952,False,1,52,67,15
167497,2019-11-20 00:00:00+03:00,out,True,924934,False,2,120,134,14
167497,2019-11-20 00:00:00+03:00,out,True,924948,False,1,1254,1281,27
167497,2019-11-20 00:00:00+03:00,out,True,924960,False,1,74,100,26
167497,2019-11-20 00:00:00+03:00,in,False,924958,False,2,99,110,11
167497,2019-11-20 00:00:00+03:00,out,True,924950,False,3,548,598,50
167497,2019-11-20 00:00:00+03:00,out,False,924954,True,1,0,29,29
167497,2019-11-20 00:00:00+03:00,out,False,924958,True,3,0,103,103
167497,2019-11-20 00:00:00+03:00,out,False,924960,True,4,0,111,111
167497,2019-11-20 00:00:00+03:00,out,True,924958,False,4,321,363,42
167497,2019-11-20 00:00:00+03:00,in,False,924960,False,1,53,63,10
167497,2019-11-20 00:00:00+03:00,out,False,924940,False,4,491,539,48
167497,2019-11-20 00:00:00+03:00,in,False,-1,True,8,0,282,282
167497,2019-11-20 00:00:00+03:00,out,False,924960,False,3,225,253,28
167497,2019-11-20 00:00:00+03:00,out,False,924950,False,1,188,196,8
167497,2019-11-20 00:00:00+03:00,out,False,924934,False,18,1734,2057,323
167497,2019-11-20 00:00:00+03:00,in,False,-1,True,2,0,48,48
167497,2019-11-20 00:00:00+03:00,out,False,924956,False,1,15,26,11
167497,2019-11-20 00:00:00+03:00,out,False,924934,True,7,0,252,252
167497,2019-11-20 00:00:00+03:00,out,False,924954,False,4,176,238,62
167497,2019-11-20 00:00:00+03:00,out,True,924946,True,2,0,31,31
167497,2019-11-20 00:00:00+03:00,in,False,924948,False,1,55,61,6
167497,2019-11-20 00:00:00+03:00,out,True,924946,False,1,31,51,20
167497,2019-11-20 00:00:00+03:00,out,True,924954,True,2,0,94,94
167497,2019-11-20 00:00:00+03:00,out,True,924928,False,2,214,267,53
167497,2019-11-20 00:00:00+03:00,in,False,924950,False,2,591,628,37
167497,2019-11-20 00:00:00+03:00,out,True,921116,False,1,105,128,23
167497,2019-11-20 00:00:00+03:00,out,False,924948,True,1,0,27,27
167497,2019-11-20 00:00:00+03:00,out,False,924948,False,3,316,356,40
167497,2019-11-20 00:00:00+03:00,out,True,924960,True,1,0,22,22
167497,2019-11-20 00:00:00+03:00,in,False,950672,False,1,48,61,13
167497,2019-11-20 00:00:00+03:00,out,True,924934,True,3,0,53,53
167497,2019-11-20 00:00:00+03:00,out,False,924958,False,1,600,608,8
167497,2019-11-20 00:00:00+03:00,out,False,924940,True,4,0,25,25
167497,2019-11-20 00:00:00+03:00,out,True,924932,False,2,156,165,9
167497,2019-11-20 00:00:00+03:00,out,True,924954,False,3,262,298,36
167497,2019-11-20 00:00:00+03:00,in,False,924950,False,2,591,628,37
167497,2019-11-20 00:00:00+03:00,out,True,924932,False,2,156,165,9
167497,2019-11-20 00:00:00+03:00,out,True,924960,False,1,74,100,26
167497,2019-11-20 00:00:00+03:00,in,False,924948,False,1,55,61,6
167497,2019-11-20 00:00:00+03:00,in,False,924958,False,2,99,110,11
167497,2019-11-21 00:00:00+03:00,out,False,924958,True,3,0,53,53
167497,2019-11-21 00:00:00+03:00,out,True,924952,False,1,16,28,12
167497,2019-11-21 00:00:00+03:00,out,True,924956,False,1,44,71,27
167497,2019-11-21 00:00:00+03:00,in,False,924950,False,1,133,149,16
167497,2019-11-21 00:00:00+03:00,out,False,924958,False,7,1975,2050,75
167497,2019-11-21 00:00:00+03:00,in,False,-1,True,1,0,64,64
167497,2019-11-21 00:00:00+03:00,out,False,924940,True,1,0,29,29
167497,2019-11-21 00:00:00+03:00,out,False,924954,True,2,0,28,28
167497,2019-11-21 00:00:00+03:00,out,False,932836,True,3,0,100,100
167497,2019-11-21 00:00:00+03:00,out,False,924940,False,4,175,198,23
167497,2019-11-21 00:00:00+03:00,out,False,932836,False,7,420,523,103
167497,2019-11-21 00:00:00+03:00,out,True,924958,False,2,7,54,47
167497,2019-11-21 00:00:00+03:00,in,False,924940,False,1,207,236,29
167497,2019-11-21 00:00:00+03:00,out,False,924956,False,1,781,792,11
167497,2019-11-21 00:00:00+03:00,out,False,924960,True,2,0,78,78
167497,2019-11-21 00:00:00+03:00,out,False,924946,True,1,0,37,37
167497,2019-11-21 00:00:00+03:00,out,True,932836,False,2,225,248,23
167497,2019-11-21 00:00:00+03:00,in,False,924960,False,1,41,55,14
167497,2019-11-21 00:00:00+03:00,out,True,924956,True,1,0,40,40
167497,2019-11-21 00:00:00+03:00,out,True,924940,False,1,52,81,29
167497,2019-11-21 00:00:00+03:00,out,True,924948,False,1,13,20,7
167497,2019-11-21 00:00:00+03:00,in,False,924958,False,4,154,206,52
167497,2019-11-21 00:00:00+03:00,out,True,924934,False,2,106,140,34
167497,2019-11-21 00:00:00+03:00,out,False,-1,True,1,0,0,0
167497,2019-11-21 00:00:00+03:00,out,False,924960,False,1,7,9,2
167497,2019-11-21 00:00:00+03:00,in,False,932836,False,2,130,144,14
167497,2019-11-21 00:00:00+03:00,out,True,924954,False,2,239,271,32
167497,2019-11-21 00:00:00+03:00,out,False,924934,True,2,0,114,114
167497,2019-11-21 00:00:00+03:00,out,True,924934,True,1,0,1,1
167497,2019-11-21 00:00:00+03:00,out,False,924934,False,9,489,585,96
167497,2019-11-21 00:00:00+03:00,out,True,924940,True,1,0,63,63
167497,2019-11-21 00:00:00+03:00,out,False,-1,True,1,0,0,0
167497,2019-11-21 00:00:00+03:00,out,True,924956,True,1,0,40,40
167497,2019-11-21 00:00:00+03:00,out,False,924960,False,1,7,9,2
167497,2019-11-22 00:00:00+03:00,out,False,924940,True,1,0,23,23
167497,2019-11-22 00:00:00+03:00,in,False,924928,False,1,44,56,12
167497,2019-11-22 00:00:00+03:00,out,True,924958,False,2,167,194,27
167497,2019-11-22 00:00:00+03:00,out,False,924958,True,1,0,30,30
167497,2019-11-22 00:00:00+03:00,in,False,924954,False,2,1193,1289,96
167497,2019-11-22 00:00:00+03:00,in,False,924958,False,2,155,188,33
167497,2019-11-22 00:00:00+03:00,out,True,924932,False,1,113,120,7
167497,2019-11-22 00:00:00+03:00,out,True,924948,False,1,49,60,11
167497,2019-11-22 00:00:00+03:00,out,True,924930,False,3,547,587,40
167497,2019-11-22 00:00:00+03:00,out,True,924934,False,3,171,201,30
167497,2019-11-22 00:00:00+03:00,out,False,924948,False,1,45,56,11
167497,2019-11-22 00:00:00+03:00,in,False,924950,False,1,58,87,29
167497,2019-11-22 00:00:00+03:00,out,False,924960,True,1,0,39,39
167497,2019-11-22 00:00:00+03:00,out,True,924950,False,3,204,242,38
167497,2019-11-22 00:00:00+03:00,out,False,924960,False,1,940,956,16
167497,2019-11-22 00:00:00+03:00,out,False,924934,False,11,1164,1286,122
167497,2019-11-22 00:00:00+03:00,in,False,-1,True,5,0,116,116
167497,2019-11-22 00:00:00+03:00,out,False,924948,True,1,0,14,14
167497,2019-11-22 00:00:00+03:00,in,False,924960,False,3,1354,1386,32
167497,2019-11-22 00:00:00+03:00,out,True,924934,True,1,0,30,30
167497,2019-11-22 00:00:00+03:00,out,False,924934,True,7,0,211,211
167497,2019-11-22 00:00:00+03:00,out,True,924952,False,1,73,85,12
167497,2019-11-22 00:00:00+03:00,in,False,-1,True,1,0,34,34
167497,2019-11-22 00:00:00+03:00,out,False,924954,True,3,0,34,34
167497,2019-11-22 00:00:00+03:00,out,True,924958,True,1,0,19,19
167497,2019-11-22 00:00:00+03:00,out,True,924960,True,1,0,20,20
167497,2019-11-22 00:00:00+03:00,out,False,924954,False,6,1152,1230,78
167497,2019-11-22 00:00:00+03:00,in,False,924956,False,1,16,25,9
167497,2019-11-22 00:00:00+03:00,out,True,924954,True,4,0,67,67
167497,2019-11-22 00:00:00+03:00,out,False,924940,False,3,263,291,28
167497,2019-11-22 00:00:00+03:00,in,False,924936,False,1,66,82,16
167497,2019-11-23 00:00:00+03:00,in,True,924954,False,1,10,52,42
167497,2019-11-23 00:00:00+03:00,out,False,924948,True,2,0,56,56
167497,2019-11-23 00:00:00+03:00,out,False,924950,False,4,252,271,19
167497,2019-11-23 00:00:00+03:00,out,False,924948,False,1,62,80,18
167497,2019-11-23 00:00:00+03:00,out,False,924958,True,2,0,29,29
167497,2019-11-23 00:00:00+03:00,out,True,924960,False,1,70,74,4
167497,2019-11-23 00:00:00+03:00,out,False,924940,True,1,0,28,28
167497,2019-11-23 00:00:00+03:00,out,False,924950,True,1,0,23,23
167497,2019-11-23 00:00:00+03:00,in,False,924960,False,1,10,21,11
167497,2019-11-23 00:00:00+03:00,out,True,924954,True,1,0,15,15
167497,2019-11-23 00:00:00+03:00,out,False,924954,False,3,616,642,26
167497,2019-11-23 00:00:00+03:00,out,False,924930,False,2,18,76,58
167497,2019-11-23 00:00:00+03:00,out,False,924954,True,2,0,62,62
167497,2019-11-23 00:00:00+03:00,out,False,924930,True,1,0,48,48
167497,2019-11-23 00:00:00+03:00,out,False,924958,False,1,34,43,9
167497,2019-11-23 00:00:00+03:00,out,True,924940,False,1,210,212,2
167497,2019-11-23 00:00:00+03:00,out,False,924930,True,1,0,48,48
167497,2019-11-23 00:00:00+03:00,in,True,924954,False,1,10,52,42
167497,2019-11-24 00:00:00+03:00,out,False,932836,False,2,190,227,37
167497,2019-11-24 00:00:00+03:00,out,False,924960,True,1,0,31,31
167497,2019-11-24 00:00:00+03:00,out,False,924954,False,2,60,82,22
167497,2019-11-24 00:00:00+03:00,out,False,924930,False,6,665,772,107
167497,2019-11-24 00:00:00+03:00,out,False,924956,False,2,62,100,38
167497,2019-11-24 00:00:00+03:00,out,False,924948,True,2,0,114,114
167497,2019-11-24 00:00:00+03:00,out,False,924948,False,3,111,154,43
167497,2019-11-24 00:00:00+03:00,out,False,924954,True,1,0,22,22
167497,2019-11-24 00:00:00+03:00,in,False,924948,False,1,170,200,30
167497,2019-11-24 00:00:00+03:00,out,False,924930,True,1,0,1,1
167497,2019-11-25 00:00:00+03:00,out,True,924960,False,2,199,248,49
167497,2019-11-25 00:00:00+03:00,out,False,924948,False,4,225,286,61
167497,2019-11-25 00:00:00+03:00,out,False,924950,False,1,36,64,28
167497,2019-11-25 00:00:00+03:00,out,True,924960,True,1,0,35,35
167497,2019-11-25 00:00:00+03:00,in,False,924930,False,1,90,98,8
167497,2019-11-25 00:00:00+03:00,out,True,924958,True,2,0,61,61
167497,2019-11-25 00:00:00+03:00,out,True,924934,False,5,315,375,60
167497,2019-11-25 00:00:00+03:00,out,True,924934,True,4,0,24,24
167497,2019-11-25 00:00:00+03:00,in,False,924958,False,1,27,32,5
167497,2019-11-25 00:00:00+03:00,in,True,924930,False,1,316,343,27
167497,2019-11-25 00:00:00+03:00,out,False,924930,False,7,622,702,80
167497,2019-11-25 00:00:00+03:00,out,False,924930,True,1,0,60,60
167497,2019-11-25 00:00:00+03:00,out,True,932836,True,3,0,35,35
167497,2019-11-25 00:00:00+03:00,out,False,932836,False,4,242,305,63
167497,2019-11-25 00:00:00+03:00,in,False,-1,True,6,0,284,284
167497,2019-11-25 00:00:00+03:00,out,False,924948,True,2,0,44,44
167497,2019-11-25 00:00:00+03:00,out,False,924934,False,15,1600,1795,195
167497,2019-11-25 00:00:00+03:00,out,False,924960,False,4,1008,1057,49
167497,2019-11-25 00:00:00+03:00,out,False,924958,False,2,734,747,13
167497,2019-11-25 00:00:00+03:00,in,False,924950,False,1,220,231,11
167497,2019-11-25 00:00:00+03:00,out,True,924930,False,2,240,251,11
167497,2019-11-25 00:00:00+03:00,out,True,924950,False,5,378,437,59
167497,2019-11-25 00:00:00+03:00,out,False,924934,True,8,0,347,347
167497,2019-11-25 00:00:00+03:00,in,False,-1,True,1,0,22,22
167497,2019-11-25 00:00:00+03:00,out,True,924954,True,1,0,21,21
167497,2019-11-25 00:00:00+03:00,out,True,924958,False,3,59,89,30
167497,2019-11-25 00:00:00+03:00,out,False,932836,True,2,0,67,67
167497,2019-11-25 00:00:00+03:00,in,False,924956,False,1,80,86,6
167497,2019-11-25 00:00:00+03:00,out,True,924950,True,3,0,4,4
167497,2019-11-25 00:00:00+03:00,out,False,924956,True,2,0,66,66
167497,2019-11-25 00:00:00+03:00,out,True,932836,False,4,5189,5241,52
167497,2019-11-25 00:00:00+03:00,out,True,924954,False,11,741,888,147
167497,2019-11-25 00:00:00+03:00,out,True,924952,False,1,32,41,9
167497,2019-11-25 00:00:00+03:00,out,False,924954,False,2,898,920,22
167497,2019-11-25 00:00:00+03:00,out,True,924948,False,1,149,162,13
167497,2019-11-25 00:00:00+03:00,in,False,924960,False,3,579,639,60
167497,2019-11-25 00:00:00+03:00,in,False,932836,False,3,556,582,26
167497,2019-11-25 00:00:00+03:00,out,False,924954,True,3,0,69,69
167497,2019-11-25 00:00:00+03:00,in,False,924930,False,1,90,98,8
167497,2019-11-25 00:00:00+03:00,out,False,924934,False,15,1600,1795,195
167497,2019-11-25 00:00:00+03:00,out,True,924960,True,1,0,35,35
167497,2019-11-25 00:00:00+03:00,out,False,924950,False,1,36,64,28
167497,2019-11-25 00:00:00+03:00,in,False,-1,True,1,0,22,22
167497,2019-11-26 00:00:00+03:00,out,True,924956,True,1,0,75,75
167497,2019-11-26 00:00:00+03:00,in,False,924960,False,2,116,142,26
167497,2019-11-26 00:00:00+03:00,in,False,932836,False,5,311,351,40
167497,2019-11-26 00:00:00+03:00,out,False,924956,False,1,35,68,33
167497,2019-11-26 00:00:00+03:00,out,False,924934,True,1,0,41,41
167497,2019-11-26 00:00:00+03:00,in,False,924934,False,1,739,848,109
167497,2019-11-26 00:00:00+03:00,out,True,924934,True,2,0,80,80
167497,2019-11-26 00:00:00+03:00,in,False,924958,False,2,174,186,12
167497,2019-11-26 00:00:00+03:00,out,False,924940,True,1,0,7,7
167497,2019-11-26 00:00:00+03:00,in,False,-1,True,5,0,258,258
167497,2019-11-26 00:00:00+03:00,out,True,924958,False,3,417,497,80
167497,2019-11-26 00:00:00+03:00,out,True,924956,False,4,285,382,97
167497,2019-11-26 00:00:00+03:00,out,False,932836,True,2,0,79,79
167497,2019-11-26 00:00:00+03:00,out,False,932836,False,9,654,774,120
167497,2019-11-26 00:00:00+03:00,in,False,924956,False,3,310,336,26
167497,2019-11-26 00:00:00+03:00,out,False,924960,False,1,32,53,21
167497,2019-11-26 00:00:00+03:00,out,True,932836,False,2,461,493,32
167497,2019-11-26 00:00:00+03:00,out,False,924954,False,7,741,873,132
167497,2019-11-26 00:00:00+03:00,out,False,924940,False,7,524,600,76
167497,2019-11-26 00:00:00+03:00,out,False,924934,False,13,1683,1849,166
167497,2019-11-26 00:00:00+03:00,out,True,924960,False,1,58,83,25
167497,2019-11-26 00:00:00+03:00,in,True,924960,False,1,59,112,53
167497,2019-11-26 00:00:00+03:00,in,True,924954,False,1,721,762,41
167497,2019-11-26 00:00:00+03:00,out,True,924934,False,10,556,662,106
167497,2019-11-26 00:00:00+03:00,out,False,924958,False,6,1893,1962,69
167497,2019-11-26 00:00:00+03:00,out,True,924934,True,2,0,80,80
167497,2019-11-26 00:00:00+03:00,out,True,924958,False,3,417,497,80
167497,2019-11-26 00:00:00+03:00,out,False,924960,False,1,32,53,21
167497,2019-11-26 00:00:00+03:00,in,False,924956,False,3,310,336,26
167497,2019-11-27 00:00:00+03:00,in,False,-1,True,1,0,20,20
167497,2019-11-27 00:00:00+03:00,out,False,924934,True,1,0,60,60
167497,2019-11-27 00:00:00+03:00,out,True,924940,False,8,2096,2186,90
167497,2019-11-27 00:00:00+03:00,out,True,924956,False,2,299,336,37
167497,2019-11-27 00:00:00+03:00,out,False,924954,False,4,429,465,36
167497,2019-11-27 00:00:00+03:00,in,False,932836,False,1,27,56,29
167497,2019-11-27 00:00:00+03:00,out,False,924954,True,2,0,25,25
167497,2019-11-27 00:00:00+03:00,out,True,924950,False,6,332,452,120
167497,2019-11-27 00:00:00+03:00,out,True,924958,False,1,29,35,6
167497,2019-11-27 00:00:00+03:00,out,True,924934,False,2,123,137,14
167497,2019-11-27 00:00:00+03:00,out,False,924934,False,5,302,412,110
167497,2019-11-27 00:00:00+03:00,out,False,924940,False,2,186,209,23
167497,2019-11-27 00:00:00+03:00,in,False,-1,True,6,0,378,378
167497,2019-11-27 00:00:00+03:00,in,False,924956,False,2,239,270,31
167497,2019-11-27 00:00:00+03:00,out,True,924958,True,1,0,9,9
167497,2019-11-27 00:00:00+03:00,out,True,924952,False,1,21,27,6
167497,2019-11-27 00:00:00+03:00,in,False,924954,False,2,567,666,99
167497,2019-11-27 00:00:00+03:00,out,False,924956,True,2,0,62,62
167497,2019-11-27 00:00:00+03:00,out,False,924940,True,2,0,60,60
167497,2019-11-27 00:00:00+03:00,in,False,924928,False,1,113,129,16
167497,2019-11-27 00:00:00+03:00,out,True,924934,True,2,0,53,53
167497,2019-11-27 00:00:00+03:00,out,True,924950,True,2,0,36,36
167497,2019-11-27 00:00:00+03:00,out,True,924960,False,1,109,136,27
167497,2019-11-27 00:00:00+03:00,in,False,924940,False,1,46,56,10
167497,2019-11-27 00:00:00+03:00,out,False,924960,False,2,453,481,28
167497,2019-11-27 00:00:00+03:00,out,True,924956,True,1,0,2,2
167497,2019-11-27 00:00:00+03:00,in,False,924958,False,2,99,113,14
167497,2019-11-27 00:00:00+03:00,out,False,932836,False,8,731,826,95
167497,2019-11-27 00:00:00+03:00,out,False,924956,False,1,51,62,11
167497,2019-11-27 00:00:00+03:00,out,False,932836,True,2,0,54,54
167497,2019-11-27 00:00:00+03:00,in,False,924960,False,2,153,264,111
167497,2019-11-27 00:00:00+03:00,out,False,924950,False,2,208,241,33
167497,2019-11-27 00:00:00+03:00,out,False,924958,False,2,363,379,16
167497,2019-11-27 00:00:00+03:00,out,True,924950,True,2,0,36,36
167497,2019-11-28 00:00:00+03:00,out,False,924948,False,15,643,875,232
167497,2019-11-28 00:00:00+03:00,out,False,924960,False,2,37,51,14
167497,2019-11-28 00:00:00+03:00,out,True,924954,False,8,521,626,105
167497,2019-11-28 00:00:00+03:00,out,True,924958,False,3,203,233,30
167497,2019-11-28 00:00:00+03:00,out,True,924960,True,2,0,44,44
167497,2019-11-28 00:00:00+03:00,out,True,924958,True,1,0,0,0
167497,2019-11-28 00:00:00+03:00,in,True,924960,False,1,162,182,20
167497,2019-11-28 00:00:00+03:00,out,False,924940,False,5,488,541,53
167497,2019-11-28 00:00:00+03:00,in,False,924930,False,1,37,71,34
167497,2019-11-28 00:00:00+03:00,out,False,924930,False,11,1117,1254,137
167497,2019-11-28 00:00:00+03:00,out,False,924934,False,14,969,1135,166
167497,2019-11-28 00:00:00+03:00,out,False,924948,True,10,0,267,267
167497,2019-11-28 00:00:00+03:00,in,False,924960,False,2,292,310,18
167497,2019-11-28 00:00:00+03:00,out,True,924960,False,2,136,153,17
167497,2019-11-28 00:00:00+03:00,out,True,924950,True,1,0,27,27
167497,2019-11-28 00:00:00+03:00,out,True,924934,True,2,0,84,84
167497,2019-11-28 00:00:00+03:00,out,False,924934,True,6,0,233,233
167497,2019-11-28 00:00:00+03:00,in,False,924954,True,1,0,31,31
167497,2019-11-28 00:00:00+03:00,in,False,924950,False,1,39,52,13
167497,2019-11-28 00:00:00+03:00,out,True,924956,True,2,0,30,30
167497,2019-11-28 00:00:00+03:00,in,False,-1,True,3,0,46,46
167497,2019-11-28 00:00:00+03:00,out,True,924950,False,4,682,731,49
167497,2019-11-28 00:00:00+03:00,out,True,924946,False,1,79,83,4
167497,2019-11-28 00:00:00+03:00,in,False,932836,False,1,67,97,30
167497,2019-11-28 00:00:00+03:00,out,True,924930,True,1,0,60,60
167497,2019-11-28 00:00:00+03:00,out,False,924958,False,1,597,610,13
167497,2019-11-28 00:00:00+03:00,out,True,924934,False,9,716,903,187
167497,2019-11-28 00:00:00+03:00,out,True,924956,False,4,398,455,57
167497,2019-11-28 00:00:00+03:00,in,False,924954,False,1,137,168,31
167497,2019-11-28 00:00:00+03:00,out,False,924940,True,2,0,45,45
167497,2019-11-28 00:00:00+03:00,out,False,924930,True,7,0,184,184
167497,2019-11-28 00:00:00+03:00,out,True,924930,False,1,40,66,26
167497,2019-11-28 00:00:00+03:00,out,False,924954,False,1,133,142,9
167497,2019-11-28 00:00:00+03:00,in,False,924940,False,3,327,391,64
167497,2019-11-28 00:00:00+03:00,in,False,-1,True,3,0,54,54
167506,2019-09-20 00:00:00+03:00,in,False,-1,True,2,0,4,4
167506,2019-09-25 00:00:00+03:00,in,False,-1,True,1,0,2,2
167506,2019-09-25 00:00:00+03:00,in,False,-1,True,1,0,2,2
167506,2019-09-26 00:00:00+03:00,in,False,919956,False,1,10,19,9
167506,2019-09-30 00:00:00+03:00,in,False,923744,False,1,55,60,5
167506,2019-09-30 00:00:00+03:00,in,False,-1,True,1,0,21,21
167506,2019-09-30 00:00:00+03:00,in,False,919956,False,1,47,59,12
167506,2019-09-30 00:00:00+03:00,in,True,919956,False,1,32,46,14
167506,2019-09-30 00:00:00+03:00,in,False,-1,True,5,0,38,38
167506,2019-10-02 00:00:00+03:00,in,False,-1,True,1,0,20,20
167506,2019-10-03 00:00:00+03:00,in,False,919956,False,1,2,11,9
167506,2019-10-03 00:00:00+03:00,in,False,-1,True,1,0,15,15
167506,2019-10-03 00:00:00+03:00,in,False,919958,False,2,38,73,35
167506,2019-10-03 00:00:00+03:00,in,False,-1,True,1,0,15,15
167506,2019-10-04 00:00:00+03:00,in,False,-1,True,1,0,19,19
167506,2019-10-15 00:00:00+03:00,in,False,-1,True,2,0,72,72
167506,2019-10-16 00:00:00+03:00,in,False,919956,False,1,20,37,17
167506,2019-10-17 00:00:00+03:00,in,False,919956,False,1,4,13,9
167506,2019-10-18 00:00:00+03:00,in,False,919956,False,1,19,28,9
167506,2019-10-21 00:00:00+03:00,in,False,919956,False,1,1,14,13
167506,2019-10-22 00:00:00+03:00,in,False,919956,False,1,6,15,9
167506,2019-10-25 00:00:00+03:00,in,False,919956,False,1,8,17,9
167506,2019-11-17 00:00:00+03:00,in,False,-1,True,2,0,59,59
167506,2019-11-19 00:00:00+03:00,in,False,919956,False,1,42,53,11
167506,2019-11-21 00:00:00+03:00,in,False,919956,False,1,18,26,8
167506,2019-11-21 00:00:00+03:00,in,False,919956,False,1,18,26,8
167521,2019-09-25 00:00:00+03:00,in,False,-1,True,2,0,103,103
167521,2019-09-25 00:00:00+03:00,in,False,919790,False,10,764,1035,271
167521,2019-09-25 00:00:00+03:00,in,False,919792,False,5,296,412,116
167521,2019-09-26 00:00:00+03:00,in,False,919792,False,21,1663,2232,569
167521,2019-09-26 00:00:00+03:00,in,False,919790,False,1,1,60,59
167521,2019-09-26 00:00:00+03:00,in,False,919794,False,26,1607,2431,824
167521,2019-09-26 00:00:00+03:00,in,False,-1,True,54,0,1240,1240
167521,2019-09-27 00:00:00+03:00,in,False,919790,False,25,2191,3122,931
167521,2019-09-27 00:00:00+03:00,out,False,919792,False,4,268,308,40
167521,2019-09-27 00:00:00+03:00,in,False,-1,True,10,0,624,624
167521,2019-09-27 00:00:00+03:00,in,False,919792,False,25,2570,3333,763
167521,2019-09-27 00:00:00+03:00,out,False,919792,True,2,0,2,2
167521,2019-09-27 00:00:00+03:00,in,False,-1,True,10,0,624,624
167521,2019-09-28 00:00:00+03:00,in,False,919792,False,10,325,816,491
167521,2019-09-28 00:00:00+03:00,in,False,919794,False,25,1959,3041,1082
167521,2019-09-28 00:00:00+03:00,in,False,919790,False,10,866,1183,317
167521,2019-09-28 00:00:00+03:00,in,False,-1,True,56,0,1168,1168
167521,2019-09-28 00:00:00+03:00,out,False,919792,False,3,291,318,27
167521,2019-09-28 00:00:00+03:00,in,False,919794,False,25,1959,3041,1082
167521,2019-09-28 00:00:00+03:00,in,False,919790,False,10,866,1183,317
167521,2019-09-29 00:00:00+03:00,in,False,-1,True,33,0,706,706
167521,2019-09-29 00:00:00+03:00,out,False,919794,False,1,166,178,12
167521,2019-09-29 00:00:00+03:00,in,False,919790,False,25,1510,2331,821
167521,2019-09-29 00:00:00+03:00,in,False,919794,False,25,3306,4060,754
167521,2019-09-30 00:00:00+03:00,in,False,919790,False,33,2155,3442,1287
167521,2019-09-30 00:00:00+03:00,in,False,-1,True,12,0,624,624
167521,2019-09-30 00:00:00+03:00,in,False,919792,False,3,143,202,59
167521,2019-09-30 00:00:00+03:00,out,False,919792,False,1,36,49,13
167521,2019-09-30 00:00:00+03:00,in,False,919790,False,33,2155,3442,1287
167521,2019-10-01 00:00:00+03:00,out,False,919792,False,3,52,73,21
167521,2019-10-01 00:00:00+03:00,in,False,919794,False,42,2698,3818,1120
167521,2019-10-01 00:00:00+03:00,in,False,-1,True,15,0,369,369
167521,2019-10-01 00:00:00+03:00,in,False,919792,False,14,968,1330,362
167521,2019-10-02 00:00:00+03:00,in,False,919792,False,4,647,770,123
167521,2019-10-02 00:00:00+03:00,in,False,919790,False,34,2552,3771,1219
167521,2019-10-02 00:00:00+03:00,in,False,-1,True,50,0,1081,1081
167521,2019-10-03 00:00:00+03:00,in,False,919792,False,13,1067,1442,375
167521,2019-10-03 00:00:00+03:00,out,False,919792,False,1,95,101,6
167521,2019-10-03 00:00:00+03:00,in,False,-1,True,21,0,423,423
167521,2019-10-03 00:00:00+03:00,in,False,919790,False,38,2082,3384,1302
167521,2019-10-03 00:00:00+03:00,out,False,919792,True,1,0,23,23
167521,2019-10-03 00:00:00+03:00,in,False,-1,True,21,0,423,423
167521,2019-10-03 00:00:00+03:00,out,False,919792,False,1,95,101,6
167521,2019-10-04 00:00:00+03:00,in,False,919794,False,21,1345,1884,539
167521,2019-10-04 00:00:00+03:00,in,False,-1,True,25,0,1069,1069
167521,2019-10-04 00:00:00+03:00,in,False,919792,False,12,1425,1813,388
167521,2019-10-04 00:00:00+03:00,in,False,919790,False,2,86,138,52
167521,2019-10-04 00:00:00+03:00,out,False,919792,False,2,203,226,23
167521,2019-10-05 00:00:00+03:00,in,False,-1,True,13,0,288,288
167521,2019-10-05 00:00:00+03:00,out,False,919794,False,1,37,49,12
167521,2019-10-05 00:00:00+03:00,in,False,919792,False,5,368,486,118
167521,2019-10-05 00:00:00+03:00,in,False,919790,False,13,903,1311,408
167521,2019-10-05 00:00:00+03:00,in,False,919794,False,33,2198,3096,898
167521,2019-10-06 00:00:00+03:00,in,False,919794,False,30,2612,3440,828
167521,2019-10-06 00:00:00+03:00,in,False,919792,False,20,1359,1942,583
167521,2019-10-06 00:00:00+03:00,in,False,-1,True,22,0,734,734
167521,2019-10-07 00:00:00+03:00,in,False,919792,False,16,909,1303,394
167521,2019-10-07 00:00:00+03:00,in,False,919794,True,1,0,17,17
167521,2019-10-07 00:00:00+03:00,in,False,919794,False,45,2670,4560,1890
167521,2019-10-07 00:00:00+03:00,out,False,919792,False,1,17,26,9
167521,2019-10-07 00:00:00+03:00,in,False,-1,True,27,0,571,571
167521,2019-10-07 00:00:00+03:00,in,False,919794,False,45,2670,4560,1890
167521,2019-10-07 00:00:00+03:00,out,False,919792,False,1,17,26,9
167521,2019-10-08 00:00:00+03:00,in,False,919790,False,6,591,766,175
167521,2019-10-08 00:00:00+03:00,in,False,919794,False,28,1966,2643,677
167521,2019-10-08 00:00:00+03:00,in,False,919792,False,10,675,1018,343
167521,2019-10-08 00:00:00+03:00,in,False,-1,True,15,0,316,316
167521,2019-10-09 00:00:00+03:00,in,False,919792,False,5,483,628,145
167521,2019-10-09 00:00:00+03:00,in,False,-1,True,7,0,138,138
167521,2019-10-09 00:00:00+03:00,out,False,919790,False,1,15,34,19
167521,2019-10-09 00:00:00+03:00,in,False,919790,False,40,2497,3763,1266
167521,2019-10-09 00:00:00+03:00,in,False,-1,True,7,0,138,138
167521,2019-10-09 00:00:00+03:00,in,False,919792,False,5,483,628,145
167521,2019-10-10 00:00:00+03:00,in,False,919790,False,41,2929,4183,1254
167521,2019-10-10 00:00:00+03:00,in,False,919792,False,18,1312,1939,627
167521,2019-10-10 00:00:00+03:00,in,False,-1,True,59,0,1510,1510
167521,2019-10-10 00:00:00+03:00,out,False,919790,True,1,0,2,2
167521,2019-10-11 00:00:00+03:00,in,False,919792,False,26,1704,2516,812
167521,2019-10-11 00:00:00+03:00,out,False,919790,False,5,323,385,62
167521,2019-10-11 00:00:00+03:00,in,False,919790,False,35,2663,4101,1438
167521,2019-10-11 00:00:00+03:00,in,False,-1,True,41,0,1108,1108
167521,2019-10-12 00:00:00+03:00,out,False,919792,False,1,50,60,10
167521,2019-10-12 00:00:00+03:00,in,False,-1,True,19,0,1781,1781
167521,2019-10-12 00:00:00+03:00,in,False,919794,False,47,4830,6942,2112
167521,2019-10-12 00:00:00+03:00,in,False,919792,False,28,1610,2385,775
167521,2019-10-13 00:00:00+03:00,in,False,919794,False,41,2826,4255,1429
167521,2019-10-13 00:00:00+03:00,out,False,919792,False,1,74,86,12
167521,2019-10-13 00:00:00+03:00,in,False,-1,True,46,0,1505,1505
167521,2019-10-13 00:00:00+03:00,in,False,919792,False,19,1368,2217,849
167521,2019-10-13 00:00:00+03:00,in,False,919794,False,41,2826,4255,1429
167521,2019-10-14 00:00:00+03:00,in,False,-1,True,28,0,1096,1096
167521,2019-10-14 00:00:00+03:00,in,False,919790,False,16,1447,1941,494
167521,2019-10-14 00:00:00+03:00,in,False,919794,False,38,2325,3412,1087
167521,2019-10-15 00:00:00+03:00,in,False,919792,False,2,196,245,49
167521,2019-10-15 00:00:00+03:00,in,False,919790,False,45,3194,4611,1417
167521,2019-10-15 00:00:00+03:00,in,False,-1,True,35,0,854,854
167521,2019-10-16 00:00:00+03:00,in,False,919790,False,22,1388,1946,558
167521,2019-10-16 00:00:00+03:00,in,False,919792,False,9,365,667,302
167521,2019-10-16 00:00:00+03:00,out,False,919792,False,4,248,301,53
167521,2019-10-16 00:00:00+03:00,in,False,-1,True,35,0,969,969
167521,2019-10-16 00:00:00+03:00,out,False,919792,True,1,0,33,33
167521,2019-10-16 00:00:00+03:00,out,False,919792,False,4,248,301,53
167521,2019-10-16 00:00:00+03:00,in,False,919790,False,22,1388,1946,558
167521,2019-10-17 00:00:00+03:00,out,False,919790,True,4,0,8,8
167521,2019-10-17 00:00:00+03:00,in,False,919790,False,5,329,551,222
167521,2019-10-17 00:00:00+03:00,in,False,919792,False,23,1921,2495,574
167521,2019-10-17 00:00:00+03:00,out,False,919792,True,1,0,4,4
167521,2019-10-17 00:00:00+03:00,in,False,919794,False,44,4520,5784,1264
167521,2019-10-17 00:00:00+03:00,in,False,-1,True,27,0,901,901
167521,2019-10-17 00:00:00+03:00,out,False,919792,False,1,20,27,7
167521,2019-10-17 00:00:00+03:00,out,False,919794,False,2,107,119,12
167521,2019-10-17 00:00:00+03:00,in,False,919792,False,23,1921,2495,574
167521,2019-10-18 00:00:00+03:00,out,False,919792,False,1,157,168,11
167521,2019-10-18 00:00:00+03:00,in,False,919792,False,18,1623,2214,591
167521,2019-10-18 00:00:00+03:00,in,False,919794,False,33,3699,4531,832
167521,2019-10-18 00:00:00+03:00,out,False,919794,False,1,254,258,4
167521,2019-10-18 00:00:00+03:00,in,False,-1,True,12,0,239,239
167521,2019-10-18 00:00:00+03:00,in,False,919792,False,18,1623,2214,591
167521,2019-10-19 00:00:00+03:00,in,False,919792,False,22,1396,1925,529
167521,2019-10-19 00:00:00+03:00,out,False,919792,False,4,107,147,40
167521,2019-10-19 00:00:00+03:00,in,False,919794,False,41,3267,4200,933
167521,2019-10-19 00:00:00+03:00,in,False,919790,False,4,207,307,100
167521,2019-10-19 00:00:00+03:00,in,False,-1,True,27,0,719,719
167521,2019-10-20 00:00:00+03:00,in,False,919792,False,5,208,341,133
167521,2019-10-20 00:00:00+03:00,in,False,919794,False,35,2475,3564,1089
167521,2019-10-20 00:00:00+03:00,in,False,-1,True,23,0,567,567
167521,2019-10-20 00:00:00+03:00,in,False,919790,False,24,2096,3055,959
167521,2019-10-21 00:00:00+03:00,out,False,919790,False,2,26,49,23
167521,2019-10-21 00:00:00+03:00,in,False,-1,True,59,0,1360,1360
167521,2019-10-21 00:00:00+03:00,in,False,919794,False,41,3132,4344,1212
167521,2019-10-21 00:00:00+03:00,in,False,919790,False,14,1263,1693,430
167521,2019-10-22 00:00:00+03:00,in,False,919792,False,6,397,603,206
167521,2019-10-22 00:00:00+03:00,in,False,919790,False,35,2257,3257,1000
167521,2019-10-22 00:00:00+03:00,in,False,-1,True,4,0,232,232
167521,2019-10-23 00:00:00+03:00,in,False,-1,True,9,0,1313,1313
167521,2019-10-23 00:00:00+03:00,in,False,919792,False,17,1396,1847,451
167521,2019-10-23 00:00:00+03:00,in,False,944808,False,1,91,96,5
167521,2019-10-23 00:00:00+03:00,out,False,919790,False,1,26,34,8
167521,2019-10-23 00:00:00+03:00,in,False,919790,False,28,2110,3129,1019
167521,2019-10-23 00:00:00+03:00,in,False,944808,False,1,91,96,5
167521,2019-10-24 00:00:00+03:00,out,False,919792,False,2,72,99,27
167521,2019-10-24 00:00:00+03:00,in,False,919790,False,1,29,60,31
167521,2019-10-24 00:00:00+03:00,in,False,-1,True,35,0,948,948
167521,2019-10-24 00:00:00+03:00,in,False,919792,False,7,454,811,357
167521,2019-10-24 00:00:00+03:00,in,False,944808,False,1,81,85,4
167521,2019-10-24 00:00:00+03:00,in,False,919794,False,45,3354,4397,1043
167521,2019-10-24 00:00:00+03:00,out,False,919792,False,2,72,99,27
167521,2019-10-25 00:00:00+03:00,in,False,919790,False,20,1637,2325,688
167521,2019-10-25 00:00:00+03:00,in,False,946916,False,2,47,55,8
167521,2019-10-25 00:00:00+03:00,in,False,-1,True,13,0,539,539
167521,2019-10-25 00:00:00+03:00,in,False,919794,False,36,3572,4513,941
167521,2019-10-25 00:00:00+03:00,in,False,919790,False,20,1637,2325,688
167521,2019-10-26 00:00:00+03:00,out,False,919794,False,2,146,180,34
167521,2019-10-26 00:00:00+03:00,in,False,-1,True,15,0,292,292
167521,2019-10-26 00:00:00+03:00,in,False,919794,False,42,2877,4101,1224
167521,2019-10-26 00:00:00+03:00,in,False,919790,False,28,2035,2931,896
167521,2019-10-27 00:00:00+03:00,out,False,919790,False,3,82,137,55
167521,2019-10-27 00:00:00+03:00,in,False,-1,True,28,0,783,783
167521,2019-10-27 00:00:00+03:00,in,False,919790,False,33,2371,3834,1463
167521,2019-10-27 00:00:00+03:00,in,False,919792,False,25,1177,2070,893
167521,2019-10-27 00:00:00+03:00,out,False,919792,False,4,126,177,51
167521,2019-10-27 00:00:00+03:00,in,False,-1,True,28,0,783,783
167521,2019-10-27 00:00:00+03:00,out,False,919792,False,4,126,177,51
167521,2019-10-28 00:00:00+03:00,in,False,944808,False,4,264,274,10
167521,2019-10-28 00:00:00+03:00,in,False,919790,False,36,2219,3698,1479
167521,2019-10-28 00:00:00+03:00,in,False,-1,True,14,0,577,577
167521,2019-10-28 00:00:00+03:00,out,False,919790,True,1,0,20,20
167521,2019-10-28 00:00:00+03:00,out,False,919790,False,1,10,22,12
167521,2019-10-28 00:00:00+03:00,in,False,946916,False,1,60,61,1
167521,2019-10-28 00:00:00+03:00,in,False,919792,False,15,1503,1875,372
167521,2019-10-28 00:00:00+03:00,out,False,919790,False,1,10,22,12
167521,2019-10-29 00:00:00+03:00,in,False,944808,False,3,178,185,7
167521,2019-10-29 00:00:00+03:00,in,False,946916,False,3,77,86,9
167521,2019-10-29 00:00:00+03:00,out,False,919792,False,1,204,216,12
167521,2019-10-29 00:00:00+03:00,in,False,919792,False,11,879,1135,256
167521,2019-10-29 00:00:00+03:00,in,False,-1,True,5,0,179,179
167521,2019-10-29 00:00:00+03:00,in,False,919790,False,24,1218,1979,761
167521,2019-10-30 00:00:00+03:00,in,False,944808,False,2,163,165,2
167521,2019-10-30 00:00:00+03:00,in,False,-1,True,14,0,409,409
167521,2019-10-30 00:00:00+03:00,in,False,919792,False,9,750,961,211
167521,2019-10-30 00:00:00+03:00,in,False,919790,False,51,3236,4990,1754
167521,2019-10-30 00:00:00+03:00,in,False,946916,False,2,47,50,3
167521,2019-10-31 00:00:00+03:00,in,False,919792,False,20,1924,2471,547
167521,2019-10-31 00:00:00+03:00,in,False,944210,False,1,13,28,15
167521,2019-10-31 00:00:00+03:00,out,False,919792,False,1,30,40,10
167521,2019-10-31 00:00:00+03:00,in,False,-1,True,6,0,330,330
167521,2019-10-31 00:00:00+03:00,in,False,919790,False,38,2837,4272,1435
167521,2019-10-31 00:00:00+03:00,in,False,944808,False,1,6,8,2
167521,2019-11-01 00:00:00+03:00,in,False,919790,False,44,3153,5036,1883
167521,2019-11-01 00:00:00+03:00,in,False,944210,False,1,237,249,12
167521,2019-11-01 00:00:00+03:00,in,False,-1,True,35,0,2515,2515
167521,2019-11-01 00:00:00+03:00,in,False,919792,False,24,3154,3922,768
167521,2019-11-01 00:00:00+03:00,out,False,919792,False,2,186,210,24
167521,2019-11-01 00:00:00+03:00,in,False,944210,False,1,237,249,12
167521,2019-11-02 00:00:00+03:00,out,False,919792,False,1,146,157,11
167521,2019-11-02 00:00:00+03:00,in,False,919790,False,47,2458,3950,1492
167521,2019-11-02 00:00:00+03:00,in,False,-1,True,44,0,1450,1450
167521,2019-11-02 00:00:00+03:00,in,False,919792,False,29,4133,5032,899
167521,2019-11-03 00:00:00+03:00,in,False,919792,False,12,982,1299,317
167521,2019-11-03 00:00:00+03:00,in,False,-1,True,22,0,661,661
167521,2019-11-03 00:00:00+03:00,in,False,919790,False,45,2377,3662,1285
167521,2019-11-04 00:00:00+03:00,in,False,944808,False,1,2,3,1
167521,2019-11-04 00:00:00+03:00,in,False,919790,False,37,2525,3893,1368
167521,2019-11-04 00:00:00+03:00,in,False,-1,True,50,0,1303,1303
167521,2019-11-04 00:00:00+03:00,out,False,919792,False,2,76,86,10
167521,2019-11-04 00:00:00+03:00,in,False,919792,False,33,2667,3559,892
167521,2019-11-04 00:00:00+03:00,out,False,919792,False,2,76,86,10
167521,2019-11-05 00:00:00+03:00,in,False,919792,False,19,1452,1941,489
167521,2019-11-05 00:00:00+03:00,out,False,944210,True,2,0,55,55
167521,2019-11-05 00:00:00+03:00,in,False,919790,False,71,3495,5712,2217
167521,2019-11-05 00:00:00+03:00,in,False,-1,True,16,0,227,227
167521,2019-11-05 00:00:00+03:00,in,False,944808,False,25,3952,4003,51
167521,2019-11-05 00:00:00+03:00,out,False,919792,False,4,188,255,67
167521,2019-11-05 00:00:00+03:00,out,False,919792,True,2,0,4,4
167521,2019-11-05 00:00:00+03:00,out,False,944210,False,2,26,64,38
167521,2019-11-05 00:00:00+03:00,in,False,944808,False,25,3952,4003,51
167521,2019-11-06 00:00:00+03:00,in,False,919792,False,14,751,1141,390
167521,2019-11-06 00:00:00+03:00,in,False,944808,False,12,950,976,26
167521,2019-11-06 00:00:00+03:00,in,False,919790,False,50,2924,4578,1654
167521,2019-11-06 00:00:00+03:00,in,False,944210,False,1,50,59,9
167521,2019-11-06 00:00:00+03:00,out,False,944210,True,1,0,38,38
167521,2019-11-06 00:00:00+03:00,out,False,919792,False,1,14,27,13
167521,2019-11-06 00:00:00+03:00,in,False,-1,True,12,0,236,236
167521,2019-11-07 00:00:00+03:00,in,False,-1,True,33,0,688,688
167521,2019-11-07 00:00:00+03:00,in,False,944808,False,15,2120,2160,40
167521,2019-11-07 00:00:00+03:00,in,False,919792,False,17,1174,1649,475
167521,2019-11-07 00:00:00+03:00,out,False,944210,True,1,0,27,27
167521,2019-11-07 00:00:00+03:00,in,False,919790,False,31,1890,3333,1443
167521,2019-11-07 00:00:00+03:00,out,False,919792,True,1,0,32,32
167521,2019-11-07 00:00:00+03:00,out,False,944210,False,2,23,42,19
167521,2019-11-07 00:00:00+03:00,in,False,944210,False,9,553,649,96
167521,2019-11-07 00:00:00+03:00,in,False,956664,False,1,99,108,9
167521,2019-11-07 00:00:00+03:00,out,False,919792,False,1,4,43,39
167521,2019-11-08 00:00:00+03:00,in,False,919790,False,34,2845,4038,1193
167521,2019-11-08 00:00:00+03:00,in,False,944210,False,1,2,21,19
167521,2019-11-08 00:00:00+03:00,in,False,919792,False,16,1295,1716,421
167521,2019-11-08 00:00:00+03:00,in,False,-1,True,8,0,209,209
167521,2019-11-08 00:00:00+03:00,in,False,-1,True,1,0,4,4
167521,2019-11-08 00:00:00+03:00,in,False,919792,True,1,0,63,63
167521,2019-11-08 00:00:00+03:00,in,False,944808,False,16,1146,1186,40
167521,2019-11-08 00:00:00+03:00,out,False,919792,False,4,128,177,49
167521,2019-11-08 00:00:00+03:00,in,False,919792,True,1,0,63,63
167521,2019-11-08 00:00:00+03:00,in,False,919790,False,34,2845,4038,1193
167521,2019-11-08 00:00:00+03:00,in,False,919792,False,16,1295,1716,421
167521,2019-11-09 00:00:00+03:00,in,False,-1,True,28,0,2187,2187
167521,2019-11-09 00:00:00+03:00,in,False,919790,False,48,3023,4879,1856
167521,2019-11-09 00:00:00+03:00,in,False,919792,False,15,2399,3132,733
167521,2019-11-09 00:00:00+03:00,in,False,944808,False,11,1721,1737,16
167521,2019-11-09 00:00:00+03:00,out,False,919792,False,2,216,241,25
167521,2019-11-09 00:00:00+03:00,out,False,919790,False,1,108,117,9
167521,2019-11-09 00:00:00+03:00,out,False,919790,False,1,108,117,9
167521,2019-11-10 00:00:00+03:00,in,False,-1,True,36,0,1134,1134
167521,2019-11-10 00:00:00+03:00,in,False,919790,False,1,49,79,30
167521,2019-11-10 00:00:00+03:00,in,False,919794,False,29,1870,2488,618
167521,2019-11-10 00:00:00+03:00,in,False,944808,False,5,532,537,5
167521,2019-11-10 00:00:00+03:00,in,False,919792,False,19,1164,1996,832
167521,2019-11-11 00:00:00+03:00,in,False,919792,False,4,779,878,99
167521,2019-11-11 00:00:00+03:00,in,False,919794,False,24,1173,1720,547
167521,2019-11-11 00:00:00+03:00,in,False,919790,False,5,393,563,170
167521,2019-11-11 00:00:00+03:00,in,False,944210,False,2,46,68,22
167521,2019-11-11 00:00:00+03:00,out,False,944210,False,7,586,738,152
167521,2019-11-11 00:00:00+03:00,in,False,944808,False,15,2056,2092,36
167521,2019-11-11 00:00:00+03:00,in,False,-1,True,6,0,356,356
167521,2019-11-11 00:00:00+03:00,out,False,944210,True,2,0,30,30
167521,2019-11-12 00:00:00+03:00,in,False,919792,False,6,608,855,247
167521,2019-11-12 00:00:00+03:00,out,False,944210,True,1,0,5,5
167521,2019-11-12 00:00:00+03:00,out,False,944210,False,5,547,608,61
167521,2019-11-12 00:00:00+03:00,in,False,919794,False,31,2062,2836,774
167521,2019-11-12 00:00:00+03:00,in,False,944210,False,7,404,479,75
167521,2019-11-12 00:00:00+03:00,out,False,919792,False,1,22,35,13
167521,2019-11-12 00:00:00+03:00,in,False,944808,False,18,3268,3314,46
167521,2019-11-12 00:00:00+03:00,in,False,-1,True,9,0,164,164
167521,2019-11-12 00:00:00+03:00,in,False,919790,False,7,409,600,191
167521,2019-11-12 00:00:00+03:00,in,False,944210,False,7,404,479,75
167521,2019-11-12 00:00:00+03:00,in,False,919790,False,7,409,600,191
167521,2019-11-13 00:00:00+03:00,out,False,944210,False,11,1210,1460,250
167521,2019-11-13 00:00:00+03:00,in,False,944228,False,1,128,140,12
167521,2019-11-13 00:00:00+03:00,in,False,919790,False,20,1455,2028,573
167521,2019-11-13 00:00:00+03:00,in,False,-1,True,14,0,930,930
167521,2019-11-13 00:00:00+03:00,in,False,919794,False,59,4134,5797,1663
167521,2019-11-13 00:00:00+03:00,in,False,944808,False,12,1171,1207,36
167521,2019-11-13 00:00:00+03:00,in,False,944210,False,3,350,382,32
167521,2019-11-13 00:00:00+03:00,out,False,919794,False,2,104,133,29
167521,2019-11-13 00:00:00+03:00,out,False,944210,True,3,0,72,72
167521,2019-11-14 00:00:00+03:00,in,True,961770,False,1,3,10,7
167521,2019-11-14 00:00:00+03:00,in,False,-1,True,5,0,41,41
167521,2019-11-14 00:00:00+03:00,in,False,944808,False,18,1854,1891,37
167521,2019-11-14 00:00:00+03:00,in,False,944228,False,1,146,160,14
167521,2019-11-14 00:00:00+03:00,out,False,944210,False,5,699,761,62
167521,2019-11-14 00:00:00+03:00,in,False,944210,False,6,563,771,208
167521,2019-11-14 00:00:00+03:00,out,False,944210,True,2,0,30,30
167521,2019-11-14 00:00:00+03:00,out,False,919792,True,1,0,2,2
167521,2019-11-14 00:00:00+03:00,out,False,962268,True,2,0,75,75
167521,2019-11-14 00:00:00+03:00,in,False,919792,False,4,564,662,98
167521,2019-11-14 00:00:00+03:00,in,False,919790,False,63,3760,5715,1955
167521,2019-11-14 00:00:00+03:00,out,False,919792,False,1,180,189,9
167521,2019-11-14 00:00:00+03:00,in,True,962268,False,1,3,18,15
167521,2019-11-14 00:00:00+03:00,in,False,961770,False,7,143,229,86
167521,2019-11-14 00:00:00+03:00,in,False,-1,True,66,0,1413,1413
167521,2019-11-14 00:00:00+03:00,out,False,919792,False,1,180,189,9
167521,2019-11-14 00:00:00+03:00,in,False,944210,False,6,563,771,208
167521,2019-11-14 00:00:00+03:00,out,False,944210,False,5,699,761,62
167521,2019-11-14 00:00:00+03:00,in,False,-1,True,66,0,1413,1413
167521,2019-11-15 00:00:00+03:00,in,False,-1,True,43,0,864,864
167521,2019-11-15 00:00:00+03:00,in,False,944210,False,5,1166,1381,215
167521,2019-11-15 00:00:00+03:00,in,False,944246,False,1,71,114,43
167521,2019-11-15 00:00:00+03:00,in,False,919790,False,38,2820,4048,1228
167521,2019-11-15 00:00:00+03:00,in,False,944808,False,3,66,71,5
167521,2019-11-15 00:00:00+03:00,out,False,919792,False,1,99,117,18
167521,2019-11-15 00:00:00+03:00,in,False,962268,False,3,150,187,37
167521,2019-11-15 00:00:00+03:00,out,False,962268,True,13,0,221,221
167521,2019-11-15 00:00:00+03:00,out,False,962268,False,18,1846,2178,332
167521,2019-11-15 00:00:00+03:00,in,False,961770,False,7,288,370,82
167521,2019-11-15 00:00:00+03:00,in,False,919792,False,3,194,286,92
167521,2019-11-15 00:00:00+03:00,in,False,962268,False,3,150,187,37
167521,2019-11-15 00:00:00+03:00,in,False,944210,False,5,1166,1381,215
167521,2019-11-16 00:00:00+03:00,in,False,961770,False,4,191,218,27
167521,2019-11-16 00:00:00+03:00,in,False,919790,False,14,971,1372,401
167521,2019-11-16 00:00:00+03:00,in,False,946916,False,7,83,170,87
167521,2019-11-16 00:00:00+03:00,in,False,919794,False,30,2369,3084,715
167521,2019-11-16 00:00:00+03:00,in,False,944808,False,6,1293,1300,7
167521,2019-11-16 00:00:00+03:00,in,False,-1,True,31,0,902,902
167521,2019-11-16 00:00:00+03:00,in,False,919790,False,14,971,1372,401
167521,2019-11-17 00:00:00+03:00,in,False,919794,False,43,4065,5098,1033
167521,2019-11-17 00:00:00+03:00,in,False,919792,False,1,28,47,19
167521,2019-11-17 00:00:00+03:00,in,False,944808,False,4,557,562,5
167521,2019-11-17 00:00:00+03:00,in,False,-1,True,21,0,379,379
167521,2019-11-17 00:00:00+03:00,in,False,961770,False,4,131,170,39
167521,2019-11-17 00:00:00+03:00,in,False,946916,False,4,35,73,38
167521,2019-11-17 00:00:00+03:00,out,False,919794,False,3,497,529,32
167521,2019-11-17 00:00:00+03:00,in,False,919790,False,8,699,923,224
167521,2019-11-17 00:00:00+03:00,in,False,919794,False,43,4065,5098,1033
167521,2019-11-18 00:00:00+03:00,in,False,919790,False,3,241,309,68
167521,2019-11-18 00:00:00+03:00,in,False,961770,False,3,84,122,38
167521,2019-11-18 00:00:00+03:00,out,False,962268,True,5,0,152,152
167521,2019-11-18 00:00:00+03:00,in,False,919794,False,36,3208,4173,965
167521,2019-11-18 00:00:00+03:00,in,False,944808,False,19,1520,1579,59
167521,2019-11-18 00:00:00+03:00,in,False,944210,False,4,354,506,152
167521,2019-11-18 00:00:00+03:00,out,False,919794,True,7,0,92,92
167521,2019-11-18 00:00:00+03:00,in,False,962268,False,2,195,223,28
167521,2019-11-18 00:00:00+03:00,out,False,919794,False,1,66,75,9
167521,2019-11-18 00:00:00+03:00,out,False,962268,False,11,501,725,224
167521,2019-11-18 00:00:00+03:00,out,False,944560,True,1,0,10,10
167521,2019-11-18 00:00:00+03:00,in,False,944228,False,1,96,155,59
167521,2019-11-18 00:00:00+03:00,in,False,-1,True,22,0,598,598
167521,2019-11-18 00:00:00+03:00,in,False,919792,False,6,320,475,155
167521,2019-11-18 00:00:00+03:00,in,False,944246,False,1,5,26,21
167521,2019-11-18 00:00:00+03:00,in,False,944228,False,1,96,155,59
167521,2019-11-18 00:00:00+03:00,in,False,-1,True,22,0,598,598
167521,2019-11-19 00:00:00+03:00,in,False,919790,False,58,4427,6421,1994
167521,2019-11-19 00:00:00+03:00,in,False,961770,False,3,115,154,39
167521,2019-11-19 00:00:00+03:00,in,False,-1,True,50,0,1120,1120
167521,2019-11-19 00:00:00+03:00,out,False,944210,False,1,149,161,12
167521,2019-11-19 00:00:00+03:00,in,False,962268,False,2,45,71,26
167521,2019-11-19 00:00:00+03:00,out,False,962268,False,3,345,383,38
167521,2019-11-19 00:00:00+03:00,in,False,944228,False,1,33,100,67
167521,2019-11-19 00:00:00+03:00,out,False,919792,False,2,272,285,13
167521,2019-11-19 00:00:00+03:00,in,False,-1,True,1,0,16,16
167521,2019-11-19 00:00:00+03:00,in,False,944210,False,12,1637,2188,551
167521,2019-11-19 00:00:00+03:00,out,False,944228,True,2,0,5,5
167521,2019-11-19 00:00:00+03:00,in,False,946916,False,2,101,205,104
167521,2019-11-19 00:00:00+03:00,in,False,919792,False,7,436,656,220
167521,2019-11-19 00:00:00+03:00,in,False,944808,False,7,259,282,23
167521,2019-11-19 00:00:00+03:00,in,False,944228,False,1,33,100,67
167521,2019-11-20 00:00:00+03:00,out,False,919792,False,1,102,114,12
167521,2019-11-20 00:00:00+03:00,out,False,944246,False,1,60,75,15
167521,2019-11-20 00:00:00+03:00,in,False,946916,False,4,116,192,76
167521,2019-11-20 00:00:00+03:00,out,False,919790,True,1,0,9,9
167521,2019-11-20 00:00:00+03:00,in,False,961770,False,6,141,205,64
167521,2019-11-20 00:00:00+03:00,out,False,962268,False,2,10,60,50
167521,2019-11-20 00:00:00+03:00,in,False,944246,False,2,377,446,69
167521,2019-11-20 00:00:00+03:00,out,False,962268,True,4,0,72,72
167521,2019-11-20 00:00:00+03:00,in,False,919790,False,33,1984,3007,1023
167521,2019-11-20 00:00:00+03:00,in,False,944228,False,1,349,412,63
167521,2019-11-20 00:00:00+03:00,in,False,919792,False,12,1403,1769,366
167521,2019-11-20 00:00:00+03:00,in,False,-1,True,66,0,1426,1426
167521,2019-11-20 00:00:00+03:00,in,False,944808,False,12,1127,1158,31
167521,2019-11-20 00:00:00+03:00,in,False,944210,False,10,1268,1792,524
167521,2019-11-20 00:00:00+03:00,in,False,962268,False,5,345,413,68
167521,2019-11-20 00:00:00+03:00,out,False,962268,True,4,0,72,72
167521,2019-11-20 00:00:00+03:00,in,False,919792,False,12,1403,1769,366
167521,2019-11-21 00:00:00+03:00,in,False,-1,True,41,0,1004,1004
167521,2019-11-21 00:00:00+03:00,out,False,944228,False,2,316,352,36
167521,2019-11-21 00:00:00+03:00,in,False,944808,False,5,611,619,8
167521,2019-11-21 00:00:00+03:00,out,False,919792,False,1,95,112,17
167521,2019-11-21 00:00:00+03:00,in,False,962268,False,7,261,405,144
167521,2019-11-21 00:00:00+03:00,in,False,961770,False,3,123,158,35
167521,2019-11-21 00:00:00+03:00,in,False,944228,False,13,1440,2063,623
167521,2019-11-21 00:00:00+03:00,in,False,944210,False,3,265,445,180
167521,2019-11-21 00:00:00+03:00,in,False,919790,False,33,1953,2904,951
167521,2019-11-21 00:00:00+03:00,out,False,962268,False,1,360,371,11
167521,2019-11-21 00:00:00+03:00,in,False,944560,False,1,26,42,16
167521,2019-11-21 00:00:00+03:00,out,False,962268,True,6,0,44,44
167521,2019-11-21 00:00:00+03:00,in,False,944246,False,3,804,925,121
167521,2019-11-21 00:00:00+03:00,in,False,919792,False,12,1570,1905,335
167521,2019-11-21 00:00:00+03:00,out,False,919790,False,1,21,32,11
167521,2019-11-21 00:00:00+03:00,out,False,944228,True,1,0,14,14
167521,2019-11-21 00:00:00+03:00,out,False,919792,False,1,95,112,17
167521,2019-11-22 00:00:00+03:00,in,False,919790,False,29,1816,2657,841
167521,2019-11-22 00:00:00+03:00,in,False,944560,False,1,21,43,22
167521,2019-11-22 00:00:00+03:00,in,False,944210,False,12,1920,2408,488
167521,2019-11-22 00:00:00+03:00,in,False,944228,False,1,452,476,24
167521,2019-11-22 00:00:00+03:00,out,False,962268,True,3,0,34,34
167521,2019-11-22 00:00:00+03:00,out,False,962268,False,8,501,656,155
167521,2019-11-22 00:00:00+03:00,in,False,944808,False,3,425,433,8
167521,2019-11-22 00:00:00+03:00,out,False,944210,False,1,113,132,19
167521,2019-11-22 00:00:00+03:00,in,False,961770,False,5,233,294,61
167521,2019-11-22 00:00:00+03:00,in,False,-1,True,32,0,722,722
167521,2019-11-22 00:00:00+03:00,in,False,962268,False,5,336,460,124
167521,2019-11-22 00:00:00+03:00,in,False,919792,False,16,1846,2271,425
167521,2019-11-22 00:00:00+03:00,in,False,919790,False,29,1816,2657,841
167521,2019-11-23 00:00:00+03:00,in,False,961770,False,8,250,334,84
167521,2019-11-23 00:00:00+03:00,in,False,946916,False,2,16,30,14
167521,2019-11-23 00:00:00+03:00,in,False,919794,False,33,2795,3766,971
167521,2019-11-23 00:00:00+03:00,in,False,919792,False,16,1097,1500,403
167521,2019-11-23 00:00:00+03:00,in,False,-1,True,41,0,821,821
167521,2019-11-23 00:00:00+03:00,in,False,919790,False,6,552,704,152
167521,2019-11-24 00:00:00+03:00,in,False,-1,True,18,0,471,471
167521,2019-11-24 00:00:00+03:00,in,False,919794,False,31,2183,3040,857
167521,2019-11-24 00:00:00+03:00,in,False,946916,False,1,9,16,7
167521,2019-11-24 00:00:00+03:00,out,False,919790,False,1,164,179,15
167521,2019-11-24 00:00:00+03:00,in,False,919790,False,14,1133,1513,380
167521,2019-11-24 00:00:00+03:00,in,False,944808,False,2,189,191,2
167521,2019-11-24 00:00:00+03:00,in,False,961770,False,7,283,354,71
167521,2019-11-24 00:00:00+03:00,out,False,919794,False,1,48,59,11
167521,2019-11-25 00:00:00+03:00,in,False,944246,False,2,221,300,79
167521,2019-11-25 00:00:00+03:00,in,False,962268,False,4,273,326,53
167521,2019-11-25 00:00:00+03:00,in,False,944210,False,1,118,159,41
167521,2019-11-25 00:00:00+03:00,in,False,944228,False,5,806,1000,194
167521,2019-11-25 00:00:00+03:00,in,False,961770,False,10,555,668,113
167521,2019-11-25 00:00:00+03:00,out,False,962268,False,3,205,285,80
167521,2019-11-25 00:00:00+03:00,in,False,944808,False,1,13,14,1
167521,2019-11-25 00:00:00+03:00,in,False,919790,False,13,938,1247,309
167521,2019-11-25 00:00:00+03:00,in,False,-1,True,84,0,2295,2295
167521,2019-11-25 00:00:00+03:00,in,False,919794,False,64,5075,6580,1505
167521,2019-11-25 00:00:00+03:00,out,False,962268,True,5,0,102,102
167521,2019-11-25 00:00:00+03:00,out,False,962268,True,5,0,102,102
167521,2019-11-25 00:00:00+03:00,out,False,962268,False,3,205,285,80
167521,2019-11-26 00:00:00+03:00,in,False,919790,False,45,2623,3858,1235
167521,2019-11-26 00:00:00+03:00,in,False,-1,True,44,0,945,945
167521,2019-11-26 00:00:00+03:00,in,False,919792,False,3,254,327,73
167521,2019-11-26 00:00:00+03:00,out,False,962268,True,1,0,11,11
167521,2019-11-26 00:00:00+03:00,in,False,944808,False,1,29,31,2
167521,2019-11-26 00:00:00+03:00,in,False,961770,False,3,115,139,24
167521,2019-11-26 00:00:00+03:00,in,False,962268,False,4,91,142,51
167521,2019-11-26 00:00:00+03:00,out,False,962268,False,8,485,635,150
167521,2019-11-26 00:00:00+03:00,in,False,944228,False,3,609,828,219
167521,2019-11-26 00:00:00+03:00,in,False,944210,False,18,3056,3695,639
167521,2019-11-26 00:00:00+03:00,in,False,961770,False,3,115,139,24
167521,2019-11-26 00:00:00+03:00,in,False,919790,False,45,2623,3858,1235
167521,2019-11-26 00:00:00+03:00,in,False,962268,False,4,91,142,51
167521,2019-11-27 00:00:00+03:00,in,False,-1,True,34,0,948,948
167521,2019-11-27 00:00:00+03:00,in,False,946916,False,4,574,689,115
167521,2019-11-27 00:00:00+03:00,in,False,944808,False,1,13,14,1
167521,2019-11-27 00:00:00+03:00,in,False,962268,False,2,160,202,42
167521,2019-11-27 00:00:00+03:00,out,False,962268,False,1,260,272,12
167521,2019-11-27 00:00:00+03:00,in,False,961770,False,6,209,281,72
167521,2019-11-27 00:00:00+03:00,in,False,919792,False,14,704,1047,343
167521,2019-11-27 00:00:00+03:00,in,False,944210,False,13,1702,2305,603
167521,2019-11-27 00:00:00+03:00,in,False,919790,False,38,2084,3111,1027
167521,2019-11-27 00:00:00+03:00,in,False,944808,False,1,13,14,1
167521,2019-11-28 00:00:00+03:00,in,False,962268,False,3,308,362,54
167521,2019-11-28 00:00:00+03:00,in,False,944228,False,2,131,269,138
167521,2019-11-28 00:00:00+03:00,in,False,919794,False,37,2345,3138,793
167521,2019-11-28 00:00:00+03:00,in,False,961770,False,2,80,104,24
167521,2019-11-28 00:00:00+03:00,in,False,944210,False,5,356,650,294
167521,2019-11-28 00:00:00+03:00,in,False,944560,False,3,19,70,51
167521,2019-11-28 00:00:00+03:00,in,False,919792,False,4,353,478,125
167521,2019-11-28 00:00:00+03:00,in,False,944808,False,5,572,581,9
167521,2019-11-28 00:00:00+03:00,in,False,919790,False,4,299,445,146
167521,2019-11-28 00:00:00+03:00,in,False,-1,True,34,0,689,689
167521,2019-11-28 00:00:00+03:00,in,False,919794,False,37,2345,3138,793
167521,2019-11-28 00:00:00+03:00,in,False,919792,False,4,353,478,125
167530,2019-09-20 00:00:00+03:00,out,False,915504,False,3,784,827,43
167530,2019-09-20 00:00:00+03:00,out,False,915504,True,10,0,153,153
167530,2019-09-20 00:00:00+03:00,in,False,-1,True,1,0,2,2
167530,2019-09-25 00:00:00+03:00,in,False,-1,True,1,0,2,2
167530,2019-09-25 00:00:00+03:00,out,False,915504,True,2,0,28,28
167530,2019-09-25 00:00:00+03:00,in,False,-1,True,1,0,2,2
167530,2019-09-26 00:00:00+03:00,out,False,915504,True,8,0,347,347
167530,2019-09-26 00:00:00+03:00,out,False,915504,False,5,1471,1521,50
167530,2019-09-27 00:00:00+03:00,out,False,915504,True,2,0,108,108
167530,2019-09-27 00:00:00+03:00,out,False,915504,False,3,2547,2585,38
167532,2019-09-23 00:00:00+03:00,in,False,-1,True,1,0,0,0
167532,2019-09-24 00:00:00+03:00,out,False,917846,False,13,1659,1720,61
167532,2019-09-24 00:00:00+03:00,out,False,917856,False,5,301,333,32
167532,2019-09-24 00:00:00+03:00,out,True,917852,False,1,74,79,5
167532,2019-09-24 00:00:00+03:00,in,False,917850,False,2,56,88,32
167532,2019-09-24 00:00:00+03:00,out,True,917850,False,1,0,18,18
167532,2019-09-24 00:00:00+03:00,in,False,-1,True,19,0,337,337
167532,2019-09-24 00:00:00+03:00,out,False,917850,False,1,169,174,5
167532,2019-09-24 00:00:00+03:00,out,True,917852,True,1,0,7,7
167532,2019-09-24 00:00:00+03:00,out,False,917846,True,2,0,15,15
167532,2019-09-24 00:00:00+03:00,out,False,917852,False,10,612,714,102
167532,2019-09-24 00:00:00+03:00,out,True,917846,True,5,0,18,18
167532,2019-09-24 00:00:00+03:00,out,False,917852,True,7,0,131,131
167532,2019-09-24 00:00:00+03:00,out,True,917850,True,1,0,11,11
167532,2019-09-24 00:00:00+03:00,in,False,917852,False,3,340,400,60
167532,2019-09-24 00:00:00+03:00,out,True,917846,True,5,0,18,18
167532,2019-09-24 00:00:00+03:00,out,True,917852,True,1,0,7,7
167532,2019-09-25 00:00:00+03:00,in,False,-1,True,5,0,110,110
167532,2019-09-25 00:00:00+03:00,in,False,917852,False,3,225,262,37
167532,2019-09-25 00:00:00+03:00,out,False,917850,False,3,207,225,18
167532,2019-09-25 00:00:00+03:00,in,False,917850,False,2,84,118,34
167532,2019-09-25 00:00:00+03:00,out,False,917846,False,4,780,792,12
167532,2019-09-25 00:00:00+03:00,out,False,917856,False,10,1023,1071,48
167532,2019-09-25 00:00:00+03:00,out,False,917856,True,4,0,82,82
167532,2019-09-25 00:00:00+03:00,out,False,917852,False,11,792,880,88
167532,2019-09-25 00:00:00+03:00,out,True,917850,True,3,0,8,8
167532,2019-09-25 00:00:00+03:00,out,False,917852,True,5,0,34,34
167532,2019-09-25 00:00:00+03:00,out,False,917846,False,4,780,792,12
167532,2019-09-26 00:00:00+03:00,out,False,917852,False,7,324,431,107
167532,2019-09-26 00:00:00+03:00,in,False,-1,True,3,0,62,62
167532,2019-09-26 00:00:00+03:00,out,False,917852,True,2,0,8,8
167532,2019-09-26 00:00:00+03:00,out,True,917852,True,1,0,4,4
167532,2019-09-26 00:00:00+03:00,out,False,917856,False,4,699,716,17
167532,2019-09-26 00:00:00+03:00,in,False,917850,False,1,234,251,17
167532,2019-09-26 00:00:00+03:00,in,False,917852,False,1,176,186,10
167532,2019-09-26 00:00:00+03:00,in,False,917846,False,1,164,172,8
167532,2019-09-26 00:00:00+03:00,out,False,917850,False,3,265,278,13
167532,2019-09-26 00:00:00+03:00,out,False,917850,False,3,265,278,13
167532,2019-09-27 00:00:00+03:00,out,True,917850,True,1,0,4,4
167532,2019-09-27 00:00:00+03:00,out,False,917852,False,8,811,874,63
167532,2019-09-27 00:00:00+03:00,out,False,917852,True,5,0,84,84
167532,2019-09-27 00:00:00+03:00,out,False,917850,False,1,66,72,6
167532,2019-09-27 00:00:00+03:00,out,True,917858,True,2,0,12,12
167532,2019-09-27 00:00:00+03:00,out,False,917856,True,1,0,2,2
167532,2019-09-27 00:00:00+03:00,in,False,-1,True,3,0,143,143
167532,2019-09-27 00:00:00+03:00,in,False,917852,False,3,204,270,66
167532,2019-09-27 00:00:00+03:00,out,False,917846,False,1,26,33,7
167532,2019-09-27 00:00:00+03:00,out,False,917856,False,2,97,113,16
167532,2019-09-27 00:00:00+03:00,in,False,917850,False,1,21,39,18
167532,2019-09-27 00:00:00+03:00,out,True,917858,True,2,0,12,12
167532,2019-09-27 00:00:00+03:00,in,False,-1,True,3,0,143,143
167532,2019-09-30 00:00:00+03:00,in,False,-1,True,6,0,252,252
167532,2019-09-30 00:00:00+03:00,out,True,917850,True,2,0,6,6
167532,2019-09-30 00:00:00+03:00,in,False,917852,False,6,464,546,82
167532,2019-09-30 00:00:00+03:00,out,False,917852,True,4,0,28,28
167532,2019-09-30 00:00:00+03:00,out,False,917852,False,6,768,797,29
167532,2019-09-30 00:00:00+03:00,in,False,917850,False,2,210,242,32
167532,2019-09-30 00:00:00+03:00,in,False,917852,False,6,464,546,82
167532,2019-10-01 00:00:00+03:00,in,False,-1,True,3,0,27,27
167532,2019-10-01 00:00:00+03:00,in,False,917852,False,2,61,91,30
167532,2019-10-01 00:00:00+03:00,in,False,917846,False,2,147,164,17
167532,2019-10-01 00:00:00+03:00,out,False,917852,False,4,301,338,37
167532,2019-10-01 00:00:00+03:00,out,False,917856,False,2,542,560,18
167532,2019-10-01 00:00:00+03:00,in,False,917850,False,3,277,315,38
167532,2019-10-01 00:00:00+03:00,out,False,917852,False,4,301,338,37
167532,2019-10-01 00:00:00+03:00,in,False,-1,True,3,0,27,27
167532,2019-10-02 00:00:00+03:00,in,False,917850,False,2,111,146,35
167532,2019-10-02 00:00:00+03:00,out,True,917852,True,1,0,0,0
167532,2019-10-02 00:00:00+03:00,out,False,917852,False,7,687,753,66
167532,2019-10-02 00:00:00+03:00,out,False,917852,True,1,0,61,61
167532,2019-10-03 00:00:00+03:00,out,False,917852,True,9,0,196,196
167532,2019-10-03 00:00:00+03:00,in,False,917852,False,1,25,34,9
167532,2019-10-03 00:00:00+03:00,in,False,-1,True,11,0,236,236
167532,2019-10-03 00:00:00+03:00,out,True,917850,False,2,199,204,5
167532,2019-10-03 00:00:00+03:00,in,False,917850,False,7,388,505,117
167532,2019-10-03 00:00:00+03:00,out,False,917850,False,1,37,43,6
167532,2019-10-03 00:00:00+03:00,out,True,917850,True,1,0,3,3
167532,2019-10-03 00:00:00+03:00,out,False,917852,False,26,1760,2023,263
167532,2019-10-03 00:00:00+03:00,in,False,917850,False,7,388,505,117
167532,2019-10-04 00:00:00+03:00,out,False,917856,False,3,513,522,9
167532,2019-10-04 00:00:00+03:00,out,False,917852,False,5,537,577,40
167532,2019-10-04 00:00:00+03:00,in,False,917850,False,3,302,353,51
167532,2019-10-04 00:00:00+03:00,in,False,917852,False,9,516,689,173
167532,2019-10-04 00:00:00+03:00,out,False,917852,True,1,0,2,2
167532,2019-10-04 00:00:00+03:00,in,False,-1,True,1,0,10,10
167532,2019-10-04 00:00:00+03:00,out,False,917852,True,1,0,2,2
167532,2019-10-07 00:00:00+03:00,in,False,-1,True,1,0,20,20
167532,2019-10-07 00:00:00+03:00,out,False,917852,True,1,0,6,6
167532,2019-10-07 00:00:00+03:00,in,False,917852,False,6,309,436,127
167532,2019-10-07 00:00:00+03:00,out,True,917850,True,1,0,3,3
167532,2019-10-07 00:00:00+03:00,out,False,917852,False,9,617,684,67
167532,2019-10-07 00:00:00+03:00,out,True,917850,False,1,142,145,3
167532,2019-10-07 00:00:00+03:00,in,False,917850,False,2,171,205,34
167532,2019-10-07 00:00:00+03:00,out,False,917852,True,1,0,6,6
167532,2019-10-07 00:00:00+03:00,in,False,-1,True,1,0,20,20
167532,2019-10-08 00:00:00+03:00,in,False,-1,True,6,0,117,117
167532,2019-10-08 00:00:00+03:00,in,False,917850,False,1,17,34,17
167532,2019-10-08 00:00:00+03:00,out,True,917856,True,1,0,2,2
167532,2019-10-08 00:00:00+03:00,out,False,917852,False,18,1550,1698,148
167532,2019-10-08 00:00:00+03:00,out,False,917856,False,2,352,372,20
167532,2019-10-08 00:00:00+03:00,in,False,917852,False,12,1080,1245,165
167532,2019-10-08 00:00:00+03:00,out,False,917852,True,5,0,107,107
167532,2019-10-08 00:00:00+03:00,out,False,917852,False,18,1550,1698,148
167532,2019-10-08 00:00:00+03:00,out,False,917856,False,2,352,372,20
167532,2019-10-09 00:00:00+03:00,out,False,917856,True,2,0,54,54
167532,2019-10-09 00:00:00+03:00,in,False,917852,False,12,1389,1543,154
167532,2019-10-09 00:00:00+03:00,in,False,917850,False,1,15,32,17
167532,2019-10-09 00:00:00+03:00,out,False,917852,False,23,1985,2181,196
167532,2019-10-09 00:00:00+03:00,out,False,917850,False,1,246,251,5
167532,2019-10-09 00:00:00+03:00,in,False,-1,True,10,0,257,257
167532,2019-10-09 00:00:00+03:00,out,False,917852,True,7,0,52,52
167532,2019-10-09 00:00:00+03:00,in,False,917850,True,1,0,19,19
167532,2019-10-09 00:00:00+03:00,in,False,917852,False,12,1389,1543,154
167532,2019-10-10 00:00:00+03:00,in,False,917850,False,1,26,43,17
167532,2019-10-10 00:00:00+03:00,in,False,917852,False,11,966,1133,167
167532,2019-10-10 00:00:00+03:00,out,False,917852,True,7,0,139,139
167532,2019-10-10 00:00:00+03:00,out,False,917852,False,23,1944,2095,151
167532,2019-10-10 00:00:00+03:00,out,False,917850,False,1,49,52,3
167532,2019-10-10 00:00:00+03:00,in,False,-1,True,14,0,299,299
167532,2019-10-10 00:00:00+03:00,out,False,917856,False,2,271,280,9
167532,2019-10-11 00:00:00+03:00,in,False,917852,False,5,258,349,91
167532,2019-10-11 00:00:00+03:00,out,True,917850,True,2,0,8,8
167532,2019-10-11 00:00:00+03:00,out,False,917850,False,6,277,363,86
167532,2019-10-11 00:00:00+03:00,out,False,917856,False,3,368,386,18
167532,2019-10-11 00:00:00+03:00,out,True,917850,False,1,86,93,7
167532,2019-10-11 00:00:00+03:00,in,False,-1,True,7,0,187,187
167532,2019-10-11 00:00:00+03:00,in,False,917850,False,2,200,233,33
167532,2019-10-11 00:00:00+03:00,out,False,917852,True,6,0,169,169
167532,2019-10-11 00:00:00+03:00,out,False,917850,True,1,0,38,38
167532,2019-10-11 00:00:00+03:00,out,False,917852,False,16,1097,1304,207
167532,2019-10-11 00:00:00+03:00,in,False,917852,False,5,258,349,91
167532,2019-10-14 00:00:00+03:00,in,False,917850,False,7,507,623,116
167532,2019-10-14 00:00:00+03:00,out,False,917852,False,16,1512,1700,188
167532,2019-10-14 00:00:00+03:00,out,False,917852,True,3,0,39,39
167532,2019-10-14 00:00:00+03:00,in,False,917858,False,1,153,167,14
167532,2019-10-14 00:00:00+03:00,in,False,-1,True,5,0,69,69
167532,2019-10-14 00:00:00+03:00,out,True,917850,False,2,347,351,4
167532,2019-10-14 00:00:00+03:00,in,False,917852,False,11,1173,1346,173
167532,2019-10-14 00:00:00+03:00,in,False,917850,False,7,507,623,116
167532,2019-10-14 00:00:00+03:00,in,False,917852,False,11,1173,1346,173
167532,2019-10-15 00:00:00+03:00,out,False,917852,True,2,0,75,75
167532,2019-10-15 00:00:00+03:00,in,False,917852,False,8,535,659,124
167532,2019-10-15 00:00:00+03:00,in,False,-1,True,5,0,238,238
167532,2019-10-15 00:00:00+03:00,out,True,917850,False,1,159,161,2
167532,2019-10-15 00:00:00+03:00,out,False,917852,False,11,1013,1156,143
167532,2019-10-15 00:00:00+03:00,in,False,917850,False,2,290,322,32
167532,2019-10-16 00:00:00+03:00,out,True,917850,False,1,166,168,2
167532,2019-10-16 00:00:00+03:00,out,False,917856,False,1,301,305,4
167532,2019-10-16 00:00:00+03:00,in,False,917852,False,5,273,354,81
167532,2019-10-16 00:00:00+03:00,in,False,-1,True,3,0,71,71
167532,2019-10-16 00:00:00+03:00,out,False,917852,False,12,852,1100,248
167532,2019-10-16 00:00:00+03:00,in,False,917850,False,3,193,245,52
167532,2019-10-16 00:00:00+03:00,out,False,917852,True,1,0,45,45
167532,2019-10-17 00:00:00+03:00,in,False,-1,True,4,0,187,187
167532,2019-10-17 00:00:00+03:00,in,False,917852,False,2,55,105,50
167532,2019-10-17 00:00:00+03:00,out,False,917850,True,2,0,60,60
167532,2019-10-17 00:00:00+03:00,in,False,917856,False,2,119,138,19
167532,2019-10-17 00:00:00+03:00,out,False,917850,False,15,1201,1343,142
167532,2019-10-17 00:00:00+03:00,out,True,917850,False,1,85,88,3
167532,2019-10-17 00:00:00+03:00,out,False,917852,False,3,382,426,44
167532,2019-10-17 00:00:00+03:00,in,False,917850,False,5,418,502,84
167532,2019-10-18 00:00:00+03:00,out,False,917850,True,1,0,33,33
167532,2019-10-18 00:00:00+03:00,out,True,917850,True,1,0,3,3
167532,2019-10-18 00:00:00+03:00,out,False,917852,True,1,0,3,3
167532,2019-10-18 00:00:00+03:00,out,False,917852,False,4,474,500,26
167532,2019-10-18 00:00:00+03:00,in,False,917850,False,3,101,151,50
167532,2019-10-18 00:00:00+03:00,out,False,917850,False,8,567,646,79
167532,2019-10-18 00:00:00+03:00,in,False,-1,True,2,0,11,11
167532,2019-10-18 00:00:00+03:00,in,False,917852,False,4,151,255,104
167532,2019-10-18 00:00:00+03:00,out,True,917850,False,1,55,57,2
167532,2019-10-18 00:00:00+03:00,in,False,917850,False,3,101,151,50
167532,2019-10-18 00:00:00+03:00,in,False,917852,False,4,151,255,104
167532,2019-10-21 00:00:00+03:00,out,False,917852,True,2,0,43,43
167532,2019-10-21 00:00:00+03:00,in,False,917850,False,6,491,591,100
167532,2019-10-21 00:00:00+03:00,out,True,917850,False,1,44,46,2
167532,2019-10-21 00:00:00+03:00,out,False,917852,False,9,1047,1160,113
167532,2019-10-21 00:00:00+03:00,out,False,917856,True,2,0,50,50
167532,2019-10-21 00:00:00+03:00,out,False,917850,False,1,164,167,3
167532,2019-10-21 00:00:00+03:00,out,False,917856,False,3,339,351,12
167532,2019-10-21 00:00:00+03:00,in,False,917852,False,8,758,900,142
167532,2019-10-21 00:00:00+03:00,in,False,-1,True,4,0,207,207
167532,2019-10-22 00:00:00+03:00,in,False,917856,False,1,215,229,14
167532,2019-10-22 00:00:00+03:00,in,False,917852,True,1,0,21,21
167532,2019-10-22 00:00:00+03:00,in,False,917850,False,7,414,531,117
167532,2019-10-22 00:00:00+03:00,in,False,917852,False,9,575,772,197
167532,2019-10-22 00:00:00+03:00,out,False,917850,False,4,231,247,16
167532,2019-10-22 00:00:00+03:00,in,False,-1,True,5,0,110,110
167532,2019-10-22 00:00:00+03:00,out,False,917856,False,5,859,874,15
167532,2019-10-22 00:00:00+03:00,out,False,917846,True,2,0,74,74
167532,2019-10-22 00:00:00+03:00,out,True,917850,False,2,135,141,6
167532,2019-10-22 00:00:00+03:00,out,False,917852,False,24,2336,2568,232
167532,2019-10-22 00:00:00+03:00,out,False,917846,False,1,23,29,6
167532,2019-10-22 00:00:00+03:00,out,False,917852,True,14,0,153,153
167532,2019-10-22 00:00:00+03:00,out,True,917850,False,2,135,141,6
167532,2019-10-22 00:00:00+03:00,out,False,917852,False,24,2336,2568,232
167532,2019-10-23 00:00:00+03:00,in,False,-1,True,10,0,265,265
167532,2019-10-23 00:00:00+03:00,out,False,917852,True,2,0,87,87
167532,2019-10-23 00:00:00+03:00,in,False,917852,False,7,370,484,114
167532,2019-10-23 00:00:00+03:00,out,False,917856,False,3,316,329,13
167532,2019-10-23 00:00:00+03:00,out,False,917850,False,3,129,144,15
167532,2019-10-23 00:00:00+03:00,out,True,917850,False,2,176,182,6
167532,2019-10-23 00:00:00+03:00,out,False,917852,False,26,2500,2768,268
167532,2019-10-23 00:00:00+03:00,in,False,917850,False,5,501,585,84
167532,2019-10-24 00:00:00+03:00,out,False,917852,False,24,1985,2216,231
167532,2019-10-24 00:00:00+03:00,out,False,917856,False,1,85,87,2
167532,2019-10-24 00:00:00+03:00,in,False,917850,False,6,276,377,101
167532,2019-10-24 00:00:00+03:00,in,False,-1,True,7,0,254,254
167532,2019-10-24 00:00:00+03:00,out,True,917850,False,1,167,169,2
167532,2019-10-24 00:00:00+03:00,out,False,917852,True,5,0,64,64
167532,2019-10-24 00:00:00+03:00,in,False,917852,False,2,332,366,34
167532,2019-10-24 00:00:00+03:00,out,True,917852,True,1,0,2,2
167532,2019-10-24 00:00:00+03:00,in,False,-1,True,7,0,254,254
167532,2019-10-24 00:00:00+03:00,out,False,917852,True,5,0,64,64
167532,2019-10-25 00:00:00+03:00,in,False,-1,True,9,0,213,213
167532,2019-10-25 00:00:00+03:00,out,False,917856,False,1,255,258,3
167532,2019-10-25 00:00:00+03:00,in,True,917850,False,1,31,49,18
167532,2019-10-25 00:00:00+03:00,out,False,917852,False,34,3319,3607,288
167532,2019-10-25 00:00:00+03:00,in,False,917852,False,14,1069,1338,269
167532,2019-10-25 00:00:00+03:00,out,False,917852,True,7,0,205,205
167532,2019-10-25 00:00:00+03:00,in,False,917850,False,3,169,220,51
167532,2019-10-25 00:00:00+03:00,out,True,917850,False,2,133,138,5
167532,2019-10-25 00:00:00+03:00,out,True,917850,True,1,0,2,2
167532,2019-10-25 00:00:00+03:00,out,False,917856,False,1,255,258,3
167532,2019-10-27 00:00:00+03:00,in,False,-1,True,1,0,5,5
167532,2019-10-28 00:00:00+03:00,in,False,917850,False,5,364,449,85
167532,2019-10-28 00:00:00+03:00,in,False,917852,False,9,484,680,196
167532,2019-10-28 00:00:00+03:00,out,True,917852,True,1,0,0,0
167532,2019-10-28 00:00:00+03:00,in,False,-1,True,9,0,203,203
167532,2019-10-28 00:00:00+03:00,out,True,917850,False,2,120,127,7
167532,2019-10-28 00:00:00+03:00,out,False,917852,False,24,1589,1804,215
167532,2019-10-28 00:00:00+03:00,out,False,917852,True,7,0,163,163
167532,2019-10-29 00:00:00+03:00,in,False,-1,True,2,0,20,20
167532,2019-10-29 00:00:00+03:00,in,False,917850,False,2,56,91,35
167532,2019-10-29 00:00:00+03:00,out,False,917852,False,27,1709,1983,274
167532,2019-10-29 00:00:00+03:00,in,False,917852,False,8,479,619,140
167532,2019-10-29 00:00:00+03:00,out,False,917852,True,3,0,6,6
167532,2019-10-30 00:00:00+03:00,in,False,-1,True,3,0,31,31
167532,2019-10-30 00:00:00+03:00,out,False,917852,False,22,2522,2716,194
167532,2019-10-30 00:00:00+03:00,in,False,917852,False,10,810,987,177
167532,2019-10-30 00:00:00+03:00,in,False,917850,False,5,331,417,86
167532,2019-10-30 00:00:00+03:00,out,False,917850,False,1,222,228,6
167532,2019-10-30 00:00:00+03:00,out,False,917852,True,3,0,58,58
167532,2019-10-30 00:00:00+03:00,out,True,917850,False,3,251,258,7
167532,2019-10-31 00:00:00+03:00,out,True,917850,True,1,0,60,60
167532,2019-10-31 00:00:00+03:00,in,False,917852,False,8,643,810,167
167532,2019-10-31 00:00:00+03:00,out,False,917852,False,33,2611,2917,306
167532,2019-10-31 00:00:00+03:00,in,False,-1,True,10,0,340,340
167532,2019-10-31 00:00:00+03:00,out,False,917852,True,11,0,249,249
167532,2019-10-31 00:00:00+03:00,in,False,917850,False,2,178,212,34
167532,2019-10-31 00:00:00+03:00,in,False,-1,True,10,0,340,340
167532,2019-11-01 00:00:00+03:00,out,False,917852,False,13,1072,1172,100
167532,2019-11-01 00:00:00+03:00,out,False,917852,True,3,0,9,9
167532,2019-11-01 00:00:00+03:00,in,False,-1,True,8,0,167,167
167532,2019-11-01 00:00:00+03:00,in,False,917850,False,1,34,51,17
167532,2019-11-01 00:00:00+03:00,in,False,917852,False,5,425,521,96
167532,2019-11-01 00:00:00+03:00,out,True,917850,False,1,15,19,4
167532,2019-11-01 00:00:00+03:00,out,True,917850,True,1,0,3,3
167532,2019-11-01 00:00:00+03:00,out,True,917850,True,1,0,3,3
167532,2019-11-05 00:00:00+03:00,in,False,917850,False,3,170,221,51
167532,2019-11-05 00:00:00+03:00,in,False,-1,True,8,0,316,316
167532,2019-11-05 00:00:00+03:00,out,True,917850,False,1,31,34,3
167532,2019-11-05 00:00:00+03:00,out,False,917852,False,19,1365,1574,209
167532,2019-11-05 00:00:00+03:00,out,False,917852,True,6,0,110,110
167532,2019-11-05 00:00:00+03:00,out,False,917846,False,1,581,595,14
167532,2019-11-05 00:00:00+03:00,in,False,917852,False,8,511,682,171
167532,2019-11-05 00:00:00+03:00,out,False,917856,False,1,85,89,4
167532,2019-11-06 00:00:00+03:00,out,True,917850,False,4,512,524,12
167532,2019-11-06 00:00:00+03:00,in,False,917850,False,9,807,964,157
167532,2019-11-06 00:00:00+03:00,out,False,917850,False,1,101,109,8
167532,2019-11-06 00:00:00+03:00,in,False,917852,False,18,1306,1670,364
167532,2019-11-06 00:00:00+03:00,out,False,917856,True,1,0,7,7
167532,2019-11-06 00:00:00+03:00,out,False,917852,False,19,2408,2503,95
167532,2019-11-06 00:00:00+03:00,out,False,917850,True,1,0,7,7
167532,2019-11-06 00:00:00+03:00,out,False,917852,True,6,0,251,251
167532,2019-11-06 00:00:00+03:00,in,False,-1,True,3,0,61,61
167532,2019-11-06 00:00:00+03:00,out,False,917850,False,1,101,109,8
167532,2019-11-07 00:00:00+03:00,in,False,917850,False,1,15,31,16
167532,2019-11-07 00:00:00+03:00,in,False,917852,False,16,1139,1440,301
167532,2019-11-07 00:00:00+03:00,in,False,-1,True,6,0,131,131
167532,2019-11-07 00:00:00+03:00,out,False,917852,False,16,2688,2886,198
167532,2019-11-07 00:00:00+03:00,out,False,917852,True,4,0,183,183
167532,2019-11-07 00:00:00+03:00,out,True,917850,True,1,0,2,2
167532,2019-11-08 00:00:00+03:00,out,False,917852,True,8,0,88,88
167532,2019-11-08 00:00:00+03:00,in,False,-1,True,20,0,167,167
167532,2019-11-08 00:00:00+03:00,in,False,917852,False,15,1615,1989,374
167532,2019-11-08 00:00:00+03:00,out,False,917852,False,21,2027,2241,214
167532,2019-11-11 00:00:00+03:00,out,False,917852,True,5,0,151,151
167532,2019-11-11 00:00:00+03:00,out,False,917852,False,18,1224,1370,146
167532,2019-11-11 00:00:00+03:00,in,False,917852,False,6,560,686,126
167532,2019-11-11 00:00:00+03:00,in,False,-1,True,8,0,180,180
167532,2019-11-11 00:00:00+03:00,in,False,917850,False,5,419,504,85
167532,2019-11-11 00:00:00+03:00,out,True,917850,False,2,146,152,6
167532,2019-11-12 00:00:00+03:00,out,True,917850,True,1,0,1,1
167532,2019-11-12 00:00:00+03:00,in,False,-1,True,5,0,62,62
167532,2019-11-12 00:00:00+03:00,out,False,917852,True,10,0,182,182
167532,2019-11-12 00:00:00+03:00,out,True,917850,False,2,88,94,6
167532,2019-11-12 00:00:00+03:00,in,False,917852,False,6,687,799,112
167532,2019-11-12 00:00:00+03:00,in,False,917850,False,7,238,356,118
167532,2019-11-12 00:00:00+03:00,out,False,917852,False,26,2193,2531,338
167532,2019-11-12 00:00:00+03:00,out,False,917856,False,4,774,807,33
167532,2019-11-12 00:00:00+03:00,out,False,917850,False,3,23,31,8
167532,2019-11-12 00:00:00+03:00,out,False,917850,True,1,0,4,4
167532,2019-11-13 00:00:00+03:00,in,False,-1,True,11,0,320,320
167532,2019-11-13 00:00:00+03:00,out,False,917852,False,26,2650,2861,211
167532,2019-11-13 00:00:00+03:00,out,False,917852,True,7,0,185,185
167532,2019-11-13 00:00:00+03:00,in,False,917850,False,6,531,634,103
167532,2019-11-13 00:00:00+03:00,out,True,917850,False,3,91,99,8
167532,2019-11-13 00:00:00+03:00,in,False,917852,False,4,243,307,64
167532,2019-11-14 00:00:00+03:00,in,False,917852,False,12,826,1065,239
167532,2019-11-14 00:00:00+03:00,out,False,917852,True,2,0,50,50
167532,2019-11-14 00:00:00+03:00,out,False,917852,False,18,1865,1988,123
167532,2019-11-14 00:00:00+03:00,out,True,917850,False,3,538,545,7
167532,2019-11-14 00:00:00+03:00,in,False,-1,True,3,0,82,82
167532,2019-11-14 00:00:00+03:00,out,False,917856,False,1,658,663,5
167532,2019-11-14 00:00:00+03:00,in,False,917850,False,4,753,822,69
167532,2019-11-14 00:00:00+03:00,out,False,917850,False,1,243,248,5
167532,2019-11-15 00:00:00+03:00,out,False,917852,False,5,404,466,62
167532,2019-11-15 00:00:00+03:00,out,False,917852,True,1,0,12,12
167532,2019-11-15 00:00:00+03:00,in,False,917850,False,4,142,210,68
167532,2019-11-15 00:00:00+03:00,in,False,-1,True,2,0,68,68
167532,2019-11-15 00:00:00+03:00,out,True,917850,False,1,30,32,2
167532,2019-11-15 00:00:00+03:00,in,False,917852,False,6,805,980,175
167532,2019-11-15 00:00:00+03:00,in,False,-1,True,2,0,68,68
167532,2019-11-18 00:00:00+03:00,out,False,917852,False,15,980,1171,191
167532,2019-11-18 00:00:00+03:00,out,False,917852,True,6,0,83,83
167532,2019-11-18 00:00:00+03:00,in,False,917852,False,11,826,1014,188
167532,2019-11-18 00:00:00+03:00,in,False,917850,False,2,95,130,35
167532,2019-11-18 00:00:00+03:00,out,False,917850,True,1,0,45,45
167532,2019-11-18 00:00:00+03:00,in,False,-1,True,5,0,89,89
167532,2019-11-18 00:00:00+03:00,out,True,917850,False,1,73,75,2
167532,2019-11-18 00:00:00+03:00,out,False,917850,True,1,0,45,45
167532,2019-11-18 00:00:00+03:00,out,True,917850,False,1,73,75,2
167532,2019-11-19 00:00:00+03:00,out,True,917852,False,1,169,170,1
167532,2019-11-19 00:00:00+03:00,out,False,917852,False,25,3162,3359,197
167532,2019-11-19 00:00:00+03:00,out,True,917850,False,1,53,56,3
167532,2019-11-19 00:00:00+03:00,in,False,-1,True,8,0,303,303
167532,2019-11-19 00:00:00+03:00,out,False,917852,True,8,0,211,211
167532,2019-11-19 00:00:00+03:00,in,False,917852,False,15,1386,1705,319
167532,2019-11-19 00:00:00+03:00,in,False,917850,False,2,274,307,33
167532,2019-11-19 00:00:00+03:00,in,False,917852,False,15,1386,1705,319
167532,2019-11-19 00:00:00+03:00,out,False,917852,False,25,3162,3359,197
167532,2019-11-20 00:00:00+03:00,out,False,917850,False,1,48,58,10
167532,2019-11-20 00:00:00+03:00,in,False,917852,False,13,749,997,248
167532,2019-11-20 00:00:00+03:00,in,False,917850,False,1,11,28,17
167532,2019-11-20 00:00:00+03:00,out,False,917852,False,30,2587,2939,352
167532,2019-11-20 00:00:00+03:00,out,False,917852,True,2,0,64,64
167532,2019-11-20 00:00:00+03:00,in,False,-1,True,7,0,125,125
167532,2019-11-21 00:00:00+03:00,in,False,917850,False,3,440,490,50
167532,2019-11-21 00:00:00+03:00,out,False,917856,True,1,0,7,7
167532,2019-11-21 00:00:00+03:00,out,True,917850,False,1,128,134,6
167532,2019-11-21 00:00:00+03:00,in,False,-1,True,11,0,289,289
167532,2019-11-21 00:00:00+03:00,out,False,917852,False,9,1404,1489,85
167532,2019-11-21 00:00:00+03:00,out,False,917850,False,1,186,189,3
167532,2019-11-21 00:00:00+03:00,out,False,917852,True,8,0,151,151
167532,2019-11-21 00:00:00+03:00,out,True,917852,False,1,191,194,3
167532,2019-11-21 00:00:00+03:00,in,False,917852,False,17,2042,2369,327
167532,2019-11-21 00:00:00+03:00,in,False,917850,False,3,440,490,50
167532,2019-11-21 00:00:00+03:00,out,False,917852,False,9,1404,1489,85
167532,2019-11-22 00:00:00+03:00,out,False,917852,False,19,1128,1323,195
167532,2019-11-22 00:00:00+03:00,out,True,917856,True,1,0,2,2
167532,2019-11-22 00:00:00+03:00,out,False,917856,False,4,546,588,42
167532,2019-11-22 00:00:00+03:00,in,False,917852,False,11,465,667,202
167532,2019-11-22 00:00:00+03:00,out,False,917852,True,5,0,103,103
167532,2019-11-22 00:00:00+03:00,in,False,-1,True,9,0,202,202
167532,2019-11-22 00:00:00+03:00,out,False,917856,True,1,0,5,5
167532,2019-11-22 00:00:00+03:00,in,False,917850,False,2,120,163,43
167532,2019-11-22 00:00:00+03:00,out,True,917850,False,1,94,97,3
167532,2019-11-22 00:00:00+03:00,out,False,917856,True,1,0,5,5
167532,2019-11-25 00:00:00+03:00,out,False,917852,True,11,0,369,369
167532,2019-11-25 00:00:00+03:00,out,False,917852,False,19,2209,2373,164
167532,2019-11-25 00:00:00+03:00,out,False,917850,False,3,229,252,23
167532,2019-11-25 00:00:00+03:00,in,False,917852,False,4,425,498,73
167532,2019-11-25 00:00:00+03:00,in,False,917850,False,6,458,565,107
167532,2019-11-25 00:00:00+03:00,out,True,917850,False,2,242,247,5
167532,2019-11-25 00:00:00+03:00,in,False,-1,True,7,0,125,125
167532,2019-11-26 00:00:00+03:00,out,False,917852,True,9,0,160,160
167532,2019-11-26 00:00:00+03:00,out,True,917850,False,1,237,239,2
167532,2019-11-26 00:00:00+03:00,in,False,917850,False,1,247,264,17
167532,2019-11-26 00:00:00+03:00,out,False,917856,False,1,53,62,9
167532,2019-11-26 00:00:00+03:00,out,False,917852,False,22,1634,1840,206
167532,2019-11-26 00:00:00+03:00,in,False,917852,False,12,639,927,288
167532,2019-11-26 00:00:00+03:00,in,False,-1,True,10,0,86,86
167532,2019-11-26 00:00:00+03:00,out,False,917852,True,9,0,160,160
167532,2019-11-27 00:00:00+03:00,in,False,917852,False,7,462,610,148
167532,2019-11-27 00:00:00+03:00,out,False,917850,False,14,872,920,48
167532,2019-11-27 00:00:00+03:00,in,False,917850,False,6,266,365,99
167532,2019-11-27 00:00:00+03:00,out,False,917852,False,2,79,107,28
167532,2019-11-27 00:00:00+03:00,out,False,917850,True,3,0,65,65
167532,2019-11-27 00:00:00+03:00,out,True,917850,True,1,0,1,1
167532,2019-11-27 00:00:00+03:00,in,False,-1,True,3,0,126,126
167532,2019-11-27 00:00:00+03:00,out,False,917846,False,1,84,94,10
167532,2019-11-28 00:00:00+03:00,out,False,917850,False,8,899,946,47
167532,2019-11-28 00:00:00+03:00,in,False,-1,True,6,0,83,83
167532,2019-11-28 00:00:00+03:00,in,False,917852,False,9,665,824,159
167532,2019-11-28 00:00:00+03:00,out,False,917850,True,3,0,110,110
167532,2019-11-28 00:00:00+03:00,out,False,917852,True,8,0,282,282
167532,2019-11-28 00:00:00+03:00,out,False,917856,False,2,560,573,13
167532,2019-11-28 00:00:00+03:00,out,False,917852,False,14,952,1079,127
167532,2019-11-28 00:00:00+03:00,out,True,917850,False,2,99,113,14
167532,2019-11-28 00:00:00+03:00,out,True,917852,False,1,69,77,8
167532,2019-11-28 00:00:00+03:00,in,False,917850,False,10,556,730,174
167532,2019-11-28 00:00:00+03:00,out,False,917846,False,2,176,204,28
167533,2019-09-21 00:00:00+03:00,in,False,-1,True,1,0,1,1
167533,2019-09-22 00:00:00+03:00,in,False,-1,True,53,0,53,53
167533,2019-09-23 00:00:00+03:00,in,False,917876,False,1,11,26,15
167533,2019-09-23 00:00:00+03:00,in,False,-1,True,1,0,12,12
167533,2019-09-24 00:00:00+03:00,in,False,-1,True,1,0,31,31
167533,2019-09-24 00:00:00+03:00,in,False,-1,True,1,0,31,31
167533,2019-09-26 00:00:00+03:00,in,False,917876,False,1,14,31,17
167533,2019-09-26 00:00:00+03:00,in,False,-1,True,1,0,31,31
167533,2019-09-26 00:00:00+03:00,in,False,917876,False,1,14,31,17
167533,2019-10-02 00:00:00+03:00,in,False,-1,True,2,0,3,3
167533,2019-10-04 00:00:00+03:00,in,False,-1,True,1,0,21,21
167533,2019-10-04 00:00:00+03:00,out,False,917876,False,1,37,53,16
167533,2019-10-09 00:00:00+03:00,in,False,917876,False,1,43,63,20
167533,2019-10-10 00:00:00+03:00,in,False,917876,False,1,116,128,12
167533,2019-10-14 00:00:00+03:00,in,False,-1,True,3,0,1,1
167533,2019-10-19 00:00:00+03:00,in,False,-1,True,1,0,2,2
167533,2019-10-21 00:00:00+03:00,in,False,917876,False,1,63,78,15
167533,2019-11-05 00:00:00+03:00,in,False,917876,False,2,91,110,19
167533,2019-11-05 00:00:00+03:00,in,False,-1,True,14,0,93,93
167533,2019-11-07 00:00:00+03:00,in,False,-1,True,9,0,4,4
167533,2019-11-07 00:00:00+03:00,in,False,917876,False,1,4,14,10
167533,2019-11-07 00:00:00+03:00,out,False,917876,False,1,27,29,2
167533,2019-11-10 00:00:00+03:00,in,False,-1,True,15,0,0,0
167533,2019-11-14 00:00:00+03:00,in,False,-1,True,2,0,3,3
167533,2019-11-19 00:00:00+03:00,in,False,-1,True,1,0,0,0
167533,2019-11-20 00:00:00+03:00,in,False,-1,True,7,0,4,4
167534,2019-10-04 00:00:00+03:00,in,False,-1,True,1,0,2,2
167534,2019-10-07 00:00:00+03:00,in,False,929332,False,2,136,162,26
167534,2019-10-07 00:00:00+03:00,in,False,929332,False,2,136,162,26
167534,2019-10-08 00:00:00+03:00,in,False,-1,True,1,0,15,15
167534,2019-10-08 00:00:00+03:00,in,False,929332,False,2,19,53,34
167534,2019-10-08 00:00:00+03:00,in,False,-1,True,1,0,15,15
167534,2019-10-09 00:00:00+03:00,in,False,929332,False,2,114,143,29
167534,2019-10-10 00:00:00+03:00,in,False,929332,False,4,2135,2197,62
167534,2019-10-10 00:00:00+03:00,in,False,-1,True,1,0,21,21
167534,2019-10-11 00:00:00+03:00,in,False,929332,False,8,1569,1670,101
167534,2019-10-11 00:00:00+03:00,in,False,929340,False,1,210,225,15
167534,2019-10-11 00:00:00+03:00,in,False,-1,True,3,0,47,47
167534,2019-10-12 00:00:00+03:00,in,False,929340,False,1,166,225,59
167534,2019-10-12 00:00:00+03:00,in,False,-1,True,4,0,8,8
167534,2019-10-14 00:00:00+03:00,in,False,929332,False,2,1347,1375,28
167534,2019-10-14 00:00:00+03:00,in,False,929332,False,2,1347,1375,28
167534,2019-10-15 00:00:00+03:00,in,False,-1,True,1,0,15,15
167534,2019-10-15 00:00:00+03:00,in,False,929332,False,1,128,141,13
167534,2019-10-15 00:00:00+03:00,in,False,929332,False,1,128,141,13
167534,2019-10-16 00:00:00+03:00,in,True,929340,False,2,53,89,36
167534,2019-10-16 00:00:00+03:00,in,False,-1,True,1,0,13,13
167534,2019-10-16 00:00:00+03:00,in,False,929332,False,1,388,400,12
167534,2019-10-17 00:00:00+03:00,in,False,929332,False,1,65,82,17
167534,2019-10-18 00:00:00+03:00,in,False,929332,False,2,379,410,31
167534,2019-10-21 00:00:00+03:00,in,False,-1,True,1,0,5,5
167534,2019-10-21 00:00:00+03:00,in,False,929332,False,3,750,792,42
167534,2019-10-22 00:00:00+03:00,in,False,929332,False,4,2854,2924,70
167534,2019-10-22 00:00:00+03:00,in,False,-1,True,1,0,81,81
167534,2019-10-24 00:00:00+03:00,in,False,929332,False,1,15,31,16
167534,2019-10-25 00:00:00+03:00,in,False,929332,False,1,270,288,18
167534,2019-10-26 00:00:00+03:00,in,False,929340,False,2,376,501,125
167534,2019-10-31 00:00:00+03:00,in,False,-1,True,1,0,61,61
167534,2019-10-31 00:00:00+03:00,in,False,929340,False,1,161,218,57
167534,2019-11-03 00:00:00+03:00,in,False,-1,True,1,0,81,81
167534,2019-11-14 00:00:00+03:00,in,False,929332,False,1,82,106,24
167534,2019-11-26 00:00:00+03:00,in,False,929340,False,1,450,507,57
167543,2019-09-24 00:00:00+03:00,in,False,-1,True,1,0,2,2
167543,2019-09-30 00:00:00+03:00,in,False,-1,True,2,0,6,6
167543,2019-10-01 00:00:00+03:00,in,False,-1,True,1,0,2,2
167543,2019-10-06 00:00:00+03:00,in,False,-1,True,2,0,10,10
167543,2019-10-06 00:00:00+03:00,out,False,928382,False,1,29,47,18
167543,2019-10-06 00:00:00+03:00,in,False,928382,False,1,39,42,3
167543,2019-10-06 00:00:00+03:00,out,False,928382,False,1,29,47,18
167543,2019-10-07 00:00:00+03:00,in,False,-1,True,4,0,24,24
167543,2019-10-09 00:00:00+03:00,in,False,-1,True,3,0,7,7
167543,2019-10-09 00:00:00+03:00,in,False,928382,True,1,0,3,3
167543,2019-10-10 00:00:00+03:00,in,False,-1,True,5,0,28,28
167543,2019-10-17 00:00:00+03:00,in,False,928382,False,1,29,32,3
167543,2019-10-17 00:00:00+03:00,in,False,-1,True,1,0,5,5
167543,2019-10-20 00:00:00+03:00,out,False,928382,True,1,0,52,52
167543,2019-10-20 00:00:00+03:00,in,False,-1,True,4,0,21,21
167543,2019-10-29 00:00:00+03:00,out,False,928382,False,1,9,45,36
167543,2019-10-29 00:00:00+03:00,in,False,928382,False,2,42,49,7
167543,2019-10-29 00:00:00+03:00,in,False,-1,True,1,0,5,5
167543,2019-10-29 00:00:00+03:00,in,False,928382,False,2,42,49,7
167543,2019-10-29 00:00:00+03:00,in,False,-1,True,1,0,5,5
167543,2019-11-13 00:00:00+03:00,in,False,-1,True,15,0,25,25
167543,2019-11-13 00:00:00+03:00,out,False,928382,False,1,34,49,15
167543,2019-11-13 00:00:00+03:00,out,False,928382,True,1,0,7,7
167543,2019-11-14 00:00:00+03:00,in,False,-1,True,6,0,32,32
167543,2019-11-15 00:00:00+03:00,in,False,-1,True,4,0,19,19
167543,2019-11-16 00:00:00+03:00,in,False,-1,True,14,0,0,0
167543,2019-11-17 00:00:00+03:00,in,False,-1,True,7,0,36,36
167543,2019-11-18 00:00:00+03:00,in,False,-1,True,2,0,11,11
167543,2019-11-18 00:00:00+03:00,in,False,928382,False,2,41,46,5
167543,2019-11-18 00:00:00+03:00,out,False,928382,True,2,0,8,8
167543,2019-11-18 00:00:00+03:00,out,False,928382,False,1,13,27,14
167543,2019-11-19 00:00:00+03:00,in,False,-1,True,2,0,1,1
167543,2019-11-20 00:00:00+03:00,in,False,928382,False,1,11,13,2
167543,2019-11-20 00:00:00+03:00,in,False,-1,True,1,0,1,1
167543,2019-11-20 00:00:00+03:00,out,False,928382,True,1,0,25,25
167543,2019-11-20 00:00:00+03:00,out,False,928382,True,1,0,25,25
167543,2019-11-22 00:00:00+03:00,in,False,-1,True,1,0,0,0
167543,2019-11-23 00:00:00+03:00,in,False,928382,False,1,41,45,4
167543,2019-11-23 00:00:00+03:00,in,False,928382,False,1,41,45,4
167543,2019-11-26 00:00:00+03:00,in,False,-1,True,2,0,4,4
167543,2019-11-27 00:00:00+03:00,in,False,-1,True,1,0,2,2
167543,2019-11-28 00:00:00+03:00,in,False,-1,True,3,0,6,6
167545,2019-09-24 00:00:00+03:00,in,False,-1,True,2,0,1,1
167545,2019-09-26 00:00:00+03:00,in,False,-1,True,1,0,2,2
167545,2019-09-27 00:00:00+03:00,in,False,-1,True,1,0,2,2
167545,2019-09-29 00:00:00+03:00,in,False,-1,True,1,0,13,13
167545,2019-09-29 00:00:00+03:00,in,False,-1,True,1,0,13,13
167545,2019-09-30 00:00:00+03:00,in,False,-1,True,6,0,100,100
167545,2019-10-01 00:00:00+03:00,out,True,916618,True,1,0,10,10
167545,2019-10-01 00:00:00+03:00,in,False,-1,True,2,0,67,67
167545,2019-10-01 00:00:00+03:00,in,False,916618,False,1,19,28,9
167545,2019-10-01 00:00:00+03:00,out,False,916618,False,1,1,20,19
167545,2019-10-01 00:00:00+03:00,out,True,916618,False,1,60,82,22
167545,2019-10-01 00:00:00+03:00,in,False,-1,True,1,0,2,2
167545,2019-10-02 00:00:00+03:00,in,False,-1,True,1,0,29,29
167545,2019-10-02 00:00:00+03:00,out,False,916618,False,1,69,100,31
167545,2019-10-03 00:00:00+03:00,in,False,916618,False,1,37,42,5
167545,2019-10-08 00:00:00+03:00,in,False,-1,True,1,0,44,44
167545,2019-10-08 00:00:00+03:00,in,False,916618,False,1,14,39,25
167545,2019-10-10 00:00:00+03:00,in,False,-1,True,1,0,61,61
167545,2019-10-10 00:00:00+03:00,in,False,916618,False,4,254,302,48
167545,2019-10-11 00:00:00+03:00,in,False,-1,True,1,0,26,26
167545,2019-10-11 00:00:00+03:00,in,False,916618,False,1,66,123,57
167545,2019-10-12 00:00:00+03:00,in,False,-1,True,2,0,16,16
167545,2019-10-14 00:00:00+03:00,out,False,916618,True,1,0,8,8
167545,2019-10-14 00:00:00+03:00,out,False,916618,False,5,506,552,46
167545,2019-10-14 00:00:00+03:00,in,False,916618,False,1,208,225,17
167545,2019-10-15 00:00:00+03:00,out,False,916618,False,1,269,277,8
167545,2019-10-15 00:00:00+03:00,in,False,-1,True,5,0,128,128
167545,2019-10-15 00:00:00+03:00,in,False,916618,False,3,39,67,28
167545,2019-10-16 00:00:00+03:00,out,False,916618,False,2,246,261,15
167545,2019-10-16 00:00:00+03:00,out,False,916618,True,2,0,4,4
167545,2019-10-16 00:00:00+03:00,in,False,-1,True,1,0,25,25
167545,2019-10-16 00:00:00+03:00,in,False,916618,False,2,246,277,31
167545,2019-10-17 00:00:00+03:00,out,False,916618,False,7,508,576,68
167545,2019-10-17 00:00:00+03:00,out,False,916618,True,2,0,53,53
167545,2019-10-17 00:00:00+03:00,in,False,916618,False,2,210,289,79
167545,2019-10-18 00:00:00+03:00,in,False,-1,True,8,0,323,323
167545,2019-10-18 00:00:00+03:00,out,False,916618,True,1,0,4,4
167545,2019-10-18 00:00:00+03:00,out,False,916618,False,3,189,217,28
167545,2019-10-18 00:00:00+03:00,out,False,916618,False,3,189,217,28
167545,2019-10-21 00:00:00+03:00,in,False,-1,True,1,0,23,23
167545,2019-10-21 00:00:00+03:00,out,False,916618,True,1,0,27,27
167545,2019-10-21 00:00:00+03:00,in,False,916618,False,3,349,399,50
167545,2019-10-21 00:00:00+03:00,out,False,916618,False,11,945,1026,81
167545,2019-10-21 00:00:00+03:00,in,False,-1,True,1,0,23,23
167545,2019-10-22 00:00:00+03:00,in,False,-1,True,3,0,9,9
167545,2019-10-22 00:00:00+03:00,in,False,916618,False,1,34,44,10
167545,2019-10-22 00:00:00+03:00,out,False,916618,False,9,510,549,39
167545,2019-10-23 00:00:00+03:00,out,False,916618,False,5,438,471,33
167545,2019-10-23 00:00:00+03:00,out,False,916618,False,5,438,471,33
167545,2019-10-24 00:00:00+03:00,out,False,916618,False,1,54,60,6
167545,2019-10-24 00:00:00+03:00,in,False,916618,False,1,14,25,11
167545,2019-10-25 00:00:00+03:00,out,False,-1,True,1,0,0,0
167545,2019-10-25 00:00:00+03:00,out,False,916618,True,1,0,36,36
167545,2019-10-25 00:00:00+03:00,out,False,916618,False,15,1464,1611,147
167545,2019-10-25 00:00:00+03:00,in,False,-1,True,1,0,65,65
167545,2019-10-28 00:00:00+03:00,in,False,916618,False,1,55,67,12
167545,2019-10-28 00:00:00+03:00,in,False,-1,True,2,0,66,66
167545,2019-10-29 00:00:00+03:00,out,False,916618,False,10,562,638,76
167545,2019-10-29 00:00:00+03:00,in,False,916618,False,1,86,111,25
167545,2019-10-29 00:00:00+03:00,out,False,916618,True,2,0,53,53
167545,2019-10-29 00:00:00+03:00,in,False,-1,True,1,0,23,23
167545,2019-10-29 00:00:00+03:00,in,False,-1,True,1,0,23,23
167545,2019-10-30 00:00:00+03:00,in,False,-1,True,1,0,13,13
167545,2019-10-30 00:00:00+03:00,out,False,916618,True,1,0,19,19
167545,2019-10-30 00:00:00+03:00,out,False,916618,False,4,280,317,37
167545,2019-10-31 00:00:00+03:00,in,False,916618,False,1,21,44,23
167545,2019-10-31 00:00:00+03:00,out,False,916618,True,1,0,33,33
167545,2019-10-31 00:00:00+03:00,out,False,916618,False,9,566,615,49
167545,2019-10-31 00:00:00+03:00,in,False,916618,False,1,21,44,23
167545,2019-11-01 00:00:00+03:00,out,False,916618,False,7,743,785,42
167545,2019-11-01 00:00:00+03:00,out,False,916618,False,7,743,785,42
167545,2019-11-02 00:00:00+03:00,in,False,-1,True,2,0,30,30
167545,2019-11-02 00:00:00+03:00,in,False,-1,True,1,0,15,15
167545,2019-11-05 00:00:00+03:00,in,False,-1,True,2,0,21,21
167545,2019-11-06 00:00:00+03:00,in,False,-1,True,1,0,30,30
167545,2019-11-06 00:00:00+03:00,in,False,916618,False,1,81,104,23
167545,2019-11-07 00:00:00+03:00,in,False,-1,True,1,0,2,2
167545,2019-11-07 00:00:00+03:00,in,False,916618,False,1,442,464,22
167545,2019-11-08 00:00:00+03:00,in,False,916618,False,1,113,133,20
167545,2019-11-11 00:00:00+03:00,in,False,916618,False,2,245,289,44
167545,2019-11-12 00:00:00+03:00,in,False,916618,False,1,53,79,26
167545,2019-11-13 00:00:00+03:00,in,False,916618,False,4,304,355,51
167545,2019-11-13 00:00:00+03:00,in,False,-1,True,5,0,59,59
167545,2019-11-14 00:00:00+03:00,in,False,-1,True,2,0,37,37
167545,2019-11-14 00:00:00+03:00,in,False,916618,False,2,232,255,23
167545,2019-11-14 00:00:00+03:00,in,False,-1,True,2,0,37,37
167545,2019-11-15 00:00:00+03:00,in,False,916618,False,4,220,274,54
167545,2019-11-18 00:00:00+03:00,in,False,-1,True,4,0,66,66
167545,2019-11-18 00:00:00+03:00,out,False,964510,False,10,975,1087,112
167545,2019-11-18 00:00:00+03:00,in,False,916618,False,1,31,85,54
167545,2019-11-18 00:00:00+03:00,out,False,964510,True,1,0,40,40
167545,2019-11-19 00:00:00+03:00,in,False,-1,True,4,0,34,34
167545,2019-11-19 00:00:00+03:00,in,False,916618,False,1,4,40,36
167545,2019-11-20 00:00:00+03:00,in,False,964510,False,2,120,147,27
167545,2019-11-20 00:00:00+03:00,out,False,964510,False,14,1026,1191,165
167545,2019-11-20 00:00:00+03:00,in,False,-1,True,1,0,22,22
167545,2019-11-20 00:00:00+03:00,out,False,964510,True,6,0,115,115
167545,2019-11-20 00:00:00+03:00,in,False,916618,False,2,154,183,29
167545,2019-11-21 00:00:00+03:00,in,False,964510,False,1,159,167,8
167545,2019-11-21 00:00:00+03:00,out,False,964510,False,31,2535,2791,256
167545,2019-11-21 00:00:00+03:00,in,False,916618,False,2,27,86,59
167545,2019-11-21 00:00:00+03:00,in,False,-1,True,2,0,40,40
167545,2019-11-21 00:00:00+03:00,in,False,964510,True,2,52,60,8
167545,2019-11-21 00:00:00+03:00,out,True,964510,True,1,0,11,11
167545,2019-11-21 00:00:00+03:00,out,False,964510,True,13,0,210,210
167545,2019-11-21 00:00:00+03:00,in,False,916618,False,2,27,86,59
167545,2019-11-22 00:00:00+03:00,out,False,964510,False,6,520,584,64
167545,2019-11-22 00:00:00+03:00,in,False,-1,True,3,0,136,136
167545,2019-11-22 00:00:00+03:00,out,True,964510,False,1,31,36,5
167545,2019-11-22 00:00:00+03:00,in,False,964510,False,5,325,377,52
167545,2019-11-22 00:00:00+03:00,out,False,964510,True,5,0,38,38
167545,2019-11-23 00:00:00+03:00,in,False,916618,False,4,227,388,161
167545,2019-11-23 00:00:00+03:00,in,False,-1,True,2,0,8,8
167545,2019-11-23 00:00:00+03:00,in,False,-1,True,1,0,45,45
167545,2019-11-25 00:00:00+03:00,out,False,964510,False,9,779,831,52
167545,2019-11-25 00:00:00+03:00,in,False,916618,False,1,17,37,20
167545,2019-11-25 00:00:00+03:00,in,False,964510,False,1,52,70,18
167545,2019-11-25 00:00:00+03:00,in,False,-1,True,2,0,51,51
167545,2019-11-25 00:00:00+03:00,out,False,964510,True,1,0,1,1
167545,2019-11-25 00:00:00+03:00,in,False,964510,False,1,52,70,18
167545,2019-11-26 00:00:00+03:00,out,False,964510,True,1,0,0,0
167545,2019-11-26 00:00:00+03:00,in,False,964510,False,4,177,214,37
167545,2019-11-26 00:00:00+03:00,out,False,964510,False,3,348,388,40
167545,2019-11-27 00:00:00+03:00,in,False,-1,True,1,0,34,34
167545,2019-11-27 00:00:00+03:00,out,True,964510,True,1,0,0,0
167545,2019-11-27 00:00:00+03:00,in,False,916618,False,1,131,141,10
167545,2019-11-27 00:00:00+03:00,out,False,964510,False,12,1238,1386,148
167545,2019-11-27 00:00:00+03:00,out,False,964510,True,4,0,143,143
167545,2019-11-27 00:00:00+03:00,out,False,964510,False,12,1238,1386,148
167545,2019-11-28 00:00:00+03:00,out,False,964510,False,10,770,847,77
167545,2019-11-28 00:00:00+03:00,out,False,964510,True,2,0,4,4
167551,2019-09-25 00:00:00+03:00,in,False,919214,False,2,25,69,44
167551,2019-09-25 00:00:00+03:00,in,False,-1,True,1,0,10,10
167551,2019-09-25 00:00:00+03:00,in,False,919218,False,2,7,36,29
167551,2019-09-25 00:00:00+03:00,in,True,919218,False,1,2,22,20
167551,2019-09-25 00:00:00+03:00,out,False,919214,True,1,0,12,12
167551,2019-09-25 00:00:00+03:00,in,False,-1,True,18,0,154,154
167551,2019-09-25 00:00:00+03:00,out,True,919218,True,1,0,13,13
167551,2019-09-27 00:00:00+03:00,out,False,919218,False,5,185,219,34
167551,2019-09-27 00:00:00+03:00,in,False,-1,True,1,0,44,44
167551,2019-09-27 00:00:00+03:00,in,False,919218,False,4,189,217,28
167551,2019-09-27 00:00:00+03:00,out,False,919218,True,1,0,31,31
167551,2019-09-29 00:00:00+03:00,in,False,919214,False,1,575,602,27
167551,2019-09-30 00:00:00+03:00,out,True,919218,False,4,158,212,54
167551,2019-09-30 00:00:00+03:00,out,True,919218,True,5,0,82,82
167551,2019-09-30 00:00:00+03:00,in,False,919218,False,3,94,164,70
167551,2019-09-30 00:00:00+03:00,in,False,919214,False,1,1027,1075,48
167551,2019-09-30 00:00:00+03:00,out,False,919218,True,1,0,1,1
167551,2019-10-01 00:00:00+03:00,in,False,919214,False,3,75,153,78
167551,2019-10-03 00:00:00+03:00,out,False,919218,True,1,0,1,1
167551,2019-10-03 00:00:00+03:00,in,False,919218,False,1,237,257,20
167551,2019-10-06 00:00:00+03:00,in,False,919214,False,1,7,31,24
167551,2019-10-07 00:00:00+03:00,out,True,919218,False,1,980,993,13
167551,2019-10-08 00:00:00+03:00,in,False,919218,False,2,186,198,12
167551,2019-10-08 00:00:00+03:00,out,True,919218,False,3,1288,1334,46
167551,2019-10-08 00:00:00+03:00,out,False,919218,False,20,2436,2660,224
167551,2019-10-08 00:00:00+03:00,in,False,919214,False,3,64,137,73
167551,2019-10-08 00:00:00+03:00,in,False,-1,True,4,0,24,24
167551,2019-10-08 00:00:00+03:00,out,True,919218,True,6,0,84,84
167551,2019-10-08 00:00:00+03:00,out,False,919218,True,11,0,200,200
167551,2019-10-09 00:00:00+03:00,out,True,919218,True,2,0,56,56
167551,2019-10-09 00:00:00+03:00,out,False,919218,False,12,1331,1505,174
167551,2019-10-09 00:00:00+03:00,out,True,919218,False,2,126,153,27
167551,2019-10-09 00:00:00+03:00,in,False,-1,True,1,0,8,8
167551,2019-10-09 00:00:00+03:00,out,False,919218,True,15,0,328,328
167551,2019-10-09 00:00:00+03:00,out,False,919218,True,15,0,328,328
167551,2019-10-10 00:00:00+03:00,out,True,919218,True,1,0,20,20
167551,2019-10-10 00:00:00+03:00,out,False,919218,False,14,591,752,161
167551,2019-10-10 00:00:00+03:00,out,False,919218,True,9,0,196,196
167551,2019-10-11 00:00:00+03:00,in,False,919214,False,1,386,442,56
167551,2019-10-11 00:00:00+03:00,in,False,919218,True,1,64,69,5
167551,2019-10-11 00:00:00+03:00,out,False,919218,False,10,444,561,117
167551,2019-10-11 00:00:00+03:00,in,False,919218,False,5,696,727,31
167551,2019-10-11 00:00:00+03:00,out,True,919218,False,1,1507,1522,15
167551,2019-10-11 00:00:00+03:00,out,False,919218,True,12,0,254,254
167551,2019-10-14 00:00:00+03:00,out,True,919218,True,1,0,44,44
167551,2019-10-14 00:00:00+03:00,out,False,919218,True,17,0,534,534
167551,2019-10-14 00:00:00+03:00,out,False,919218,False,16,1322,1532,210
167551,2019-10-14 00:00:00+03:00,in,False,-1,True,1,0,5,5
167551,2019-10-14 00:00:00+03:00,in,True,919214,False,1,17,28,11
167551,2019-10-14 00:00:00+03:00,out,True,919218,False,2,164,190,26
167551,2019-10-14 00:00:00+03:00,out,True,919218,False,2,164,190,26
167551,2019-10-15 00:00:00+03:00,in,False,919214,False,2,31,122,91
167551,2019-10-15 00:00:00+03:00,out,False,919218,True,25,0,621,621
167551,2019-10-15 00:00:00+03:00,in,False,919218,False,1,118,127,9
167551,2019-10-15 00:00:00+03:00,in,False,-1,True,2,0,78,78
167551,2019-10-15 00:00:00+03:00,out,False,919218,False,25,3698,4110,412
167551,2019-10-16 00:00:00+03:00,out,False,919218,True,19,0,661,661
167551,2019-10-16 00:00:00+03:00,out,False,919218,False,12,2181,2329,148
167551,2019-10-16 00:00:00+03:00,in,True,919218,False,1,16,75,59
167551,2019-10-17 00:00:00+03:00,out,False,919218,False,7,1875,1995,120
167551,2019-10-17 00:00:00+03:00,out,False,919218,True,15,0,361,361
167551,2019-10-18 00:00:00+03:00,in,False,-1,True,4,0,180,180
167551,2019-10-18 00:00:00+03:00,out,False,919218,False,1,233,237,4
167551,2019-10-19 00:00:00+03:00,in,False,-1,True,2,0,41,41
167551,2019-10-19 00:00:00+03:00,out,False,919218,True,6,0,125,125
167551,2019-10-19 00:00:00+03:00,out,False,919218,False,3,384,426,42
167551,2019-10-20 00:00:00+03:00,out,False,919218,False,1,1,19,18
167551,2019-10-21 00:00:00+03:00,in,False,-1,True,1,0,41,41
167551,2019-10-21 00:00:00+03:00,in,False,919214,False,3,553,612,59
167551,2019-10-21 00:00:00+03:00,in,False,919214,False,3,553,612,59
167551,2019-10-25 00:00:00+03:00,in,False,-1,True,1,0,2,2
167575,2019-09-28 00:00:00+03:00,in,False,-1,True,3,0,6,6
167575,2019-10-04 00:00:00+03:00,in,False,-1,True,1,0,2,2
167575,2019-10-04 00:00:00+03:00,out,False,926872,True,1,0,0,0
167575,2019-10-15 00:00:00+03:00,in,False,930264,False,2,332,346,14
167575,2019-10-20 00:00:00+03:00,in,False,930264,False,1,26,33,7
167575,2019-10-21 00:00:00+03:00,in,False,930264,False,1,41,59,18
167575,2019-10-22 00:00:00+03:00,in,False,-1,True,63,0,3,3
167575,2019-10-22 00:00:00+03:00,in,False,926872,False,1,73,74,1
167575,2019-10-24 00:00:00+03:00,in,False,926872,False,2,385,386,1
167575,2019-10-25 00:00:00+03:00,out,False,926872,False,1,205,208,3
167575,2019-10-25 00:00:00+03:00,out,False,926872,True,1,0,57,57
167575,2019-10-25 00:00:00+03:00,in,False,926872,False,3,303,305,2
167575,2019-10-28 00:00:00+03:00,in,False,926872,True,3,0,3,3
167575,2019-10-28 00:00:00+03:00,in,False,926872,False,4,231,233,2
167575,2019-10-29 00:00:00+03:00,out,False,926872,False,1,20,34,14
167575,2019-10-29 00:00:00+03:00,in,False,926872,False,1,4,5,1
167575,2019-10-31 00:00:00+03:00,in,False,-1,True,1,0,0,0
167575,2019-10-31 00:00:00+03:00,in,False,-1,True,1,0,0,0
167575,2019-11-03 00:00:00+03:00,in,False,926872,False,1,261,262,1
167575,2019-11-04 00:00:00+03:00,out,False,926872,False,1,10,13,3
167575,2019-11-04 00:00:00+03:00,in,False,926872,False,1,2,3,1
167575,2019-11-04 00:00:00+03:00,in,False,926872,False,1,2,3,1
167575,2019-11-16 00:00:00+03:00,in,False,926872,False,1,297,298,1
167575,2019-11-20 00:00:00+03:00,in,False,926872,False,2,205,207,2
167575,2019-11-21 00:00:00+03:00,in,False,926872,False,2,273,275,2
167575,2019-11-24 00:00:00+03:00,in,False,926872,False,2,88,89,1
167575,2019-11-25 00:00:00+03:00,out,False,926872,True,2,0,2,2
167575,2019-11-25 00:00:00+03:00,in,False,926872,False,1,6,7,1
167580,2019-09-27 00:00:00+03:00,in,False,-1,True,1,0,2,2
167580,2019-09-27 00:00:00+03:00,in,False,-1,True,1,0,2,2
167580,2019-10-04 00:00:00+03:00,in,False,-1,True,1,0,2,2
167580,2019-10-15 00:00:00+03:00,out,False,936382,True,2,0,26,26
167580,2019-10-15 00:00:00+03:00,in,False,-1,True,8,0,6,6
167580,2019-10-16 00:00:00+03:00,out,False,936382,False,11,593,718,125
167580,2019-10-16 00:00:00+03:00,in,False,-1,True,6,0,36,36
167580,2019-10-16 00:00:00+03:00,out,False,937372,False,20,1077,1297,220
167580,2019-10-16 00:00:00+03:00,out,True,937156,True,3,0,6,6
167580,2019-10-16 00:00:00+03:00,out,True,937366,True,1,0,6,6
167580,2019-10-16 00:00:00+03:00,out,True,937352,False,4,97,127,30
167580,2019-10-16 00:00:00+03:00,out,True,937370,False,1,45,73,28
167580,2019-10-16 00:00:00+03:00,out,True,936382,False,1,54,67,13
167580,2019-10-16 00:00:00+03:00,out,True,937156,False,3,15,43,28
167580,2019-10-16 00:00:00+03:00,out,False,936382,True,5,0,114,114
167580,2019-10-16 00:00:00+03:00,out,False,937372,True,33,0,786,786
167580,2019-10-16 00:00:00+03:00,out,True,937368,False,1,24,32,8
167580,2019-10-16 00:00:00+03:00,out,True,937370,True,2,0,29,29
167580,2019-10-16 00:00:00+03:00,in,False,937368,False,2,10,35,25
167580,2019-10-16 00:00:00+03:00,out,False,937372,False,20,1077,1297,220
167580,2019-10-16 00:00:00+03:00,out,True,937370,True,2,0,29,29
167580,2019-10-17 00:00:00+03:00,out,False,936382,False,15,1679,1849,170
167580,2019-10-17 00:00:00+03:00,out,False,937372,True,36,0,678,678
167580,2019-10-17 00:00:00+03:00,out,False,937372,False,37,2256,2814,558
167580,2019-10-17 00:00:00+03:00,in,False,937368,False,1,39,62,23
167580,2019-10-17 00:00:00+03:00,out,False,936382,True,3,0,94,94
167580,2019-10-17 00:00:00+03:00,in,False,-1,True,1,0,20,20
167580,2019-10-17 00:00:00+03:00,out,True,937156,True,1,0,0,0
167580,2019-10-17 00:00:00+03:00,out,False,937156,False,3,442,496,54
167580,2019-10-17 00:00:00+03:00,out,False,937368,False,1,0,12,12
167580,2019-10-18 00:00:00+03:00,out,False,936382,True,2,0,37,37
167580,2019-10-18 00:00:00+03:00,out,True,937372,False,2,614,627,13
167580,2019-10-18 00:00:00+03:00,out,True,937372,True,1,0,0,0
167580,2019-10-18 00:00:00+03:00,out,False,937372,True,45,0,888,888
167580,2019-10-18 00:00:00+03:00,out,True,936382,True,2,0,0,0
167580,2019-10-18 00:00:00+03:00,out,False,936382,False,3,555,597,42
167580,2019-10-18 00:00:00+03:00,in,False,-1,True,8,0,10,10
167580,2019-10-18 00:00:00+03:00,out,True,937156,True,1,0,0,0
167580,2019-10-18 00:00:00+03:00,out,False,937372,False,52,2492,3059,567
167580,2019-10-18 00:00:00+03:00,out,True,936382,False,1,106,109,3
167580,2019-10-18 00:00:00+03:00,out,False,936382,False,3,555,597,42
167580,2019-10-20 00:00:00+03:00,in,False,-1,True,4,0,1,1
167580,2019-10-21 00:00:00+03:00,out,False,937372,True,58,0,1142,1142
167580,2019-10-21 00:00:00+03:00,out,False,936382,False,26,1562,1800,238
167580,2019-10-21 00:00:00+03:00,out,False,937372,False,68,2739,3439,700
167580,2019-10-21 00:00:00+03:00,out,False,937156,True,1,0,2,2
167580,2019-10-21 00:00:00+03:00,out,False,937352,False,1,229,243,14
167580,2019-10-21 00:00:00+03:00,out,True,937156,True,1,0,5,5
167580,2019-10-21 00:00:00+03:00,in,False,937368,False,2,268,301,33
167580,2019-10-21 00:00:00+03:00,out,False,936382,True,31,0,752,752
167580,2019-10-21 00:00:00+03:00,out,False,936382,False,26,1562,1800,238
167580,2019-10-22 00:00:00+03:00,in,False,937368,False,1,31,57,26
167580,2019-10-22 00:00:00+03:00,out,False,936382,True,2,0,72,72
167580,2019-10-22 00:00:00+03:00,out,False,936382,False,9,920,1067,147
167580,2019-10-22 00:00:00+03:00,in,False,-1,True,4,0,62,62
167580,2019-10-22 00:00:00+03:00,out,False,937372,False,65,2704,3519,815
167580,2019-10-22 00:00:00+03:00,out,False,937372,True,91,0,1335,1335
167580,2019-10-22 00:00:00+03:00,in,False,937370,False,1,33,40,7
167580,2019-10-22 00:00:00+03:00,out,False,937156,False,4,508,538,30
167580,2019-10-22 00:00:00+03:00,out,False,937372,True,91,0,1335,1335
167580,2019-10-23 00:00:00+03:00,in,False,937368,True,1,0,10,10
167580,2019-10-23 00:00:00+03:00,in,False,937368,False,1,232,243,11
167580,2019-10-23 00:00:00+03:00,out,False,937156,False,1,206,209,3
167580,2019-10-23 00:00:00+03:00,out,False,937372,True,39,0,711,711
167580,2019-10-23 00:00:00+03:00,out,False,936382,True,17,0,398,398
167580,2019-10-23 00:00:00+03:00,out,False,937372,False,45,2122,2647,525
167580,2019-10-23 00:00:00+03:00,out,False,936382,False,30,2102,2400,298
167580,2019-10-23 00:00:00+03:00,out,False,936382,True,17,0,398,398
167580,2019-10-24 00:00:00+03:00,out,False,945728,True,1,0,16,16
167580,2019-10-24 00:00:00+03:00,out,False,937156,True,1,0,44,44
167580,2019-10-24 00:00:00+03:00,out,False,937372,False,74,3940,4813,873
167580,2019-10-24 00:00:00+03:00,out,False,936382,True,13,0,266,266
167580,2019-10-24 00:00:00+03:00,out,False,936382,False,26,3098,3405,307
167580,2019-10-24 00:00:00+03:00,in,False,937368,False,1,153,164,11
167580,2019-10-24 00:00:00+03:00,out,False,937156,False,2,65,74,9
167580,2019-10-24 00:00:00+03:00,out,False,937372,True,76,0,2106,2106
167580,2019-10-24 00:00:00+03:00,out,False,937156,True,1,0,44,44
167580,2019-10-25 00:00:00+03:00,out,False,937372,False,63,3668,4458,790
167580,2019-10-25 00:00:00+03:00,out,False,937156,False,1,286,289,3
167580,2019-10-25 00:00:00+03:00,out,False,937352,False,2,179,225,46
167580,2019-10-25 00:00:00+03:00,in,False,937368,False,2,161,176,15
167580,2019-10-25 00:00:00+03:00,out,False,937372,True,86,0,1992,1992
167580,2019-10-25 00:00:00+03:00,out,False,936382,False,9,621,713,92
167580,2019-10-25 00:00:00+03:00,out,False,936382,False,9,621,713,92
167580,2019-10-26 00:00:00+03:00,in,False,937368,False,1,42,55,13
167580,2019-10-26 00:00:00+03:00,in,False,937368,False,1,42,55,13
167580,2019-10-28 00:00:00+03:00,out,False,937372,False,50,2269,2888,619
167580,2019-10-28 00:00:00+03:00,out,False,936382,True,8,0,192,192
167580,2019-10-28 00:00:00+03:00,out,False,936382,False,17,1838,2055,217
167580,2019-10-28 00:00:00+03:00,in,False,937368,False,1,60,105,45
167580,2019-10-28 00:00:00+03:00,in,False,-1,True,2,0,21,21
167580,2019-10-28 00:00:00+03:00,out,False,937372,True,94,0,2149,2149
167580,2019-10-28 00:00:00+03:00,out,False,945728,False,3,137,192,55
167580,2019-10-28 00:00:00+03:00,out,False,945728,True,4,0,65,65
167580,2019-10-28 00:00:00+03:00,out,False,937156,False,1,14,15,1
167580,2019-10-28 00:00:00+03:00,out,False,945728,True,4,0,65,65
167580,2019-10-28 00:00:00+03:00,out,False,936382,False,17,1838,2055,217
167580,2019-10-29 00:00:00+03:00,out,False,936382,False,32,2292,2779,487
167580,2019-10-29 00:00:00+03:00,out,False,937372,False,55,2967,3607,640
167580,2019-10-29 00:00:00+03:00,in,False,937374,False,1,70,112,42
167580,2019-10-29 00:00:00+03:00,out,False,936382,True,8,0,304,304
167580,2019-10-29 00:00:00+03:00,out,False,937372,True,79,0,1580,1580
167580,2019-10-29 00:00:00+03:00,in,False,-1,True,3,0,24,24
167580,2019-10-30 00:00:00+03:00,in,False,937374,False,2,276,373,97
167580,2019-10-30 00:00:00+03:00,out,False,937352,False,3,681,707,26
167580,2019-10-30 00:00:00+03:00,out,False,936382,False,10,292,463,171
167580,2019-10-30 00:00:00+03:00,out,False,936382,True,3,0,85,85
167580,2019-10-30 00:00:00+03:00,out,False,937372,False,2,236,250,14
167580,2019-10-31 00:00:00+03:00,out,False,937352,True,3,0,103,103
167580,2019-10-31 00:00:00+03:00,out,False,936382,True,6,0,267,267
167580,2019-10-31 00:00:00+03:00,out,False,937352,False,2,264,276,12
167580,2019-10-31 00:00:00+03:00,in,False,937374,False,2,81,165,84
167580,2019-10-31 00:00:00+03:00,out,False,936382,False,16,1223,1444,221
167580,2019-10-31 00:00:00+03:00,out,False,936382,True,6,0,267,267
167580,2019-11-01 00:00:00+03:00,out,False,936382,True,1,0,6,6
167580,2019-11-01 00:00:00+03:00,out,False,936382,False,11,1469,1520,51
167580,2019-11-02 00:00:00+03:00,in,False,-1,True,1,0,14,14
167580,2019-11-02 00:00:00+03:00,in,False,937374,False,1,48,90,42
167580,2019-11-04 00:00:00+03:00,in,False,937374,False,1,11,53,42
167580,2019-11-04 00:00:00+03:00,in,False,-1,True,1,0,12,12
167580,2019-11-04 00:00:00+03:00,out,False,937352,True,3,0,85,85
167580,2019-11-05 00:00:00+03:00,out,False,945728,True,11,0,318,318
167580,2019-11-05 00:00:00+03:00,out,False,945728,False,7,299,430,131
167580,2019-11-05 00:00:00+03:00,in,False,937374,False,1,40,86,46
167580,2019-11-06 00:00:00+03:00,out,False,936382,True,1,0,49,49
167580,2019-11-06 00:00:00+03:00,out,False,937368,True,1,0,32,32
167580,2019-11-06 00:00:00+03:00,in,False,-1,True,3,0,75,75
167580,2019-11-06 00:00:00+03:00,out,False,937352,True,2,0,63,63
167580,2019-11-06 00:00:00+03:00,in,False,937374,False,1,145,184,39
167580,2019-11-06 00:00:00+03:00,out,False,936382,False,1,7,45,38
167580,2019-11-06 00:00:00+03:00,out,False,937368,True,1,0,32,32
167580,2019-11-07 00:00:00+03:00,out,False,937352,False,2,75,84,9
167580,2019-11-07 00:00:00+03:00,in,False,-1,True,8,0,238,238
167580,2019-11-07 00:00:00+03:00,in,False,937368,False,4,125,287,162
167580,2019-11-07 00:00:00+03:00,out,False,936382,False,24,1963,2317,354
167580,2019-11-07 00:00:00+03:00,out,False,936382,True,12,0,332,332
167580,2019-11-07 00:00:00+03:00,out,False,936382,True,12,0,332,332
167580,2019-11-08 00:00:00+03:00,out,True,937156,False,1,19,34,15
167580,2019-11-08 00:00:00+03:00,in,False,937368,False,2,59,130,71
167580,2019-11-08 00:00:00+03:00,out,True,937362,True,3,0,7,7
167580,2019-11-08 00:00:00+03:00,in,False,937368,True,3,139,225,86
167580,2019-11-08 00:00:00+03:00,out,False,936382,True,8,0,295,295
167580,2019-11-08 00:00:00+03:00,out,True,937370,True,2,0,12,12
167580,2019-11-08 00:00:00+03:00,out,False,937352,True,3,0,52,52
167580,2019-11-08 00:00:00+03:00,out,False,937366,True,1,0,5,5
167580,2019-11-08 00:00:00+03:00,out,True,937362,False,1,67,73,6
167580,2019-11-08 00:00:00+03:00,out,False,937156,True,1,0,27,27
167580,2019-11-08 00:00:00+03:00,out,True,937368,True,7,0,21,21
167580,2019-11-08 00:00:00+03:00,in,False,-1,True,4,0,111,111
167580,2019-11-08 00:00:00+03:00,out,False,937156,False,1,60,64,4
167580,2019-11-08 00:00:00+03:00,in,False,936382,False,1,78,117,39
167580,2019-11-08 00:00:00+03:00,out,False,936382,False,18,2173,2431,258
167580,2019-11-08 00:00:00+03:00,out,True,937362,False,1,67,73,6
167580,2019-11-08 00:00:00+03:00,out,False,937156,False,1,60,64,4
167580,2019-11-08 00:00:00+03:00,out,False,937366,True,1,0,5,5
167580,2019-11-11 00:00:00+03:00,in,False,937362,False,3,358,505,147
167580,2019-11-11 00:00:00+03:00,out,False,936382,False,4,405,449,44
167580,2019-11-11 00:00:00+03:00,out,False,936382,True,2,0,64,64
167580,2019-11-11 00:00:00+03:00,out,False,936382,False,4,405,449,44
167580,2019-11-12 00:00:00+03:00,in,False,937366,False,2,123,220,97
167580,2019-11-12 00:00:00+03:00,out,False,937156,False,20,1931,2288,357
167580,2019-11-12 00:00:00+03:00,out,False,937362,False,1,35,37,2
167580,2019-11-12 00:00:00+03:00,in,False,937362,False,2,255,361,106
167580,2019-11-12 00:00:00+03:00,in,False,-1,True,4,0,66,66
167580,2019-11-12 00:00:00+03:00,out,False,937156,True,18,0,384,384
167580,2019-11-13 00:00:00+03:00,in,False,937366,False,1,163,227,64
167580,2019-11-13 00:00:00+03:00,out,False,937156,True,1,0,21,21
167580,2019-11-13 00:00:00+03:00,in,False,937374,False,1,39,72,33
167580,2019-11-13 00:00:00+03:00,out,False,956298,False,1,21,32,11
167580,2019-11-13 00:00:00+03:00,out,False,945728,False,35,1373,1858,485
167580,2019-11-13 00:00:00+03:00,out,True,956298,False,1,88,96,8
167580,2019-11-13 00:00:00+03:00,out,False,945728,True,25,0,594,594
167580,2019-11-13 00:00:00+03:00,out,False,945728,True,25,0,594,594
167580,2019-11-14 00:00:00+03:00,out,False,956298,True,1,0,10,10
167580,2019-11-17 00:00:00+03:00,in,False,937374,False,1,170,199,29
167580,2019-11-17 00:00:00+03:00,in,False,-1,True,1,0,20,20
167580,2019-11-18 00:00:00+03:00,out,False,960672,True,5,0,213,213
167580,2019-11-18 00:00:00+03:00,out,False,960672,False,33,3462,3765,303
167580,2019-11-18 00:00:00+03:00,out,False,956298,False,1,155,164,9
167580,2019-11-18 00:00:00+03:00,in,False,937374,False,3,313,422,109
167580,2019-11-18 00:00:00+03:00,in,False,-1,True,1,0,2,2
167580,2019-11-18 00:00:00+03:00,out,False,960672,False,33,3462,3765,303
167580,2019-11-18 00:00:00+03:00,in,False,937374,False,3,313,422,109
167580,2019-11-19 00:00:00+03:00,out,False,960672,True,3,0,132,132
167580,2019-11-19 00:00:00+03:00,out,False,960672,False,15,1209,1388,179
167580,2019-11-19 00:00:00+03:00,out,True,960672,False,1,281,293,12
167580,2019-11-19 00:00:00+03:00,in,False,937374,False,1,207,244,37
167580,2019-11-19 00:00:00+03:00,out,False,937352,False,3,223,239,16
167580,2019-11-19 00:00:00+03:00,in,False,-1,True,1,0,10,10
167580,2019-11-19 00:00:00+03:00,out,True,960672,True,4,0,0,0
167580,2019-11-19 00:00:00+03:00,out,False,956298,True,1,0,7,7
167580,2019-11-19 00:00:00+03:00,out,False,956298,False,1,45,54,9
167580,2019-11-19 00:00:00+03:00,out,True,960672,False,1,281,293,12
167580,2019-11-20 00:00:00+03:00,out,True,960672,True,3,0,1,1
167580,2019-11-20 00:00:00+03:00,out,False,960672,True,6,0,275,275
167580,2019-11-20 00:00:00+03:00,out,False,937352,False,3,809,824,15
167580,2019-11-20 00:00:00+03:00,out,False,956298,False,3,1452,1454,2
167580,2019-11-20 00:00:00+03:00,out,False,960672,False,24,1867,2124,257
167580,2019-11-21 00:00:00+03:00,out,False,960672,False,17,3605,3784,179
167580,2019-11-21 00:00:00+03:00,out,False,960672,True,5,0,84,84
167580,2019-11-21 00:00:00+03:00,in,False,-1,True,1,0,1,1
167580,2019-11-21 00:00:00+03:00,out,False,956298,False,1,72,79,7
167580,2019-11-21 00:00:00+03:00,in,False,937374,False,1,28,58,30
167580,2019-11-21 00:00:00+03:00,out,False,960672,True,5,0,84,84
167580,2019-11-22 00:00:00+03:00,out,False,960672,True,4,0,68,68
167580,2019-11-22 00:00:00+03:00,out,True,960672,False,1,29,41,12
167580,2019-11-22 00:00:00+03:00,out,False,960670,True,1,0,24,24
167580,2019-11-22 00:00:00+03:00,out,False,960672,False,9,848,954,106
167580,2019-11-22 00:00:00+03:00,in,False,-1,True,2,0,36,36
167580,2019-11-22 00:00:00+03:00,out,True,960666,False,1,125,128,3
167580,2019-11-22 00:00:00+03:00,in,False,937374,False,2,125,186,61
167580,2019-11-22 00:00:00+03:00,out,True,960666,False,1,125,128,3
167580,2019-11-25 00:00:00+03:00,in,False,-1,True,4,0,88,88
167580,2019-11-25 00:00:00+03:00,out,True,960674,True,2,0,0,0
167580,2019-11-25 00:00:00+03:00,out,False,960672,True,3,0,126,126
167580,2019-11-25 00:00:00+03:00,out,False,956298,True,2,0,26,26
167580,2019-11-25 00:00:00+03:00,out,False,960672,False,19,1279,1528,249
167580,2019-11-25 00:00:00+03:00,in,False,937374,False,4,551,670,119
167580,2019-11-26 00:00:00+03:00,out,False,945728,True,1,0,53,53
167580,2019-11-26 00:00:00+03:00,out,False,960672,False,28,2365,2748,383
167580,2019-11-26 00:00:00+03:00,out,False,956298,True,2,0,58,58
167580,2019-11-26 00:00:00+03:00,in,False,-1,True,4,0,52,52
167580,2019-11-26 00:00:00+03:00,out,False,960672,True,20,0,335,335
167580,2019-11-26 00:00:00+03:00,out,False,956298,True,2,0,58,58
167580,2019-11-26 00:00:00+03:00,out,False,960672,True,20,0,335,335
167580,2019-11-26 00:00:00+03:00,out,False,945728,True,1,0,53,53
167580,2019-11-27 00:00:00+03:00,in,False,937374,False,1,66,98,32
167580,2019-11-27 00:00:00+03:00,out,False,960670,False,2,100,125,25
167580,2019-11-28 00:00:00+03:00,out,False,960672,False,15,1529,1726,197
167580,2019-11-28 00:00:00+03:00,in,False,937374,False,2,92,145,53
167580,2019-11-28 00:00:00+03:00,out,False,960672,True,4,0,74,74
167580,2019-11-28 00:00:00+03:00,in,False,937374,False,2,92,145,53
167599,2019-10-14 00:00:00+03:00,in,False,-1,True,1,0,2,2
167599,2019-11-03 00:00:00+03:00,in,False,-1,True,1,0,2,2
167599,2019-11-05 00:00:00+03:00,in,False,-1,True,14,0,52,52
167599,2019-11-12 00:00:00+03:00,in,False,954086,False,31,277,341,64
167599,2019-11-12 00:00:00+03:00,in,False,-1,True,30,0,89,89
167599,2019-11-20 00:00:00+03:00,out,False,954086,False,1,40,48,8
167621,2019-09-24 00:00:00+03:00,in,False,-1,True,1,0,8,8
167621,2019-09-25 00:00:00+03:00,in,False,918888,False,1,30,34,4
167621,2019-09-26 00:00:00+03:00,in,False,-1,True,1,0,29,29
167621,2019-09-26 00:00:00+03:00,in,False,-1,True,1,0,29,29
167621,2019-09-27 00:00:00+03:00,out,False,918888,True,1,0,14,14
167621,2019-10-01 00:00:00+03:00,in,False,-1,True,3,0,61,61
167621,2019-10-11 00:00:00+03:00,in,False,918888,False,1,25,32,7
167621,2019-10-17 00:00:00+03:00,out,False,918888,True,1,0,21,21
167621,2019-10-17 00:00:00+03:00,in,False,-1,True,2,0,50,50
167621,2019-10-18 00:00:00+03:00,in,False,918888,True,1,0,6,6
167621,2019-10-18 00:00:00+03:00,in,False,918888,False,1,1,22,21
167621,2019-10-23 00:00:00+03:00,in,False,918888,False,1,13,18,5
167621,2019-10-25 00:00:00+03:00,in,False,-1,True,1,0,30,30
167621,2019-11-01 00:00:00+03:00,in,False,-1,True,1,0,30,30
167621,2019-11-01 00:00:00+03:00,in,False,918888,False,1,34,47,13
167621,2019-11-08 00:00:00+03:00,out,False,918888,True,1,0,4,4
167621,2019-11-09 00:00:00+03:00,in,False,-1,True,8,0,240,240
167621,2019-11-12 00:00:00+03:00,in,False,918888,False,1,15,21,6
167621,2019-11-20 00:00:00+03:00,in,False,918888,False,1,34,47,13
167626,2019-09-24 00:00:00+03:00,out,False,919164,True,1,0,22,22
167626,2019-09-24 00:00:00+03:00,out,False,919194,True,1,0,14,14
167626,2019-09-24 00:00:00+03:00,out,False,919166,False,1,12,23,11
167626,2019-09-24 00:00:00+03:00,out,False,919188,True,1,0,8,8
167626,2019-09-24 00:00:00+03:00,in,False,-1,True,1,0,12,12
167626,2019-09-24 00:00:00+03:00,in,False,919164,False,2,25,46,21
167626,2019-09-24 00:00:00+03:00,in,False,-1,True,1,0,12,12
167626,2019-09-25 00:00:00+03:00,out,False,919164,True,1,0,6,6
167626,2019-09-25 00:00:00+03:00,out,False,919196,True,54,0,1321,1321
167626,2019-09-25 00:00:00+03:00,out,False,919482,False,45,4784,5513,729
167626,2019-09-25 00:00:00+03:00,out,False,919190,True,60,0,1004,1004
167626,2019-09-25 00:00:00+03:00,out,False,919314,False,102,5010,7058,2048
167626,2019-09-25 00:00:00+03:00,out,False,919318,False,53,861,1645,784
167626,2019-09-25 00:00:00+03:00,in,False,919190,False,1,270,283,13
167626,2019-09-25 00:00:00+03:00,out,False,919490,False,72,5248,6526,1278
167626,2019-09-25 00:00:00+03:00,out,False,919192,True,73,0,1853,1853
167626,2019-09-25 00:00:00+03:00,out,False,919202,True,10,0,265,265
167626,2019-09-25 00:00:00+03:00,out,False,919188,False,136,14408,16962,2554
167626,2019-09-25 00:00:00+03:00,out,False,919374,False,54,2590,3823,1233
167626,2019-09-25 00:00:00+03:00,out,True,919376,True,1,0,0,0
167626,2019-09-25 00:00:00+03:00,out,False,919190,False,22,1922,2240,318
167626,2019-09-25 00:00:00+03:00,out,False,919910,False,27,2179,2702,523
167626,2019-09-25 00:00:00+03:00,out,False,919318,True,115,0,2585,2585
167626,2019-09-25 00:00:00+03:00,out,False,919490,True,80,0,1542,1542
167626,2019-09-25 00:00:00+03:00,out,False,919310,False,10,439,559,120
167626,2019-09-25 00:00:00+03:00,out,False,919364,False,152,8981,11875,2894
167626,2019-09-25 00:00:00+03:00,in,False,919164,False,74,2349,2807,458
167626,2019-09-25 00:00:00+03:00,out,False,919194,False,51,8366,9341,975
167626,2019-09-25 00:00:00+03:00,in,False,919206,True,1,0,4,4
167626,2019-09-25 00:00:00+03:00,out,False,919504,True,59,0,1668,1668
167626,2019-09-25 00:00:00+03:00,in,False,-1,True,193,0,434,434
167626,2019-09-25 00:00:00+03:00,out,False,919192,False,87,9994,11428,1434
167626,2019-09-25 00:00:00+03:00,out,False,919370,False,39,3798,4409,611
167626,2019-09-25 00:00:00+03:00,out,False,919378,False,60,3322,4308,986
167626,2019-09-25 00:00:00+03:00,out,False,919302,True,46,0,1314,1314
167626,2019-09-25 00:00:00+03:00,out,False,919204,False,1,13,25,12
167626,2019-09-25 00:00:00+03:00,out,False,919196,False,112,10227,12122,1895
167626,2019-09-25 00:00:00+03:00,out,False,919464,True,51,0,1250,1250
167626,2019-09-25 00:00:00+03:00,out,False,919362,False,64,5485,6777,1292
167626,2019-09-25 00:00:00+03:00,out,False,919504,False,73,4529,5724,1195
167626,2019-09-25 00:00:00+03:00,out,False,919188,True,63,0,1706,1706
167626,2019-09-25 00:00:00+03:00,out,False,919464,False,49,4604,5264,660
167626,2019-09-25 00:00:00+03:00,out,False,919202,False,39,3985,4621,636
167626,2019-09-25 00:00:00+03:00,out,False,919302,False,63,9977,11210,1233
167626,2019-09-25 00:00:00+03:00,out,False,919456,False,67,5261,6199,938
167626,2019-09-25 00:00:00+03:00,in,False,919206,False,63,2218,2687,469
167626,2019-09-25 00:00:00+03:00,out,False,919378,True,61,0,1348,1348
167626,2019-09-25 00:00:00+03:00,out,False,919362,True,54,0,1894,1894
167626,2019-09-25 00:00:00+03:00,out,False,919376,True,38,0,610,610
167626,2019-09-25 00:00:00+03:00,out,False,919164,False,2,20,48,28
167626,2019-09-25 00:00:00+03:00,out,False,919476,True,41,0,1016,1016
167626,2019-09-25 00:00:00+03:00,out,False,919370,True,42,0,1124,1124
167626,2019-09-25 00:00:00+03:00,out,False,919482,True,40,0,1063,1063
167626,2019-09-25 00:00:00+03:00,out,False,919456,True,56,0,1043,1043
167626,2019-09-25 00:00:00+03:00,out,False,919374,True,90,0,2796,2796
167626,2019-09-25 00:00:00+03:00,out,False,919906,True,16,0,597,597
167626,2019-09-25 00:00:00+03:00,out,False,919162,False,102,8477,10306,1829
167626,2019-09-25 00:00:00+03:00,out,False,919364,True,114,0,3629,3629
167626,2019-09-25 00:00:00+03:00,out,False,919910,True,21,0,360,360
167626,2019-09-25 00:00:00+03:00,out,False,919372,False,60,2655,3678,1023
167626,2019-09-25 00:00:00+03:00,out,False,919314,True,118,0,3053,3053
167626,2019-09-25 00:00:00+03:00,out,False,919162,True,84,0,2383,2383
167626,2019-09-25 00:00:00+03:00,out,False,919310,True,11,0,210,210
167626,2019-09-25 00:00:00+03:00,out,False,919476,False,59,2473,3502,1029
167626,2019-09-25 00:00:00+03:00,out,False,919906,False,45,5721,6620,899
167626,2019-09-25 00:00:00+03:00,in,False,919164,True,1,0,15,15
167626,2019-09-25 00:00:00+03:00,out,False,919372,True,76,0,2171,2171
167626,2019-09-25 00:00:00+03:00,out,False,919306,True,1,0,11,11
167626,2019-09-25 00:00:00+03:00,out,False,919206,False,1,22,38,16
167626,2019-09-25 00:00:00+03:00,out,False,919194,True,33,0,1000,1000
167626,2019-09-25 00:00:00+03:00,out,False,919376,False,62,4839,5689,850
167626,2019-09-25 00:00:00+03:00,out,False,919390,True,93,0,1896,1896
167626,2019-09-25 00:00:00+03:00,out,False,919390,False,34,532,1175,643
167626,2019-09-25 00:00:00+03:00,out,False,919164,True,1,0,6,6
167626,2019-09-25 00:00:00+03:00,out,False,919906,False,45,5721,6620,899
167626,2019-09-25 00:00:00+03:00,in,False,919164,False,74,2349,2807,458
167626,2019-09-25 00:00:00+03:00,out,False,919306,True,1,0,11,11
167626,2019-09-25 00:00:00+03:00,out,False,919482,True,40,0,1063,1063
167626,2019-09-25 00:00:00+03:00,out,False,919194,False,51,8366,9341,975
167626,2019-09-25 00:00:00+03:00,out,False,919376,False,62,4839,5689,850
167626,2019-09-26 00:00:00+03:00,out,False,919194,True,39,0,1231,1231
167626,2019-09-26 00:00:00+03:00,out,False,919390,True,34,0,564,564
167626,2019-09-26 00:00:00+03:00,out,False,919318,False,77,2661,4019,1358
167626,2019-09-26 00:00:00+03:00,out,False,919390,False,53,3745,4524,779
167626,2019-09-26 00:00:00+03:00,out,False,919464,True,79,0,1833,1833
167626,2019-09-26 00:00:00+03:00,out,False,919202,True,44,0,1088,1088
167626,2019-09-26 00:00:00+03:00,out,False,919188,False,117,10899,12980,2081
167626,2019-09-26 00:00:00+03:00,out,False,919196,True,69,0,1656,1656
167626,2019-09-26 00:00:00+03:00,out,False,919362,True,56,0,1983,1983
167626,2019-09-26 00:00:00+03:00,out,False,920416,True,73,0,798,798
167626,2019-09-26 00:00:00+03:00,out,False,920414,True,46,0,1177,1177
167626,2019-09-26 00:00:00+03:00,out,False,919162,True,96,0,2500,2500
167626,2019-09-26 00:00:00+03:00,out,False,919476,False,83,6609,8007,1398
167626,2019-09-26 00:00:00+03:00,out,False,919372,True,70,0,2345,2345
167626,2019-09-26 00:00:00+03:00,out,False,919374,True,69,0,2258,2258
167626,2019-09-26 00:00:00+03:00,out,False,919490,True,69,0,1689,1689
167626,2019-09-26 00:00:00+03:00,out,False,919202,False,67,6551,7718,1167
167626,2019-09-26 00:00:00+03:00,in,False,919164,False,80,3649,4118,469
167626,2019-09-26 00:00:00+03:00,out,False,919302,True,70,0,2166,2166
167626,2019-09-26 00:00:00+03:00,in,False,919206,False,71,2581,3164,583
167626,2019-09-26 00:00:00+03:00,out,False,919364,False,127,6584,9127,2543
167626,2019-09-26 00:00:00+03:00,out,False,919456,True,40,0,1157,1157
167626,2019-09-26 00:00:00+03:00,out,False,919164,True,1,0,8,8
167626,2019-09-26 00:00:00+03:00,out,False,919194,False,68,12420,13705,1285
167626,2019-09-26 00:00:00+03:00,out,False,919376,True,37,0,1056,1056
167626,2019-09-26 00:00:00+03:00,out,False,919456,False,62,5266,6286,1020
167626,2019-09-26 00:00:00+03:00,out,False,919482,False,105,10288,11933,1645
167626,2019-09-26 00:00:00+03:00,out,False,919192,True,62,0,1482,1482
167626,2019-09-26 00:00:00+03:00,out,False,919314,True,68,0,1795,1795
167626,2019-09-26 00:00:00+03:00,out,False,919482,True,56,0,1340,1340
167626,2019-09-26 00:00:00+03:00,out,False,919504,True,41,0,1253,1253
167626,2019-09-26 00:00:00+03:00,in,False,919206,True,1,0,3,3
167626,2019-09-26 00:00:00+03:00,out,False,919378,False,57,5215,6082,867
167626,2019-09-26 00:00:00+03:00,out,False,919476,True,60,0,1351,1351
167626,2019-09-26 00:00:00+03:00,out,False,919196,False,109,10697,12657,1960
167626,2019-09-26 00:00:00+03:00,out,False,919200,True,22,0,477,477
167626,2019-09-26 00:00:00+03:00,out,False,919364,True,115,0,3585,3585
167626,2019-09-26 00:00:00+03:00,out,False,919162,False,126,10073,12193,2120
167626,2019-09-26 00:00:00+03:00,out,False,919164,False,1,165,177,12
167626,2019-09-26 00:00:00+03:00,out,False,919200,False,48,5963,6829,866
167626,2019-09-26 00:00:00+03:00,out,False,919378,True,41,0,814,814
167626,2019-09-26 00:00:00+03:00,out,False,919490,False,102,8636,10296,1660
167626,2019-09-26 00:00:00+03:00,out,False,919464,False,72,5987,7157,1170
167626,2019-09-26 00:00:00+03:00,out,False,919188,True,55,0,1269,1269
167626,2019-09-26 00:00:00+03:00,out,False,919310,False,72,3899,5259,1360
167626,2019-09-26 00:00:00+03:00,in,False,-1,True,596,0,697,697
167626,2019-09-26 00:00:00+03:00,out,False,919318,True,62,0,1544,1544
167626,2019-09-26 00:00:00+03:00,out,False,919376,False,74,6599,7957,1358
167626,2019-09-26 00:00:00+03:00,out,False,920416,False,42,2800,3446,646
167626,2019-09-26 00:00:00+03:00,out,False,920414,False,56,6973,7966,993
167626,2019-09-26 00:00:00+03:00,out,False,919302,False,78,12993,14290,1297
167626,2019-09-26 00:00:00+03:00,out,False,919372,False,78,4090,5412,1322
167626,2019-09-26 00:00:00+03:00,out,False,919310,True,29,0,779,779
167626,2019-09-26 00:00:00+03:00,out,False,919362,False,75,9372,10661,1289
167626,2019-09-26 00:00:00+03:00,out,False,919314,False,109,7195,9128,1933
167626,2019-09-26 00:00:00+03:00,out,False,919192,False,97,12048,13780,1732
167626,2019-09-26 00:00:00+03:00,out,False,919374,False,64,5362,6454,1092
167626,2019-09-26 00:00:00+03:00,out,False,919504,False,84,6281,7913,1632
167626,2019-09-26 00:00:00+03:00,out,False,919374,False,64,5362,6454,1092
167626,2019-09-26 00:00:00+03:00,out,False,919162,True,96,0,2500,2500
167626,2019-09-26 00:00:00+03:00,out,False,919390,True,34,0,564,564
167626,2019-09-26 00:00:00+03:00,out,False,919194,True,39,0,1231,1231
167626,2019-09-26 00:00:00+03:00,out,False,919202,False,67,6551,7718,1167
167626,2019-09-26 00:00:00+03:00,out,False,919362,True,56,0,1983,1983
167626,2019-09-26 00:00:00+03:00,out,False,919490,False,102,8636,10296,1660
167626,2019-09-26 00:00:00+03:00,out,False,919314,False,109,7195,9128,1933
167626,2019-09-26 00:00:00+03:00,out,False,919456,False,62,5266,6286,1020
167626,2019-09-27 00:00:00+03:00,out,False,919456,True,64,0,1421,1421
167626,2019-09-27 00:00:00+03:00,out,False,919166,True,1,0,3,3
167626,2019-09-27 00:00:00+03:00,out,False,921594,True,58,0,1663,1663
167626,2019-09-27 00:00:00+03:00,out,False,919456,False,71,5109,6266,1157
167626,2019-09-27 00:00:00+03:00,out,False,919188,True,113,0,3123,3123
167626,2019-09-27 00:00:00+03:00,out,False,920414,True,60,0,1261,1261
167626,2019-09-27 00:00:00+03:00,out,False,919374,False,56,3263,4381,1118
167626,2019-09-27 00:00:00+03:00,in,False,919166,False,124,3811,4430,619
167626,2019-09-27 00:00:00+03:00,out,False,921574,True,67,0,1864,1864
167626,2019-09-27 00:00:00+03:00,out,False,919906,False,61,8064,9377,1313
167626,2019-09-27 00:00:00+03:00,out,False,919188,False,109,8995,11185,2190
167626,2019-09-27 00:00:00+03:00,in,False,-1,True,242,0,656,656
167626,2019-09-27 00:00:00+03:00,out,False,919192,True,67,0,1715,1715
167626,2019-09-27 00:00:00+03:00,out,False,921594,False,64,6127,7240,1113
167626,2019-09-27 00:00:00+03:00,out,False,919196,True,56,0,1513,1513
167626,2019-09-27 00:00:00+03:00,out,False,919166,False,4,94,173,79
167626,2019-09-27 00:00:00+03:00,out,False,919310,True,52,0,1753,1753
167626,2019-09-27 00:00:00+03:00,out,False,919318,True,41,0,799,799
167626,2019-09-27 00:00:00+03:00,in,False,919204,False,136,5320,6079,759
167626,2019-09-27 00:00:00+03:00,out,False,919374,True,53,0,1534,1534
167626,2019-09-27 00:00:00+03:00,out,False,919382,False,30,2408,3068,660
167626,2019-09-27 00:00:00+03:00,out,False,919196,False,104,10852,12808,1956
167626,2019-09-27 00:00:00+03:00,out,False,919318,False,41,2026,2674,648
167626,2019-09-27 00:00:00+03:00,out,False,919910,True,14,0,278,278
167626,2019-09-27 00:00:00+03:00,out,False,919910,False,14,1331,1585,254
167626,2019-09-27 00:00:00+03:00,out,False,919198,False,57,3979,5012,1033
167626,2019-09-27 00:00:00+03:00,out,False,919162,False,107,9704,11785,2081
167626,2019-09-27 00:00:00+03:00,out,False,919370,True,65,0,1722,1722
167626,2019-09-27 00:00:00+03:00,out,False,919364,False,127,4672,6993,2321
167626,2019-09-27 00:00:00+03:00,out,False,919194,False,36,7606,8255,649
167626,2019-09-27 00:00:00+03:00,out,False,919376,True,33,0,939,939
167626,2019-09-27 00:00:00+03:00,out,False,921592,False,104,3919,5794,1875
167626,2019-09-27 00:00:00+03:00,out,False,919382,True,55,0,941,941
167626,2019-09-27 00:00:00+03:00,out,False,919504,True,42,0,1332,1332
167626,2019-09-27 00:00:00+03:00,out,False,920416,False,30,1484,1978,494
167626,2019-09-27 00:00:00+03:00,out,False,919162,True,87,0,2613,2613
167626,2019-09-27 00:00:00+03:00,out,False,919302,False,88,15916,17707,1791
167626,2019-09-27 00:00:00+03:00,out,False,919202,False,68,6597,7774,1177
167626,2019-09-27 00:00:00+03:00,out,False,919504,False,74,5062,6288,1226
167626,2019-09-27 00:00:00+03:00,out,False,919302,True,76,0,2335,2335
167626,2019-09-27 00:00:00+03:00,out,False,919376,False,45,3569,4413,844
167626,2019-09-27 00:00:00+03:00,out,False,921596,True,75,0,1799,1799
167626,2019-09-27 00:00:00+03:00,out,False,921584,False,57,3098,4186,1088
167626,2019-09-27 00:00:00+03:00,out,False,919306,False,45,4032,4785,753
167626,2019-09-27 00:00:00+03:00,out,False,919370,False,78,9350,10677,1327
167626,2019-09-27 00:00:00+03:00,out,False,919378,True,74,0,1823,1823
167626,2019-09-27 00:00:00+03:00,out,False,919310,False,66,3464,4672,1208
167626,2019-09-27 00:00:00+03:00,out,False,919364,True,148,0,3857,3857
167626,2019-09-27 00:00:00+03:00,out,False,920416,True,67,0,896,896
167626,2019-09-27 00:00:00+03:00,out,False,921596,False,78,5730,7217,1487
167626,2019-09-27 00:00:00+03:00,out,False,919378,False,67,5811,7018,1207
167626,2019-09-27 00:00:00+03:00,out,False,921584,True,75,0,1535,1535
167626,2019-09-27 00:00:00+03:00,out,False,919906,True,44,0,1318,1318
167626,2019-09-27 00:00:00+03:00,out,False,919192,False,65,8072,9135,1063
167626,2019-09-27 00:00:00+03:00,out,False,919198,True,55,0,1151,1151
167626,2019-09-27 00:00:00+03:00,out,False,919202,True,65,0,1911,1911
167626,2019-09-27 00:00:00+03:00,out,False,920414,False,83,8961,10461,1500
167626,2019-09-27 00:00:00+03:00,out,False,919306,True,39,0,942,942
167626,2019-09-27 00:00:00+03:00,out,False,921574,False,79,8306,9723,1417
167626,2019-09-27 00:00:00+03:00,out,False,921592,True,55,0,1506,1506
167626,2019-09-27 00:00:00+03:00,out,False,919194,True,30,0,935,935
167626,2019-09-27 00:00:00+03:00,out,False,919310,False,66,3464,4672,1208
167626,2019-09-27 00:00:00+03:00,out,False,919456,True,64,0,1421,1421
167626,2019-09-27 00:00:00+03:00,out,False,919382,False,30,2408,3068,660
167626,2019-09-27 00:00:00+03:00,out,False,919166,True,1,0,3,3
167626,2019-09-27 00:00:00+03:00,out,False,919910,True,14,0,278,278
167626,2019-09-27 00:00:00+03:00,out,False,919374,False,56,3263,4381,1118
167626,2019-09-28 00:00:00+03:00,out,False,-1,True,1,0,2,2
167626,2019-09-28 00:00:00+03:00,out,False,919382,True,160,0,3276,3276
167626,2019-09-28 00:00:00+03:00,out,False,919196,True,56,0,1510,1510
167626,2019-09-28 00:00:00+03:00,out,False,919302,False,36,5006,5885,879
167626,2019-09-28 00:00:00+03:00,out,False,919302,True,55,0,1864,1864
167626,2019-09-28 00:00:00+03:00,out,False,921584,True,102,0,2498,2498
167626,2019-09-28 00:00:00+03:00,out,False,919310,False,124,6860,9389,2529
167626,2019-09-28 00:00:00+03:00,out,False,919364,True,159,0,4840,4840
167626,2019-09-28 00:00:00+03:00,out,False,921594,False,31,2148,2728,580
167626,2019-09-28 00:00:00+03:00,out,False,919370,False,77,8010,9496,1486
167626,2019-09-28 00:00:00+03:00,out,False,919202,False,66,6277,7717,1440
167626,2019-09-28 00:00:00+03:00,out,False,919370,True,87,0,2338,2338
167626,2019-09-28 00:00:00+03:00,out,False,921574,True,83,0,2467,2467
167626,2019-09-28 00:00:00+03:00,out,False,921584,False,100,3160,5082,1922
167626,2019-09-28 00:00:00+03:00,out,False,921592,True,63,0,2101,2101
167626,2019-09-28 00:00:00+03:00,out,False,921596,True,44,0,1199,1199
167626,2019-09-28 00:00:00+03:00,out,False,919906,True,56,0,1571,1571
167626,2019-09-28 00:00:00+03:00,out,False,919374,True,123,0,3612,3612
167626,2019-09-28 00:00:00+03:00,out,False,919200,True,65,0,1853,1853
167626,2019-09-28 00:00:00+03:00,out,False,919374,False,80,3896,5613,1717
167626,2019-09-28 00:00:00+03:00,out,False,921592,False,85,4333,5953,1620
167626,2019-09-28 00:00:00+03:00,out,False,919188,False,102,7821,10057,2236
167626,2019-09-28 00:00:00+03:00,out,False,919364,False,130,5908,8499,2591
167626,2019-09-28 00:00:00+03:00,out,False,921596,False,68,4712,6181,1469
167626,2019-09-28 00:00:00+03:00,out,False,919310,True,82,0,2429,2429
167626,2019-09-28 00:00:00+03:00,out,False,919906,False,59,6275,7803,1528
167626,2019-09-28 00:00:00+03:00,out,False,919910,False,1,361,383,22
167626,2019-09-28 00:00:00+03:00,out,False,919196,False,109,9784,12117,2333
167626,2019-09-28 00:00:00+03:00,out,False,919202,True,54,0,1437,1437
167626,2019-09-28 00:00:00+03:00,out,False,919382,False,50,1264,2276,1012
167626,2019-09-28 00:00:00+03:00,in,False,919204,False,68,6998,7396,398
167626,2019-09-28 00:00:00+03:00,out,False,919306,False,90,11458,13371,1913
167626,2019-09-28 00:00:00+03:00,out,False,919306,True,73,0,1824,1824
167626,2019-09-28 00:00:00+03:00,out,False,920416,True,128,0,1675,1675
167626,2019-09-28 00:00:00+03:00,out,False,919188,True,90,0,2261,2261
167626,2019-09-28 00:00:00+03:00,out,False,919198,False,51,3937,4884,947
167626,2019-09-28 00:00:00+03:00,out,False,919318,True,134,0,3118,3118
167626,2019-09-28 00:00:00+03:00,out,False,920416,False,39,1519,2269,750
167626,2019-09-28 00:00:00+03:00,out,False,919318,False,71,1906,3478,1572
167626,2019-09-28 00:00:00+03:00,out,False,919200,False,72,7632,9117,1485
167626,2019-09-28 00:00:00+03:00,out,False,919198,True,46,0,928,928
167626,2019-09-28 00:00:00+03:00,in,False,919166,False,71,3232,3695,463
167626,2019-09-28 00:00:00+03:00,out,False,921574,False,74,8888,10228,1340
167626,2019-09-28 00:00:00+03:00,out,False,921594,True,38,0,919,919
167626,2019-09-28 00:00:00+03:00,out,False,919910,True,3,0,139,139
167626,2019-09-28 00:00:00+03:00,in,False,-1,True,275,0,600,600
167626,2019-09-28 00:00:00+03:00,out,False,921596,False,68,4712,6181,1469
167626,2019-09-28 00:00:00+03:00,out,False,919202,False,66,6277,7717,1440
167626,2019-09-28 00:00:00+03:00,out,False,921592,False,85,4333,5953,1620
167626,2019-09-28 00:00:00+03:00,out,False,920416,False,39,1519,2269,750
167626,2019-09-28 00:00:00+03:00,in,False,-1,True,275,0,600,600
167626,2019-09-29 00:00:00+03:00,in,False,-1,True,254,0,322,322
167626,2019-09-29 00:00:00+03:00,in,False,919206,False,64,1838,2268,430
167626,2019-09-29 00:00:00+03:00,out,False,919464,False,67,7930,9253,1323
167626,2019-09-29 00:00:00+03:00,out,False,919482,False,82,9260,10693,1433
167626,2019-09-29 00:00:00+03:00,out,False,919504,False,127,7941,10395,2454
167626,2019-09-29 00:00:00+03:00,out,False,921592,False,39,1739,2527,788
167626,2019-09-29 00:00:00+03:00,out,False,919362,True,80,0,2560,2560
167626,2019-09-29 00:00:00+03:00,out,False,922710,False,76,8042,9458,1416
167626,2019-09-29 00:00:00+03:00,out,False,919372,True,74,0,2422,2422
167626,2019-09-29 00:00:00+03:00,out,False,919200,False,95,11931,13741,1810
167626,2019-09-29 00:00:00+03:00,out,False,921592,True,38,0,1335,1335
167626,2019-09-29 00:00:00+03:00,out,False,919310,True,32,0,877,877
167626,2019-09-29 00:00:00+03:00,out,False,919376,False,80,6809,8310,1501
167626,2019-09-29 00:00:00+03:00,out,False,919202,True,48,0,1340,1340
167626,2019-09-29 00:00:00+03:00,out,False,919318,True,40,0,992,992
167626,2019-09-29 00:00:00+03:00,out,False,919200,True,74,0,1863,1863
167626,2019-09-29 00:00:00+03:00,out,False,919310,False,58,2912,3964,1052
167626,2019-09-29 00:00:00+03:00,out,False,919202,False,35,4153,4746,593
167626,2019-09-29 00:00:00+03:00,out,False,919314,False,121,9158,11493,2335
167626,2019-09-29 00:00:00+03:00,out,False,919464,True,86,0,1978,1978
167626,2019-09-29 00:00:00+03:00,out,False,919504,True,85,0,2734,2734
167626,2019-09-29 00:00:00+03:00,out,False,919318,False,44,2840,3517,677
167626,2019-09-29 00:00:00+03:00,in,False,919164,False,61,2870,3211,341
167626,2019-09-29 00:00:00+03:00,out,True,919200,True,3,0,0,0
167626,2019-09-29 00:00:00+03:00,in,False,919206,True,1,0,10,10
167626,2019-09-29 00:00:00+03:00,out,False,919490,True,101,0,2379,2379
167626,2019-09-29 00:00:00+03:00,out,False,919482,True,67,0,2096,2096
167626,2019-09-29 00:00:00+03:00,out,False,919372,False,89,3851,5523,1672
167626,2019-09-29 00:00:00+03:00,out,False,919374,True,76,0,2665,2665
167626,2019-09-29 00:00:00+03:00,out,False,919376,True,57,0,1411,1411
167626,2019-09-29 00:00:00+03:00,out,False,919364,True,150,0,4442,4442
167626,2019-09-29 00:00:00+03:00,out,False,919364,False,110,5751,7774,2023
167626,2019-09-29 00:00:00+03:00,out,False,919490,False,92,7344,8882,1538
167626,2019-09-29 00:00:00+03:00,out,False,919476,True,89,0,2134,2134
167626,2019-09-29 00:00:00+03:00,out,False,919314,True,83,0,2668,2668
167626,2019-09-29 00:00:00+03:00,out,False,919362,False,98,9713,11499,1786
167626,2019-09-29 00:00:00+03:00,out,False,919476,False,100,5824,7596,1772
167626,2019-09-29 00:00:00+03:00,out,False,922710,True,66,0,1339,1339
167626,2019-09-29 00:00:00+03:00,out,False,919374,False,89,5273,6947,1674
167626,2019-09-29 00:00:00+03:00,out,False,919476,False,100,5824,7596,1772
167626,2019-09-29 00:00:00+03:00,out,False,919476,True,89,0,2134,2134
167626,2019-09-29 00:00:00+03:00,out,False,919314,True,83,0,2668,2668
167626,2019-09-29 00:00:00+03:00,out,False,919364,True,150,0,4442,4442
167626,2019-09-30 00:00:00+03:00,out,False,919302,False,71,12350,13785,1435
167626,2019-09-30 00:00:00+03:00,out,False,919490,True,31,0,753,753
167626,2019-09-30 00:00:00+03:00,out,False,922710,False,66,2732,3705,973
167626,2019-09-30 00:00:00+03:00,in,False,919206,False,84,3261,3813,552
167626,2019-09-30 00:00:00+03:00,out,False,919302,True,48,0,1562,1562
167626,2019-09-30 00:00:00+03:00,in,False,919164,False,78,4184,4627,443
167626,2019-09-30 00:00:00+03:00,out,False,919910,True,11,0,378,378
167626,2019-09-30 00:00:00+03:00,out,False,919490,False,33,3440,3904,464
167626,2019-09-30 00:00:00+03:00,out,False,919194,False,9,700,866,166
167626,2019-09-30 00:00:00+03:00,out,False,919476,False,51,2735,3625,890
167626,2019-09-30 00:00:00+03:00,out,False,919364,True,148,0,3869,3869
167626,2019-09-30 00:00:00+03:00,out,False,919196,False,132,10229,12836,2607
167626,2019-09-30 00:00:00+03:00,out,False,922710,True,62,0,1261,1261
167626,2019-09-30 00:00:00+03:00,out,False,919390,False,51,2198,2908,710
167626,2019-09-30 00:00:00+03:00,out,False,919362,True,79,0,2584,2584
167626,2019-09-30 00:00:00+03:00,out,False,919162,True,111,0,2802,2802
167626,2019-09-30 00:00:00+03:00,out,False,919378,False,78,7833,9255,1422
167626,2019-09-30 00:00:00+03:00,out,False,919362,False,97,11565,13504,1939
167626,2019-09-30 00:00:00+03:00,out,False,919192,True,80,0,1726,1726
167626,2019-09-30 00:00:00+03:00,out,False,919456,True,17,0,552,552
167626,2019-09-30 00:00:00+03:00,out,False,919310,False,11,715,963,248
167626,2019-09-30 00:00:00+03:00,out,False,919482,False,41,4887,5570,683
167626,2019-09-30 00:00:00+03:00,out,False,919192,False,84,9951,11348,1397
167626,2019-09-30 00:00:00+03:00,out,False,919162,False,136,12028,14218,2190
167626,2019-09-30 00:00:00+03:00,out,False,919310,True,8,0,186,186
167626,2019-09-30 00:00:00+03:00,in,False,-1,True,387,0,577,577
167626,2019-09-30 00:00:00+03:00,out,False,923666,False,25,4148,4715,567
167626,2019-09-30 00:00:00+03:00,out,False,919378,True,111,0,2693,2693
167626,2019-09-30 00:00:00+03:00,out,False,919504,True,28,0,885,885
167626,2019-09-30 00:00:00+03:00,out,False,919464,False,30,2748,3253,505
167626,2019-09-30 00:00:00+03:00,out,False,923666,True,10,0,282,282
167626,2019-09-30 00:00:00+03:00,out,False,919476,True,45,0,1200,1200
167626,2019-09-30 00:00:00+03:00,out,False,919906,True,61,0,1394,1394
167626,2019-09-30 00:00:00+03:00,out,False,919196,True,91,0,2350,2350
167626,2019-09-30 00:00:00+03:00,out,False,919314,True,92,0,2589,2589
167626,2019-09-30 00:00:00+03:00,out,False,919202,True,76,0,1762,1762
167626,2019-09-30 00:00:00+03:00,out,False,920414,False,34,4061,4621,560
167626,2019-09-30 00:00:00+03:00,out,False,919390,True,38,0,766,766
167626,2019-09-30 00:00:00+03:00,out,False,919482,True,26,0,724,724
167626,2019-09-30 00:00:00+03:00,out,False,919372,True,54,0,1620,1620
167626,2019-09-30 00:00:00+03:00,out,False,919364,False,116,5845,7858,2013
167626,2019-09-30 00:00:00+03:00,in,False,919164,True,1,0,7,7
167626,2019-09-30 00:00:00+03:00,out,False,919318,True,2,0,16,16
167626,2019-09-30 00:00:00+03:00,out,False,919504,False,61,3888,4897,1009
167626,2019-09-30 00:00:00+03:00,out,False,919464,True,28,0,654,654
167626,2019-09-30 00:00:00+03:00,out,False,919194,True,11,0,418,418
167626,2019-09-30 00:00:00+03:00,out,False,919314,False,116,4902,6880,1978
167626,2019-09-30 00:00:00+03:00,out,False,919910,False,29,1943,2463,520
167626,2019-09-30 00:00:00+03:00,out,False,919372,False,64,2931,4149,1218
167626,2019-09-30 00:00:00+03:00,out,False,919906,False,54,4744,5908,1164
167626,2019-09-30 00:00:00+03:00,out,False,919456,False,16,775,1020,245
167626,2019-09-30 00:00:00+03:00,out,False,920414,True,25,0,572,572
167626,2019-09-30 00:00:00+03:00,out,False,919318,False,7,494,598,104
167626,2019-09-30 00:00:00+03:00,out,False,919202,False,83,10251,11673,1422
167626,2019-09-30 00:00:00+03:00,in,False,-1,True,1,0,31,31
167626,2019-09-30 00:00:00+03:00,out,False,919362,True,79,0,2584,2584
167626,2019-09-30 00:00:00+03:00,out,False,919372,False,64,2931,4149,1218
167626,2019-09-30 00:00:00+03:00,out,False,923666,False,25,4148,4715,567
167626,2019-09-30 00:00:00+03:00,out,False,919456,False,16,775,1020,245
167626,2019-09-30 00:00:00+03:00,out,False,919302,False,71,12350,13785,1435
167626,2019-09-30 00:00:00+03:00,out,False,919390,True,38,0,766,766
167626,2019-09-30 00:00:00+03:00,out,False,919476,True,45,0,1200,1200
167626,2019-09-30 00:00:00+03:00,out,False,919196,False,132,10229,12836,2607
167626,2019-09-30 00:00:00+03:00,out,False,919906,True,61,0,1394,1394
167626,2019-09-30 00:00:00+03:00,out,False,919490,False,33,3440,3904,464
167626,2019-10-01 00:00:00+03:00,out,False,919198,True,56,0,1176,1176
167626,2019-10-01 00:00:00+03:00,out,False,921574,False,86,8414,9997,1583
167626,2019-10-01 00:00:00+03:00,out,False,919370,True,36,0,805,805
167626,2019-10-01 00:00:00+03:00,in,False,919204,True,3,0,16,16
167626,2019-10-01 00:00:00+03:00,out,False,923666,True,46,0,1042,1042
167626,2019-10-01 00:00:00+03:00,out,False,919196,False,110,10522,12459,1937
167626,2019-10-01 00:00:00+03:00,out,False,919194,False,71,9028,10351,1323
167626,2019-10-01 00:00:00+03:00,out,False,919906,False,62,7448,8694,1246
167626,2019-10-01 00:00:00+03:00,out,False,920414,False,80,9136,10487,1351
167626,2019-10-01 00:00:00+03:00,in,False,919204,False,142,11841,12902,1061
167626,2019-10-01 00:00:00+03:00,out,False,921596,False,95,8345,9928,1583
167626,2019-10-01 00:00:00+03:00,in,False,919166,False,162,9317,10112,795
167626,2019-10-01 00:00:00+03:00,out,False,919370,False,38,4376,4987,611
167626,2019-10-01 00:00:00+03:00,out,False,919306,False,14,1648,1907,259
167626,2019-10-01 00:00:00+03:00,out,False,919364,False,127,6409,8713,2304
167626,2019-10-01 00:00:00+03:00,out,False,919382,False,75,3389,4703,1314
167626,2019-10-01 00:00:00+03:00,out,False,919906,True,63,0,1299,1299
167626,2019-10-01 00:00:00+03:00,in,False,-1,True,367,0,597,597
167626,2019-10-01 00:00:00+03:00,out,False,919390,False,53,2307,3300,993
167626,2019-10-01 00:00:00+03:00,out,False,919378,False,53,2533,3303,770
167626,2019-10-01 00:00:00+03:00,out,False,920416,True,116,0,1682,1682
167626,2019-10-01 00:00:00+03:00,out,False,919162,True,80,0,2022,2022
167626,2019-10-01 00:00:00+03:00,out,False,919310,True,64,0,1663,1663
167626,2019-10-01 00:00:00+03:00,out,False,919374,False,76,5116,6647,1531
167626,2019-10-01 00:00:00+03:00,out,False,-1,True,1,0,0,0
167626,2019-10-01 00:00:00+03:00,out,False,919476,False,91,4110,5901,1791
167626,2019-10-01 00:00:00+03:00,out,False,919200,False,74,10232,11802,1570
167626,2019-10-01 00:00:00+03:00,out,False,919302,False,84,15003,16590,1587
167626,2019-10-01 00:00:00+03:00,out,False,919910,True,10,0,282,282
167626,2019-10-01 00:00:00+03:00,out,False,919382,True,135,0,2273,2273
167626,2019-10-01 00:00:00+03:00,out,False,919166,False,3,245,301,56
167626,2019-10-01 00:00:00+03:00,out,False,919302,True,75,0,2209,2209
167626,2019-10-01 00:00:00+03:00,out,False,919310,False,107,6046,8149,2103
167626,2019-10-01 00:00:00+03:00,out,False,921574,True,64,0,1996,1996
167626,2019-10-01 00:00:00+03:00,out,False,919378,True,82,0,1958,1958
167626,2019-10-01 00:00:00+03:00,out,False,921592,True,42,0,1379,1379
167626,2019-10-01 00:00:00+03:00,out,False,919476,True,66,0,1905,1905
167626,2019-10-01 00:00:00+03:00,out,False,921592,False,70,3747,5076,1329
167626,2019-10-01 00:00:00+03:00,out,False,919910,False,23,2806,3135,329
167626,2019-10-01 00:00:00+03:00,out,False,923666,False,72,14021,15391,1370
167626,2019-10-01 00:00:00+03:00,out,False,919372,False,75,2297,3988,1691
167626,2019-10-01 00:00:00+03:00,out,False,919202,True,89,0,2433,2433
167626,2019-10-01 00:00:00+03:00,out,False,919364,True,126,0,3333,3333
167626,2019-10-01 00:00:00+03:00,out,False,919372,True,130,0,4257,4257
167626,2019-10-01 00:00:00+03:00,out,False,919374,True,132,0,3595,3595
167626,2019-10-01 00:00:00+03:00,out,False,921594,True,60,0,1529,1529
167626,2019-10-01 00:00:00+03:00,out,False,919192,True,72,0,1774,1774
167626,2019-10-01 00:00:00+03:00,out,False,921596,True,49,0,1470,1470
167626,2019-10-01 00:00:00+03:00,out,False,919200,True,48,0,1336,1336
167626,2019-10-01 00:00:00+03:00,out,False,919202,False,93,12275,13910,1635
167626,2019-10-01 00:00:00+03:00,out,False,921594,False,81,7299,8675,1376
167626,2019-10-01 00:00:00+03:00,out,False,919198,False,89,5310,6955,1645
167626,2019-10-01 00:00:00+03:00,out,False,919162,False,121,8643,10960,2317
167626,2019-10-01 00:00:00+03:00,out,False,920414,True,78,0,1841,1841
167626,2019-10-01 00:00:00+03:00,out,False,920416,False,43,3312,4118,806
167626,2019-10-01 00:00:00+03:00,out,False,919306,True,16,0,413,413
167626,2019-10-01 00:00:00+03:00,out,False,919194,True,55,0,1626,1626
167626,2019-10-01 00:00:00+03:00,out,False,919390,True,149,0,2796,2796
167626,2019-10-01 00:00:00+03:00,out,False,919196,True,80,0,2280,2280
167626,2019-10-01 00:00:00+03:00,in,False,919166,True,1,0,4,4
167626,2019-10-01 00:00:00+03:00,out,False,919192,False,78,6006,7380,1374
167626,2019-10-01 00:00:00+03:00,out,False,923666,False,72,14021,15391,1370
167626,2019-10-01 00:00:00+03:00,in,False,919204,False,142,11841,12902,1061
167626,2019-10-01 00:00:00+03:00,in,False,919166,False,162,9317,10112,795
167626,2019-10-01 00:00:00+03:00,out,False,919162,True,80,0,2022,2022
167626,2019-10-01 00:00:00+03:00,out,False,923666,True,46,0,1042,1042
167626,2019-10-01 00:00:00+03:00,out,False,919906,True,63,0,1299,1299
167626,2019-10-01 00:00:00+03:00,out,False,921574,True,64,0,1996,1996
167626,2019-10-01 00:00:00+03:00,out,False,921596,False,95,8345,9928,1583
167626,2019-10-01 00:00:00+03:00,out,False,919310,True,64,0,1663,1663
167626,2019-10-01 00:00:00+03:00,out,False,919310,False,107,6046,8149,2103
167626,2019-10-01 00:00:00+03:00,out,False,919378,False,53,2533,3303,770
167626,2019-10-02 00:00:00+03:00,out,False,923666,False,98,12396,14021,1625
167626,2019-10-02 00:00:00+03:00,out,False,919390,False,38,1769,2357,588
167626,2019-10-02 00:00:00+03:00,out,False,919194,False,2,553,619,66
167626,2019-10-02 00:00:00+03:00,out,False,920416,True,108,0,1381,1381
167626,2019-10-02 00:00:00+03:00,out,False,919382,False,68,4507,5601,1094
167626,2019-10-02 00:00:00+03:00,out,False,919196,True,102,0,2259,2259
167626,2019-10-02 00:00:00+03:00,out,False,921594,True,56,0,1434,1434
167626,2019-10-02 00:00:00+03:00,out,False,919202,True,95,0,2401,2401
167626,2019-10-02 00:00:00+03:00,out,False,919390,True,37,0,783,783
167626,2019-10-02 00:00:00+03:00,out,False,919362,True,60,0,1655,1655
167626,2019-10-02 00:00:00+03:00,out,False,925134,True,10,0,320,320
167626,2019-10-02 00:00:00+03:00,out,False,921596,True,59,0,1359,1359
167626,2019-10-02 00:00:00+03:00,out,False,921574,False,88,8458,9829,1371
167626,2019-10-02 00:00:00+03:00,out,False,921596,False,81,8178,9576,1398
167626,2019-10-02 00:00:00+03:00,out,False,919162,False,124,9506,11650,2144
167626,2019-10-02 00:00:00+03:00,out,False,921574,True,85,0,2054,2054
167626,2019-10-02 00:00:00+03:00,out,False,919370,True,28,0,631,631
167626,2019-10-02 00:00:00+03:00,out,False,921592,True,67,0,1913,1913
167626,2019-10-02 00:00:00+03:00,out,False,919906,False,42,3927,4701,774
167626,2019-10-02 00:00:00+03:00,out,False,925134,False,34,3695,4245,550
167626,2019-10-02 00:00:00+03:00,out,False,919372,True,72,0,2383,2383
167626,2019-10-02 00:00:00+03:00,in,False,919204,False,134,12340,13297,957
167626,2019-10-02 00:00:00+03:00,out,False,919194,True,3,0,95,95
167626,2019-10-02 00:00:00+03:00,out,False,922710,True,32,0,1070,1070
167626,2019-10-02 00:00:00+03:00,out,False,919310,True,56,0,1325,1325
167626,2019-10-02 00:00:00+03:00,out,False,919910,True,3,0,36,36
167626,2019-10-02 00:00:00+03:00,out,False,919364,False,133,5221,8005,2784
167626,2019-10-02 00:00:00+03:00,out,False,919382,True,93,0,1807,1807
167626,2019-10-02 00:00:00+03:00,out,False,923666,True,74,0,1999,1999
167626,2019-10-02 00:00:00+03:00,out,False,919196,False,138,12160,14632,2472
167626,2019-10-02 00:00:00+03:00,out,False,921584,True,60,0,1526,1526
167626,2019-10-02 00:00:00+03:00,out,False,919370,False,41,5239,6012,773
167626,2019-10-02 00:00:00+03:00,in,False,919204,True,3,0,27,27
167626,2019-10-02 00:00:00+03:00,out,False,919202,False,102,12001,13889,1888
167626,2019-10-02 00:00:00+03:00,out,False,919302,True,49,0,1422,1422
167626,2019-10-02 00:00:00+03:00,in,False,-1,True,551,0,1072,1072
167626,2019-10-02 00:00:00+03:00,out,False,922710,False,59,4171,5027,856
167626,2019-10-02 00:00:00+03:00,out,False,921584,False,68,2142,3298,1156
167626,2019-10-02 00:00:00+03:00,out,False,919364,True,145,0,4404,4404
167626,2019-10-02 00:00:00+03:00,out,False,920416,False,43,2553,3211,658
167626,2019-10-02 00:00:00+03:00,out,False,919162,True,83,0,2389,2389
167626,2019-10-02 00:00:00+03:00,out,False,919166,True,1,0,19,19
167626,2019-10-02 00:00:00+03:00,out,False,919306,False,34,3406,4037,631
167626,2019-10-02 00:00:00+03:00,out,False,919910,False,9,1273,1435,162
167626,2019-10-02 00:00:00+03:00,out,False,919374,False,92,6772,8437,1665
167626,2019-10-02 00:00:00+03:00,out,False,919192,False,85,9860,11332,1472
167626,2019-10-02 00:00:00+03:00,out,True,923666,True,2,0,0,0
167626,2019-10-02 00:00:00+03:00,out,False,919362,False,77,7882,9168,1286
167626,2019-10-02 00:00:00+03:00,out,False,919310,False,75,4077,5244,1167
167626,2019-10-02 00:00:00+03:00,out,False,919374,True,67,0,2135,2135
167626,2019-10-02 00:00:00+03:00,out,False,921594,False,73,7030,8283,1253
167626,2019-10-02 00:00:00+03:00,in,False,919166,False,143,9483,10178,695
167626,2019-10-02 00:00:00+03:00,out,False,919906,True,43,0,1087,1087
167626,2019-10-02 00:00:00+03:00,out,False,919372,False,91,4531,6281,1750
167626,2019-10-02 00:00:00+03:00,out,False,921592,False,94,5349,6928,1579
167626,2019-10-02 00:00:00+03:00,out,False,919166,False,1,25,38,13
167626,2019-10-02 00:00:00+03:00,out,False,919302,False,94,16071,18072,2001
167626,2019-10-02 00:00:00+03:00,out,False,919306,True,19,0,655,655
167626,2019-10-02 00:00:00+03:00,out,False,919192,True,55,0,1344,1344
167626,2019-10-02 00:00:00+03:00,out,False,919910,False,9,1273,1435,162
167626,2019-10-02 00:00:00+03:00,out,False,921574,False,88,8458,9829,1371
167626,2019-10-02 00:00:00+03:00,out,False,919310,False,75,4077,5244,1167
167626,2019-10-02 00:00:00+03:00,out,False,919202,True,95,0,2401,2401
167626,2019-10-02 00:00:00+03:00,out,False,919390,False,38,1769,2357,588
167626,2019-10-02 00:00:00+03:00,in,False,-1,True,551,0,1072,1072
167626,2019-10-02 00:00:00+03:00,out,False,921592,True,67,0,1913,1913
167626,2019-10-02 00:00:00+03:00,out,False,919906,True,43,0,1087,1087
167626,2019-10-03 00:00:00+03:00,out,False,919192,True,73,0,1985,1985
167626,2019-10-03 00:00:00+03:00,out,False,919370,True,47,0,1627,1627
167626,2019-10-03 00:00:00+03:00,out,False,919910,True,16,0,114,114
167626,2019-10-03 00:00:00+03:00,out,False,919482,False,86,9817,11303,1486
167626,2019-10-03 00:00:00+03:00,out,False,923666,True,31,0,914,914
167626,2019-10-03 00:00:00+03:00,out,False,919376,True,79,0,1955,1955
167626,2019-10-03 00:00:00+03:00,out,False,923666,False,46,5100,5938,838
167626,2019-10-03 00:00:00+03:00,out,False,919162,False,106,8729,10456,1727
167626,2019-10-03 00:00:00+03:00,out,False,919464,False,84,8568,9889,1321
167626,2019-10-03 00:00:00+03:00,out,False,919372,False,75,1737,3289,1552
167626,2019-10-03 00:00:00+03:00,out,False,919202,True,81,0,1972,1972
167626,2019-10-03 00:00:00+03:00,out,False,922710,False,90,3873,5356,1483
167626,2019-10-03 00:00:00+03:00,out,False,919476,True,105,0,3174,3174
167626,2019-10-03 00:00:00+03:00,out,False,919456,False,41,4317,5114,797
167626,2019-10-03 00:00:00+03:00,out,False,922710,True,142,0,3632,3632
167626,2019-10-03 00:00:00+03:00,in,False,-1,True,1,0,1,1
167626,2019-10-03 00:00:00+03:00,out,False,920416,True,87,0,1191,1191
167626,2019-10-03 00:00:00+03:00,out,False,919202,False,88,8977,10639,1662
167626,2019-10-03 00:00:00+03:00,out,False,919200,False,46,4916,5785,869
167626,2019-10-03 00:00:00+03:00,out,False,919490,False,97,7213,8857,1644
167626,2019-10-03 00:00:00+03:00,out,False,919306,False,100,12059,13820,1761
167626,2019-10-03 00:00:00+03:00,out,False,919196,True,100,0,2144,2144
167626,2019-10-03 00:00:00+03:00,out,False,919906,True,40,0,1049,1049
167626,2019-10-03 00:00:00+03:00,out,False,919390,True,4,0,98,98
167626,2019-10-03 00:00:00+03:00,out,False,919476,False,125,7655,9895,2240
167626,2019-10-03 00:00:00+03:00,in,False,919206,False,109,3703,4459,756
167626,2019-10-03 00:00:00+03:00,out,False,919200,True,53,0,1230,1230
167626,2019-10-03 00:00:00+03:00,out,False,919376,False,90,7900,9496,1596
167626,2019-10-03 00:00:00+03:00,out,False,919164,True,1,0,13,13
167626,2019-10-03 00:00:00+03:00,in,False,919164,False,104,5564,6084,520
167626,2019-10-03 00:00:00+03:00,out,False,919302,False,79,14848,16341,1493
167626,2019-10-03 00:00:00+03:00,out,False,919318,True,139,0,3028,3028
167626,2019-10-03 00:00:00+03:00,out,False,919362,True,113,0,3129,3129
167626,2019-10-03 00:00:00+03:00,in,False,-1,True,1311,0,1136,1136
167626,2019-10-03 00:00:00+03:00,out,False,919504,True,65,0,2117,2117
167626,2019-10-03 00:00:00+03:00,out,False,919192,False,83,7796,9244,1448
167626,2019-10-03 00:00:00+03:00,out,False,919310,True,9,0,290,290
167626,2019-10-03 00:00:00+03:00,out,False,919490,True,99,0,2105,2105
167626,2019-10-03 00:00:00+03:00,out,False,919364,True,143,0,4421,4421
167626,2019-10-03 00:00:00+03:00,out,False,919456,True,53,0,1123,1123
167626,2019-10-03 00:00:00+03:00,out,False,920416,False,36,1753,2311,558
167626,2019-10-03 00:00:00+03:00,out,False,919504,False,105,6672,8448,1776
167626,2019-10-03 00:00:00+03:00,out,False,919306,True,64,0,1931,1931
167626,2019-10-03 00:00:00+03:00,out,False,919162,True,69,0,1911,1911
167626,2019-10-03 00:00:00+03:00,out,False,921584,False,47,1483,2137,654
167626,2019-10-03 00:00:00+03:00,out,False,919314,True,131,0,3679,3679
167626,2019-10-03 00:00:00+03:00,out,False,919364,False,115,4350,6836,2486
167626,2019-10-03 00:00:00+03:00,out,False,919372,True,138,0,3426,3426
167626,2019-10-03 00:00:00+03:00,out,False,921584,True,80,0,1500,1500
167626,2019-10-03 00:00:00+03:00,out,False,921592,False,130,6003,8236,2233
167626,2019-10-03 00:00:00+03:00,out,False,919464,True,67,0,1698,1698
167626,2019-10-03 00:00:00+03:00,out,False,921592,True,72,0,1582,1582
167626,2019-10-03 00:00:00+03:00,out,True,919906,True,1,0,0,0
167626,2019-10-03 00:00:00+03:00,out,False,919194,True,1,0,38,38
167626,2019-10-03 00:00:00+03:00,out,False,919362,False,109,8434,10473,2039
167626,2019-10-03 00:00:00+03:00,out,False,919318,False,72,1562,2555,993
167626,2019-10-03 00:00:00+03:00,out,False,919910,False,13,3270,3490,220
167626,2019-10-03 00:00:00+03:00,out,False,919310,False,20,1034,1387,353
167626,2019-10-03 00:00:00+03:00,out,False,919906,False,40,4619,5584,965
167626,2019-10-03 00:00:00+03:00,out,False,919390,False,11,358,540,182
167626,2019-10-03 00:00:00+03:00,out,False,919302,True,72,0,2392,2392
167626,2019-10-03 00:00:00+03:00,in,False,919206,True,1,0,7,7
167626,2019-10-03 00:00:00+03:00,out,False,919196,False,134,10700,13229,2529
167626,2019-10-03 00:00:00+03:00,out,False,919482,True,74,0,1919,1919
167626,2019-10-03 00:00:00+03:00,out,False,919314,False,119,6319,8283,1964
167626,2019-10-03 00:00:00+03:00,out,False,919370,False,88,9139,10691,1552
167626,2019-10-03 00:00:00+03:00,out,False,919482,False,86,9817,11303,1486
167626,2019-10-03 00:00:00+03:00,out,False,922710,True,142,0,3632,3632
167626,2019-10-03 00:00:00+03:00,out,False,919504,False,105,6672,8448,1776
167626,2019-10-03 00:00:00+03:00,out,False,920416,False,36,1753,2311,558
167626,2019-10-03 00:00:00+03:00,out,False,919314,False,119,6319,8283,1964
167626,2019-10-03 00:00:00+03:00,in,False,919206,True,1,0,7,7
167626,2019-10-04 00:00:00+03:00,out,False,920414,False,69,7291,8411,1120
167626,2019-10-04 00:00:00+03:00,out,False,919202,False,110,11762,13847,2085
167626,2019-10-04 00:00:00+03:00,out,False,919362,True,85,0,2340,2340
167626,2019-10-04 00:00:00+03:00,out,False,919314,False,104,5019,7111,2092
167626,2019-10-04 00:00:00+03:00,out,False,919318,True,121,0,3069,3069
167626,2019-10-04 00:00:00+03:00,out,False,919164,False,2,43,77,34
167626,2019-10-04 00:00:00+03:00,out,False,919364,False,101,4473,6743,2270
167626,2019-10-04 00:00:00+03:00,out,False,919198,False,72,4484,5789,1305
167626,2019-10-04 00:00:00+03:00,out,False,919310,False,69,3982,5144,1162
167626,2019-10-04 00:00:00+03:00,out,False,919196,False,103,10315,12163,1848
167626,2019-10-04 00:00:00+03:00,out,False,919504,False,135,9591,11869,2278
167626,2019-10-04 00:00:00+03:00,out,False,919198,True,39,0,850,850
167626,2019-10-04 00:00:00+03:00,out,False,919910,False,15,2190,2401,211
167626,2019-10-04 00:00:00+03:00,out,False,919310,True,42,0,1048,1048
167626,2019-10-04 00:00:00+03:00,out,False,919482,False,80,9201,10673,1472
167626,2019-10-04 00:00:00+03:00,out,False,919162,True,61,0,1840,1840
167626,2019-10-04 00:00:00+03:00,out,False,919196,True,75,0,1629,1629
167626,2019-10-04 00:00:00+03:00,out,False,919482,True,95,0,2228,2228
167626,2019-10-04 00:00:00+03:00,out,False,919318,False,79,3443,4440,997
167626,2019-10-04 00:00:00+03:00,out,False,919910,True,15,0,375,375
167626,2019-10-04 00:00:00+03:00,out,False,919490,True,83,0,1890,1890
167626,2019-10-04 00:00:00+03:00,out,False,921592,True,30,0,1114,1114
167626,2019-10-04 00:00:00+03:00,out,False,920414,True,89,0,1790,1790
167626,2019-10-04 00:00:00+03:00,out,False,919194,False,50,6026,6996,970
167626,2019-10-04 00:00:00+03:00,out,False,919194,True,41,0,910,910
167626,2019-10-04 00:00:00+03:00,out,False,923666,False,58,9209,10332,1123
167626,2019-10-04 00:00:00+03:00,out,False,919476,False,115,8496,10631,2135
167626,2019-10-04 00:00:00+03:00,out,False,919362,False,86,8296,9896,1600
167626,2019-10-04 00:00:00+03:00,out,False,921592,False,58,2827,3862,1035
167626,2019-10-04 00:00:00+03:00,out,False,919162,False,97,8505,10299,1794
167626,2019-10-04 00:00:00+03:00,out,False,919370,True,76,0,1844,1844
167626,2019-10-04 00:00:00+03:00,out,False,919456,False,72,5551,6790,1239
167626,2019-10-04 00:00:00+03:00,out,False,919364,True,131,0,3369,3369
167626,2019-10-04 00:00:00+03:00,out,False,919306,True,66,0,1961,1961
167626,2019-10-04 00:00:00+03:00,out,True,919314,True,1,0,0,0
167626,2019-10-04 00:00:00+03:00,out,False,919306,False,98,9763,11397,1634
167626,2019-10-04 00:00:00+03:00,out,False,921584,False,59,1408,2356,948
167626,2019-10-04 00:00:00+03:00,in,False,919206,False,97,3610,4362,752
167626,2019-10-04 00:00:00+03:00,out,False,919504,True,77,0,2347,2347
167626,2019-10-04 00:00:00+03:00,out,False,923666,True,61,0,1544,1544
167626,2019-10-04 00:00:00+03:00,out,False,928228,True,1,0,6,6
167626,2019-10-04 00:00:00+03:00,out,False,919314,True,141,0,3568,3568
167626,2019-10-04 00:00:00+03:00,out,False,919192,False,71,7470,8695,1225
167626,2019-10-04 00:00:00+03:00,out,False,921584,True,101,0,1955,1955
167626,2019-10-04 00:00:00+03:00,out,False,919456,True,156,0,3127,3127
167626,2019-10-04 00:00:00+03:00,out,False,919302,False,91,17041,18730,1689
167626,2019-10-04 00:00:00+03:00,out,False,919202,True,80,0,2225,2225
167626,2019-10-04 00:00:00+03:00,out,False,919464,True,96,0,2231,2231
167626,2019-10-04 00:00:00+03:00,out,False,919192,True,77,0,1881,1881
167626,2019-10-04 00:00:00+03:00,in,False,-1,True,1641,0,1210,1210
167626,2019-10-04 00:00:00+03:00,out,False,919464,False,78,6670,7709,1039
167626,2019-10-04 00:00:00+03:00,in,False,-1,True,6,0,5,5
167626,2019-10-04 00:00:00+03:00,out,False,919490,False,89,8191,9628,1437
167626,2019-10-04 00:00:00+03:00,out,False,928228,False,8,935,1083,148
167626,2019-10-04 00:00:00+03:00,out,False,919476,True,108,0,2922,2922
167626,2019-10-04 00:00:00+03:00,out,False,919302,True,61,0,2186,2186
167626,2019-10-04 00:00:00+03:00,in,False,919164,False,95,5166,5686,520
167626,2019-10-04 00:00:00+03:00,out,False,919370,False,76,8012,9222,1210
167626,2019-10-04 00:00:00+03:00,out,False,923666,False,58,9209,10332,1123
167626,2019-10-04 00:00:00+03:00,out,True,919314,True,1,0,0,0
167626,2019-10-04 00:00:00+03:00,out,False,919310,False,69,3982,5144,1162
167626,2019-10-04 00:00:00+03:00,out,False,919362,True,85,0,2340,2340
167626,2019-10-04 00:00:00+03:00,out,False,919456,True,156,0,3127,3127
167626,2019-10-04 00:00:00+03:00,out,False,919910,False,15,2190,2401,211
167626,2019-10-04 00:00:00+03:00,out,False,919456,False,72,5551,6790,1239
167626,2019-10-04 00:00:00+03:00,out,False,928228,True,1,0,6,6
167626,2019-10-04 00:00:00+03:00,out,False,919504,True,77,0,2347,2347
167626,2019-10-05 00:00:00+03:00,out,False,921594,False,77,6608,7844,1236
167626,2019-10-05 00:00:00+03:00,out,False,919196,False,11,435,655,220
167626,2019-10-05 00:00:00+03:00,out,False,921594,True,67,0,1627,1627
167626,2019-10-05 00:00:00+03:00,out,False,928228,True,21,0,252,252
167626,2019-10-05 00:00:00+03:00,out,False,919362,True,102,0,3262,3262
167626,2019-10-05 00:00:00+03:00,out,False,921574,False,86,8252,9859,1607
167626,2019-10-05 00:00:00+03:00,out,False,921592,False,86,4043,5576,1533
167626,2019-10-05 00:00:00+03:00,out,False,919196,True,24,0,568,568
167626,2019-10-05 00:00:00+03:00,out,False,919306,True,48,0,1490,1490
167626,2019-10-05 00:00:00+03:00,out,False,922710,False,65,5903,7238,1335
167626,2019-10-05 00:00:00+03:00,out,False,919166,False,2,73,87,14
167626,2019-10-05 00:00:00+03:00,out,False,919476,True,48,0,1023,1023
167626,2019-10-05 00:00:00+03:00,out,False,920416,False,46,2569,3396,827
167626,2019-10-05 00:00:00+03:00,in,False,919204,False,94,9447,10460,1013
167626,2019-10-05 00:00:00+03:00,out,False,920414,False,97,8921,10534,1613
167626,2019-10-05 00:00:00+03:00,out,False,919200,False,58,6510,7597,1087
167626,2019-10-05 00:00:00+03:00,out,False,921574,True,49,0,1419,1419
167626,2019-10-05 00:00:00+03:00,out,False,921584,False,2,2,53,51
167626,2019-10-05 00:00:00+03:00,out,False,923666,True,64,0,1365,1365
167626,2019-10-05 00:00:00+03:00,out,False,919906,True,31,0,980,980
167626,2019-10-05 00:00:00+03:00,out,False,919198,True,32,0,855,855
167626,2019-10-05 00:00:00+03:00,out,False,919382,True,77,0,1518,1518
167626,2019-10-05 00:00:00+03:00,out,False,919364,True,133,0,3030,3030
167626,2019-10-05 00:00:00+03:00,out,False,919310,True,46,0,1514,1514
167626,2019-10-05 00:00:00+03:00,out,False,919318,True,28,0,998,998
167626,2019-10-05 00:00:00+03:00,out,False,919198,False,49,3423,4318,895
167626,2019-10-05 00:00:00+03:00,in,False,919166,True,1,0,3,3
167626,2019-10-05 00:00:00+03:00,out,False,928518,True,49,0,1445,1445
167626,2019-10-05 00:00:00+03:00,out,False,919476,False,61,3456,4638,1182
167626,2019-10-05 00:00:00+03:00,out,False,921596,False,81,7300,8655,1355
167626,2019-10-05 00:00:00+03:00,out,False,921596,True,69,0,2000,2000
167626,2019-10-05 00:00:00+03:00,in,False,919166,False,113,8501,9144,643
167626,2019-10-05 00:00:00+03:00,in,False,-1,True,2,0,0,0
167626,2019-10-05 00:00:00+03:00,out,False,919310,False,64,3156,4472,1316
167626,2019-10-05 00:00:00+03:00,out,False,921584,True,3,0,73,73
167626,2019-10-05 00:00:00+03:00,out,False,928228,False,17,2181,2476,295
167626,2019-10-05 00:00:00+03:00,out,False,919306,False,102,12382,14361,1979
167626,2019-10-05 00:00:00+03:00,out,False,920416,True,77,0,903,903
167626,2019-10-05 00:00:00+03:00,out,False,923666,False,96,10602,12345,1743
167626,2019-10-05 00:00:00+03:00,out,False,921592,True,56,0,1472,1472
167626,2019-10-05 00:00:00+03:00,in,False,-1,True,797,0,878,878
167626,2019-10-05 00:00:00+03:00,out,False,920414,True,75,0,1886,1886
167626,2019-10-05 00:00:00+03:00,out,False,919906,False,36,5238,5882,644
167626,2019-10-05 00:00:00+03:00,out,False,919374,True,70,0,1839,1839
167626,2019-10-05 00:00:00+03:00,out,False,919382,False,65,3233,4317,1084
167626,2019-10-05 00:00:00+03:00,out,False,919362,False,103,9214,11191,1977
167626,2019-10-05 00:00:00+03:00,out,False,919200,True,48,0,1043,1043
167626,2019-10-05 00:00:00+03:00,out,False,919374,False,69,3921,5366,1445
167626,2019-10-05 00:00:00+03:00,out,False,919318,False,37,1323,1753,430
167626,2019-10-05 00:00:00+03:00,out,False,928518,False,47,2583,3529,946
167626,2019-10-05 00:00:00+03:00,out,False,919364,False,103,4574,6470,1896
167626,2019-10-05 00:00:00+03:00,out,False,922710,True,43,0,1379,1379
167626,2019-10-05 00:00:00+03:00,out,False,919382,True,77,0,1518,1518
167626,2019-10-05 00:00:00+03:00,out,False,920416,False,46,2569,3396,827
167626,2019-10-05 00:00:00+03:00,out,False,928228,True,21,0,252,252
167626,2019-10-05 00:00:00+03:00,out,False,919306,True,48,0,1490,1490
167626,2019-10-05 00:00:00+03:00,out,False,921584,True,3,0,73,73
167626,2019-10-05 00:00:00+03:00,out,False,921596,True,69,0,2000,2000
167626,2019-10-06 00:00:00+03:00,in,False,919204,True,1,1,5,4
167626,2019-10-06 00:00:00+03:00,out,False,921574,False,79,7125,8685,1560
167626,2019-10-06 00:00:00+03:00,out,False,928518,True,39,0,1156,1156
167626,2019-10-06 00:00:00+03:00,out,False,919362,False,119,11005,13014,2009
167626,2019-10-06 00:00:00+03:00,out,False,919382,False,26,1230,1739,509
167626,2019-10-06 00:00:00+03:00,out,False,919306,False,106,9354,11597,2243
167626,2019-10-06 00:00:00+03:00,out,False,919204,True,1,0,5,5
167626,2019-10-06 00:00:00+03:00,out,False,919906,False,110,10413,12669,2256
167626,2019-10-06 00:00:00+03:00,out,False,920416,False,9,277,498,221
167626,2019-10-06 00:00:00+03:00,out,False,919364,False,106,4846,6960,2114
167626,2019-10-06 00:00:00+03:00,out,False,919374,False,45,1633,2405,772
167626,2019-10-06 00:00:00+03:00,out,False,919204,False,1,37,46,9
167626,2019-10-06 00:00:00+03:00,out,False,919364,True,142,0,3925,3925
167626,2019-10-06 00:00:00+03:00,out,False,923666,True,68,0,1521,1521
167626,2019-10-06 00:00:00+03:00,in,False,-1,True,532,0,679,679
167626,2019-10-06 00:00:00+03:00,out,False,919306,True,58,0,1860,1860
167626,2019-10-06 00:00:00+03:00,in,False,919166,False,2,153,163,10
167626,2019-10-06 00:00:00+03:00,out,False,928518,False,81,4745,6268,1523
167626,2019-10-06 00:00:00+03:00,in,False,919204,False,86,9229,10182,953
167626,2019-10-06 00:00:00+03:00,out,False,921574,True,66,0,2113,2113
167626,2019-10-06 00:00:00+03:00,out,False,919382,True,41,0,1004,1004
167626,2019-10-06 00:00:00+03:00,out,False,921596,False,24,2290,2750,460
167626,2019-10-06 00:00:00+03:00,out,False,919200,True,55,0,1466,1466
167626,2019-10-06 00:00:00+03:00,out,False,919202,False,95,11460,13310,1850
167626,2019-10-06 00:00:00+03:00,out,False,921594,True,46,0,1260,1260
167626,2019-10-06 00:00:00+03:00,out,False,919362,True,97,0,3139,3139
167626,2019-10-06 00:00:00+03:00,out,False,919906,True,80,0,2207,2207
167626,2019-10-06 00:00:00+03:00,out,False,921594,False,64,7100,8220,1120
167626,2019-10-06 00:00:00+03:00,out,False,920416,True,27,0,620,620
167626,2019-10-06 00:00:00+03:00,out,False,919374,True,45,0,1430,1430
167626,2019-10-06 00:00:00+03:00,out,False,921592,False,79,4486,5852,1366
167626,2019-10-06 00:00:00+03:00,out,False,919202,True,90,0,1969,1969
167626,2019-10-06 00:00:00+03:00,out,False,923666,False,95,8414,10106,1692
167626,2019-10-06 00:00:00+03:00,out,False,922710,False,57,2533,3406,873
167626,2019-10-06 00:00:00+03:00,out,False,919310,True,25,0,798,798
167626,2019-10-06 00:00:00+03:00,out,False,921592,True,60,0,1954,1954
167626,2019-10-06 00:00:00+03:00,out,False,922710,True,49,0,811,811
167626,2019-10-06 00:00:00+03:00,out,False,919310,False,60,3625,4784,1159
167626,2019-10-06 00:00:00+03:00,out,False,919200,False,69,7582,8851,1269
167626,2019-10-06 00:00:00+03:00,out,False,921596,True,28,0,766,766
167626,2019-10-06 00:00:00+03:00,out,False,919200,True,55,0,1466,1466
167626,2019-10-06 00:00:00+03:00,out,False,923666,True,68,0,1521,1521
167626,2019-10-06 00:00:00+03:00,out,False,919306,True,58,0,1860,1860
167626,2019-10-07 00:00:00+03:00,out,False,919464,True,74,0,1712,1712
167626,2019-10-07 00:00:00+03:00,out,False,919162,False,100,9068,10883,1815
167626,2019-10-07 00:00:00+03:00,out,False,919482,True,95,0,2021,2021
167626,2019-10-07 00:00:00+03:00,out,False,919456,False,62,3810,4960,1150
167626,2019-10-07 00:00:00+03:00,out,False,919370,False,74,9060,10246,1186
167626,2019-10-07 00:00:00+03:00,out,False,919318,False,87,2375,3993,1618
167626,2019-10-07 00:00:00+03:00,out,False,919192,False,92,9618,11035,1417
167626,2019-10-07 00:00:00+03:00,out,False,919364,True,130,0,3351,3351
167626,2019-10-07 00:00:00+03:00,out,False,919476,True,96,0,2212,2212
167626,2019-10-07 00:00:00+03:00,out,False,919162,True,78,0,1719,1719
167626,2019-10-07 00:00:00+03:00,out,False,919196,True,88,0,1963,1963
167626,2019-10-07 00:00:00+03:00,out,False,919464,False,67,5203,6241,1038
167626,2019-10-07 00:00:00+03:00,out,False,919194,True,46,0,1034,1034
167626,2019-10-07 00:00:00+03:00,out,False,919302,True,71,0,2503,2503
167626,2019-10-07 00:00:00+03:00,out,False,919192,True,76,0,1537,1537
167626,2019-10-07 00:00:00+03:00,out,False,919476,False,86,7062,8740,1678
167626,2019-10-07 00:00:00+03:00,out,False,919314,False,111,6182,8348,2166
167626,2019-10-07 00:00:00+03:00,out,False,919482,False,90,9582,11106,1524
167626,2019-10-07 00:00:00+03:00,out,False,919504,True,63,0,1912,1912
167626,2019-10-07 00:00:00+03:00,in,False,919206,False,103,4369,5384,1015
167626,2019-10-07 00:00:00+03:00,out,False,919318,True,118,0,2580,2580
167626,2019-10-07 00:00:00+03:00,out,False,919490,False,95,7107,8595,1488
167626,2019-10-07 00:00:00+03:00,out,False,923666,True,43,0,939,939
167626,2019-10-07 00:00:00+03:00,out,True,919476,True,1,0,0,0
167626,2019-10-07 00:00:00+03:00,out,False,919910,False,13,1330,1561,231
167626,2019-10-07 00:00:00+03:00,out,False,921574,True,40,0,1045,1045
167626,2019-10-07 00:00:00+03:00,out,False,919504,False,122,8605,10738,2133
167626,2019-10-07 00:00:00+03:00,out,False,919310,False,70,3429,4673,1244
167626,2019-10-07 00:00:00+03:00,out,False,919302,False,97,15200,17373,2173
167626,2019-10-07 00:00:00+03:00,out,False,919490,True,68,0,2080,2080
167626,2019-10-07 00:00:00+03:00,out,False,919202,True,98,0,1981,1981
167626,2019-10-07 00:00:00+03:00,out,False,919376,False,92,6449,7991,1542
167626,2019-10-07 00:00:00+03:00,out,False,919314,True,124,0,3259,3259
167626,2019-10-07 00:00:00+03:00,out,False,923666,False,66,6498,7757,1259
167626,2019-10-07 00:00:00+03:00,out,False,919456,True,47,0,1413,1413
167626,2019-10-07 00:00:00+03:00,out,False,921574,False,51,4851,5713,862
167626,2019-10-07 00:00:00+03:00,out,False,921584,True,36,0,842,842
167626,2019-10-07 00:00:00+03:00,out,False,919196,False,114,10451,12576,2125
167626,2019-10-07 00:00:00+03:00,in,False,-1,True,2168,0,2361,2361
167626,2019-10-07 00:00:00+03:00,out,False,919310,True,69,0,1917,1917
167626,2019-10-07 00:00:00+03:00,out,False,919906,True,1,0,12,12
167626,2019-10-07 00:00:00+03:00,out,False,919910,True,12,0,385,385
167626,2019-10-07 00:00:00+03:00,out,False,921584,False,30,1523,2145,622
167626,2019-10-07 00:00:00+03:00,out,False,919202,False,103,11327,13318,1991
167626,2019-10-07 00:00:00+03:00,out,False,919376,True,78,0,1786,1786
167626,2019-10-07 00:00:00+03:00,out,False,919364,False,93,4675,6522,1847
167626,2019-10-07 00:00:00+03:00,out,False,919370,True,75,0,2048,2048
167626,2019-10-07 00:00:00+03:00,out,False,919194,False,67,9519,10698,1179
167626,2019-10-07 00:00:00+03:00,out,False,919906,False,1,34,52,18
167626,2019-10-07 00:00:00+03:00,out,False,919194,True,46,0,1034,1034
167626,2019-10-07 00:00:00+03:00,out,False,921574,True,40,0,1045,1045
167626,2019-10-07 00:00:00+03:00,out,False,919202,False,103,11327,13318,1991
167626,2019-10-07 00:00:00+03:00,out,False,919910,True,12,0,385,385
167626,2019-10-08 00:00:00+03:00,out,False,919372,True,33,0,849,849
167626,2019-10-08 00:00:00+03:00,out,False,919194,False,58,9527,10548,1021
167626,2019-10-08 00:00:00+03:00,out,False,919504,True,61,0,1816,1816
167626,2019-10-08 00:00:00+03:00,out,False,919382,False,59,3131,4194,1063
167626,2019-10-08 00:00:00+03:00,out,False,919456,True,22,0,495,495
167626,2019-10-08 00:00:00+03:00,out,False,919910,True,19,0,501,501
167626,2019-10-08 00:00:00+03:00,out,False,923666,True,38,0,845,845
167626,2019-10-08 00:00:00+03:00,out,False,919482,False,76,8691,9944,1253
167626,2019-10-08 00:00:00+03:00,out,False,919194,True,35,0,963,963
167626,2019-10-08 00:00:00+03:00,out,False,919192,False,45,6341,7190,849
167626,2019-10-08 00:00:00+03:00,out,False,919482,True,86,0,1762,1762
167626,2019-10-08 00:00:00+03:00,out,False,919910,False,36,3635,4266,631
167626,2019-10-08 00:00:00+03:00,out,False,919200,True,42,0,1063,1063
167626,2019-10-08 00:00:00+03:00,out,False,919464,False,44,4266,4989,723
167626,2019-10-08 00:00:00+03:00,out,False,919504,False,94,5916,7655,1739
167626,2019-10-08 00:00:00+03:00,out,False,921584,True,73,0,1603,1603
167626,2019-10-08 00:00:00+03:00,out,False,919202,True,36,0,850,850
167626,2019-10-08 00:00:00+03:00,in,False,-1,True,1917,0,2044,2044
167626,2019-10-08 00:00:00+03:00,out,False,919364,False,82,4089,5754,1665
167626,2019-10-08 00:00:00+03:00,out,False,919370,False,59,6867,7938,1071
167626,2019-10-08 00:00:00+03:00,out,False,919318,False,86,4145,5547,1402
167626,2019-10-08 00:00:00+03:00,out,False,919490,False,65,5315,6417,1102
167626,2019-10-08 00:00:00+03:00,out,False,919196,False,62,5518,6566,1048
167626,2019-10-08 00:00:00+03:00,out,False,919364,True,89,0,2819,2819
167626,2019-10-08 00:00:00+03:00,out,False,919302,False,66,12323,13803,1480
167626,2019-10-08 00:00:00+03:00,out,False,919490,True,77,0,1956,1956
167626,2019-10-08 00:00:00+03:00,in,False,919164,False,65,6081,6593,512
167626,2019-10-08 00:00:00+03:00,out,False,922710,False,70,5987,7156,1169
167626,2019-10-08 00:00:00+03:00,out,False,919302,True,64,0,2557,2557
167626,2019-10-08 00:00:00+03:00,out,False,919314,True,66,0,1715,1715
167626,2019-10-08 00:00:00+03:00,out,False,919200,False,44,3503,4315,812
167626,2019-10-08 00:00:00+03:00,out,False,919376,True,40,0,1256,1256
167626,2019-10-08 00:00:00+03:00,out,False,921584,False,29,772,1210,438
167626,2019-10-08 00:00:00+03:00,out,False,919464,True,59,0,1448,1448
167626,2019-10-08 00:00:00+03:00,out,False,919192,True,37,0,977,977
167626,2019-10-08 00:00:00+03:00,out,False,919162,True,84,0,1736,1736
167626,2019-10-08 00:00:00+03:00,out,False,923666,False,60,7266,8303,1037
167626,2019-10-08 00:00:00+03:00,out,False,919906,False,1,12,22,10
167626,2019-10-08 00:00:00+03:00,out,False,920414,False,71,7042,8103,1061
167626,2019-10-08 00:00:00+03:00,out,False,922710,True,36,0,1369,1369
167626,2019-10-08 00:00:00+03:00,out,False,919162,False,88,7278,8848,1570
167626,2019-10-08 00:00:00+03:00,out,False,919376,False,69,7346,8560,1214
167626,2019-10-08 00:00:00+03:00,out,False,919198,False,47,3087,3889,802
167626,2019-10-08 00:00:00+03:00,out,False,919196,True,43,0,929,929
167626,2019-10-08 00:00:00+03:00,out,False,919476,True,64,0,1697,1697
167626,2019-10-08 00:00:00+03:00,in,False,919206,True,2,2,24,22
167626,2019-10-08 00:00:00+03:00,out,False,919314,False,89,6525,8170,1645
167626,2019-10-08 00:00:00+03:00,in,False,919206,False,91,3244,4180,936
167626,2019-10-08 00:00:00+03:00,out,False,-1,True,1,0,0,0
167626,2019-10-08 00:00:00+03:00,out,False,919198,True,53,0,1172,1172
167626,2019-10-08 00:00:00+03:00,out,False,919456,False,15,1665,1881,216
167626,2019-10-08 00:00:00+03:00,out,False,919318,True,33,0,557,557
167626,2019-10-08 00:00:00+03:00,out,False,919906,True,1,0,7,7
167626,2019-10-08 00:00:00+03:00,out,False,919310,False,50,1912,2963,1051
167626,2019-10-08 00:00:00+03:00,out,False,920414,True,57,0,1277,1277
167626,2019-10-08 00:00:00+03:00,out,False,919372,False,66,3385,4678,1293
167626,2019-10-08 00:00:00+03:00,out,False,919310,True,69,0,1985,1985
167626,2019-10-08 00:00:00+03:00,out,False,919476,False,62,5222,6259,1037
167626,2019-10-08 00:00:00+03:00,out,False,919370,True,66,0,1917,1917
167626,2019-10-08 00:00:00+03:00,out,False,919202,False,65,7820,9047,1227
167626,2019-10-08 00:00:00+03:00,out,False,919382,True,61,0,863,863
167626,2019-10-08 00:00:00+03:00,out,False,919198,False,47,3087,3889,802
167626,2019-10-08 00:00:00+03:00,out,False,919504,True,61,0,1816,1816
167626,2019-10-08 00:00:00+03:00,out,False,919196,True,43,0,929,929
167626,2019-10-08 00:00:00+03:00,out,False,919202,False,65,7820,9047,1227
167626,2019-10-08 00:00:00+03:00,in,False,919206,True,2,2,24,22
167626,2019-10-08 00:00:00+03:00,out,False,919194,True,35,0,963,963
167626,2019-10-08 00:00:00+03:00,out,False,919376,False,69,7346,8560,1214
167626,2019-10-08 00:00:00+03:00,out,False,-1,True,1,0,0,0
167626,2019-10-08 00:00:00+03:00,out,False,919318,True,33,0,557,557
167626,2019-10-08 00:00:00+03:00,out,False,919314,True,66,0,1715,1715
167626,2019-10-09 00:00:00+03:00,in,False,-1,True,1,0,0,0
167626,2019-10-09 00:00:00+03:00,out,False,921592,False,43,2381,3106,725
167626,2019-10-09 00:00:00+03:00,out,False,919204,True,1,0,1,1
167626,2019-10-09 00:00:00+03:00,out,False,928518,False,71,4817,6121,1304
167626,2019-10-09 00:00:00+03:00,out,False,919192,False,73,7646,8877,1231
167626,2019-10-09 00:00:00+03:00,out,False,919194,True,37,0,987,987
167626,2019-10-09 00:00:00+03:00,out,False,919362,True,70,0,1783,1783
167626,2019-10-09 00:00:00+03:00,out,False,921574,False,73,7203,8405,1202
167626,2019-10-09 00:00:00+03:00,out,False,919906,False,20,3400,3701,301
167626,2019-10-09 00:00:00+03:00,out,False,920416,True,97,0,1271,1271
167626,2019-10-09 00:00:00+03:00,out,False,921594,False,57,4703,5731,1028
167626,2019-10-09 00:00:00+03:00,out,False,919194,False,78,12942,14351,1409
167626,2019-10-09 00:00:00+03:00,out,False,920414,True,61,0,1658,1658
167626,2019-10-09 00:00:00+03:00,out,False,919162,True,84,0,2278,2278
167626,2019-10-09 00:00:00+03:00,in,False,919204,False,88,8302,9194,892
167626,2019-10-09 00:00:00+03:00,out,False,919382,True,135,0,2796,2796
167626,2019-10-09 00:00:00+03:00,out,False,923666,True,71,0,1776,1776
167626,2019-10-09 00:00:00+03:00,out,False,919192,True,74,0,1610,1610
167626,2019-10-09 00:00:00+03:00,out,False,919196,False,99,8829,10748,1919
167626,2019-10-09 00:00:00+03:00,out,False,922710,False,58,2903,4070,1167
167626,2019-10-09 00:00:00+03:00,out,False,920414,False,57,6494,7425,931
167626,2019-10-09 00:00:00+03:00,out,False,919204,False,2,82,110,28
167626,2019-10-09 00:00:00+03:00,out,False,919202,True,24,0,744,744
167626,2019-10-09 00:00:00+03:00,out,False,919302,True,88,0,2895,2895
167626,2019-10-09 00:00:00+03:00,out,False,919364,False,91,4543,6040,1497
167626,2019-10-09 00:00:00+03:00,out,False,920416,False,24,962,1399,437
167626,2019-10-09 00:00:00+03:00,out,False,919464,False,7,607,746,139
167626,2019-10-09 00:00:00+03:00,out,False,919382,False,70,1731,3061,1330
167626,2019-10-09 00:00:00+03:00,out,False,919372,True,9,0,269,269
167626,2019-10-09 00:00:00+03:00,out,False,921574,True,57,0,1332,1332
167626,2019-10-09 00:00:00+03:00,out,False,921594,True,56,0,1153,1153
167626,2019-10-09 00:00:00+03:00,out,False,919314,True,10,0,270,270
167626,2019-10-09 00:00:00+03:00,out,False,919906,True,12,0,425,425
167626,2019-10-09 00:00:00+03:00,out,False,919306,True,52,0,1172,1172
167626,2019-10-09 00:00:00+03:00,out,False,919314,False,22,2978,3384,406
167626,2019-10-09 00:00:00+03:00,out,False,919362,False,106,9457,11257,1800
167626,2019-10-09 00:00:00+03:00,out,False,923666,False,96,9456,11094,1638
167626,2019-10-09 00:00:00+03:00,in,False,-1,True,1432,0,1273,1273
167626,2019-10-09 00:00:00+03:00,out,False,919310,False,29,1167,1876,709
167626,2019-10-09 00:00:00+03:00,out,False,919364,True,126,0,2761,2761
167626,2019-10-09 00:00:00+03:00,out,False,921596,False,74,7068,8316,1248
167626,2019-10-09 00:00:00+03:00,out,False,919196,True,107,0,2611,2611
167626,2019-10-09 00:00:00+03:00,out,False,919464,True,4,0,169,169
167626,2019-10-09 00:00:00+03:00,out,False,919302,False,94,15159,17026,1867
167626,2019-10-09 00:00:00+03:00,out,False,919372,False,13,1226,1495,269
167626,2019-10-09 00:00:00+03:00,out,False,921596,True,53,0,1559,1559
167626,2019-10-09 00:00:00+03:00,out,False,919162,False,119,10306,12467,2161
167626,2019-10-09 00:00:00+03:00,out,False,919306,False,90,8873,10707,1834
167626,2019-10-09 00:00:00+03:00,out,False,919202,False,36,3378,4023,645
167626,2019-10-09 00:00:00+03:00,out,False,928518,True,25,0,686,686
167626,2019-10-09 00:00:00+03:00,out,False,922710,True,154,0,3131,3131
167626,2019-10-09 00:00:00+03:00,out,False,919310,True,40,0,988,988
167626,2019-10-09 00:00:00+03:00,out,False,921592,True,28,0,801,801
167626,2019-10-09 00:00:00+03:00,out,False,919310,True,40,0,988,988
167626,2019-10-09 00:00:00+03:00,out,False,928518,True,25,0,686,686
167626,2019-10-09 00:00:00+03:00,out,False,919302,True,88,0,2895,2895
167626,2019-10-09 00:00:00+03:00,out,False,919464,False,7,607,746,139
167626,2019-10-09 00:00:00+03:00,out,False,919202,True,24,0,744,744
167626,2019-10-09 00:00:00+03:00,out,False,919194,True,37,0,987,987
167626,2019-10-09 00:00:00+03:00,out,False,919364,True,126,0,2761,2761
167626,2019-10-09 00:00:00+03:00,out,False,919192,True,74,0,1610,1610
167626,2019-10-10 00:00:00+03:00,out,False,919376,False,46,4700,5455,755
167626,2019-10-10 00:00:00+03:00,out,False,920416,False,43,2562,3294,732
167626,2019-10-10 00:00:00+03:00,out,False,919204,True,2,0,2,2
167626,2019-10-10 00:00:00+03:00,out,False,919200,False,31,2793,3434,641
167626,2019-10-10 00:00:00+03:00,out,True,923666,True,1,0,1,1
167626,2019-10-10 00:00:00+03:00,out,False,919374,True,82,0,2293,2293
167626,2019-10-10 00:00:00+03:00,out,False,919382,True,90,0,1790,1790
167626,2019-10-10 00:00:00+03:00,out,False,921584,True,52,0,930,930
167626,2019-10-10 00:00:00+03:00,out,False,919314,False,60,5226,6372,1146
167626,2019-10-10 00:00:00+03:00,out,False,919372,True,2,0,75,75
167626,2019-10-10 00:00:00+03:00,out,False,922710,False,52,4620,5399,779
167626,2019-10-10 00:00:00+03:00,out,False,919364,False,96,4627,6562,1935
167626,2019-10-10 00:00:00+03:00,in,False,919204,False,124,10324,11193,869
167626,2019-10-10 00:00:00+03:00,out,False,919910,False,4,269,328,59
167626,2019-10-10 00:00:00+03:00,in,False,919166,False,205,10902,12024,1122
167626,2019-10-10 00:00:00+03:00,out,False,921592,True,51,0,1350,1350
167626,2019-10-10 00:00:00+03:00,out,False,923666,True,23,0,419,419
167626,2019-10-10 00:00:00+03:00,out,False,919318,True,14,0,314,314
167626,2019-10-10 00:00:00+03:00,out,False,921574,True,55,0,1558,1558
167626,2019-10-10 00:00:00+03:00,out,False,921584,False,28,1319,1858,539
167626,2019-10-10 00:00:00+03:00,out,False,919476,False,71,5494,6601,1107
167626,2019-10-10 00:00:00+03:00,out,False,919162,False,106,7149,8964,1815
167626,2019-10-10 00:00:00+03:00,out,False,919310,True,58,0,1796,1796
167626,2019-10-10 00:00:00+03:00,out,False,919192,True,52,0,1274,1274
167626,2019-10-10 00:00:00+03:00,out,False,919362,False,127,13402,15410,2008
167626,2019-10-10 00:00:00+03:00,out,False,921574,False,82,7933,9389,1456
167626,2019-10-10 00:00:00+03:00,out,False,919302,False,92,14708,16513,1805
167626,2019-10-10 00:00:00+03:00,out,False,919196,True,67,0,1953,1953
167626,2019-10-10 00:00:00+03:00,out,False,919476,True,27,0,800,800
167626,2019-10-10 00:00:00+03:00,in,False,919166,True,1,1,4,3
167626,2019-10-10 00:00:00+03:00,out,False,919162,True,66,0,1659,1659
167626,2019-10-10 00:00:00+03:00,out,False,919196,False,106,8487,10606,2119
167626,2019-10-10 00:00:00+03:00,out,False,919374,False,57,3865,5001,1136
167626,2019-10-10 00:00:00+03:00,out,False,921596,False,76,6887,8232,1345
167626,2019-10-10 00:00:00+03:00,out,True,919192,True,1,0,0,0
167626,2019-10-10 00:00:00+03:00,out,False,921594,False,67,6380,7511,1131
167626,2019-10-10 00:00:00+03:00,out,False,919302,True,61,0,1865,1865
167626,2019-10-10 00:00:00+03:00,out,False,919906,False,110,13076,14868,1792
167626,2019-10-10 00:00:00+03:00,out,False,919910,True,2,0,119,119
167626,2019-10-10 00:00:00+03:00,out,False,919314,True,36,0,1181,1181
167626,2019-10-10 00:00:00+03:00,out,False,922710,True,85,0,1881,1881
167626,2019-10-10 00:00:00+03:00,out,False,919202,True,46,0,1095,1095
167626,2019-10-10 00:00:00+03:00,out,False,919194,False,59,7950,9100,1150
167626,2019-10-10 00:00:00+03:00,in,False,-1,True,924,0,1278,1278
167626,2019-10-10 00:00:00+03:00,out,False,919376,True,33,0,942,942
167626,2019-10-10 00:00:00+03:00,out,False,921596,True,52,0,1438,1438
167626,2019-10-10 00:00:00+03:00,out,False,919382,False,53,2653,3589,936
167626,2019-10-10 00:00:00+03:00,out,False,919490,True,36,0,664,664
167626,2019-10-10 00:00:00+03:00,out,False,919372,False,4,251,300,49
167626,2019-10-10 00:00:00+03:00,out,False,919490,False,48,4538,5368,830
167626,2019-10-10 00:00:00+03:00,out,False,919310,False,79,4104,5478,1374
167626,2019-10-10 00:00:00+03:00,out,False,921592,False,93,4909,6463,1554
167626,2019-10-10 00:00:00+03:00,out,False,923666,False,32,3869,4351,482
167626,2019-10-10 00:00:00+03:00,out,False,919318,False,25,1320,1730,410
167626,2019-10-10 00:00:00+03:00,out,False,919200,True,39,0,836,836
167626,2019-10-10 00:00:00+03:00,out,False,919202,False,99,7636,9440,1804
167626,2019-10-10 00:00:00+03:00,out,False,919906,True,91,0,3217,3217
167626,2019-10-10 00:00:00+03:00,out,False,920416,True,106,0,1289,1289
167626,2019-10-10 00:00:00+03:00,out,False,919362,True,91,0,2810,2810
167626,2019-10-10 00:00:00+03:00,out,False,919364,True,132,0,3696,3696
167626,2019-10-10 00:00:00+03:00,out,False,919192,False,81,8048,9467,1419
167626,2019-10-10 00:00:00+03:00,out,False,921594,True,51,0,1212,1212
167626,2019-10-10 00:00:00+03:00,out,True,919906,True,1,0,0,0
167626,2019-10-10 00:00:00+03:00,out,False,919166,False,5,162,220,58
167626,2019-10-10 00:00:00+03:00,out,False,919194,True,45,0,1132,1132
167626,2019-10-10 00:00:00+03:00,out,True,919192,True,1,0,0,0
167626,2019-10-10 00:00:00+03:00,in,False,919166,True,1,1,4,3
167626,2019-10-10 00:00:00+03:00,out,False,919382,True,90,0,1790,1790
167626,2019-10-10 00:00:00+03:00,out,False,921592,True,51,0,1350,1350
167626,2019-10-10 00:00:00+03:00,out,True,919906,True,1,0,0,0
167626,2019-10-10 00:00:00+03:00,out,False,922710,False,52,4620,5399,779
167626,2019-10-10 00:00:00+03:00,out,False,921594,False,67,6380,7511,1131
167626,2019-10-10 00:00:00+03:00,out,False,921584,True,52,0,930,930
167626,2019-10-11 00:00:00+03:00,out,False,919196,True,12,0,334,334
167626,2019-10-11 00:00:00+03:00,out,False,919490,True,53,0,1218,1218
167626,2019-10-11 00:00:00+03:00,out,False,919194,True,50,0,1363,1363
167626,2019-10-11 00:00:00+03:00,out,False,919314,False,85,3551,5114,1563
167626,2019-10-11 00:00:00+03:00,out,False,919456,True,43,0,1189,1189
167626,2019-10-11 00:00:00+03:00,out,False,919374,True,57,0,1640,1640
167626,2019-10-11 00:00:00+03:00,out,False,919376,False,78,9659,10859,1200
167626,2019-10-11 00:00:00+03:00,out,False,919372,True,41,0,1334,1334
167626,2019-10-11 00:00:00+03:00,out,False,919302,False,90,14324,16228,1904
167626,2019-10-11 00:00:00+03:00,out,False,919376,True,57,0,1642,1642
167626,2019-10-11 00:00:00+03:00,out,False,919302,True,76,0,2569,2569
167626,2019-10-11 00:00:00+03:00,out,False,919364,True,146,0,3580,3580
167626,2019-10-11 00:00:00+03:00,out,False,919464,False,39,4162,4888,726
167626,2019-10-11 00:00:00+03:00,out,False,919370,False,38,6179,6817,638
167626,2019-10-11 00:00:00+03:00,out,False,923666,True,53,0,1148,1148
167626,2019-10-11 00:00:00+03:00,out,False,919318,False,87,2109,3241,1132
167626,2019-10-11 00:00:00+03:00,in,False,-1,True,5,0,1,1
167626,2019-10-11 00:00:00+03:00,out,False,919370,True,46,0,1215,1215
167626,2019-10-11 00:00:00+03:00,in,False,-1,True,1705,0,2455,2455
167626,2019-10-11 00:00:00+03:00,out,False,919906,False,67,7437,8524,1087
167626,2019-10-11 00:00:00+03:00,in,False,919164,True,1,1,10,9
167626,2019-10-11 00:00:00+03:00,out,False,919318,True,66,0,1863,1863
167626,2019-10-11 00:00:00+03:00,out,False,919194,False,53,9656,10686,1030
167626,2019-10-11 00:00:00+03:00,out,False,919162,True,86,0,2244,2244
167626,2019-10-11 00:00:00+03:00,out,False,919310,False,48,2517,3355,838
167626,2019-10-11 00:00:00+03:00,out,False,919504,True,58,0,1795,1795
167626,2019-10-11 00:00:00+03:00,out,False,919456,False,62,5127,6142,1015
167626,2019-10-11 00:00:00+03:00,out,False,919378,False,45,1563,2312,749
167626,2019-10-11 00:00:00+03:00,out,False,919198,False,71,3779,4943,1164
167626,2019-10-11 00:00:00+03:00,out,False,919164,False,1,7,18,11
167626,2019-10-11 00:00:00+03:00,out,False,919464,True,37,0,812,812
167626,2019-10-11 00:00:00+03:00,out,False,919504,False,115,7176,9185,2009
167626,2019-10-11 00:00:00+03:00,in,False,919164,False,84,7578,8276,698
167626,2019-10-11 00:00:00+03:00,out,False,919378,True,60,0,1444,1444
167626,2019-10-11 00:00:00+03:00,out,False,919196,False,8,263,400,137
167626,2019-10-11 00:00:00+03:00,out,False,919310,True,18,0,512,512
167626,2019-10-11 00:00:00+03:00,out,False,919162,False,95,7644,9397,1753
167626,2019-10-11 00:00:00+03:00,in,False,919206,False,100,3304,4096,792
167626,2019-10-11 00:00:00+03:00,out,False,934426,False,1,6,12,6
167626,2019-10-11 00:00:00+03:00,out,False,919362,True,39,0,1146,1146
167626,2019-10-11 00:00:00+03:00,out,False,919364,False,68,2735,4030,1295
167626,2019-10-11 00:00:00+03:00,out,False,919372,False,41,2565,3296,731
167626,2019-10-11 00:00:00+03:00,out,False,923666,False,63,5717,6741,1024
167626,2019-10-11 00:00:00+03:00,out,False,919482,False,60,5570,6509,939
167626,2019-10-11 00:00:00+03:00,out,False,919362,False,73,6026,7440,1414
167626,2019-10-11 00:00:00+03:00,out,False,919192,True,74,0,1697,1697
167626,2019-10-11 00:00:00+03:00,out,False,919314,True,100,0,2316,2316
167626,2019-10-11 00:00:00+03:00,out,False,919490,False,75,6077,7218,1141
167626,2019-10-11 00:00:00+03:00,out,False,919192,False,84,9622,11083,1461
167626,2019-10-11 00:00:00+03:00,out,False,919198,True,53,0,1169,1169
167626,2019-10-11 00:00:00+03:00,out,False,919374,False,69,4569,5855,1286
167626,2019-10-11 00:00:00+03:00,out,False,919482,True,37,0,845,845
167626,2019-10-11 00:00:00+03:00,out,False,919906,True,53,0,1735,1735
167626,2019-10-11 00:00:00+03:00,in,False,-1,True,1705,0,2455,2455
167626,2019-10-11 00:00:00+03:00,out,False,919378,True,60,0,1444,1444
167626,2019-10-11 00:00:00+03:00,out,False,919196,False,8,263,400,137
167626,2019-10-12 00:00:00+03:00,out,False,919166,False,1,168,174,6
167626,2019-10-12 00:00:00+03:00,out,False,921584,False,26,1175,1633,458
167626,2019-10-12 00:00:00+03:00,out,False,919194,False,46,10348,11212,864
167626,2019-10-12 00:00:00+03:00,out,False,919198,False,56,3951,5066,1115
167626,2019-10-12 00:00:00+03:00,out,False,919504,False,121,8242,10469,2227
167626,2019-10-12 00:00:00+03:00,out,False,919310,True,83,0,2149,2149
167626,2019-10-12 00:00:00+03:00,out,False,934426,True,55,0,1622,1622
167626,2019-10-12 00:00:00+03:00,in,False,-1,True,2,0,0,0
167626,2019-10-12 00:00:00+03:00,out,False,919202,False,96,7980,9773,1793
167626,2019-10-12 00:00:00+03:00,out,False,921584,True,41,0,646,646
167626,2019-10-12 00:00:00+03:00,out,False,919200,False,72,7127,8526,1399
167626,2019-10-12 00:00:00+03:00,out,False,919306,True,69,0,1800,1800
167626,2019-10-12 00:00:00+03:00,out,False,923666,True,98,0,2155,2155
167626,2019-10-12 00:00:00+03:00,out,False,919464,True,54,0,1130,1130
167626,2019-10-12 00:00:00+03:00,out,False,919504,True,84,0,2825,2825
167626,2019-10-12 00:00:00+03:00,out,False,919202,True,52,0,1230,1230
167626,2019-10-12 00:00:00+03:00,out,False,919464,False,52,4559,5497,938
167626,2019-10-12 00:00:00+03:00,out,False,919310,False,49,1846,2708,862
167626,2019-10-12 00:00:00+03:00,out,False,919482,True,43,0,1242,1242
167626,2019-10-12 00:00:00+03:00,out,False,919370,False,50,5562,6419,857
167626,2019-10-12 00:00:00+03:00,in,False,919166,False,52,5145,5490,345
167626,2019-10-12 00:00:00+03:00,out,False,920414,True,62,0,1575,1575
167626,2019-10-12 00:00:00+03:00,out,False,934426,False,48,2089,3032,943
167626,2019-10-12 00:00:00+03:00,out,False,919314,True,85,0,2400,2400
167626,2019-10-12 00:00:00+03:00,in,False,919206,True,2,2,34,32
167626,2019-10-12 00:00:00+03:00,out,False,919456,True,34,0,813,813
167626,2019-10-12 00:00:00+03:00,out,False,922710,False,76,6740,8101,1361
167626,2019-10-12 00:00:00+03:00,in,False,919206,False,64,2117,2574,457
167626,2019-10-12 00:00:00+03:00,out,False,920414,False,60,6934,7959,1025
167626,2019-10-12 00:00:00+03:00,out,False,919198,True,37,0,954,954
167626,2019-10-12 00:00:00+03:00,out,False,919456,False,41,2149,2885,736
167626,2019-10-12 00:00:00+03:00,out,False,919314,False,116,8271,10459,2188
167626,2019-10-12 00:00:00+03:00,out,False,919476,True,65,0,1452,1452
167626,2019-10-12 00:00:00+03:00,out,False,919194,True,30,0,871,871
167626,2019-10-12 00:00:00+03:00,out,False,919306,False,67,8644,10040,1396
167626,2019-10-12 00:00:00+03:00,out,False,919376,False,84,8838,10252,1414
167626,2019-10-12 00:00:00+03:00,out,False,919490,True,85,0,2243,2243
167626,2019-10-12 00:00:00+03:00,out,False,919482,False,58,7247,8226,979
167626,2019-10-12 00:00:00+03:00,out,False,919490,False,52,4286,5174,888
167626,2019-10-12 00:00:00+03:00,out,False,923666,False,131,12493,14837,2344
167626,2019-10-12 00:00:00+03:00,out,False,919200,True,35,0,855,855
167626,2019-10-12 00:00:00+03:00,out,True,919200,True,1,0,0,0
167626,2019-10-12 00:00:00+03:00,out,False,919370,True,44,0,1239,1239
167626,2019-10-12 00:00:00+03:00,out,False,919376,True,34,0,775,775
167626,2019-10-12 00:00:00+03:00,in,False,-1,True,1115,0,805,805
167626,2019-10-12 00:00:00+03:00,out,False,919476,False,81,5299,6784,1485
167626,2019-10-12 00:00:00+03:00,out,False,922710,True,59,0,1233,1233
167626,2019-10-12 00:00:00+03:00,out,False,919194,False,46,10348,11212,864
167626,2019-10-13 00:00:00+03:00,out,False,919906,True,61,0,1530,1530
167626,2019-10-13 00:00:00+03:00,in,False,-1,True,536,0,959,959
167626,2019-10-13 00:00:00+03:00,out,False,919306,False,100,10907,12719,1812
167626,2019-10-13 00:00:00+03:00,out,False,919362,False,76,5607,7019,1412
167626,2019-10-13 00:00:00+03:00,out,False,919504,True,79,0,2392,2392
167626,2019-10-13 00:00:00+03:00,out,False,919362,True,83,0,2204,2204
167626,2019-10-13 00:00:00+03:00,out,False,921574,True,80,0,2240,2240
167626,2019-10-13 00:00:00+03:00,out,False,919504,False,118,7470,9615,2145
167626,2019-10-13 00:00:00+03:00,out,False,919906,False,107,11440,13510,2070
167626,2019-10-13 00:00:00+03:00,out,False,919200,False,53,7005,7941,936
167626,2019-10-13 00:00:00+03:00,out,False,919378,False,87,5550,6989,1439
167626,2019-10-13 00:00:00+03:00,out,False,919194,False,16,2564,2831,267
167626,2019-10-13 00:00:00+03:00,in,False,919204,False,77,5171,5805,634
167626,2019-10-13 00:00:00+03:00,out,False,920416,False,38,2633,3306,673
167626,2019-10-13 00:00:00+03:00,out,False,919364,True,131,0,3939,3939
167626,2019-10-13 00:00:00+03:00,out,False,919306,True,63,0,1827,1827
167626,2019-10-13 00:00:00+03:00,out,False,919200,True,38,0,885,885
167626,2019-10-13 00:00:00+03:00,out,False,919198,False,68,4560,5733,1173
167626,2019-10-13 00:00:00+03:00,out,False,921574,False,82,7434,9097,1663
167626,2019-10-13 00:00:00+03:00,out,False,919198,True,75,0,1844,1844
167626,2019-10-13 00:00:00+03:00,out,False,920416,True,91,0,1077,1077
167626,2019-10-13 00:00:00+03:00,in,False,919166,False,53,3396,3751,355
167626,2019-10-13 00:00:00+03:00,out,False,919364,False,91,3792,5368,1576
167626,2019-10-13 00:00:00+03:00,out,False,919456,True,37,0,1002,1002
167626,2019-10-13 00:00:00+03:00,out,False,920414,True,52,0,1272,1272
167626,2019-10-13 00:00:00+03:00,out,False,919310,True,2,0,11,11
167626,2019-10-13 00:00:00+03:00,out,False,919194,True,13,0,205,205
167626,2019-10-13 00:00:00+03:00,out,False,919204,False,1,58,92,34
167626,2019-10-13 00:00:00+03:00,out,False,919374,True,72,0,1965,1965
167626,2019-10-13 00:00:00+03:00,out,False,921596,False,65,5617,6867,1250
167626,2019-10-13 00:00:00+03:00,out,False,919318,True,5,0,43,43
167626,2019-10-13 00:00:00+03:00,out,False,919374,False,99,7423,9328,1905
167626,2019-10-13 00:00:00+03:00,out,False,921584,True,27,0,657,657
167626,2019-10-13 00:00:00+03:00,out,False,919382,False,61,2299,3205,906
167626,2019-10-13 00:00:00+03:00,out,False,919382,True,91,0,1472,1472
167626,2019-10-13 00:00:00+03:00,out,False,919456,False,37,4115,4730,615
167626,2019-10-13 00:00:00+03:00,in,False,919204,True,1,0,5,5
167626,2019-10-13 00:00:00+03:00,out,False,921596,True,59,0,1396,1396
167626,2019-10-13 00:00:00+03:00,out,False,921584,False,12,437,651,214
167626,2019-10-13 00:00:00+03:00,out,False,919318,False,8,185,247,62
167626,2019-10-13 00:00:00+03:00,out,False,919378,True,125,0,2436,2436
167626,2019-10-13 00:00:00+03:00,out,False,920414,False,54,5575,6399,824
167626,2019-10-13 00:00:00+03:00,out,False,919202,False,69,5905,7111,1206
167626,2019-10-13 00:00:00+03:00,out,False,919202,True,55,0,1292,1292
167626,2019-10-13 00:00:00+03:00,out,False,919194,False,16,2564,2831,267
167626,2019-10-13 00:00:00+03:00,in,False,919166,False,53,3396,3751,355
167626,2019-10-13 00:00:00+03:00,out,False,921574,True,80,0,2240,2240
167626,2019-10-14 00:00:00+03:00,out,False,921574,True,25,0,563,563
167626,2019-10-14 00:00:00+03:00,out,False,919364,False,97,3378,5040,1662
167626,2019-10-14 00:00:00+03:00,out,False,919202,True,28,0,603,603
167626,2019-10-14 00:00:00+03:00,out,False,919162,False,66,4148,5347,1199
167626,2019-10-14 00:00:00+03:00,in,False,919190,False,1,46,55,9
167626,2019-10-14 00:00:00+03:00,out,False,920416,False,38,3315,3930,615
167626,2019-10-14 00:00:00+03:00,out,False,919382,False,51,2998,3904,906
167626,2019-10-14 00:00:00+03:00,out,False,919196,False,65,5220,6426,1206
167626,2019-10-14 00:00:00+03:00,in,False,919204,True,1,0,24,24
167626,2019-10-14 00:00:00+03:00,out,False,919192,False,81,8078,9356,1278
167626,2019-10-14 00:00:00+03:00,out,False,919364,True,143,0,3085,3085
167626,2019-10-14 00:00:00+03:00,out,False,921594,False,67,5134,6256,1122
167626,2019-10-14 00:00:00+03:00,out,False,919378,True,70,0,1991,1991
167626,2019-10-14 00:00:00+03:00,out,False,919464,False,1,6,13,7
167626,2019-10-14 00:00:00+03:00,out,False,921574,False,55,5852,6976,1124
167626,2019-10-14 00:00:00+03:00,out,False,921584,True,56,0,1292,1292
167626,2019-10-14 00:00:00+03:00,out,False,919490,False,1,6,12,6
167626,2019-10-14 00:00:00+03:00,out,False,919374,True,50,0,1496,1496
167626,2019-10-14 00:00:00+03:00,out,False,919310,True,34,0,1022,1022
167626,2019-10-14 00:00:00+03:00,out,False,919194,False,55,7644,8688,1044
167626,2019-10-14 00:00:00+03:00,out,False,919306,True,37,0,1161,1161
167626,2019-10-14 00:00:00+03:00,out,False,919306,False,53,6575,7458,883
167626,2019-10-14 00:00:00+03:00,out,False,923666,False,81,8611,9863,1252
167626,2019-10-14 00:00:00+03:00,out,False,919362,True,47,0,1484,1484
167626,2019-10-14 00:00:00+03:00,out,False,919302,False,80,14999,16571,1572
167626,2019-10-14 00:00:00+03:00,out,False,921584,False,25,811,1294,483
167626,2019-10-14 00:00:00+03:00,out,False,919196,True,54,0,1341,1341
167626,2019-10-14 00:00:00+03:00,out,False,922710,True,22,0,643,643
167626,2019-10-14 00:00:00+03:00,out,False,923666,True,50,0,948,948
167626,2019-10-14 00:00:00+03:00,out,False,919192,True,85,0,1869,1869
167626,2019-10-14 00:00:00+03:00,out,False,919382,True,82,0,1475,1475
167626,2019-10-14 00:00:00+03:00,out,False,920416,True,86,0,928,928
167626,2019-10-14 00:00:00+03:00,out,False,919372,False,32,1891,2453,562
167626,2019-10-14 00:00:00+03:00,out,False,919190,False,1,114,123,9
167626,2019-10-14 00:00:00+03:00,out,False,921592,True,60,0,1903,1903
167626,2019-10-14 00:00:00+03:00,in,False,919204,False,207,15014,16759,1745
167626,2019-10-14 00:00:00+03:00,out,False,919302,True,57,0,2013,2013
167626,2019-10-14 00:00:00+03:00,out,False,921592,False,99,5182,7015,1833
167626,2019-10-14 00:00:00+03:00,out,False,919372,True,67,0,1075,1075
167626,2019-10-14 00:00:00+03:00,out,False,922710,False,48,4517,5328,811
167626,2019-10-14 00:00:00+03:00,in,False,-1,True,1411,0,1901,1901
167626,2019-10-14 00:00:00+03:00,out,False,921596,True,41,0,986,986
167626,2019-10-14 00:00:00+03:00,out,False,919374,False,73,5142,6523,1381
167626,2019-10-14 00:00:00+03:00,out,False,919310,False,71,4222,5478,1256
167626,2019-10-14 00:00:00+03:00,out,False,921594,True,65,0,1351,1351
167626,2019-10-14 00:00:00+03:00,out,False,919194,True,52,0,1084,1084
167626,2019-10-14 00:00:00+03:00,out,False,919202,False,48,4917,5823,906
167626,2019-10-14 00:00:00+03:00,out,False,919362,False,60,6548,7808,1260
167626,2019-10-14 00:00:00+03:00,out,False,919378,False,43,3583,4354,771
167626,2019-10-14 00:00:00+03:00,out,False,919162,True,80,0,1973,1973
167626,2019-10-14 00:00:00+03:00,out,False,921596,False,58,6629,7679,1050
167626,2019-10-14 00:00:00+03:00,out,False,919302,True,57,0,2013,2013
167626,2019-10-14 00:00:00+03:00,out,False,919306,False,53,6575,7458,883
167626,2019-10-14 00:00:00+03:00,out,False,919374,False,73,5142,6523,1381
167626,2019-10-14 00:00:00+03:00,out,False,919310,False,71,4222,5478,1256
167626,2019-10-15 00:00:00+03:00,out,False,919188,True,11,0,277,277
167626,2019-10-15 00:00:00+03:00,out,False,919490,True,28,0,625,625
167626,2019-10-15 00:00:00+03:00,out,False,923666,True,18,0,414,414
167626,2019-10-15 00:00:00+03:00,out,False,919310,True,46,0,1220,1220
167626,2019-10-15 00:00:00+03:00,out,False,920416,False,22,1159,1600,441
167626,2019-10-15 00:00:00+03:00,out,False,921596,False,18,2099,2460,361
167626,2019-10-15 00:00:00+03:00,out,False,919374,False,61,3773,4884,1111
167626,2019-10-15 00:00:00+03:00,out,False,919910,False,8,1454,1658,204
167626,2019-10-15 00:00:00+03:00,out,False,919314,False,124,5668,7958,2290
167626,2019-10-15 00:00:00+03:00,out,False,919198,False,35,2923,3576,653
167626,2019-10-15 00:00:00+03:00,out,False,919162,True,48,0,1276,1276
167626,2019-10-15 00:00:00+03:00,out,False,919302,False,76,15409,16917,1508
167626,2019-10-15 00:00:00+03:00,out,False,919302,True,63,0,2152,2152
167626,2019-10-15 00:00:00+03:00,out,False,919200,False,37,4136,4911,775
167626,2019-10-15 00:00:00+03:00,out,False,919456,True,15,0,471,471
167626,2019-10-15 00:00:00+03:00,out,False,919200,True,20,0,419,419
167626,2019-10-15 00:00:00+03:00,in,False,919206,False,70,2476,3014,538
167626,2019-10-15 00:00:00+03:00,out,False,919194,True,19,0,316,316
167626,2019-10-15 00:00:00+03:00,out,False,919464,False,39,3575,4272,697
167626,2019-10-15 00:00:00+03:00,out,False,919370,True,29,0,766,766
167626,2019-10-15 00:00:00+03:00,out,False,919476,False,28,1686,2244,558
167626,2019-10-15 00:00:00+03:00,out,False,919372,False,57,3717,4765,1048
167626,2019-10-15 00:00:00+03:00,out,False,919166,False,1,90,97,7
167626,2019-10-15 00:00:00+03:00,out,False,919196,False,50,3690,4520,830
167626,2019-10-15 00:00:00+03:00,out,False,919906,False,13,1211,1496,285
167626,2019-10-15 00:00:00+03:00,out,False,919196,True,69,0,1631,1631
167626,2019-10-15 00:00:00+03:00,out,False,919198,True,20,0,485,485
167626,2019-10-15 00:00:00+03:00,out,False,922710,False,62,3878,4981,1103
167626,2019-10-15 00:00:00+03:00,out,False,919482,True,31,0,1267,1267
167626,2019-10-15 00:00:00+03:00,out,False,919310,False,64,3752,4812,1060
167626,2019-10-15 00:00:00+03:00,out,False,921584,True,50,0,740,740
167626,2019-10-15 00:00:00+03:00,out,False,919314,True,82,0,2114,2114
167626,2019-10-15 00:00:00+03:00,out,False,919188,False,33,5003,5598,595
167626,2019-10-15 00:00:00+03:00,out,False,919318,True,44,0,843,843
167626,2019-10-15 00:00:00+03:00,in,False,919206,True,1,1,12,11
167626,2019-10-15 00:00:00+03:00,out,False,919162,False,65,4571,5858,1287
167626,2019-10-15 00:00:00+03:00,in,False,919166,False,62,4100,4635,535
167626,2019-10-15 00:00:00+03:00,out,False,919482,False,19,1449,1713,264
167626,2019-10-15 00:00:00+03:00,out,False,934426,False,63,2324,3601,1277
167626,2019-10-15 00:00:00+03:00,in,False,919166,True,3,1,33,32
167626,2019-10-15 00:00:00+03:00,out,False,919374,True,51,0,1377,1377
167626,2019-10-15 00:00:00+03:00,out,False,919390,True,80,0,1197,1197
167626,2019-10-15 00:00:00+03:00,out,False,919194,False,35,4963,5566,603
167626,2019-10-15 00:00:00+03:00,out,False,921596,True,23,0,626,626
167626,2019-10-15 00:00:00+03:00,out,False,919464,True,25,0,587,587
167626,2019-10-15 00:00:00+03:00,out,False,920416,True,59,0,716,716
167626,2019-10-15 00:00:00+03:00,out,False,919376,True,35,0,1045,1045
167626,2019-10-15 00:00:00+03:00,out,False,919376,False,42,4728,5457,729
167626,2019-10-15 00:00:00+03:00,out,False,919364,True,130,0,3953,3953
167626,2019-10-15 00:00:00+03:00,out,False,919192,True,32,0,619,619
167626,2019-10-15 00:00:00+03:00,out,False,919372,True,52,0,1466,1466
167626,2019-10-15 00:00:00+03:00,out,False,919364,False,67,2855,4231,1376
167626,2019-10-15 00:00:00+03:00,out,False,919318,False,77,3953,4884,931
167626,2019-10-15 00:00:00+03:00,out,False,919906,True,14,0,364,364
167626,2019-10-15 00:00:00+03:00,out,False,919192,False,58,5802,6730,928
167626,2019-10-15 00:00:00+03:00,out,False,922710,True,61,0,1735,1735
167626,2019-10-15 00:00:00+03:00,out,False,919390,False,46,2448,3116,668
167626,2019-10-15 00:00:00+03:00,in,False,-1,True,1914,0,2063,2063
167626,2019-10-15 00:00:00+03:00,out,False,934426,True,55,0,1463,1463
167626,2019-10-15 00:00:00+03:00,out,False,919370,False,25,3520,3928,408
167626,2019-10-15 00:00:00+03:00,out,False,919490,False,37,3123,3695,572
167626,2019-10-15 00:00:00+03:00,out,False,923666,False,34,4373,5019,646
167626,2019-10-15 00:00:00+03:00,out,False,921584,False,25,612,1136,524
167626,2019-10-15 00:00:00+03:00,out,False,919910,True,9,0,114,114
167626,2019-10-15 00:00:00+03:00,out,False,919476,True,41,0,1060,1060
167626,2019-10-15 00:00:00+03:00,out,False,919456,False,17,1269,1545,276
167626,2019-10-15 00:00:00+03:00,out,False,919482,True,31,0,1267,1267
167626,2019-10-15 00:00:00+03:00,out,False,919188,False,33,5003,5598,595
167626,2019-10-15 00:00:00+03:00,out,False,921584,False,25,612,1136,524
167626,2019-10-15 00:00:00+03:00,in,False,919206,False,70,2476,3014,538
167626,2019-10-16 00:00:00+03:00,out,False,923666,True,1,0,0,0
167626,2019-10-16 00:00:00+03:00,out,False,919162,True,2,0,0,0
167626,2019-10-16 00:00:00+03:00,out,False,919310,True,4,0,1,1
167626,2019-10-16 00:00:00+03:00,out,False,919192,True,4,0,0,0
167626,2019-10-16 00:00:00+03:00,in,False,-1,True,935,0,1852,1852
167626,2019-10-17 00:00:00+03:00,out,False,919314,True,1,0,0,0
167626,2019-10-17 00:00:00+03:00,out,False,919310,True,2,0,1,1
167626,2019-10-17 00:00:00+03:00,out,False,919188,True,1,0,0,0
167626,2019-10-17 00:00:00+03:00,out,False,919364,True,7,0,0,0
167626,2019-10-17 00:00:00+03:00,out,False,920416,True,1,0,0,0
167626,2019-10-17 00:00:00+03:00,out,False,919382,True,1,0,0,0
167626,2019-10-17 00:00:00+03:00,in,False,-1,True,731,0,1492,1492
167626,2019-10-17 00:00:00+03:00,out,False,919302,True,1,0,0,0
167626,2019-10-17 00:00:00+03:00,out,False,919382,True,1,0,0,0
167626,2019-10-18 00:00:00+03:00,in,False,-1,True,2,0,4,4
167626,2019-10-18 00:00:00+03:00,out,False,921584,True,2,0,0,0
167626,2019-10-18 00:00:00+03:00,in,False,-1,True,1185,0,2452,2452
167626,2019-10-19 00:00:00+03:00,in,False,-1,True,239,0,478,478
167626,2019-10-19 00:00:00+03:00,out,False,919476,True,2,0,10,10
167626,2019-10-20 00:00:00+03:00,out,False,919198,True,5,0,20,20
167630,2019-09-26 00:00:00+03:00,in,False,920666,False,1,20,26,6
167630,2019-09-26 00:00:00+03:00,out,False,920666,False,4,252,282,30
167630,2019-09-26 00:00:00+03:00,out,False,920666,True,6,0,115,115
167630,2019-09-27 00:00:00+03:00,in,False,920666,False,5,781,824,43
167630,2019-09-27 00:00:00+03:00,in,False,-1,True,1,0,45,45
167630,2019-09-27 00:00:00+03:00,out,False,920666,False,10,1521,1618,97
167630,2019-09-27 00:00:00+03:00,out,False,920666,True,7,0,128,128
167630,2019-09-30 00:00:00+03:00,in,False,920666,False,5,791,914,123
167630,2019-09-30 00:00:00+03:00,out,False,920666,False,4,655,698,43
167630,2019-09-30 00:00:00+03:00,out,False,920666,True,2,0,53,53
167630,2019-09-30 00:00:00+03:00,out,False,920666,True,2,0,53,53
167630,2019-10-01 00:00:00+03:00,out,False,920666,True,4,0,55,55
167630,2019-10-01 00:00:00+03:00,out,False,920666,False,9,2480,2606,126
167630,2019-10-01 00:00:00+03:00,out,False,920666,True,4,0,55,55
167630,2019-10-02 00:00:00+03:00,in,False,920666,False,7,1229,1289,60
167630,2019-10-02 00:00:00+03:00,in,False,-1,True,1,0,6,6
167630,2019-10-02 00:00:00+03:00,out,False,920666,True,1,0,8,8
167630,2019-10-02 00:00:00+03:00,out,False,920666,False,5,609,676,67
167630,2019-10-03 00:00:00+03:00,out,False,920666,False,2,411,431,20
167630,2019-10-03 00:00:00+03:00,in,False,920666,False,2,521,539,18
167630,2019-10-03 00:00:00+03:00,out,False,920666,True,1,0,21,21
167630,2019-10-03 00:00:00+03:00,in,False,920666,False,2,521,539,18
167630,2019-10-03 00:00:00+03:00,out,False,920666,False,2,411,431,20
167630,2019-10-04 00:00:00+03:00,out,False,920666,False,3,487,513,26
167630,2019-10-04 00:00:00+03:00,out,False,920666,True,1,0,10,10
167630,2019-10-04 00:00:00+03:00,in,False,920666,False,8,1184,1262,78
167630,2019-10-04 00:00:00+03:00,out,False,920666,True,1,0,10,10
167630,2019-10-07 00:00:00+03:00,in,False,920666,False,9,1128,1228,100
167630,2019-10-07 00:00:00+03:00,out,False,920666,True,1,0,46,46
167630,2019-10-07 00:00:00+03:00,out,False,920666,False,3,304,332,28
167630,2019-10-08 00:00:00+03:00,in,False,920666,False,1,248,257,9
167630,2019-10-09 00:00:00+03:00,out,False,920666,False,4,1089,1139,50
167630,2019-10-09 00:00:00+03:00,in,False,920666,False,7,1480,1538,58
167630,2019-10-10 00:00:00+03:00,out,False,920666,False,4,476,502,26
167630,2019-10-10 00:00:00+03:00,in,False,920666,False,11,1918,2054,136
167630,2019-10-11 00:00:00+03:00,out,False,920666,True,1,0,47,47
167630,2019-10-11 00:00:00+03:00,out,False,920666,False,3,492,569,77
167630,2019-10-11 00:00:00+03:00,in,False,920666,False,4,1004,1068,64
167630,2019-10-14 00:00:00+03:00,in,False,920666,False,4,449,483,34
167630,2019-10-14 00:00:00+03:00,in,False,920666,False,4,449,483,34
167630,2019-10-15 00:00:00+03:00,out,False,920666,False,15,2112,2317,205
167630,2019-10-15 00:00:00+03:00,out,False,920666,True,5,0,131,131
167630,2019-10-15 00:00:00+03:00,in,False,920666,False,6,1657,1697,40
167630,2019-10-16 00:00:00+03:00,out,False,920666,False,5,338,420,82
167630,2019-10-16 00:00:00+03:00,in,False,920666,False,4,1837,1867,30
167630,2019-10-16 00:00:00+03:00,out,False,920666,True,6,0,284,284
167630,2019-10-16 00:00:00+03:00,out,False,920666,False,5,338,420,82
167630,2019-10-17 00:00:00+03:00,out,False,920666,False,2,164,183,19
167630,2019-10-17 00:00:00+03:00,in,False,920666,False,3,649,680,31
167630,2019-10-17 00:00:00+03:00,in,False,920666,False,3,649,680,31
167630,2019-10-18 00:00:00+03:00,in,False,920666,False,2,1155,1170,15
167630,2019-10-18 00:00:00+03:00,out,False,920666,False,8,1639,1726,87
167630,2019-10-18 00:00:00+03:00,in,False,-1,True,1,0,22,22
167630,2019-10-18 00:00:00+03:00,out,False,920666,False,8,1639,1726,87
167630,2019-10-21 00:00:00+03:00,out,False,920666,False,9,953,1075,122
167630,2019-10-21 00:00:00+03:00,in,False,920666,False,6,945,990,45
167630,2019-10-22 00:00:00+03:00,in,False,-1,True,1,0,15,15
167630,2019-10-23 00:00:00+03:00,in,False,-1,True,2,0,5,5
167630,2019-10-23 00:00:00+03:00,in,False,920666,False,1,20,27,7
167630,2019-10-23 00:00:00+03:00,out,False,920666,False,2,438,464,26
167630,2019-10-23 00:00:00+03:00,out,False,920666,True,1,0,36,36
167630,2019-10-24 00:00:00+03:00,out,False,920666,False,1,63,73,10
167630,2019-10-24 00:00:00+03:00,in,False,-1,True,1,0,2,2
167630,2019-10-25 00:00:00+03:00,out,False,920666,True,1,0,2,2
167630,2019-10-25 00:00:00+03:00,out,False,920666,False,13,2078,2230,152
167630,2019-10-25 00:00:00+03:00,in,False,-1,True,1,0,48,48
167630,2019-10-25 00:00:00+03:00,in,False,920666,False,6,538,577,39
167630,2019-10-28 00:00:00+03:00,in,False,920666,False,7,1111,1171,60
167630,2019-10-28 00:00:00+03:00,out,False,920666,False,7,775,865,90
167630,2019-10-28 00:00:00+03:00,out,False,920666,False,7,775,865,90
167630,2019-10-29 00:00:00+03:00,in,False,920666,False,4,600,652,52
167630,2019-10-29 00:00:00+03:00,out,False,920666,False,1,469,480,11
167630,2019-10-30 00:00:00+03:00,in,False,-1,True,4,0,36,36
167630,2019-10-30 00:00:00+03:00,out,False,920666,False,8,456,585,129
167630,2019-10-30 00:00:00+03:00,in,False,920666,False,3,572,595,23
167630,2019-10-30 00:00:00+03:00,out,False,920666,True,1,0,34,34
167630,2019-10-31 00:00:00+03:00,in,False,920666,False,3,1030,1052,22
167630,2019-10-31 00:00:00+03:00,out,False,920666,False,1,118,127,9
167630,2019-11-01 00:00:00+03:00,out,False,920666,False,4,67,150,83
167630,2019-11-01 00:00:00+03:00,in,False,920666,False,2,373,387,14
167630,2019-11-05 00:00:00+03:00,out,False,920666,True,2,0,76,76
167630,2019-11-05 00:00:00+03:00,in,False,920666,False,9,1138,1199,61
167630,2019-11-05 00:00:00+03:00,in,False,920666,False,9,1138,1199,61
167630,2019-11-06 00:00:00+03:00,in,False,920666,False,4,759,789,30
167630,2019-11-06 00:00:00+03:00,out,False,920666,False,3,568,593,25
167630,2019-11-11 00:00:00+03:00,in,False,920666,False,4,597,626,29
167630,2019-11-11 00:00:00+03:00,out,False,920666,False,4,641,702,61
167630,2019-11-11 00:00:00+03:00,in,False,920666,False,4,597,626,29
167630,2019-11-12 00:00:00+03:00,out,False,920666,False,3,201,237,36
167630,2019-11-12 00:00:00+03:00,in,False,920666,False,1,637,645,8
167630,2019-11-13 00:00:00+03:00,out,False,920666,False,1,32,58,26
167630,2019-11-13 00:00:00+03:00,in,False,920666,False,4,668,705,37
167630,2019-11-14 00:00:00+03:00,out,False,920666,False,2,100,128,28
167630,2019-11-14 00:00:00+03:00,in,False,920666,False,3,443,468,25
167630,2019-11-15 00:00:00+03:00,out,False,920666,True,4,0,97,97
167630,2019-11-15 00:00:00+03:00,out,False,920666,False,19,1956,2178,222
167630,2019-11-15 00:00:00+03:00,in,False,-1,True,2,0,88,88
167630,2019-11-15 00:00:00+03:00,in,False,920666,False,6,832,867,35
167630,2019-11-18 00:00:00+03:00,out,False,920666,False,17,1081,1358,277
167630,2019-11-18 00:00:00+03:00,in,False,920666,False,6,1287,1330,43
167630,2019-11-18 00:00:00+03:00,out,False,920666,True,3,0,28,28
167630,2019-11-19 00:00:00+03:00,in,False,920666,False,4,1272,1297,25
167630,2019-11-19 00:00:00+03:00,out,False,920666,True,2,0,5,5
167630,2019-11-19 00:00:00+03:00,out,False,920666,False,10,916,1061,145
167630,2019-11-19 00:00:00+03:00,in,False,920666,False,4,1272,1297,25
167630,2019-11-20 00:00:00+03:00,out,False,920666,False,1,80,114,34
167630,2019-11-20 00:00:00+03:00,in,False,920666,False,6,732,782,50
167630,2019-11-20 00:00:00+03:00,out,False,920666,True,2,0,54,54
167630,2019-11-20 00:00:00+03:00,in,False,920666,True,1,0,7,7
167630,2019-11-20 00:00:00+03:00,out,False,920666,True,2,0,54,54
167630,2019-11-21 00:00:00+03:00,in,False,920666,False,3,2654,2683,29
167630,2019-11-21 00:00:00+03:00,out,False,920666,False,1,721,729,8
167630,2019-11-22 00:00:00+03:00,out,False,920666,False,10,1105,1135,30
167630,2019-11-22 00:00:00+03:00,in,False,920666,False,6,1777,1821,44
167630,2019-11-22 00:00:00+03:00,out,False,920666,True,5,0,51,51
167630,2019-11-22 00:00:00+03:00,out,False,920666,False,10,1105,1135,30
167630,2019-11-25 00:00:00+03:00,in,False,920666,False,3,72,120,48
167630,2019-11-25 00:00:00+03:00,out,False,920666,False,4,135,147,12
167630,2019-11-26 00:00:00+03:00,out,False,920666,False,2,264,288,24
167630,2019-11-26 00:00:00+03:00,in,False,920666,False,2,488,502,14
167630,2019-11-26 00:00:00+03:00,out,False,920666,True,1,0,0,0
167630,2019-11-27 00:00:00+03:00,out,False,920666,False,3,215,254,39
167630,2019-11-27 00:00:00+03:00,in,False,920666,False,1,214,220,6
167630,2019-11-28 00:00:00+03:00,in,False,920666,False,4,923,953,30
167631,2019-10-07 00:00:00+03:00,in,False,-1,True,9,0,0,0
167631,2019-10-08 00:00:00+03:00,in,False,-1,True,49,0,0,0
167634,2019-09-26 00:00:00+03:00,in,False,918436,False,1,12,30,18
167634,2019-10-03 00:00:00+03:00,in,False,918436,False,5,183,234,51
167634,2019-10-07 00:00:00+03:00,in,False,918436,False,1,37,45,8
167634,2019-10-07 00:00:00+03:00,in,False,918436,False,1,37,45,8
167634,2019-10-10 00:00:00+03:00,in,False,918436,False,1,109,119,10
167634,2019-10-11 00:00:00+03:00,in,False,918436,False,1,171,181,10
167634,2019-10-16 00:00:00+03:00,out,False,918436,False,2,42,66,24
167634,2019-10-16 00:00:00+03:00,in,False,918436,False,1,8,17,9
167634,2019-10-31 00:00:00+03:00,in,False,918436,False,1,8,16,8
167634,2019-11-01 00:00:00+03:00,in,False,918436,False,1,186,196,10
167634,2019-11-01 00:00:00+03:00,out,False,918436,False,1,102,115,13
167634,2019-11-01 00:00:00+03:00,in,False,918436,True,1,0,19,19
167634,2019-11-01 00:00:00+03:00,out,False,918436,True,1,0,14,14
167634,2019-11-01 00:00:00+03:00,in,False,918436,False,1,186,196,10
167634,2019-11-05 00:00:00+03:00,in,False,918436,False,1,7,15,8
167634,2019-11-05 00:00:00+03:00,out,False,918436,False,47,3116,3600,484
167634,2019-11-05 00:00:00+03:00,in,False,-1,True,2,0,38,38
167634,2019-11-05 00:00:00+03:00,out,False,918436,True,50,0,849,849
167634,2019-11-05 00:00:00+03:00,out,True,918436,False,1,188,197,9
167634,2019-11-06 00:00:00+03:00,out,False,918436,True,16,0,396,396
167634,2019-11-06 00:00:00+03:00,out,False,918436,False,21,1884,2090,206
167634,2019-11-06 00:00:00+03:00,in,False,918436,False,2,149,173,24
167634,2019-11-06 00:00:00+03:00,in,False,918436,False,2,149,173,24
167634,2019-11-07 00:00:00+03:00,out,False,918436,True,19,0,297,297
167634,2019-11-07 00:00:00+03:00,out,False,918436,False,42,3954,4346,392
167634,2019-11-07 00:00:00+03:00,in,False,-1,True,1,0,146,146
167634,2019-11-07 00:00:00+03:00,in,False,918436,False,2,108,133,25
167634,2019-11-07 00:00:00+03:00,out,False,918436,False,42,3954,4346,392
167634,2019-11-07 00:00:00+03:00,out,False,918436,True,19,0,297,297
167634,2019-11-08 00:00:00+03:00,in,False,918436,False,3,107,283,176
167634,2019-11-08 00:00:00+03:00,out,False,918436,True,48,0,822,822
167634,2019-11-08 00:00:00+03:00,out,False,918436,False,60,3040,3795,755
167634,2019-11-11 00:00:00+03:00,in,False,-1,True,2,0,14,14
167634,2019-11-11 00:00:00+03:00,out,False,918436,True,33,0,831,831
167634,2019-11-11 00:00:00+03:00,in,False,918436,False,2,305,399,94
167634,2019-11-11 00:00:00+03:00,out,False,918436,False,47,4678,5204,526
167634,2019-11-11 00:00:00+03:00,in,False,918436,False,2,305,399,94
167634,2019-11-12 00:00:00+03:00,out,False,918436,True,17,0,341,341
167634,2019-11-12 00:00:00+03:00,out,False,918436,False,32,4314,4558,244
167634,2019-11-12 00:00:00+03:00,in,False,-1,True,1,0,0,0
167634,2019-11-13 00:00:00+03:00,out,False,918436,False,29,1884,2176,292
167634,2019-11-13 00:00:00+03:00,in,False,918436,False,2,768,840,72
167634,2019-11-13 00:00:00+03:00,out,False,918436,True,23,0,344,344
167634,2019-11-14 00:00:00+03:00,out,False,918436,False,51,3594,4147,553
167634,2019-11-14 00:00:00+03:00,out,False,918436,True,32,0,544,544
167634,2019-11-14 00:00:00+03:00,in,False,918436,False,1,41,48,7
167634,2019-11-15 00:00:00+03:00,in,False,-1,True,2,0,48,48
167634,2019-11-15 00:00:00+03:00,out,False,918436,False,47,2748,3199,451
167634,2019-11-15 00:00:00+03:00,out,False,918436,True,29,0,438,438
167634,2019-11-15 00:00:00+03:00,in,False,918436,False,1,38,51,13
167634,2019-11-15 00:00:00+03:00,out,False,918436,True,29,0,438,438
167634,2019-11-15 00:00:00+03:00,out,False,918436,False,47,2748,3199,451
167634,2019-11-18 00:00:00+03:00,in,False,918436,False,5,97,144,47
167634,2019-11-18 00:00:00+03:00,out,False,918436,False,48,4186,4701,515
167634,2019-11-18 00:00:00+03:00,out,False,918436,True,25,0,356,356
167634,2019-11-20 00:00:00+03:00,out,False,918436,False,4,147,168,21
167634,2019-11-20 00:00:00+03:00,in,False,918436,False,1,11,25,14
167634,2019-11-20 00:00:00+03:00,out,False,918436,True,3,0,75,75
167634,2019-11-21 00:00:00+03:00,in,False,918436,False,1,44,53,9
167634,2019-11-21 00:00:00+03:00,in,False,-1,True,1,0,3,3
167644,2019-10-01 00:00:00+03:00,in,False,924544,False,3,511,530,19
167644,2019-10-01 00:00:00+03:00,in,False,-1,True,11,0,115,115
167644,2019-10-02 00:00:00+03:00,in,False,-1,True,1,0,1,1
167644,2019-10-02 00:00:00+03:00,in,False,924544,False,6,578,616,38
167644,2019-10-03 00:00:00+03:00,in,False,-1,True,1,0,2,2
167644,2019-10-03 00:00:00+03:00,out,False,924546,False,2,339,371,32
167644,2019-10-03 00:00:00+03:00,in,False,924544,False,4,352,376,24
167644,2019-10-07 00:00:00+03:00,in,False,-1,True,1,0,22,22
167644,2019-10-07 00:00:00+03:00,out,False,924546,False,1,561,572,11
167644,2019-10-07 00:00:00+03:00,in,False,924546,False,2,184,225,41
167644,2019-10-07 00:00:00+03:00,in,False,924544,False,1,144,151,7
167644,2019-10-08 00:00:00+03:00,in,False,-1,True,1,0,23,23
167644,2019-10-08 00:00:00+03:00,in,False,924544,False,2,342,352,10
167644,2019-10-08 00:00:00+03:00,in,False,924546,False,2,156,176,20
167644,2019-10-09 00:00:00+03:00,out,False,924546,False,2,108,118,10
167644,2019-10-10 00:00:00+03:00,out,False,924546,False,4,311,318,7
167644,2019-10-10 00:00:00+03:00,out,False,924544,False,2,240,244,4
167644,2019-10-10 00:00:00+03:00,out,False,924546,True,1,0,5,5
167644,2019-10-10 00:00:00+03:00,in,False,924544,False,2,73,85,12
167644,2019-10-10 00:00:00+03:00,in,False,924546,False,2,1181,1199,18
167644,2019-10-10 00:00:00+03:00,in,False,924546,False,2,1181,1199,18
167644,2019-10-11 00:00:00+03:00,in,False,924546,False,4,151,241,90
167644,2019-10-11 00:00:00+03:00,out,False,924546,False,3,192,204,12
167644,2019-10-11 00:00:00+03:00,in,False,-1,True,5,0,110,110
167644,2019-10-14 00:00:00+03:00,out,False,924546,False,1,21,38,17
167644,2019-10-14 00:00:00+03:00,in,False,924546,False,3,122,145,23
167644,2019-10-14 00:00:00+03:00,in,False,924544,False,3,202,218,16
167644,2019-10-14 00:00:00+03:00,out,False,924544,False,1,530,532,2
167644,2019-10-15 00:00:00+03:00,in,False,924546,False,2,427,443,16
167644,2019-10-15 00:00:00+03:00,in,False,-1,True,1,0,2,2
167644,2019-10-15 00:00:00+03:00,in,False,924544,False,2,187,197,10
167644,2019-10-15 00:00:00+03:00,in,False,-1,True,1,0,2,2
167644,2019-10-15 00:00:00+03:00,in,False,924544,False,2,187,197,10
167644,2019-10-16 00:00:00+03:00,in,False,924544,False,2,145,159,14
167644,2019-10-16 00:00:00+03:00,in,False,924546,False,3,261,290,29
167644,2019-10-17 00:00:00+03:00,out,False,924544,False,1,54,96,42
167644,2019-10-17 00:00:00+03:00,out,False,924544,True,3,0,35,35
167644,2019-10-17 00:00:00+03:00,in,False,924544,False,2,252,270,18
167644,2019-10-18 00:00:00+03:00,in,False,924544,False,1,95,103,8
167644,2019-10-18 00:00:00+03:00,in,False,924546,False,1,50,60,10
167644,2019-10-18 00:00:00+03:00,out,False,924546,False,2,360,376,16
167644,2019-10-21 00:00:00+03:00,in,False,924546,False,1,158,167,9
167644,2019-10-22 00:00:00+03:00,in,False,924544,False,1,60,67,7
167644,2019-10-22 00:00:00+03:00,in,False,924546,False,1,336,345,9
167644,2019-10-23 00:00:00+03:00,in,False,924546,False,1,21,40,19
167644,2019-10-23 00:00:00+03:00,in,False,-1,True,2,0,41,41
167644,2019-10-24 00:00:00+03:00,in,False,924546,False,2,956,982,26
167644,2019-10-24 00:00:00+03:00,out,False,924546,False,2,139,165,26
167644,2019-10-24 00:00:00+03:00,in,False,-1,True,4,0,308,308
167644,2019-10-24 00:00:00+03:00,out,False,924546,False,2,139,165,26
167644,2019-10-25 00:00:00+03:00,out,False,924546,True,1,0,19,19
167644,2019-10-25 00:00:00+03:00,in,False,-1,True,3,0,161,161
167644,2019-10-25 00:00:00+03:00,out,False,924546,False,3,206,238,32
167644,2019-10-25 00:00:00+03:00,in,False,924546,False,4,1666,1735,69
167644,2019-10-25 00:00:00+03:00,in,False,924546,True,1,0,20,20
167644,2019-10-25 00:00:00+03:00,out,False,924546,False,3,206,238,32
167644,2019-10-28 00:00:00+03:00,out,False,924546,False,1,1470,1486,16
167644,2019-10-28 00:00:00+03:00,in,False,924544,False,1,23,29,6
167644,2019-10-29 00:00:00+03:00,in,False,924544,False,3,317,335,18
167644,2019-10-29 00:00:00+03:00,out,False,924544,False,1,42,44,2
167644,2019-10-29 00:00:00+03:00,in,False,-1,True,2,0,119,119
167644,2019-10-29 00:00:00+03:00,out,False,924546,False,1,91,107,16
167644,2019-10-30 00:00:00+03:00,out,False,924546,False,9,1728,1855,127
167644,2019-10-30 00:00:00+03:00,out,False,924546,True,1,0,19,19
167644,2019-10-30 00:00:00+03:00,in,False,-1,True,1,0,137,137
167644,2019-10-30 00:00:00+03:00,in,False,924544,False,2,538,551,13
167644,2019-10-31 00:00:00+03:00,in,False,924544,False,2,118,131,13
167644,2019-10-31 00:00:00+03:00,out,False,924544,False,1,156,159,3
167644,2019-10-31 00:00:00+03:00,out,False,924546,False,1,743,756,13
167644,2019-11-01 00:00:00+03:00,in,False,924544,False,5,604,638,34
167644,2019-11-05 00:00:00+03:00,in,False,924546,False,1,403,422,19
167644,2019-11-05 00:00:00+03:00,out,False,924544,False,1,82,83,1
167644,2019-11-05 00:00:00+03:00,in,False,924544,False,5,200,235,35
167644,2019-11-06 00:00:00+03:00,in,False,924544,False,2,213,228,15
167644,2019-11-07 00:00:00+03:00,in,False,924546,False,1,30,54,24
167644,2019-11-07 00:00:00+03:00,out,False,924546,False,6,980,1038,58
167644,2019-11-07 00:00:00+03:00,in,False,924544,False,7,499,563,64
167644,2019-11-07 00:00:00+03:00,out,False,924546,True,1,0,18,18
167644,2019-11-08 00:00:00+03:00,in,False,924544,False,4,265,296,31
167644,2019-11-08 00:00:00+03:00,in,False,924546,False,1,111,190,79
167644,2019-11-08 00:00:00+03:00,out,False,924546,False,1,66,70,4
167644,2019-11-08 00:00:00+03:00,in,False,-1,True,2,0,67,67
167644,2019-11-08 00:00:00+03:00,out,False,924546,False,1,66,70,4
167644,2019-11-09 00:00:00+03:00,in,False,-1,True,2,0,99,99
167644,2019-11-11 00:00:00+03:00,out,False,924546,False,4,126,142,16
167644,2019-11-11 00:00:00+03:00,in,False,-1,True,3,0,113,113
167644,2019-11-11 00:00:00+03:00,in,False,924544,False,5,193,227,34
167644,2019-11-11 00:00:00+03:00,in,False,924546,False,3,241,287,46
167644,2019-11-12 00:00:00+03:00,in,False,-1,True,2,0,84,84
167644,2019-11-12 00:00:00+03:00,in,False,924546,False,2,77,116,39
167644,2019-11-13 00:00:00+03:00,out,False,924546,True,1,0,5,5
167644,2019-11-13 00:00:00+03:00,out,False,924546,False,4,1137,1163,26
167644,2019-11-13 00:00:00+03:00,in,False,924544,False,3,150,172,22
167644,2019-11-14 00:00:00+03:00,in,False,924544,False,3,723,742,19
167644,2019-11-14 00:00:00+03:00,in,False,-1,True,1,0,44,44
167644,2019-11-15 00:00:00+03:00,in,False,924544,False,3,163,181,18
167644,2019-11-15 00:00:00+03:00,in,False,-1,True,3,0,128,128
167644,2019-11-15 00:00:00+03:00,out,False,924546,True,1,0,47,47
167644,2019-11-15 00:00:00+03:00,out,False,924546,False,1,45,59,14
167644,2019-11-15 00:00:00+03:00,out,False,924546,True,1,0,47,47
167644,2019-11-18 00:00:00+03:00,out,False,924544,False,1,361,367,6
167644,2019-11-18 00:00:00+03:00,in,False,924546,False,1,781,796,15
167644,2019-11-18 00:00:00+03:00,in,False,-1,True,8,0,380,380
167644,2019-11-18 00:00:00+03:00,out,False,924546,False,4,216,253,37
167644,2019-11-18 00:00:00+03:00,in,False,924544,False,2,332,346,14
167644,2019-11-19 00:00:00+03:00,in,False,924544,False,5,252,288,36
167644,2019-11-20 00:00:00+03:00,in,False,924544,False,2,919,931,12
167644,2019-11-20 00:00:00+03:00,in,False,-1,True,2,0,32,32
167644,2019-11-20 00:00:00+03:00,out,False,924546,True,1,0,5,5
167644,2019-11-20 00:00:00+03:00,in,False,924546,False,2,420,446,26
167644,2019-11-20 00:00:00+03:00,out,False,924544,True,1,0,3,3
167644,2019-11-21 00:00:00+03:00,in,False,924544,False,2,393,404,11
167644,2019-11-21 00:00:00+03:00,in,False,924544,False,2,393,404,11
167644,2019-11-22 00:00:00+03:00,in,False,-1,True,2,0,4,4
167644,2019-11-22 00:00:00+03:00,in,False,924544,False,4,306,325,19
167644,2019-11-22 00:00:00+03:00,in,False,-1,True,2,0,4,4
167644,2019-11-23 00:00:00+03:00,in,False,-1,True,1,0,67,67
167644,2019-11-25 00:00:00+03:00,out,False,924546,False,3,196,218,22
167644,2019-11-25 00:00:00+03:00,in,False,924544,False,4,85,106,21
167644,2019-11-25 00:00:00+03:00,in,False,-1,True,1,0,30,30
167644,2019-11-26 00:00:00+03:00,in,False,924544,False,2,182,193,11
167644,2019-11-26 00:00:00+03:00,in,False,-1,True,3,0,136,136
167644,2019-11-27 00:00:00+03:00,out,False,924546,True,1,0,10,10
167644,2019-11-27 00:00:00+03:00,in,False,924544,False,3,400,424,24
167644,2019-11-27 00:00:00+03:00,in,False,-1,True,2,0,4,4
167644,2019-11-27 00:00:00+03:00,out,False,924546,False,4,2117,2157,40
167644,2019-11-27 00:00:00+03:00,in,False,924546,False,2,2471,2504,33
167644,2019-11-27 00:00:00+03:00,out,False,924546,True,1,0,10,10
167644,2019-11-27 00:00:00+03:00,out,False,924546,False,4,2117,2157,40
167644,2019-11-28 00:00:00+03:00,out,False,924546,False,3,662,686,24
167644,2019-11-28 00:00:00+03:00,in,False,924546,False,2,1119,1140,21
167644,2019-11-28 00:00:00+03:00,in,False,-1,True,2,0,20,20
167644,2019-11-28 00:00:00+03:00,out,False,924546,True,1,0,38,38
167644,2019-11-28 00:00:00+03:00,out,False,924544,False,1,538,545,7
167644,2019-11-28 00:00:00+03:00,in,False,924544,False,6,139,172,33
167644,2019-11-28 00:00:00+03:00,in,False,924546,False,2,1119,1140,21
167645,2019-09-24 00:00:00+03:00,out,False,919128,False,1,63,79,16
167645,2019-09-25 00:00:00+03:00,in,False,-1,True,4,0,10,10
167645,2019-09-25 00:00:00+03:00,out,False,919126,False,36,833,1516,683
167645,2019-09-25 00:00:00+03:00,out,False,919126,True,28,0,635,635
167645,2019-10-01 00:00:00+03:00,out,False,919126,False,37,2179,2765,586
167645,2019-10-01 00:00:00+03:00,out,False,919126,True,27,0,806,806
167645,2019-10-01 00:00:00+03:00,out,True,919126,True,2,0,3,3
167645,2019-10-01 00:00:00+03:00,out,True,919126,False,1,24,47,23
167645,2019-10-01 00:00:00+03:00,in,False,-1,True,5,0,10,10
167645,2019-10-02 00:00:00+03:00,out,False,919126,True,44,0,710,710
167645,2019-10-02 00:00:00+03:00,in,False,-1,True,4,0,9,9
167645,2019-10-02 00:00:00+03:00,out,False,919126,False,23,537,993,456
167645,2019-10-03 00:00:00+03:00,out,False,919126,True,16,0,281,281
167645,2019-10-03 00:00:00+03:00,out,False,919126,False,24,1597,2006,409
167645,2019-10-09 00:00:00+03:00,out,False,919126,True,10,0,129,129
167645,2019-10-09 00:00:00+03:00,out,False,919126,False,8,232,350,118
167645,2019-10-10 00:00:00+03:00,out,False,919128,False,3,74,182,108
167645,2019-10-10 00:00:00+03:00,out,False,919126,False,6,928,1019,91
167645,2019-10-10 00:00:00+03:00,in,False,-1,True,1,0,2,2
167645,2019-10-10 00:00:00+03:00,out,False,919126,True,4,0,101,101
167645,2019-10-10 00:00:00+03:00,out,False,919128,True,290,0,2814,2814
167645,2019-10-11 00:00:00+03:00,out,False,919128,True,32,0,437,437
167645,2019-10-11 00:00:00+03:00,out,False,919128,False,1,47,54,7
167645,2019-10-14 00:00:00+03:00,out,False,919128,False,1,142,166,24
167645,2019-10-14 00:00:00+03:00,out,False,919128,True,1,0,44,44
167645,2019-10-14 00:00:00+03:00,out,False,919126,False,5,263,381,118
167645,2019-10-16 00:00:00+03:00,out,False,919126,False,7,352,448,96
167645,2019-10-16 00:00:00+03:00,in,False,-1,True,2,0,4,4
167645,2019-10-17 00:00:00+03:00,out,False,919126,False,4,384,439,55
167645,2019-10-17 00:00:00+03:00,out,False,919128,True,58,0,642,642
167645,2019-10-17 00:00:00+03:00,out,False,919126,True,3,0,29,29
167645,2019-10-17 00:00:00+03:00,out,False,919128,False,1,60,67,7
167645,2019-10-18 00:00:00+03:00,out,False,919126,False,2,105,131,26
167645,2019-10-18 00:00:00+03:00,out,False,919126,True,4,0,126,126
167645,2019-10-21 00:00:00+03:00,in,False,-1,True,1,0,2,2
167646,2019-11-18 00:00:00+03:00,out,False,964712,True,5,0,38,38
167646,2019-11-18 00:00:00+03:00,out,False,964712,False,1,9,30,21
167646,2019-11-18 00:00:00+03:00,out,True,964712,False,3,55,140,85
167646,2019-11-18 00:00:00+03:00,in,True,964712,False,1,5,28,23
167646,2019-11-18 00:00:00+03:00,in,False,964712,False,3,94,136,42
167646,2019-11-18 00:00:00+03:00,out,True,964712,False,3,55,140,85
167646,2019-11-18 00:00:00+03:00,in,False,964712,False,3,94,136,42
167646,2019-11-23 00:00:00+03:00,in,True,964712,False,2,7,64,57
167646,2019-11-23 00:00:00+03:00,in,False,-1,True,1,0,29,29
167646,2019-11-23 00:00:00+03:00,in,False,-1,True,3,0,83,83
167646,2019-11-23 00:00:00+03:00,in,False,-1,True,3,0,83,83
167646,2019-11-23 00:00:00+03:00,in,False,-1,True,1,0,29,29
167646,2019-11-25 00:00:00+03:00,in,False,-1,True,1,0,59,59
167650,2019-09-26 00:00:00+03:00,in,False,-1,True,2,0,35,35
167650,2019-09-27 00:00:00+03:00,out,False,921306,False,1,44,66,22
167650,2019-09-27 00:00:00+03:00,in,False,-1,True,1,0,55,55
167650,2019-09-27 00:00:00+03:00,in,False,921306,False,1,84,109,25
167650,2019-09-27 00:00:00+03:00,out,False,921306,True,1,0,60,60
167650,2019-09-29 00:00:00+03:00,out,False,921318,True,1,0,10,10
167650,2019-09-29 00:00:00+03:00,out,False,921318,True,1,0,10,10
167650,2019-09-30 00:00:00+03:00,in,False,-1,True,1,0,14,14
167650,2019-10-01 00:00:00+03:00,in,False,-1,True,8,0,226,226
167650,2019-10-01 00:00:00+03:00,out,False,921318,False,14,585,905,320
167650,2019-10-01 00:00:00+03:00,in,False,921306,False,5,608,749,141
167650,2019-10-01 00:00:00+03:00,out,False,921318,True,18,0,497,497
167650,2019-10-01 00:00:00+03:00,in,False,921318,False,22,2942,3150,208
167650,2019-10-01 00:00:00+03:00,out,False,921318,True,18,0,497,497
167650,2019-10-02 00:00:00+03:00,out,False,921318,True,18,0,369,369
167650,2019-10-02 00:00:00+03:00,out,False,921318,False,26,1753,2051,298
167650,2019-10-02 00:00:00+03:00,in,False,-1,True,22,0,545,545
167650,2019-10-02 00:00:00+03:00,in,False,921318,False,32,3567,3992,425
167650,2019-10-02 00:00:00+03:00,in,False,921306,False,3,368,402,34
167650,2019-10-03 00:00:00+03:00,out,False,921318,False,40,3208,3683,475
167650,2019-10-03 00:00:00+03:00,in,False,921318,False,61,6955,7503,548
167650,2019-10-03 00:00:00+03:00,out,False,921306,False,4,209,261,52
167650,2019-10-03 00:00:00+03:00,out,False,921318,True,74,0,1229,1229
167650,2019-10-03 00:00:00+03:00,in,False,921306,False,12,1268,1448,180
167650,2019-10-03 00:00:00+03:00,in,False,-1,True,51,0,1272,1272
167650,2019-10-03 00:00:00+03:00,out,False,921318,True,74,0,1229,1229
167650,2019-10-04 00:00:00+03:00,out,False,921318,False,41,2927,3499,572
167650,2019-10-04 00:00:00+03:00,in,False,921318,False,49,3593,3983,390
167650,2019-10-04 00:00:00+03:00,in,False,921306,False,15,2046,2302,256
167650,2019-10-04 00:00:00+03:00,in,False,-1,True,22,0,246,246
167650,2019-10-04 00:00:00+03:00,out,False,921318,True,50,0,1125,1125
167650,2019-10-04 00:00:00+03:00,out,False,921306,True,2,0,4,4
167650,2019-10-04 00:00:00+03:00,out,False,921306,False,2,53,121,68
167650,2019-10-04 00:00:00+03:00,out,False,921318,True,50,0,1125,1125
167650,2019-10-05 00:00:00+03:00,in,False,921318,True,1,1,6,5
167650,2019-10-05 00:00:00+03:00,in,False,-1,True,10,0,135,135
167650,2019-10-05 00:00:00+03:00,out,False,921318,False,50,3525,4227,702
167650,2019-10-05 00:00:00+03:00,out,False,921306,False,3,124,168,44
167650,2019-10-05 00:00:00+03:00,in,False,921318,False,35,3017,3400,383
167650,2019-10-05 00:00:00+03:00,in,False,921306,False,9,612,748,136
167650,2019-10-05 00:00:00+03:00,out,False,921306,True,1,0,44,44
167650,2019-10-05 00:00:00+03:00,out,False,921318,True,65,0,1264,1264
167650,2019-10-06 00:00:00+03:00,in,False,-1,True,83,0,15,15
167650,2019-10-06 00:00:00+03:00,in,False,-1,True,3,0,0,0
167650,2019-10-07 00:00:00+03:00,out,False,921306,True,8,0,154,154
167650,2019-10-07 00:00:00+03:00,in,False,921318,False,56,5583,6128,545
167650,2019-10-07 00:00:00+03:00,out,False,921318,False,57,4156,4821,665
167650,2019-10-07 00:00:00+03:00,out,False,921318,True,68,0,1062,1062
167650,2019-10-07 00:00:00+03:00,in,False,-1,True,21,0,321,321
167650,2019-10-07 00:00:00+03:00,in,False,921306,False,33,3048,3515,467
167650,2019-10-07 00:00:00+03:00,out,False,921306,False,11,738,901,163
167650,2019-10-07 00:00:00+03:00,in,False,-1,True,21,0,321,321
167650,2019-10-08 00:00:00+03:00,in,False,921306,False,26,2210,2714,504
167650,2019-10-08 00:00:00+03:00,out,False,921306,True,9,0,244,244
167650,2019-10-08 00:00:00+03:00,out,False,921318,True,83,0,1428,1428
167650,2019-10-08 00:00:00+03:00,in,False,-1,True,32,0,481,481
167650,2019-10-08 00:00:00+03:00,out,False,921306,False,19,1505,1790,285
167650,2019-10-08 00:00:00+03:00,in,False,921318,False,64,5592,6245,653
167650,2019-10-08 00:00:00+03:00,out,False,921318,False,54,3001,3779,778
167650,2019-10-09 00:00:00+03:00,out,False,921318,False,27,2040,2435,395
167650,2019-10-09 00:00:00+03:00,in,True,921318,False,1,29,52,23
167650,2019-10-09 00:00:00+03:00,out,True,931458,False,1,32,65,33
167650,2019-10-09 00:00:00+03:00,in,False,921318,False,59,5789,6369,580
167650,2019-10-09 00:00:00+03:00,out,False,931458,True,14,0,373,373
167650,2019-10-09 00:00:00+03:00,out,True,931458,True,2,0,14,14
167650,2019-10-09 00:00:00+03:00,out,False,921306,False,12,763,1036,273
167650,2019-10-09 00:00:00+03:00,in,False,-1,True,4,0,105,105
167650,2019-10-09 00:00:00+03:00,out,False,931458,False,21,1474,1965,491
167650,2019-10-09 00:00:00+03:00,in,False,-1,True,13,0,352,352
167650,2019-10-09 00:00:00+03:00,out,False,921318,True,28,0,493,493
167650,2019-10-09 00:00:00+03:00,in,False,921306,False,12,1198,1469,271
167650,2019-10-09 00:00:00+03:00,out,False,921306,True,3,0,74,74
167650,2019-10-09 00:00:00+03:00,in,False,931458,False,18,1222,1528,306
167650,2019-10-09 00:00:00+03:00,in,False,-1,True,4,0,105,105
167650,2019-10-10 00:00:00+03:00,out,False,931458,True,52,0,1229,1229
167650,2019-10-10 00:00:00+03:00,in,False,921306,False,11,913,1177,264
167650,2019-10-10 00:00:00+03:00,out,False,931458,False,62,3405,4282,877
167650,2019-10-10 00:00:00+03:00,out,False,921306,True,1,0,35,35
167650,2019-10-10 00:00:00+03:00,out,False,921318,False,32,2108,2551,443
167650,2019-10-10 00:00:00+03:00,in,False,-1,True,13,0,235,235
167650,2019-10-10 00:00:00+03:00,in,False,931458,False,21,1828,2005,177
167650,2019-10-10 00:00:00+03:00,in,False,921318,False,42,4900,5281,381
167650,2019-10-10 00:00:00+03:00,out,False,921306,False,11,485,702,217
167650,2019-10-10 00:00:00+03:00,out,False,921318,True,32,0,644,644
167650,2019-10-10 00:00:00+03:00,in,False,921318,False,42,4900,5281,381
167650,2019-10-11 00:00:00+03:00,out,False,921306,True,5,0,123,123
167650,2019-10-11 00:00:00+03:00,in,False,931458,False,45,3149,3740,591
167650,2019-10-11 00:00:00+03:00,in,False,-1,True,28,0,814,814
167650,2019-10-11 00:00:00+03:00,out,False,931458,True,38,0,927,927
167650,2019-10-11 00:00:00+03:00,out,False,931458,False,58,3471,4277,806
167650,2019-10-11 00:00:00+03:00,out,False,921306,False,6,358,439,81
167650,2019-10-11 00:00:00+03:00,in,False,921306,False,12,901,1175,274
167650,2019-10-12 00:00:00+03:00,in,False,931458,False,61,4049,4825,776
167650,2019-10-12 00:00:00+03:00,out,False,931458,True,44,0,1138,1138
167650,2019-10-12 00:00:00+03:00,out,False,931458,False,52,2952,3666,714
167650,2019-10-12 00:00:00+03:00,in,False,-1,True,18,0,614,614
167650,2019-10-12 00:00:00+03:00,in,False,921306,False,12,1217,1551,334
167650,2019-10-12 00:00:00+03:00,in,False,921306,False,12,1217,1551,334
167650,2019-10-13 00:00:00+03:00,in,False,-1,True,1,0,36,36
167650,2019-10-13 00:00:00+03:00,in,False,921318,False,13,1608,1730,122
167650,2019-10-13 00:00:00+03:00,in,False,-1,True,1,0,36,36
167650,2019-10-14 00:00:00+03:00,out,False,931458,False,20,1753,2011,258
167650,2019-10-14 00:00:00+03:00,in,False,921306,False,3,177,231,54
167650,2019-10-14 00:00:00+03:00,in,False,-1,True,21,0,884,884
167650,2019-10-14 00:00:00+03:00,in,False,921318,False,49,4189,4809,620
167650,2019-10-14 00:00:00+03:00,out,False,931458,True,14,0,292,292
167650,2019-10-14 00:00:00+03:00,out,False,921306,False,4,205,248,43
167650,2019-10-14 00:00:00+03:00,out,False,921306,True,6,0,193,193
167650,2019-10-14 00:00:00+03:00,in,False,931458,False,33,2851,3180,329
167650,2019-10-14 00:00:00+03:00,in,False,931458,True,1,0,6,6
167650,2019-10-14 00:00:00+03:00,out,False,921318,False,23,1594,1952,358
167650,2019-10-14 00:00:00+03:00,out,False,921318,True,45,0,808,808
167650,2019-10-14 00:00:00+03:00,in,False,-1,True,1,0,27,27
167650,2019-10-14 00:00:00+03:00,in,False,921318,True,1,0,86,86
167650,2019-10-14 00:00:00+03:00,in,False,931458,False,33,2851,3180,329
167650,2019-10-14 00:00:00+03:00,in,False,921318,True,1,0,86,86
167650,2019-10-15 00:00:00+03:00,out,False,921318,True,14,0,305,305
167650,2019-10-15 00:00:00+03:00,in,False,921318,True,1,0,36,36
167650,2019-10-15 00:00:00+03:00,out,False,921306,False,6,908,967,59
167650,2019-10-15 00:00:00+03:00,out,False,921306,True,1,0,60,60
167650,2019-10-15 00:00:00+03:00,in,False,921318,False,54,4721,5234,513
167650,2019-10-15 00:00:00+03:00,out,False,921318,False,17,2227,2425,198
167650,2019-10-15 00:00:00+03:00,in,False,921306,False,3,394,450,56
167650,2019-10-15 00:00:00+03:00,out,False,931458,True,32,0,696,696
167650,2019-10-15 00:00:00+03:00,out,False,931458,False,43,2326,2948,622
167650,2019-10-15 00:00:00+03:00,in,False,931458,False,31,2645,3032,387
167650,2019-10-15 00:00:00+03:00,in,False,-1,True,26,0,710,710
167650,2019-10-15 00:00:00+03:00,out,False,931458,False,43,2326,2948,622
167650,2019-10-16 00:00:00+03:00,out,False,921306,True,10,0,163,163
167650,2019-10-16 00:00:00+03:00,out,False,921318,False,9,1071,1190,119
167650,2019-10-16 00:00:00+03:00,in,False,-1,True,25,0,1045,1045
167650,2019-10-16 00:00:00+03:00,out,False,931458,True,8,0,123,123
167650,2019-10-16 00:00:00+03:00,in,False,931458,False,21,1801,2104,303
167650,2019-10-16 00:00:00+03:00,out,False,921318,True,23,0,324,324
167650,2019-10-16 00:00:00+03:00,in,False,921306,False,1,60,70,10
167650,2019-10-16 00:00:00+03:00,in,False,921318,False,46,4640,5332,692
167650,2019-10-16 00:00:00+03:00,out,False,931458,False,12,751,952,201
167650,2019-10-16 00:00:00+03:00,out,False,921306,False,19,457,828,371
167650,2019-10-17 00:00:00+03:00,in,False,-1,True,25,0,1326,1326
167650,2019-10-17 00:00:00+03:00,in,False,921306,False,4,204,328,124
167650,2019-10-17 00:00:00+03:00,out,False,921318,False,23,1840,2123,283
167650,2019-10-17 00:00:00+03:00,in,False,921318,False,74,7390,8443,1053
167650,2019-10-17 00:00:00+03:00,in,False,931458,False,2,5,23,18
167650,2019-10-17 00:00:00+03:00,out,True,921318,True,1,0,0,0
167650,2019-10-17 00:00:00+03:00,out,False,921318,True,32,0,565,565
167650,2019-10-17 00:00:00+03:00,out,False,921306,False,5,311,389,78
167650,2019-10-17 00:00:00+03:00,out,True,921318,True,1,0,0,0
167650,2019-10-18 00:00:00+03:00,out,False,921318,False,18,1184,1371,187
167650,2019-10-18 00:00:00+03:00,out,False,921318,True,62,0,646,646
167650,2019-10-18 00:00:00+03:00,in,False,921318,False,73,5539,6548,1009
167650,2019-10-18 00:00:00+03:00,out,True,921318,True,2,0,0,0
167650,2019-10-18 00:00:00+03:00,in,False,-1,True,14,0,580,580
167650,2019-10-18 00:00:00+03:00,out,False,921318,True,62,0,646,646
167650,2019-10-19 00:00:00+03:00,in,False,931458,False,61,4490,5555,1065
167650,2019-10-19 00:00:00+03:00,in,False,-1,True,2,0,7,7
167650,2019-10-19 00:00:00+03:00,in,False,-1,True,36,0,1381,1381
167650,2019-10-19 00:00:00+03:00,in,False,921306,True,1,0,14,14
167650,2019-10-19 00:00:00+03:00,in,False,931458,True,2,0,90,90
167650,2019-10-19 00:00:00+03:00,out,False,921306,False,14,625,867,242
167650,2019-10-19 00:00:00+03:00,out,False,931458,False,67,4378,5500,1122
167650,2019-10-19 00:00:00+03:00,out,False,931458,True,42,0,979,979
167650,2019-10-19 00:00:00+03:00,out,False,921306,True,6,0,240,240
167650,2019-10-19 00:00:00+03:00,in,False,921306,False,8,538,694,156
167650,2019-10-19 00:00:00+03:00,in,False,931458,True,2,0,90,90
167650,2019-10-20 00:00:00+03:00,out,True,931458,False,1,6,15,9
167650,2019-10-20 00:00:00+03:00,out,False,931458,False,34,2119,2656,537
167650,2019-10-20 00:00:00+03:00,out,False,921306,True,3,0,26,26
167650,2019-10-20 00:00:00+03:00,in,False,-1,True,21,0,927,927
167650,2019-10-20 00:00:00+03:00,out,False,921306,False,3,87,118,31
167650,2019-10-20 00:00:00+03:00,out,False,931458,True,17,0,432,432
167650,2019-10-20 00:00:00+03:00,in,False,921306,False,10,957,1208,251
167650,2019-10-20 00:00:00+03:00,in,False,931458,False,41,3151,3733,582
167650,2019-10-21 00:00:00+03:00,out,False,921306,True,8,0,332,332
167650,2019-10-21 00:00:00+03:00,out,False,921318,False,14,796,958,162
167650,2019-10-21 00:00:00+03:00,out,False,931458,True,16,0,428,428
167650,2019-10-21 00:00:00+03:00,in,False,921318,False,63,5632,6497,865
167650,2019-10-21 00:00:00+03:00,out,False,921318,True,15,0,210,210
167650,2019-10-21 00:00:00+03:00,out,False,931458,False,16,1384,1617,233
167650,2019-10-21 00:00:00+03:00,in,False,931458,False,40,2727,3260,533
167650,2019-10-21 00:00:00+03:00,in,False,-1,True,28,0,1157,1157
167650,2019-10-21 00:00:00+03:00,out,False,921306,False,11,408,619,211
167650,2019-10-21 00:00:00+03:00,out,False,921306,False,11,408,619,211
167650,2019-10-22 00:00:00+03:00,in,False,-1,True,34,0,1308,1308
167650,2019-10-22 00:00:00+03:00,out,False,921318,True,17,0,260,260
167650,2019-10-22 00:00:00+03:00,in,False,921306,True,1,0,23,23
167650,2019-10-22 00:00:00+03:00,out,False,921318,False,14,1117,1295,178
167650,2019-10-22 00:00:00+03:00,out,False,931458,False,18,910,1162,252
167650,2019-10-22 00:00:00+03:00,out,False,921306,True,2,0,70,70
167650,2019-10-22 00:00:00+03:00,out,False,931458,True,20,0,486,486
167650,2019-10-22 00:00:00+03:00,in,False,931458,False,50,4196,4754,558
167650,2019-10-22 00:00:00+03:00,in,False,921318,False,48,4287,4987,700
167650,2019-10-22 00:00:00+03:00,out,False,921306,False,4,202,292,90
167650,2019-10-22 00:00:00+03:00,out,False,921318,True,17,0,260,260
167650,2019-10-23 00:00:00+03:00,in,False,-1,True,1,0,39,39
167650,2019-10-23 00:00:00+03:00,out,False,931458,True,27,0,648,648
167650,2019-10-23 00:00:00+03:00,out,False,921306,True,3,0,61,61
167650,2019-10-23 00:00:00+03:00,in,False,921306,False,9,736,961,225
167650,2019-10-23 00:00:00+03:00,out,False,931458,False,36,2934,3500,566
167650,2019-10-23 00:00:00+03:00,in,False,-1,True,51,0,1598,1598
167650,2019-10-23 00:00:00+03:00,in,False,931458,False,71,5492,6739,1247
167650,2019-10-23 00:00:00+03:00,out,False,921320,True,5,0,78,78
167650,2019-10-23 00:00:00+03:00,in,False,921320,False,11,1263,1608,345
167650,2019-10-23 00:00:00+03:00,out,False,921306,False,14,865,1100,235
167650,2019-10-23 00:00:00+03:00,out,False,921320,False,13,517,684,167
167650,2019-10-23 00:00:00+03:00,out,False,921320,True,5,0,78,78
167650,2019-10-23 00:00:00+03:00,in,False,921306,False,9,736,961,225
167650,2019-10-24 00:00:00+03:00,in,False,-1,True,2,0,106,106
167650,2019-10-24 00:00:00+03:00,out,False,921306,False,2,84,103,19
167650,2019-10-24 00:00:00+03:00,out,False,931458,False,50,2201,3039,838
167650,2019-10-24 00:00:00+03:00,in,False,921320,False,7,869,1020,151
167650,2019-10-24 00:00:00+03:00,in,False,921306,True,1,0,12,12
167650,2019-10-24 00:00:00+03:00,out,False,921320,True,8,0,329,329
167650,2019-10-24 00:00:00+03:00,out,False,921320,False,9,438,637,199
167650,2019-10-24 00:00:00+03:00,out,False,931458,True,34,0,903,903
167650,2019-10-24 00:00:00+03:00,in,False,931458,False,60,4628,5629,1001
167650,2019-10-24 00:00:00+03:00,in,False,-1,True,35,0,1553,1553
167650,2019-10-24 00:00:00+03:00,in,False,921306,False,10,506,693,187
167650,2019-10-24 00:00:00+03:00,out,False,921306,True,2,0,91,91
167650,2019-10-25 00:00:00+03:00,out,True,921318,True,3,0,0,0
167650,2019-10-25 00:00:00+03:00,in,False,921320,False,1,52,77,25
167650,2019-10-25 00:00:00+03:00,out,False,921318,False,33,1507,1891,384
167650,2019-10-25 00:00:00+03:00,out,False,921306,False,20,866,1228,362
167650,2019-10-25 00:00:00+03:00,in,False,921318,True,1,0,5,5
167650,2019-10-25 00:00:00+03:00,out,False,921318,True,62,0,889,889
167650,2019-10-25 00:00:00+03:00,out,False,921306,True,8,0,261,261
167650,2019-10-25 00:00:00+03:00,in,False,921306,False,12,614,817,203
167650,2019-10-25 00:00:00+03:00,in,False,921318,False,68,5695,6608,913
167650,2019-10-25 00:00:00+03:00,in,False,-1,True,14,0,254,254
167650,2019-10-26 00:00:00+03:00,out,False,931458,True,8,0,137,137
167650,2019-10-26 00:00:00+03:00,in,False,921306,False,1,54,75,21
167650,2019-10-26 00:00:00+03:00,in,False,931458,False,16,1435,1592,157
167650,2019-10-26 00:00:00+03:00,out,False,921306,False,8,239,387,148
167650,2019-10-26 00:00:00+03:00,out,False,921306,True,3,0,68,68
167650,2019-10-26 00:00:00+03:00,in,False,-1,True,10,0,356,356
167650,2019-10-26 00:00:00+03:00,out,False,921318,False,23,1197,1463,266
167650,2019-10-26 00:00:00+03:00,in,False,921318,False,30,2649,2972,323
167650,2019-10-26 00:00:00+03:00,out,False,931458,False,15,1171,1351,180
167650,2019-10-26 00:00:00+03:00,out,False,921318,True,45,0,550,550
167650,2019-10-26 00:00:00+03:00,in,False,931458,False,16,1435,1592,157
167650,2019-10-27 00:00:00+03:00,out,False,921318,True,41,0,761,761
167650,2019-10-27 00:00:00+03:00,out,False,921318,False,24,1297,1641,344
167650,2019-10-27 00:00:00+03:00,in,False,921306,True,1,0,21,21
167650,2019-10-27 00:00:00+03:00,in,False,921318,False,44,2966,3397,431
167650,2019-10-27 00:00:00+03:00,in,False,-1,True,8,0,126,126
167650,2019-10-27 00:00:00+03:00,in,False,921306,False,1,129,154,25
167650,2019-10-27 00:00:00+03:00,in,False,-1,True,8,0,126,126
167650,2019-10-27 00:00:00+03:00,in,False,921306,False,1,129,154,25
167650,2019-10-27 00:00:00+03:00,out,False,921318,True,41,0,761,761
167650,2019-10-28 00:00:00+03:00,in,False,921318,False,47,4965,5788,823
167650,2019-10-28 00:00:00+03:00,out,False,921318,False,18,1137,1385,248
167650,2019-10-28 00:00:00+03:00,out,False,921306,False,8,215,341,126
167650,2019-10-28 00:00:00+03:00,out,True,931458,True,2,0,14,14
167650,2019-10-28 00:00:00+03:00,out,True,931458,False,1,1,8,7
167650,2019-10-28 00:00:00+03:00,out,False,931458,False,10,589,785,196
167650,2019-10-28 00:00:00+03:00,out,False,921318,True,24,0,463,463
167650,2019-10-28 00:00:00+03:00,out,False,921306,True,3,0,93,93
167650,2019-10-28 00:00:00+03:00,in,False,-1,True,1,0,4,4
167650,2019-10-28 00:00:00+03:00,in,False,931458,False,34,2932,3387,455
167650,2019-10-28 00:00:00+03:00,out,False,931458,True,7,0,155,155
167650,2019-10-28 00:00:00+03:00,in,False,-1,True,19,0,589,589
167650,2019-10-28 00:00:00+03:00,out,True,931458,False,1,1,8,7
167650,2019-10-28 00:00:00+03:00,out,False,931458,True,7,0,155,155
167650,2019-10-29 00:00:00+03:00,out,False,921320,True,4,0,174,174
167650,2019-10-29 00:00:00+03:00,out,False,931458,True,36,0,907,907
167650,2019-10-29 00:00:00+03:00,in,False,931458,False,63,4855,6088,1233
167650,2019-10-29 00:00:00+03:00,in,False,-1,True,32,0,1375,1375
167650,2019-10-29 00:00:00+03:00,out,False,931458,False,38,3088,3683,595
167650,2019-10-29 00:00:00+03:00,in,False,921320,False,8,664,819,155
167650,2019-10-29 00:00:00+03:00,out,False,921320,False,5,542,629,87
167650,2019-10-29 00:00:00+03:00,out,False,931458,False,38,3088,3683,595
167650,2019-10-30 00:00:00+03:00,in,False,921306,False,5,744,807,63
167650,2019-10-30 00:00:00+03:00,in,False,931458,False,51,4093,4764,671
167650,2019-10-30 00:00:00+03:00,out,False,921306,False,2,75,110,35
167650,2019-10-30 00:00:00+03:00,out,False,931458,True,32,0,745,745
167650,2019-10-30 00:00:00+03:00,in,False,921320,False,1,35,64,29
167650,2019-10-30 00:00:00+03:00,in,False,-1,True,25,0,985,985
167650,2019-10-30 00:00:00+03:00,out,False,931458,False,52,2403,3221,818
167650,2019-10-30 00:00:00+03:00,in,False,921320,False,1,35,64,29
167650,2019-10-30 00:00:00+03:00,in,False,-1,True,25,0,985,985
167650,2019-10-31 00:00:00+03:00,out,False,921320,False,1,19,35,16
167650,2019-10-31 00:00:00+03:00,out,False,921306,True,10,0,243,243
167650,2019-10-31 00:00:00+03:00,out,False,921318,False,19,581,791,210
167650,2019-10-31 00:00:00+03:00,in,False,921306,False,11,797,971,174
167650,2019-10-31 00:00:00+03:00,out,False,921318,True,50,0,745,745
167650,2019-10-31 00:00:00+03:00,in,False,-1,True,6,0,137,137
167650,2019-10-31 00:00:00+03:00,out,True,931458,True,2,0,10,10
167650,2019-10-31 00:00:00+03:00,in,False,-1,True,8,0,116,116
167650,2019-10-31 00:00:00+03:00,in,True,931458,False,1,3,46,43
167650,2019-10-31 00:00:00+03:00,in,False,921318,False,32,2036,2459,423
167650,2019-10-31 00:00:00+03:00,out,False,921306,False,9,677,816,139
167650,2019-10-31 00:00:00+03:00,in,False,931458,False,18,1096,1313,217
167650,2019-10-31 00:00:00+03:00,out,False,931458,True,10,0,224,224
167650,2019-10-31 00:00:00+03:00,in,True,921306,False,1,20,27,7
167650,2019-10-31 00:00:00+03:00,out,True,921318,True,1,0,0,0
167650,2019-10-31 00:00:00+03:00,out,False,931458,False,11,904,1083,179
167650,2019-10-31 00:00:00+03:00,out,False,921318,False,19,581,791,210
167650,2019-11-01 00:00:00+03:00,out,False,921318,False,5,345,394,49
167650,2019-11-01 00:00:00+03:00,in,False,-1,True,15,0,511,511
167650,2019-11-01 00:00:00+03:00,in,False,931458,False,11,617,773,156
167650,2019-11-01 00:00:00+03:00,out,False,921320,False,3,19,110,91
167650,2019-11-01 00:00:00+03:00,out,False,931458,False,2,171,211,40
167650,2019-11-01 00:00:00+03:00,out,False,921320,True,17,0,561,561
167650,2019-11-01 00:00:00+03:00,in,False,921320,False,1,152,250,98
167650,2019-11-01 00:00:00+03:00,out,False,931458,True,5,0,131,131
167650,2019-11-01 00:00:00+03:00,in,False,921318,False,20,2299,2655,356
167650,2019-11-01 00:00:00+03:00,out,False,921318,True,7,0,101,101
167650,2019-11-01 00:00:00+03:00,out,False,921320,False,3,19,110,91
167650,2019-11-01 00:00:00+03:00,in,False,921318,False,20,2299,2655,356
167650,2019-11-02 00:00:00+03:00,out,False,921306,False,2,84,122,38
167650,2019-11-02 00:00:00+03:00,in,False,921306,False,6,343,480,137
167650,2019-11-02 00:00:00+03:00,out,False,921318,True,41,0,694,694
167650,2019-11-02 00:00:00+03:00,in,False,921318,False,33,2194,2589,395
167650,2019-11-02 00:00:00+03:00,out,False,921306,True,1,0,4,4
167650,2019-11-02 00:00:00+03:00,in,False,-1,True,6,0,83,83
167650,2019-11-02 00:00:00+03:00,out,False,921318,False,35,1680,2164,484
167650,2019-11-02 00:00:00+03:00,out,True,921318,True,1,0,1,1
167650,2019-11-03 00:00:00+03:00,in,False,921318,False,18,1538,1746,208
167650,2019-11-03 00:00:00+03:00,out,False,921318,False,10,385,526,141
167650,2019-11-03 00:00:00+03:00,in,False,-1,True,2,0,14,14
167650,2019-11-03 00:00:00+03:00,in,False,921306,False,1,54,112,58
167650,2019-11-03 00:00:00+03:00,out,False,921318,True,9,0,167,167
167650,2019-11-04 00:00:00+03:00,out,False,931458,False,4,233,285,52
167650,2019-11-04 00:00:00+03:00,out,False,921318,True,1,0,10,10
167650,2019-11-04 00:00:00+03:00,out,False,921320,False,10,357,508,151
167650,2019-11-04 00:00:00+03:00,out,False,921318,False,2,239,257,18
167650,2019-11-04 00:00:00+03:00,in,False,931458,False,14,855,990,135
167650,2019-11-04 00:00:00+03:00,out,False,921320,True,5,0,108,108
167650,2019-11-04 00:00:00+03:00,in,False,921318,False,15,1000,1176,176
167650,2019-11-04 00:00:00+03:00,in,False,-1,True,1,0,2,2
167650,2019-11-04 00:00:00+03:00,in,False,921320,False,1,94,121,27
167650,2019-11-05 00:00:00+03:00,in,False,921320,False,3,460,530,70
167650,2019-11-05 00:00:00+03:00,in,False,921318,False,24,1885,2106,221
167650,2019-11-05 00:00:00+03:00,out,False,931458,False,12,764,893,129
167650,2019-11-05 00:00:00+03:00,out,False,931458,True,9,0,228,228
167650,2019-11-05 00:00:00+03:00,out,False,921318,False,4,177,230,53
167650,2019-11-05 00:00:00+03:00,out,False,921320,True,13,0,315,315
167650,2019-11-05 00:00:00+03:00,out,False,921320,False,8,328,469,141
167650,2019-11-05 00:00:00+03:00,out,False,921318,True,4,0,40,40
167650,2019-11-05 00:00:00+03:00,in,False,-1,True,23,0,661,661
167650,2019-11-05 00:00:00+03:00,in,False,931458,False,31,3346,3776,430
167650,2019-11-05 00:00:00+03:00,in,False,931458,True,1,0,14,14
167650,2019-11-05 00:00:00+03:00,out,False,921320,True,13,0,315,315
167650,2019-11-06 00:00:00+03:00,out,False,921318,True,49,0,731,731
167650,2019-11-06 00:00:00+03:00,in,False,931458,False,36,3349,3613,264
167650,2019-11-06 00:00:00+03:00,out,False,921306,False,5,543,620,77
167650,2019-11-06 00:00:00+03:00,out,False,921318,False,39,3245,3684,439
167650,2019-11-06 00:00:00+03:00,in,False,931458,True,1,0,33,33
167650,2019-11-06 00:00:00+03:00,out,False,921306,True,2,0,59,59
167650,2019-11-06 00:00:00+03:00,in,False,921306,False,34,3847,4414,567
167650,2019-11-06 00:00:00+03:00,out,True,921318,True,1,0,0,0
167650,2019-11-06 00:00:00+03:00,out,False,931458,True,9,0,165,165
167650,2019-11-06 00:00:00+03:00,in,False,921318,False,89,9120,10351,1231
167650,2019-11-06 00:00:00+03:00,in,False,921320,False,6,594,655,61
167650,2019-11-06 00:00:00+03:00,in,False,-1,True,33,0,870,870
167650,2019-11-06 00:00:00+03:00,out,False,931458,False,8,765,889,124
167650,2019-11-06 00:00:00+03:00,out,False,931458,True,9,0,165,165
167650,2019-11-07 00:00:00+03:00,out,False,921318,True,23,0,373,373
167650,2019-11-07 00:00:00+03:00,in,False,921306,False,14,1350,1616,266
167650,2019-11-07 00:00:00+03:00,in,False,921318,False,75,7546,8538,992
167650,2019-11-07 00:00:00+03:00,in,False,931458,False,67,6570,7229,659
167650,2019-11-07 00:00:00+03:00,out,False,921320,False,6,90,195,105
167650,2019-11-07 00:00:00+03:00,out,False,931458,False,27,2225,2645,420
167650,2019-11-07 00:00:00+03:00,out,False,921320,True,2,0,83,83
167650,2019-11-07 00:00:00+03:00,out,True,931458,True,1,0,8,8
167650,2019-11-07 00:00:00+03:00,out,False,921306,True,4,0,120,120
167650,2019-11-07 00:00:00+03:00,out,False,931458,True,35,0,795,795
167650,2019-11-07 00:00:00+03:00,out,False,921318,False,16,1153,1299,146
167650,2019-11-07 00:00:00+03:00,in,False,-1,True,34,0,1192,1192
167650,2019-11-07 00:00:00+03:00,out,False,921306,False,4,295,396,101
167650,2019-11-07 00:00:00+03:00,in,False,-1,True,34,0,1192,1192
167650,2019-11-07 00:00:00+03:00,out,False,921320,False,6,90,195,105
167650,2019-11-08 00:00:00+03:00,out,False,921320,True,2,0,28,28
167650,2019-11-08 00:00:00+03:00,out,False,921306,True,10,0,397,397
167650,2019-11-08 00:00:00+03:00,out,False,921306,False,11,851,1085,234
167650,2019-11-08 00:00:00+03:00,out,False,931458,True,30,0,714,714
167650,2019-11-08 00:00:00+03:00,in,False,-1,True,62,0,2075,2075
167650,2019-11-08 00:00:00+03:00,out,False,921320,False,1,33,64,31
167650,2019-11-08 00:00:00+03:00,in,False,931458,False,83,7806,8813,1007
167650,2019-11-08 00:00:00+03:00,in,False,921306,False,44,4582,5537,955
167650,2019-11-08 00:00:00+03:00,out,False,931458,False,47,4193,4813,620
167650,2019-11-08 00:00:00+03:00,in,False,921306,False,44,4582,5537,955
167650,2019-11-09 00:00:00+03:00,in,False,921320,False,2,35,93,58
167650,2019-11-09 00:00:00+03:00,out,False,931458,True,41,0,1078,1078
167650,2019-11-09 00:00:00+03:00,out,False,931458,False,57,4012,4841,829
167650,2019-11-09 00:00:00+03:00,in,False,-1,True,67,0,2901,2901
167650,2019-11-09 00:00:00+03:00,in,False,931458,False,92,6870,8966,2096
167650,2019-11-09 00:00:00+03:00,in,False,921306,False,4,237,301,64
167650,2019-11-09 00:00:00+03:00,out,False,921306,False,1,4,46,42
167650,2019-11-09 00:00:00+03:00,out,False,931458,False,57,4012,4841,829
167650,2019-11-10 00:00:00+03:00,out,False,921318,True,34,0,630,630
167650,2019-11-10 00:00:00+03:00,out,False,921318,False,45,2702,3301,599
167650,2019-11-10 00:00:00+03:00,in,False,-1,True,37,0,1951,1951
167650,2019-11-10 00:00:00+03:00,out,True,921318,True,1,0,1,1
167650,2019-11-10 00:00:00+03:00,out,False,921306,True,6,0,243,243
167650,2019-11-10 00:00:00+03:00,out,False,931458,False,6,93,161,68
167650,2019-11-10 00:00:00+03:00,out,False,921306,False,4,159,229,70
167650,2019-11-10 00:00:00+03:00,in,False,921318,False,73,6360,7274,914
167650,2019-11-11 00:00:00+03:00,in,False,-1,True,1,0,49,49
167650,2019-11-11 00:00:00+03:00,in,False,931458,False,133,12379,16377,3998
167650,2019-11-11 00:00:00+03:00,out,False,931458,True,68,0,1319,1319
167650,2019-11-11 00:00:00+03:00,in,False,-1,True,130,0,5516,5516
167650,2019-11-11 00:00:00+03:00,out,False,931458,False,83,5899,7198,1299
167650,2019-11-12 00:00:00+03:00,in,False,-1,True,1,0,7,7
167650,2019-11-12 00:00:00+03:00,out,False,921318,True,21,0,363,363
167650,2019-11-12 00:00:00+03:00,out,False,921320,True,7,0,140,140
167650,2019-11-12 00:00:00+03:00,in,False,921318,False,54,4830,5719,889
167650,2019-11-12 00:00:00+03:00,out,False,921320,False,11,436,613,177
167650,2019-11-12 00:00:00+03:00,out,False,931458,True,22,0,436,436
167650,2019-11-12 00:00:00+03:00,in,False,931458,False,67,5709,6781,1072
167650,2019-11-12 00:00:00+03:00,in,False,-1,True,41,0,1092,1092
167650,2019-11-12 00:00:00+03:00,out,False,921318,False,25,1859,2165,306
167650,2019-11-12 00:00:00+03:00,out,False,931458,False,36,2378,2885,507
167650,2019-11-12 00:00:00+03:00,out,True,931458,True,2,0,11,11
167650,2019-11-12 00:00:00+03:00,out,False,921318,True,21,0,363,363
167650,2019-11-13 00:00:00+03:00,in,False,931458,True,1,0,55,55
167650,2019-11-13 00:00:00+03:00,out,False,921306,True,3,0,57,57
167650,2019-11-13 00:00:00+03:00,out,False,931458,True,17,0,301,301
167650,2019-11-13 00:00:00+03:00,out,False,921318,False,28,2762,3111,349
167650,2019-11-13 00:00:00+03:00,in,False,-1,True,52,0,1859,1859
167650,2019-11-13 00:00:00+03:00,in,False,921318,False,64,6321,7425,1104
167650,2019-11-13 00:00:00+03:00,out,False,931458,False,33,2097,2546,449
167650,2019-11-13 00:00:00+03:00,out,False,921318,True,22,0,372,372
167650,2019-11-13 00:00:00+03:00,out,False,921320,False,2,110,144,34
167650,2019-11-13 00:00:00+03:00,in,False,931458,False,74,6887,7871,984
167650,2019-11-13 00:00:00+03:00,in,False,921306,False,2,124,169,45
167650,2019-11-13 00:00:00+03:00,out,False,921306,False,2,88,122,34
167650,2019-11-14 00:00:00+03:00,out,False,921320,True,3,0,51,51
167650,2019-11-14 00:00:00+03:00,in,False,921320,False,1,61,104,43
167650,2019-11-14 00:00:00+03:00,in,False,-1,True,88,0,5198,5198
167650,2019-11-14 00:00:00+03:00,in,False,931458,False,80,6877,8849,1972
167650,2019-11-14 00:00:00+03:00,out,False,931458,False,47,3995,4601,606
167650,2019-11-14 00:00:00+03:00,out,False,931458,True,48,0,933,933
167650,2019-11-14 00:00:00+03:00,in,False,931458,True,1,1,43,42
167650,2019-11-14 00:00:00+03:00,in,False,921318,False,35,2901,3569,668
167650,2019-11-14 00:00:00+03:00,out,False,921318,False,3,139,169,30
167650,2019-11-14 00:00:00+03:00,out,False,921320,False,5,125,240,115
167650,2019-11-14 00:00:00+03:00,out,False,921318,True,4,0,61,61
167650,2019-11-14 00:00:00+03:00,out,False,921320,False,5,125,240,115
167650,2019-11-15 00:00:00+03:00,in,False,931458,False,63,5216,5958,742
167650,2019-11-15 00:00:00+03:00,out,False,921318,True,32,0,494,494
167650,2019-11-15 00:00:00+03:00,out,False,921320,False,1,54,61,7
167650,2019-11-15 00:00:00+03:00,out,False,921306,False,26,1214,1786,572
167650,2019-11-15 00:00:00+03:00,out,False,931458,True,12,0,274,274
167650,2019-11-15 00:00:00+03:00,out,False,921306,True,14,0,489,489
167650,2019-11-15 00:00:00+03:00,in,False,921306,False,1,84,104,20
167650,2019-11-15 00:00:00+03:00,in,False,-1,True,29,0,1108,1108
167650,2019-11-15 00:00:00+03:00,in,False,921318,False,52,5705,6520,815
167650,2019-11-15 00:00:00+03:00,out,False,921318,False,18,894,1063,169
167650,2019-11-15 00:00:00+03:00,out,False,931458,False,24,2584,2944,360
167650,2019-11-15 00:00:00+03:00,out,False,921306,True,14,0,489,489
167650,2019-11-16 00:00:00+03:00,in,False,921318,False,89,8804,10710,1906
167650,2019-11-16 00:00:00+03:00,out,False,921318,True,35,0,578,578
167650,2019-11-16 00:00:00+03:00,out,True,921318,True,1,0,0,0
167650,2019-11-16 00:00:00+03:00,out,False,921318,False,35,2860,3357,497
167650,2019-11-16 00:00:00+03:00,in,False,921306,False,13,1203,1731,528
167650,2019-11-16 00:00:00+03:00,out,False,921306,True,2,0,74,74
167650,2019-11-16 00:00:00+03:00,out,False,921306,False,6,274,343,69
167650,2019-11-16 00:00:00+03:00,in,False,-1,True,59,0,2467,2467
167650,2019-11-16 00:00:00+03:00,in,False,921318,True,1,0,20,20
167650,2019-11-17 00:00:00+03:00,in,False,921318,True,1,0,35,35
167650,2019-11-17 00:00:00+03:00,out,False,921318,True,49,0,799,799
167650,2019-11-17 00:00:00+03:00,in,False,921318,False,83,7124,9026,1902
167650,2019-11-17 00:00:00+03:00,out,False,921318,False,43,2655,3221,566
167650,2019-11-17 00:00:00+03:00,out,False,921306,False,7,432,616,184
167650,2019-11-17 00:00:00+03:00,in,False,921306,False,3,206,306,100
167650,2019-11-17 00:00:00+03:00,in,False,-1,True,1,0,28,28
167650,2019-11-17 00:00:00+03:00,in,False,-1,True,55,0,2256,2256
167650,2019-11-18 00:00:00+03:00,in,False,931458,False,80,6708,8321,1613
167650,2019-11-18 00:00:00+03:00,in,False,-1,True,66,0,2839,2839
167650,2019-11-18 00:00:00+03:00,out,False,921318,False,27,2315,2643,328
167650,2019-11-18 00:00:00+03:00,in,False,921318,False,76,6320,7554,1234
167650,2019-11-18 00:00:00+03:00,out,False,931458,True,26,0,693,693
167650,2019-11-18 00:00:00+03:00,in,False,921320,False,1,16,51,35
167650,2019-11-18 00:00:00+03:00,out,False,931458,False,28,1829,2254,425
167650,2019-11-18 00:00:00+03:00,out,False,921318,True,31,0,494,494
167650,2019-11-18 00:00:00+03:00,out,False,931458,False,28,1829,2254,425
167650,2019-11-19 00:00:00+03:00,in,False,921318,False,85,7677,8994,1317
167650,2019-11-19 00:00:00+03:00,out,False,921320,False,12,297,530,233
167650,2019-11-19 00:00:00+03:00,out,False,931458,True,14,0,329,329
167650,2019-11-19 00:00:00+03:00,out,False,921306,True,2,0,32,32
167650,2019-11-19 00:00:00+03:00,in,False,931458,False,79,6347,7750,1403
167650,2019-11-19 00:00:00+03:00,in,False,-1,True,57,0,2497,2497
167650,2019-11-19 00:00:00+03:00,out,False,921318,False,28,1689,2029,340
167650,2019-11-19 00:00:00+03:00,out,False,921306,False,6,786,897,111
167650,2019-11-19 00:00:00+03:00,out,False,931458,False,20,1456,1715,259
167650,2019-11-19 00:00:00+03:00,in,False,921320,False,4,373,481,108
167650,2019-11-19 00:00:00+03:00,in,False,931458,True,1,0,9,9
167650,2019-11-19 00:00:00+03:00,out,False,921318,True,48,0,693,693
167650,2019-11-19 00:00:00+03:00,out,False,921320,True,8,0,251,251
167650,2019-11-20 00:00:00+03:00,in,False,-1,True,61,0,2503,2503
167650,2019-11-20 00:00:00+03:00,out,False,921306,True,17,0,737,737
167650,2019-11-20 00:00:00+03:00,out,False,921320,False,10,292,430,138
167650,2019-11-20 00:00:00+03:00,in,False,921320,False,2,280,296,16
167650,2019-11-20 00:00:00+03:00,out,False,931458,True,28,0,543,543
167650,2019-11-20 00:00:00+03:00,out,False,931458,False,44,4260,4867,607
167650,2019-11-20 00:00:00+03:00,in,False,931458,False,97,9283,10941,1658
167650,2019-11-20 00:00:00+03:00,out,False,921306,False,10,737,901,164
167650,2019-11-20 00:00:00+03:00,out,False,921320,True,7,0,247,247
167650,2019-11-20 00:00:00+03:00,in,False,921306,False,5,787,923,136
167650,2019-11-20 00:00:00+03:00,in,False,931458,True,1,1,75,74
167650,2019-11-20 00:00:00+03:00,out,False,921306,True,17,0,737,737
167650,2019-11-21 00:00:00+03:00,out,False,921306,True,10,0,308,308
167650,2019-11-21 00:00:00+03:00,in,False,921320,False,9,966,1161,195
167650,2019-11-21 00:00:00+03:00,in,False,931458,False,94,9403,11329,1926
167650,2019-11-21 00:00:00+03:00,in,False,921306,False,15,1817,2170,353
167650,2019-11-21 00:00:00+03:00,in,False,-1,True,59,0,2265,2265
167650,2019-11-21 00:00:00+03:00,out,False,921320,True,12,0,323,323
167650,2019-11-21 00:00:00+03:00,out,False,921320,False,19,525,899,374
167650,2019-11-21 00:00:00+03:00,out,False,931458,False,51,3212,3894,682
167650,2019-11-21 00:00:00+03:00,out,False,931458,True,48,0,955,955
167650,2019-11-21 00:00:00+03:00,in,False,921320,True,1,1,43,42
167650,2019-11-21 00:00:00+03:00,out,False,921306,False,23,1068,1502,434
167650,2019-11-22 00:00:00+03:00,out,False,931458,False,15,734,876,142
167650,2019-11-22 00:00:00+03:00,in,False,921306,False,2,279,350,71
167650,2019-11-22 00:00:00+03:00,in,False,921318,False,56,5062,6197,1135
167650,2019-11-22 00:00:00+03:00,out,True,921318,True,1,0,0,0
167650,2019-11-22 00:00:00+03:00,out,False,921306,True,8,0,209,209
167650,2019-11-22 00:00:00+03:00,out,False,931458,True,64,0,617,617
167650,2019-11-22 00:00:00+03:00,in,False,-1,True,32,0,1312,1312
167650,2019-11-22 00:00:00+03:00,out,False,921318,False,17,1732,1952,220
167650,2019-11-22 00:00:00+03:00,in,False,931458,False,50,4037,4994,957
167650,2019-11-22 00:00:00+03:00,out,False,-1,True,1,0,0,0
167650,2019-11-22 00:00:00+03:00,out,False,921318,True,36,0,769,769
167650,2019-11-22 00:00:00+03:00,out,False,921306,False,5,167,277,110
167650,2019-11-22 00:00:00+03:00,in,False,921318,False,56,5062,6197,1135
167650,2019-11-22 00:00:00+03:00,out,False,931458,False,15,734,876,142
167650,2019-11-22 00:00:00+03:00,out,False,921306,False,5,167,277,110
167650,2019-11-23 00:00:00+03:00,in,False,921318,False,66,6647,7891,1244
167650,2019-11-23 00:00:00+03:00,out,False,921306,True,4,0,110,110
167650,2019-11-23 00:00:00+03:00,in,False,921306,False,3,232,348,116
167650,2019-11-23 00:00:00+03:00,out,False,931458,True,38,0,211,211
167650,2019-11-23 00:00:00+03:00,out,False,921306,False,9,522,685,163
167650,2019-11-23 00:00:00+03:00,out,False,921318,True,37,0,593,593
167650,2019-11-23 00:00:00+03:00,out,False,921318,False,26,1535,1838,303
167650,2019-11-23 00:00:00+03:00,in,False,-1,True,36,0,1642,1642
167650,2019-11-23 00:00:00+03:00,out,False,931458,False,3,38,55,17
167650,2019-11-24 00:00:00+03:00,out,False,931458,False,7,63,107,44
167650,2019-11-24 00:00:00+03:00,in,False,921318,False,58,5306,6293,987
167650,2019-11-24 00:00:00+03:00,out,False,921318,False,32,2004,2348,344
167650,2019-11-24 00:00:00+03:00,out,False,931458,True,24,0,183,183
167650,2019-11-24 00:00:00+03:00,in,False,921320,False,9,950,1104,154
167650,2019-11-24 00:00:00+03:00,in,False,-1,True,35,0,1538,1538
167650,2019-11-24 00:00:00+03:00,out,False,921320,False,7,250,317,67
167650,2019-11-24 00:00:00+03:00,out,False,921320,True,7,0,237,237
167650,2019-11-24 00:00:00+03:00,out,False,921318,True,55,0,699,699
167650,2019-11-24 00:00:00+03:00,out,False,921320,False,7,250,317,67
167650,2019-11-25 00:00:00+03:00,out,False,931458,False,20,1328,1527,199
167650,2019-11-25 00:00:00+03:00,out,False,931458,True,20,0,354,354
167650,2019-11-25 00:00:00+03:00,in,False,931458,False,59,5765,6625,860
167650,2019-11-25 00:00:00+03:00,in,False,-1,True,27,0,874,874
167650,2019-11-25 00:00:00+03:00,in,False,921306,False,4,292,389,97
167650,2019-11-25 00:00:00+03:00,out,False,921318,False,17,1495,1701,206
167650,2019-11-25 00:00:00+03:00,out,False,921306,True,10,0,272,272
167650,2019-11-25 00:00:00+03:00,out,False,921318,True,15,0,228,228
167650,2019-11-25 00:00:00+03:00,in,False,931458,True,2,0,53,53
167650,2019-11-25 00:00:00+03:00,in,False,921318,False,43,5234,5876,642
167650,2019-11-25 00:00:00+03:00,out,False,921306,False,9,441,666,225
167650,2019-11-25 00:00:00+03:00,out,False,921320,False,13,401,650,249
167650,2019-11-25 00:00:00+03:00,out,False,921320,True,4,0,135,135
167650,2019-11-25 00:00:00+03:00,in,False,921320,False,1,76,111,35
167650,2019-11-25 00:00:00+03:00,in,False,921318,False,43,5234,5876,642
167650,2019-11-25 00:00:00+03:00,out,False,921320,True,4,0,135,135
167650,2019-11-26 00:00:00+03:00,out,False,921320,True,5,0,201,201
167650,2019-11-26 00:00:00+03:00,in,False,-1,True,45,0,1804,1804
167650,2019-11-26 00:00:00+03:00,in,False,921320,False,8,1001,1133,132
167650,2019-11-26 00:00:00+03:00,out,False,921320,False,11,485,759,274
167650,2019-11-26 00:00:00+03:00,out,False,931458,False,51,3075,3763,688
167650,2019-11-26 00:00:00+03:00,in,False,931458,True,1,0,37,37
167650,2019-11-26 00:00:00+03:00,in,False,931458,False,74,6961,8762,1801
167650,2019-11-26 00:00:00+03:00,out,False,931458,True,43,0,942,942
167650,2019-11-26 00:00:00+03:00,out,False,921320,True,5,0,201,201
167650,2019-11-27 00:00:00+03:00,out,False,921318,False,19,2173,2388,215
167650,2019-11-27 00:00:00+03:00,in,False,921318,False,51,5657,6285,628
167650,2019-11-27 00:00:00+03:00,in,False,931458,False,42,3316,3963,647
167650,2019-11-27 00:00:00+03:00,out,False,931458,False,33,2123,2537,414
167650,2019-11-27 00:00:00+03:00,in,False,921320,False,1,248,266,18
167650,2019-11-27 00:00:00+03:00,in,False,-1,True,26,0,753,753
167650,2019-11-27 00:00:00+03:00,out,False,931458,True,26,0,624,624
167650,2019-11-27 00:00:00+03:00,out,False,921306,False,3,117,192,75
167650,2019-11-27 00:00:00+03:00,out,False,921306,True,11,0,325,325
167650,2019-11-27 00:00:00+03:00,out,False,921320,True,4,0,74,74
167650,2019-11-27 00:00:00+03:00,out,False,921318,True,11,0,156,156
167650,2019-11-27 00:00:00+03:00,out,False,921320,False,5,132,184,52
167650,2019-11-27 00:00:00+03:00,in,False,921306,False,2,144,165,21
167650,2019-11-27 00:00:00+03:00,out,False,921306,False,3,117,192,75
167650,2019-11-28 00:00:00+03:00,out,False,921306,False,10,381,537,156
167650,2019-11-28 00:00:00+03:00,in,False,-1,True,73,0,3353,3353
167650,2019-11-28 00:00:00+03:00,out,False,921320,True,1,0,52,52
167650,2019-11-28 00:00:00+03:00,out,False,921318,True,45,0,680,680
167650,2019-11-28 00:00:00+03:00,out,False,921320,False,3,55,93,38
167650,2019-11-28 00:00:00+03:00,in,False,921318,False,92,9740,11782,2042
167650,2019-11-28 00:00:00+03:00,in,False,921306,False,11,602,973,371
167650,2019-11-28 00:00:00+03:00,out,False,921318,False,22,1759,2006,247
167650,2019-11-28 00:00:00+03:00,in,False,921320,False,1,18,22,4
167650,2019-11-28 00:00:00+03:00,out,False,921306,True,2,0,50,50
167650,2019-11-28 00:00:00+03:00,in,False,921306,False,11,602,973,371
167653,2019-10-17 00:00:00+03:00,in,False,-1,True,2,0,8,8
167653,2019-10-17 00:00:00+03:00,in,False,939706,False,1,7,33,26
167653,2019-10-18 00:00:00+03:00,out,False,939706,False,1,3,7,4
167653,2019-10-18 00:00:00+03:00,in,False,-1,True,14,0,148,148
167653,2019-10-18 00:00:00+03:00,out,False,939706,True,15,0,232,232
167653,2019-10-18 00:00:00+03:00,in,False,939706,False,5,263,323,60
167653,2019-10-19 00:00:00+03:00,in,False,-1,True,4,0,73,73
167653,2019-10-19 00:00:00+03:00,in,False,939706,False,2,59,84,25
167653,2019-10-20 00:00:00+03:00,in,False,-1,True,1,0,0,0
167653,2019-10-21 00:00:00+03:00,in,False,939706,False,2,136,152,16
167653,2019-10-21 00:00:00+03:00,in,False,-1,True,10,0,123,123
167653,2019-10-22 00:00:00+03:00,in,False,939706,False,3,183,218,35
167653,2019-10-22 00:00:00+03:00,in,False,-1,True,6,0,65,65
167653,2019-10-22 00:00:00+03:00,in,False,-1,True,6,0,65,65
167653,2019-10-22 00:00:00+03:00,in,False,939706,False,3,183,218,35
167653,2019-10-23 00:00:00+03:00,in,False,-1,True,1,0,10,10
167653,2019-10-24 00:00:00+03:00,in,False,-1,True,4,0,82,82
167653,2019-10-24 00:00:00+03:00,in,False,939706,False,1,10,20,10
167653,2019-10-25 00:00:00+03:00,in,False,939706,False,1,5,9,4
167653,2019-10-25 00:00:00+03:00,in,False,-1,True,9,0,98,98
167653,2019-10-26 00:00:00+03:00,in,False,939706,False,3,205,251,46
167653,2019-10-26 00:00:00+03:00,in,False,-1,True,10,0,124,124
167653,2019-10-29 00:00:00+03:00,in,False,-1,True,3,0,16,16
167653,2019-10-30 00:00:00+03:00,in,False,-1,True,1,0,5,5
167653,2019-10-31 00:00:00+03:00,in,False,939706,False,1,90,105,15
167653,2019-10-31 00:00:00+03:00,in,False,-1,True,2,0,2,2
167653,2019-11-01 00:00:00+03:00,in,False,-1,True,3,0,18,18
167653,2019-11-02 00:00:00+03:00,in,False,-1,True,5,0,75,75
167653,2019-11-04 00:00:00+03:00,in,False,939706,False,1,53,57,4
167653,2019-11-04 00:00:00+03:00,in,False,939708,False,1,23,31,8
167653,2019-11-04 00:00:00+03:00,in,False,-1,True,5,0,56,56
167653,2019-11-05 00:00:00+03:00,in,False,-1,True,5,0,84,84
167653,2019-11-05 00:00:00+03:00,in,False,-1,True,5,0,84,84
167653,2019-11-06 00:00:00+03:00,in,False,-1,True,2,0,44,44
167653,2019-11-07 00:00:00+03:00,in,False,939706,False,17,579,659,80
167653,2019-11-07 00:00:00+03:00,in,False,-1,True,68,0,928,928
167653,2019-11-07 00:00:00+03:00,in,False,939708,False,1,39,44,5
167653,2019-11-08 00:00:00+03:00,out,False,939706,True,1,0,23,23
167653,2019-11-08 00:00:00+03:00,in,False,939706,True,1,1,4,3
167653,2019-11-08 00:00:00+03:00,out,False,939706,False,3,84,116,32
167653,2019-11-08 00:00:00+03:00,in,False,-1,True,57,0,584,584
167653,2019-11-08 00:00:00+03:00,in,False,939706,False,10,573,628,55
167653,2019-11-09 00:00:00+03:00,in,False,939706,False,12,645,710,65
167653,2019-11-09 00:00:00+03:00,in,False,-1,True,38,0,515,515
167653,2019-11-10 00:00:00+03:00,in,False,-1,True,16,0,0,0
167653,2019-11-11 00:00:00+03:00,in,False,939706,True,1,0,14,14
167653,2019-11-11 00:00:00+03:00,in,False,939706,False,27,2229,2474,245
167653,2019-11-11 00:00:00+03:00,in,False,-1,True,80,0,947,947
167653,2019-11-11 00:00:00+03:00,out,False,939706,False,4,147,194,47
167653,2019-11-11 00:00:00+03:00,out,False,939706,False,4,147,194,47
167653,2019-11-12 00:00:00+03:00,out,False,939706,True,13,0,332,332
167653,2019-11-12 00:00:00+03:00,in,False,-1,True,44,0,692,692
167653,2019-11-12 00:00:00+03:00,in,False,939708,True,1,1,6,5
167653,2019-11-12 00:00:00+03:00,out,False,939706,False,74,2627,3773,1146
167653,2019-11-12 00:00:00+03:00,in,False,939708,False,3,188,229,41
167653,2019-11-12 00:00:00+03:00,in,False,939706,False,27,1927,2232,305
167653,2019-11-13 00:00:00+03:00,in,False,-1,True,53,0,667,667
167653,2019-11-13 00:00:00+03:00,out,False,939706,False,1,30,39,9
167653,2019-11-14 00:00:00+03:00,in,False,-1,True,63,0,967,967
167653,2019-11-14 00:00:00+03:00,out,False,939706,False,11,703,872,169
167653,2019-11-14 00:00:00+03:00,out,False,939706,True,5,0,98,98
167653,2019-11-14 00:00:00+03:00,in,False,939706,False,22,2034,2226,192
167653,2019-11-15 00:00:00+03:00,in,False,939706,False,21,1012,1153,141
167653,2019-11-15 00:00:00+03:00,in,False,-1,True,36,0,524,524
167653,2019-11-15 00:00:00+03:00,in,False,939708,False,1,78,88,10
167653,2019-11-16 00:00:00+03:00,out,False,939706,False,14,622,861,239
167653,2019-11-16 00:00:00+03:00,in,False,-1,True,24,0,493,493
167653,2019-11-16 00:00:00+03:00,out,False,939706,True,7,0,218,218
167653,2019-11-16 00:00:00+03:00,in,False,939706,True,1,0,7,7
167653,2019-11-16 00:00:00+03:00,in,False,939706,False,9,583,643,60
167653,2019-11-16 00:00:00+03:00,in,False,939706,False,9,583,643,60
167653,2019-11-17 00:00:00+03:00,in,False,-1,True,9,0,220,220
167653,2019-11-17 00:00:00+03:00,out,False,939706,True,7,0,150,150
167653,2019-11-17 00:00:00+03:00,out,False,939706,False,20,578,900,322
167653,2019-11-17 00:00:00+03:00,in,False,939706,False,4,401,424,23
167653,2019-11-18 00:00:00+03:00,in,False,939706,False,16,1314,1430,116
167653,2019-11-18 00:00:00+03:00,in,False,-1,True,54,0,733,733
167653,2019-11-19 00:00:00+03:00,in,False,-1,True,38,0,557,557
167653,2019-11-19 00:00:00+03:00,in,False,939706,True,1,0,2,2
167653,2019-11-19 00:00:00+03:00,out,False,939706,False,36,1330,1873,543
167653,2019-11-19 00:00:00+03:00,out,False,939706,True,17,0,404,404
167653,2019-11-19 00:00:00+03:00,in,False,939706,False,32,2791,3040,249
167653,2019-11-20 00:00:00+03:00,out,False,939706,True,22,0,469,469
167653,2019-11-20 00:00:00+03:00,out,False,939706,False,33,2077,2659,582
167653,2019-11-20 00:00:00+03:00,in,False,939706,False,43,2581,2951,370
167653,2019-11-20 00:00:00+03:00,in,False,-1,True,51,0,760,760
167653,2019-11-20 00:00:00+03:00,in,False,939706,False,43,2581,2951,370
167653,2019-11-21 00:00:00+03:00,in,False,939706,False,33,2513,2866,353
167653,2019-11-21 00:00:00+03:00,in,False,939708,False,1,16,38,22
167653,2019-11-21 00:00:00+03:00,in,False,-1,True,56,0,619,619
167653,2019-11-21 00:00:00+03:00,out,False,939706,True,27,0,691,691
167653,2019-11-21 00:00:00+03:00,out,False,939706,False,75,2639,3891,1252
167653,2019-11-22 00:00:00+03:00,out,True,939706,True,3,0,4,4
167653,2019-11-22 00:00:00+03:00,out,False,939706,True,42,0,923,923
167653,2019-11-22 00:00:00+03:00,in,False,-1,True,41,0,714,714
167653,2019-11-22 00:00:00+03:00,in,False,939706,False,37,2653,2991,338
167653,2019-11-22 00:00:00+03:00,out,False,939706,False,100,3610,5170,1560
167653,2019-11-23 00:00:00+03:00,out,False,939706,True,25,0,706,706
167653,2019-11-23 00:00:00+03:00,in,False,-1,True,27,0,529,529
167653,2019-11-23 00:00:00+03:00,out,False,939706,False,69,2894,4150,1256
167653,2019-11-23 00:00:00+03:00,in,False,939706,False,39,2138,2462,324
167653,2019-11-24 00:00:00+03:00,in,False,-1,True,23,0,446,446
167653,2019-11-25 00:00:00+03:00,in,False,939706,False,42,3257,3749,492
167653,2019-11-25 00:00:00+03:00,out,False,939706,False,54,2443,3308,865
167653,2019-11-25 00:00:00+03:00,in,False,-1,True,47,0,802,802
167653,2019-11-25 00:00:00+03:00,out,False,939708,False,26,2249,2641,392
167653,2019-11-25 00:00:00+03:00,in,False,939708,False,2,143,176,33
167653,2019-11-25 00:00:00+03:00,out,False,939708,True,10,0,178,178
167653,2019-11-25 00:00:00+03:00,out,False,939706,True,22,0,501,501
167653,2019-11-25 00:00:00+03:00,out,True,939706,True,1,0,4,4
167653,2019-11-25 00:00:00+03:00,in,False,939706,False,42,3257,3749,492
167653,2019-11-25 00:00:00+03:00,in,False,-1,True,47,0,802,802
167653,2019-11-26 00:00:00+03:00,out,False,939706,True,29,0,665,665
167653,2019-11-26 00:00:00+03:00,out,True,939706,True,3,0,9,9
167653,2019-11-26 00:00:00+03:00,out,False,939706,False,88,3870,5170,1300
167653,2019-11-26 00:00:00+03:00,in,False,-1,True,37,0,660,660
167653,2019-11-26 00:00:00+03:00,in,False,939706,False,32,2051,2367,316
167653,2019-11-27 00:00:00+03:00,in,False,-1,True,33,0,488,488
167653,2019-11-27 00:00:00+03:00,out,False,939706,False,57,2822,3616,794
167653,2019-11-27 00:00:00+03:00,out,False,939706,True,19,0,457,457
167653,2019-11-27 00:00:00+03:00,in,False,939706,False,35,3391,3829,438
167653,2019-11-28 00:00:00+03:00,in,False,-1,True,73,0,1236,1236
167653,2019-11-28 00:00:00+03:00,out,False,939706,False,97,3701,5334,1633
167653,2019-11-28 00:00:00+03:00,out,False,939706,True,28,0,467,467
167653,2019-11-28 00:00:00+03:00,in,False,939706,False,37,2779,3130,351
167653,2019-11-28 00:00:00+03:00,in,False,939706,False,37,2779,3130,351
167654,2019-09-24 00:00:00+03:00,in,False,918986,False,1,9,14,5
167654,2019-09-24 00:00:00+03:00,in,False,918978,False,4,68,101,33
167654,2019-10-01 00:00:00+03:00,out,False,918988,True,1,0,0,0
167654,2019-10-01 00:00:00+03:00,in,False,918988,False,1,16,29,13
167654,2019-10-01 00:00:00+03:00,in,False,-1,True,2,0,6,6
167654,2019-10-01 00:00:00+03:00,out,False,918986,True,1,0,0,0
167654,2019-10-01 00:00:00+03:00,out,False,918978,True,3,0,0,0
167654,2019-10-01 00:00:00+03:00,in,False,918986,False,1,4,10,6
167654,2019-10-04 00:00:00+03:00,out,False,918986,False,11,923,1059,136
167654,2019-10-04 00:00:00+03:00,out,False,918978,True,6,0,184,184
167654,2019-10-04 00:00:00+03:00,in,False,918986,False,1,92,105,13
167654,2019-10-04 00:00:00+03:00,out,False,918978,False,16,657,916,259
167654,2019-10-04 00:00:00+03:00,out,False,918986,True,8,0,189,189
167654,2019-10-04 00:00:00+03:00,out,True,918978,True,1,0,1,1
167654,2019-10-05 00:00:00+03:00,out,False,918978,True,7,0,259,259
167654,2019-10-05 00:00:00+03:00,out,False,918978,False,21,1334,1851,517
167654,2019-10-05 00:00:00+03:00,in,False,918978,True,1,0,14,14
167654,2019-10-06 00:00:00+03:00,out,False,918986,True,4,0,96,96
167654,2019-10-06 00:00:00+03:00,out,False,918986,False,6,363,459,96
167654,2019-10-07 00:00:00+03:00,out,False,918986,True,1,0,56,56
167654,2019-10-07 00:00:00+03:00,out,False,918986,False,5,352,425,73
167654,2019-10-07 00:00:00+03:00,out,False,918978,False,7,237,314,77
167654,2019-10-07 00:00:00+03:00,out,False,918978,True,1,0,41,41
167654,2019-10-07 00:00:00+03:00,out,False,-1,True,1,0,0,0
167654,2019-10-07 00:00:00+03:00,in,False,-1,True,1,0,2,2
167654,2019-10-07 00:00:00+03:00,in,False,918986,False,1,137,154,17
167654,2019-10-08 00:00:00+03:00,out,False,918978,False,4,62,96,34
167654,2019-10-08 00:00:00+03:00,out,False,918986,False,5,277,359,82
167654,2019-10-08 00:00:00+03:00,in,False,-1,True,2,0,88,88
167654,2019-10-08 00:00:00+03:00,out,False,918986,True,9,0,329,329
167654,2019-10-09 00:00:00+03:00,in,False,918978,False,1,19,27,8
167654,2019-10-09 00:00:00+03:00,out,False,-1,True,1,0,0,0
167654,2019-10-09 00:00:00+03:00,in,False,918986,False,1,95,109,14
167654,2019-10-09 00:00:00+03:00,out,False,918986,True,16,0,412,412
167654,2019-10-09 00:00:00+03:00,out,False,918978,True,14,0,538,538
167654,2019-10-09 00:00:00+03:00,out,False,918986,False,35,2374,3023,649
167654,2019-10-09 00:00:00+03:00,in,False,-1,True,1,0,13,13
167654,2019-10-09 00:00:00+03:00,out,False,918978,False,28,1754,2266,512
167654,2019-10-10 00:00:00+03:00,in,False,-1,True,1,0,9,9
167654,2019-10-11 00:00:00+03:00,out,False,918986,True,3,0,63,63
167654,2019-10-11 00:00:00+03:00,out,False,918986,False,3,53,107,54
167654,2019-10-11 00:00:00+03:00,in,False,-1,True,1,0,13,13
167654,2019-10-14 00:00:00+03:00,out,False,918986,False,1,5,42,37
167654,2019-10-15 00:00:00+03:00,in,False,-1,True,1,0,4,4
167654,2019-10-15 00:00:00+03:00,out,False,918978,False,6,402,500,98
167654,2019-10-15 00:00:00+03:00,out,False,918986,False,5,62,135,73
167654,2019-10-15 00:00:00+03:00,out,False,918978,True,1,0,27,27
167654,2019-10-15 00:00:00+03:00,in,False,918986,False,1,11,23,12
167654,2019-10-15 00:00:00+03:00,out,False,918986,True,1,0,60,60
167654,2019-10-15 00:00:00+03:00,in,False,918978,False,1,35,42,7
167654,2019-10-16 00:00:00+03:00,in,False,918978,False,2,185,207,22
167654,2019-10-16 00:00:00+03:00,out,False,918986,False,11,289,471,182
167654,2019-10-16 00:00:00+03:00,out,False,918978,True,3,0,63,63
167654,2019-10-16 00:00:00+03:00,out,False,918986,True,2,0,67,67
167654,2019-10-16 00:00:00+03:00,out,False,918978,False,10,493,678,185
167654,2019-10-16 00:00:00+03:00,in,False,-1,True,1,0,13,13
167654,2019-10-16 00:00:00+03:00,out,False,918986,False,11,289,471,182
167654,2019-10-17 00:00:00+03:00,out,False,918986,False,8,626,750,124
167654,2019-10-17 00:00:00+03:00,out,False,918978,True,3,0,79,79
167654,2019-10-17 00:00:00+03:00,out,False,918978,False,11,563,752,189
167654,2019-10-17 00:00:00+03:00,out,False,918986,True,3,0,39,39
167654,2019-10-17 00:00:00+03:00,out,False,918986,False,8,626,750,124
167654,2019-10-18 00:00:00+03:00,in,False,918978,False,1,17,21,4
167654,2019-10-18 00:00:00+03:00,in,False,918986,False,3,265,308,43
167654,2019-10-18 00:00:00+03:00,out,False,918978,False,1,24,40,16
167654,2019-10-18 00:00:00+03:00,out,False,918986,False,2,85,125,40
167654,2019-10-18 00:00:00+03:00,in,False,-1,True,2,0,51,51
167654,2019-10-18 00:00:00+03:00,in,False,918986,False,3,265,308,43
167654,2019-10-19 00:00:00+03:00,in,False,918978,False,3,954,994,40
167654,2019-10-19 00:00:00+03:00,in,False,-1,True,3,0,94,94
167654,2019-10-19 00:00:00+03:00,out,False,918978,True,1,0,28,28
167654,2019-10-19 00:00:00+03:00,out,False,918978,False,2,376,406,30
167654,2019-10-19 00:00:00+03:00,in,False,-1,True,3,0,94,94
167654,2019-10-20 00:00:00+03:00,in,False,-1,True,1,0,6,6
167654,2019-10-21 00:00:00+03:00,out,False,918978,True,5,0,89,89
167654,2019-10-21 00:00:00+03:00,in,False,918978,False,7,925,1004,79
167654,2019-10-21 00:00:00+03:00,out,False,918986,False,3,31,62,31
167654,2019-10-21 00:00:00+03:00,in,False,918986,False,18,2315,2503,188
167654,2019-10-21 00:00:00+03:00,out,False,918986,True,3,0,102,102
167654,2019-10-21 00:00:00+03:00,out,False,918978,False,10,547,679,132
167654,2019-10-21 00:00:00+03:00,in,False,-1,True,12,0,409,409
167654,2019-10-22 00:00:00+03:00,in,False,-1,True,19,0,501,501
167654,2019-10-22 00:00:00+03:00,out,False,918986,True,5,0,184,184
167654,2019-10-22 00:00:00+03:00,out,False,918986,False,11,518,706,188
167654,2019-10-22 00:00:00+03:00,in,False,918978,False,15,2137,2282,145
167654,2019-10-22 00:00:00+03:00,out,False,918978,False,20,1320,1596,276
167654,2019-10-22 00:00:00+03:00,out,False,918978,True,14,0,230,230
167654,2019-10-22 00:00:00+03:00,in,False,918986,False,12,1604,1735,131
167654,2019-10-22 00:00:00+03:00,out,False,918978,True,14,0,230,230
167654,2019-10-23 00:00:00+03:00,out,False,918978,False,15,649,878,229
167654,2019-10-23 00:00:00+03:00,out,False,918986,False,13,565,815,250
167654,2019-10-23 00:00:00+03:00,in,False,918978,False,8,812,915,103
167654,2019-10-23 00:00:00+03:00,out,False,918986,True,7,0,103,103
167654,2019-10-23 00:00:00+03:00,in,False,-1,True,29,0,906,906
167654,2019-10-23 00:00:00+03:00,out,False,-1,True,1,0,0,0
167654,2019-10-23 00:00:00+03:00,out,False,918978,True,9,0,124,124
167654,2019-10-23 00:00:00+03:00,in,False,918986,False,9,743,846,103
167654,2019-10-24 00:00:00+03:00,in,False,-1,True,62,0,1773,1773
167654,2019-10-24 00:00:00+03:00,out,False,918978,True,15,0,334,334
167654,2019-10-24 00:00:00+03:00,in,False,918986,False,15,3124,3260,136
167654,2019-10-24 00:00:00+03:00,out,False,918986,False,14,683,899,216
167654,2019-10-24 00:00:00+03:00,out,False,918978,False,17,1257,1563,306
167654,2019-10-24 00:00:00+03:00,out,False,918986,True,4,0,29,29
167654,2019-10-24 00:00:00+03:00,in,False,918978,False,29,4193,4469,276
167654,2019-10-25 00:00:00+03:00,out,False,-1,True,7,0,0,0
167654,2019-10-25 00:00:00+03:00,in,False,918986,False,10,2295,2360,65
167654,2019-10-25 00:00:00+03:00,out,False,918978,False,28,1722,2151,429
167654,2019-10-25 00:00:00+03:00,in,False,-1,True,29,0,787,787
167654,2019-10-25 00:00:00+03:00,out,False,918986,False,5,548,622,74
167654,2019-10-25 00:00:00+03:00,in,False,918978,False,29,3258,3540,282
167654,2019-10-25 00:00:00+03:00,out,False,918978,True,33,0,254,254
167654,2019-10-25 00:00:00+03:00,out,False,918986,True,6,0,90,90
167654,2019-10-25 00:00:00+03:00,in,False,918986,False,10,2295,2360,65
167654,2019-10-26 00:00:00+03:00,out,False,918978,False,24,1756,2165,409
167654,2019-10-26 00:00:00+03:00,in,False,918978,False,18,2734,2901,167
167654,2019-10-26 00:00:00+03:00,out,False,918978,True,3,0,113,113
167654,2019-10-26 00:00:00+03:00,in,False,-1,True,27,0,425,425
167654,2019-10-27 00:00:00+03:00,in,False,918986,False,5,461,514,53
167654,2019-10-27 00:00:00+03:00,out,False,918986,False,21,1053,1489,436
167654,2019-10-27 00:00:00+03:00,in,False,-1,True,9,0,284,284
167654,2019-10-27 00:00:00+03:00,out,False,918986,True,15,0,574,574
167654,2019-10-28 00:00:00+03:00,in,False,-1,True,104,0,3335,3335
167654,2019-10-28 00:00:00+03:00,in,False,918978,False,20,3215,3444,229
167654,2019-10-28 00:00:00+03:00,out,False,-1,True,1,0,1,1
167654,2019-10-28 00:00:00+03:00,in,False,918986,False,21,2980,3210,230
167654,2019-10-28 00:00:00+03:00,out,False,918978,False,27,3604,4081,477
167654,2019-10-28 00:00:00+03:00,out,False,918986,True,9,0,114,114
167654,2019-10-28 00:00:00+03:00,out,False,918978,True,14,0,236,236
167654,2019-10-28 00:00:00+03:00,out,False,918986,False,24,1614,2011,397
167654,2019-10-29 00:00:00+03:00,out,False,918986,False,42,2892,3541,649
167654,2019-10-29 00:00:00+03:00,in,False,-1,True,31,0,727,727
167654,2019-10-29 00:00:00+03:00,out,False,918978,False,36,1660,2314,654
167654,2019-10-29 00:00:00+03:00,out,False,918978,True,11,0,311,311
167654,2019-10-29 00:00:00+03:00,out,False,-1,True,3,0,0,0
167654,2019-10-29 00:00:00+03:00,in,False,918978,True,1,0,30,30
167654,2019-10-29 00:00:00+03:00,in,False,918978,False,13,1542,1680,138
167654,2019-10-29 00:00:00+03:00,in,False,918986,False,12,3831,3947,116
167654,2019-10-29 00:00:00+03:00,out,False,918986,True,11,0,322,322
167654,2019-10-29 00:00:00+03:00,out,False,918978,True,11,0,311,311
167654,2019-10-29 00:00:00+03:00,in,False,918986,False,12,3831,3947,116
167654,2019-10-30 00:00:00+03:00,in,False,918986,False,21,2983,3208,225
167654,2019-10-30 00:00:00+03:00,out,False,918986,False,19,1393,1739,346
167654,2019-10-30 00:00:00+03:00,in,False,918978,False,23,3068,3320,252
167654,2019-10-30 00:00:00+03:00,out,False,918986,True,12,0,305,305
167654,2019-10-30 00:00:00+03:00,in,False,-1,True,47,0,868,868
167654,2019-10-30 00:00:00+03:00,out,False,918978,True,10,0,301,301
167654,2019-10-30 00:00:00+03:00,out,False,918978,False,27,1203,1731,528
167654,2019-10-31 00:00:00+03:00,out,False,918986,False,49,2321,3154,833
167654,2019-10-31 00:00:00+03:00,in,False,-1,True,60,0,1646,1646
167654,2019-10-31 00:00:00+03:00,out,False,918986,True,23,0,616,616
167654,2019-10-31 00:00:00+03:00,in,False,918978,False,14,1649,1804,155
167654,2019-10-31 00:00:00+03:00,out,False,918978,False,29,2613,3006,393
167654,2019-10-31 00:00:00+03:00,out,False,918978,True,5,0,94,94
167654,2019-10-31 00:00:00+03:00,in,False,918986,False,20,2052,2261,209
167654,2019-11-01 00:00:00+03:00,in,False,-1,True,31,0,746,746
167654,2019-11-01 00:00:00+03:00,out,False,918986,False,43,3436,4151,715
167654,2019-11-01 00:00:00+03:00,out,False,918978,False,28,1564,2028,464
167654,2019-11-01 00:00:00+03:00,out,False,918978,True,10,0,180,180
167654,2019-11-01 00:00:00+03:00,out,False,-1,True,2,0,0,0
167654,2019-11-01 00:00:00+03:00,in,False,918986,False,26,4375,4568,193
167654,2019-11-01 00:00:00+03:00,out,False,918986,True,20,0,358,358
167654,2019-11-01 00:00:00+03:00,in,False,918978,False,25,2575,2832,257
167654,2019-11-02 00:00:00+03:00,out,False,918978,False,32,2162,2708,546
167654,2019-11-02 00:00:00+03:00,out,False,918978,True,7,0,249,249
167654,2019-11-02 00:00:00+03:00,in,False,-1,True,34,0,788,788
167654,2019-11-02 00:00:00+03:00,in,False,918978,False,22,2687,2899,212
167654,2019-11-03 00:00:00+03:00,out,False,918986,True,10,0,176,176
167654,2019-11-03 00:00:00+03:00,out,False,918986,False,21,944,1315,371
167654,2019-11-03 00:00:00+03:00,in,False,-1,True,17,0,419,419
167654,2019-11-03 00:00:00+03:00,in,False,918986,False,8,1515,1595,80
167654,2019-11-04 00:00:00+03:00,in,False,-1,True,31,0,237,237
167654,2019-11-05 00:00:00+03:00,out,False,918986,True,8,0,162,162
167654,2019-11-05 00:00:00+03:00,out,True,918978,True,1,0,0,0
167654,2019-11-05 00:00:00+03:00,in,False,-1,True,100,0,2096,2096
167654,2019-11-05 00:00:00+03:00,in,False,918986,False,10,1678,1750,72
167654,2019-11-05 00:00:00+03:00,out,False,918978,True,22,0,444,444
167654,2019-11-05 00:00:00+03:00,out,False,918978,False,41,2281,2894,613
167654,2019-11-05 00:00:00+03:00,in,False,918978,False,31,5893,6147,254
167654,2019-11-05 00:00:00+03:00,out,False,918986,False,30,1703,2227,524
167654,2019-11-06 00:00:00+03:00,in,False,918986,False,26,3239,3488,249
167654,2019-11-06 00:00:00+03:00,out,False,918978,True,7,0,185,185
167654,2019-11-06 00:00:00+03:00,in,False,-1,True,69,0,1626,1626
167654,2019-11-06 00:00:00+03:00,out,False,918986,False,55,3100,4241,1141
167654,2019-11-06 00:00:00+03:00,in,False,918978,False,17,2770,2951,181
167654,2019-11-06 00:00:00+03:00,out,False,-1,True,2,0,0,0
167654,2019-11-06 00:00:00+03:00,out,False,918986,True,22,0,648,648
167654,2019-11-06 00:00:00+03:00,out,False,918978,False,29,2858,3385,527
167654,2019-11-06 00:00:00+03:00,in,False,918986,False,26,3239,3488,249
167654,2019-11-06 00:00:00+03:00,out,False,918978,False,29,2858,3385,527
167654,2019-11-07 00:00:00+03:00,in,False,918978,False,19,3018,3248,230
167654,2019-11-07 00:00:00+03:00,out,False,918986,True,25,0,650,650
167654,2019-11-07 00:00:00+03:00,out,False,918978,True,5,0,100,100
167654,2019-11-07 00:00:00+03:00,in,False,918986,False,18,2500,2661,161
167654,2019-11-07 00:00:00+03:00,out,False,918978,False,19,1879,2192,313
167654,2019-11-07 00:00:00+03:00,out,False,918986,False,48,4287,5164,877
167654,2019-11-07 00:00:00+03:00,in,False,-1,True,26,0,572,572
167654,2019-11-07 00:00:00+03:00,out,False,918986,False,48,4287,5164,877
167654,2019-11-07 00:00:00+03:00,in,False,918986,False,18,2500,2661,161
167654,2019-11-08 00:00:00+03:00,out,False,918978,False,23,1047,1474,427
167654,2019-11-08 00:00:00+03:00,out,False,918986,False,24,1494,1904,410
167654,2019-11-08 00:00:00+03:00,in,False,-1,True,18,0,318,318
167654,2019-11-08 00:00:00+03:00,in,False,918978,False,25,2852,3106,254
167654,2019-11-08 00:00:00+03:00,out,False,918986,True,9,0,247,247
167654,2019-11-08 00:00:00+03:00,in,False,918986,False,14,2164,2296,132
167654,2019-11-08 00:00:00+03:00,out,False,918978,True,4,0,163,163
167654,2019-11-08 00:00:00+03:00,out,False,918978,True,4,0,163,163
167654,2019-11-08 00:00:00+03:00,in,False,918986,False,14,2164,2296,132
167654,2019-11-09 00:00:00+03:00,out,False,918978,True,4,0,167,167
167654,2019-11-09 00:00:00+03:00,in,False,918978,False,25,3882,4137,255
167654,2019-11-09 00:00:00+03:00,in,False,-1,True,26,0,377,377
167654,2019-11-09 00:00:00+03:00,out,False,918978,False,27,1227,1773,546
167654,2019-11-09 00:00:00+03:00,out,False,918978,True,4,0,167,167
167654,2019-11-09 00:00:00+03:00,in,False,918978,False,25,3882,4137,255
167654,2019-11-10 00:00:00+03:00,in,False,-1,True,9,0,108,108
167654,2019-11-10 00:00:00+03:00,in,False,918978,False,10,1026,1110,84
167654,2019-11-10 00:00:00+03:00,out,False,918978,True,4,0,104,104
167654,2019-11-10 00:00:00+03:00,out,False,918978,False,25,935,1391,456
167654,2019-11-10 00:00:00+03:00,out,False,918978,False,25,935,1391,456
167654,2019-11-11 00:00:00+03:00,out,False,918978,True,26,0,468,468
167654,2019-11-11 00:00:00+03:00,out,False,918986,False,52,2328,3322,994
167654,2019-11-11 00:00:00+03:00,out,False,918978,False,37,3373,3958,585
167654,2019-11-11 00:00:00+03:00,out,False,918986,True,23,0,544,544
167654,2019-11-11 00:00:00+03:00,in,False,-1,True,72,0,1336,1336
167654,2019-11-11 00:00:00+03:00,in,False,918986,False,38,6705,7021,316
167654,2019-11-11 00:00:00+03:00,out,True,918986,False,1,1,1,0
167654,2019-11-11 00:00:00+03:00,in,False,918978,False,29,4865,5116,251
167654,2019-11-11 00:00:00+03:00,out,False,918986,False,52,2328,3322,994
167654,2019-11-12 00:00:00+03:00,out,True,918986,True,1,0,2,2
167654,2019-11-12 00:00:00+03:00,in,False,-1,True,49,0,592,592
167654,2019-11-12 00:00:00+03:00,out,False,918978,True,10,0,260,260
167654,2019-11-12 00:00:00+03:00,out,False,918978,False,36,1896,2632,736
167654,2019-11-12 00:00:00+03:00,in,False,918986,False,24,3269,3493,224
167654,2019-11-12 00:00:00+03:00,in,False,918978,False,17,1529,1694,165
167654,2019-11-12 00:00:00+03:00,out,False,918986,True,11,0,192,192
167654,2019-11-12 00:00:00+03:00,out,False,918986,False,40,2036,2716,680
167654,2019-11-13 00:00:00+03:00,out,False,918978,True,9,0,237,237
167654,2019-11-13 00:00:00+03:00,in,False,918986,False,21,4779,5011,232
167654,2019-11-13 00:00:00+03:00,out,False,918978,False,23,803,1270,467
167654,2019-11-13 00:00:00+03:00,out,False,918986,True,12,0,357,357
167654,2019-11-13 00:00:00+03:00,out,False,918986,False,20,1357,1760,403
167654,2019-11-13 00:00:00+03:00,in,False,-1,True,28,0,491,491
167654,2019-11-13 00:00:00+03:00,in,False,918978,False,16,1510,1687,177
167654,2019-11-13 00:00:00+03:00,out,False,918986,True,12,0,357,357
167654,2019-11-14 00:00:00+03:00,in,False,918978,False,10,1058,1166,108
167654,2019-11-14 00:00:00+03:00,out,False,918978,True,3,0,108,108
167654,2019-11-14 00:00:00+03:00,in,False,-1,True,17,0,336,336
167654,2019-11-14 00:00:00+03:00,out,False,918978,False,14,532,801,269
167654,2019-11-14 00:00:00+03:00,out,False,918986,False,9,424,566,142
167654,2019-11-14 00:00:00+03:00,out,False,918986,True,13,0,420,420
167654,2019-11-14 00:00:00+03:00,in,False,918986,False,12,1465,1577,112
167654,2019-11-14 00:00:00+03:00,out,False,918978,False,14,532,801,269
167654,2019-11-14 00:00:00+03:00,in,False,-1,True,17,0,336,336
167654,2019-11-15 00:00:00+03:00,in,False,918978,False,28,3313,3548,235
167654,2019-11-15 00:00:00+03:00,in,False,918986,False,15,2701,2834,133
167654,2019-11-15 00:00:00+03:00,in,False,-1,True,30,0,677,677
167654,2019-11-15 00:00:00+03:00,out,False,918986,True,9,0,291,291
167654,2019-11-15 00:00:00+03:00,out,False,918978,True,1,0,26,26
167654,2019-11-15 00:00:00+03:00,out,False,918978,False,16,1069,1329,260
167654,2019-11-15 00:00:00+03:00,out,False,918986,False,29,1911,2316,405
167654,2019-11-15 00:00:00+03:00,in,False,918978,True,1,0,5,5
167654,2019-11-16 00:00:00+03:00,out,False,918978,True,6,0,84,84
167654,2019-11-16 00:00:00+03:00,in,False,918986,False,3,762,786,24
167654,2019-11-16 00:00:00+03:00,in,False,-1,True,15,0,304,304
167654,2019-11-16 00:00:00+03:00,out,False,918986,False,10,196,418,222
167654,2019-11-16 00:00:00+03:00,in,False,918978,False,15,1963,2107,144
167654,2019-11-16 00:00:00+03:00,out,False,918978,False,11,1666,1905,239
167654,2019-11-16 00:00:00+03:00,out,False,918986,True,5,0,140,140
167654,2019-11-16 00:00:00+03:00,in,False,918986,False,3,762,786,24
167654,2019-11-17 00:00:00+03:00,in,False,918986,False,2,308,349,41
167654,2019-11-17 00:00:00+03:00,out,False,918986,True,7,0,158,158
167654,2019-11-17 00:00:00+03:00,out,False,918986,False,26,669,1151,482
167654,2019-11-17 00:00:00+03:00,in,False,-1,True,28,0,508,508
167654,2019-11-17 00:00:00+03:00,out,False,918986,False,26,669,1151,482
167654,2019-11-17 00:00:00+03:00,in,False,918986,False,2,308,349,41
167654,2019-11-18 00:00:00+03:00,in,False,918978,False,26,6347,6596,249
167654,2019-11-18 00:00:00+03:00,out,False,918986,True,15,0,457,457
167654,2019-11-18 00:00:00+03:00,out,False,918978,True,15,0,325,325
167654,2019-11-18 00:00:00+03:00,in,False,918986,False,24,2488,2738,250
167654,2019-11-18 00:00:00+03:00,out,False,918986,False,31,2391,2868,477
167654,2019-11-18 00:00:00+03:00,in,False,-1,True,94,0,2320,2320
167654,2019-11-18 00:00:00+03:00,out,False,918978,False,36,2102,2655,553
167654,2019-11-19 00:00:00+03:00,in,False,-1,True,117,0,3240,3240
167654,2019-11-19 00:00:00+03:00,in,False,918978,False,30,4197,4548,351
167654,2019-11-19 00:00:00+03:00,out,False,918986,True,9,0,186,186
167654,2019-11-19 00:00:00+03:00,out,False,918978,True,7,0,176,176
167654,2019-11-19 00:00:00+03:00,out,False,918978,False,33,1775,2334,559
167654,2019-11-19 00:00:00+03:00,out,False,918986,False,29,2369,2884,515
167654,2019-11-19 00:00:00+03:00,in,False,918986,False,10,972,1093,121
167654,2019-11-19 00:00:00+03:00,in,False,918986,False,10,972,1093,121
167654,2019-11-20 00:00:00+03:00,out,False,918986,False,39,2238,2968,730
167654,2019-11-20 00:00:00+03:00,in,False,918978,False,26,3206,3450,244
167654,2019-11-20 00:00:00+03:00,out,False,918986,True,19,0,340,340
167654,2019-11-20 00:00:00+03:00,in,False,-1,True,29,0,325,325
167654,2019-11-20 00:00:00+03:00,out,False,918978,True,6,0,122,122
167654,2019-11-20 00:00:00+03:00,out,False,918978,False,19,1773,2075,302
167654,2019-11-20 00:00:00+03:00,in,False,918986,False,25,3430,3638,208
167654,2019-11-21 00:00:00+03:00,in,False,918986,False,26,2558,2841,283
167654,2019-11-21 00:00:00+03:00,out,False,918986,True,10,0,285,285
167654,2019-11-21 00:00:00+03:00,in,False,918978,False,16,1848,2043,195
167654,2019-11-21 00:00:00+03:00,out,False,918986,False,27,1028,1526,498
167654,2019-11-21 00:00:00+03:00,out,False,918978,False,14,1161,1379,218
167654,2019-11-21 00:00:00+03:00,out,False,918978,True,4,0,112,112
167654,2019-11-21 00:00:00+03:00,in,False,-1,True,18,0,210,210
167654,2019-11-21 00:00:00+03:00,out,False,918978,False,14,1161,1379,218
167654,2019-11-22 00:00:00+03:00,in,False,918978,True,1,0,10,10
167654,2019-11-22 00:00:00+03:00,out,False,918978,True,8,0,214,214
167654,2019-11-22 00:00:00+03:00,in,False,918986,False,14,1642,1712,70
167654,2019-11-22 00:00:00+03:00,out,False,918986,False,8,623,749,126
167654,2019-11-22 00:00:00+03:00,out,False,918986,True,14,0,224,224
167654,2019-11-22 00:00:00+03:00,in,False,-1,True,51,0,531,531
167654,2019-11-22 00:00:00+03:00,in,False,918978,False,39,4576,4945,369
167654,2019-11-22 00:00:00+03:00,out,False,-1,True,1,0,0,0
167654,2019-11-22 00:00:00+03:00,out,False,918978,False,28,1363,1778,415
167654,2019-11-22 00:00:00+03:00,out,False,918986,False,8,623,749,126
167654,2019-11-23 00:00:00+03:00,out,False,918978,False,24,1124,1542,418
167654,2019-11-23 00:00:00+03:00,in,False,918978,False,30,2624,2891,267
167654,2019-11-23 00:00:00+03:00,in,False,-1,True,14,0,201,201
167654,2019-11-23 00:00:00+03:00,out,False,918978,True,5,0,267,267
167654,2019-11-24 00:00:00+03:00,out,False,918986,False,27,1536,2045,509
167654,2019-11-24 00:00:00+03:00,out,False,918986,True,10,0,338,338
167654,2019-11-24 00:00:00+03:00,in,False,-1,True,7,0,89,89
167654,2019-11-24 00:00:00+03:00,in,False,918986,False,3,274,302,28
167654,2019-11-25 00:00:00+03:00,in,False,-1,True,21,0,274,274
167654,2019-11-25 00:00:00+03:00,out,False,918986,False,33,1463,2064,601
167654,2019-11-25 00:00:00+03:00,out,False,918978,False,15,1089,1308,219
167654,2019-11-25 00:00:00+03:00,in,False,918978,False,30,4702,4933,231
167654,2019-11-25 00:00:00+03:00,out,True,918986,True,1,0,0,0
167654,2019-11-25 00:00:00+03:00,out,False,918978,True,14,0,233,233
167654,2019-11-25 00:00:00+03:00,in,False,918986,False,26,4123,4367,244
167654,2019-11-25 00:00:00+03:00,out,False,918986,True,5,0,133,133
167654,2019-11-26 00:00:00+03:00,out,False,918978,False,2,100,137,37
167654,2019-11-26 00:00:00+03:00,out,False,918986,False,21,1126,1508,382
167654,2019-11-26 00:00:00+03:00,in,False,918978,False,13,1688,1800,112
167654,2019-11-26 00:00:00+03:00,out,False,918986,True,10,0,361,361
167654,2019-11-26 00:00:00+03:00,in,False,918986,False,27,3749,4064,315
167654,2019-11-26 00:00:00+03:00,out,False,918978,True,5,0,191,191
167654,2019-11-26 00:00:00+03:00,in,False,-1,True,37,0,610,610
167654,2019-11-26 00:00:00+03:00,in,False,918986,False,27,3749,4064,315
167654,2019-11-26 00:00:00+03:00,out,False,918986,True,10,0,361,361
167654,2019-11-26 00:00:00+03:00,out,False,918986,False,21,1126,1508,382
167654,2019-11-27 00:00:00+03:00,out,False,918986,True,7,0,242,242
167654,2019-11-27 00:00:00+03:00,in,False,918978,False,25,4624,4863,239
167654,2019-11-27 00:00:00+03:00,out,False,918986,False,30,1868,2361,493
167654,2019-11-27 00:00:00+03:00,in,False,-1,True,29,0,291,291
167654,2019-11-27 00:00:00+03:00,in,False,918986,False,22,3121,3350,229
167654,2019-11-27 00:00:00+03:00,out,False,918978,False,13,1059,1254,195
167654,2019-11-27 00:00:00+03:00,out,False,918978,True,5,0,108,108
167654,2019-11-27 00:00:00+03:00,in,False,918986,False,22,3121,3350,229
167654,2019-11-27 00:00:00+03:00,out,False,918986,False,30,1868,2361,493
167654,2019-11-27 00:00:00+03:00,out,False,918978,True,5,0,108,108
167654,2019-11-28 00:00:00+03:00,in,False,-1,True,27,0,465,465
167654,2019-11-28 00:00:00+03:00,out,False,918986,True,10,0,360,360
167654,2019-11-28 00:00:00+03:00,out,False,918978,True,1,0,60,60
167654,2019-11-28 00:00:00+03:00,out,False,918986,False,23,2399,2819,420
167654,2019-11-28 00:00:00+03:00,in,False,918986,False,20,2357,2559,202
167654,2019-11-28 00:00:00+03:00,out,False,918978,False,7,1243,1327,84
167654,2019-11-28 00:00:00+03:00,in,False,918978,False,28,2669,2951,282
167654,2019-11-28 00:00:00+03:00,out,False,918978,True,1,0,60,60
167664,2019-09-26 00:00:00+03:00,in,False,920874,False,1,14,31,17
167664,2019-09-27 00:00:00+03:00,in,False,-1,True,1,0,35,35
167664,2019-09-30 00:00:00+03:00,in,False,920874,False,1,56,71,15
167664,2019-10-02 00:00:00+03:00,in,False,920874,False,1,238,253,15
167664,2019-10-04 00:00:00+03:00,in,False,920874,False,2,281,313,32
167664,2019-10-07 00:00:00+03:00,in,False,-1,True,1,0,51,51
167664,2019-10-10 00:00:00+03:00,in,False,920874,False,2,128,275,147
167664,2019-10-15 00:00:00+03:00,in,False,920874,False,1,188,202,14
167664,2019-10-18 00:00:00+03:00,in,False,920874,False,1,179,192,13
167664,2019-10-21 00:00:00+03:00,in,False,-1,True,1,0,37,37
167664,2019-10-25 00:00:00+03:00,in,False,-1,True,1,0,58,58
167664,2019-10-27 00:00:00+03:00,in,False,-1,True,2,0,4,4
167664,2019-10-28 00:00:00+03:00,in,False,-1,True,5,0,312,312
167664,2019-10-29 00:00:00+03:00,in,False,-1,True,2,0,82,82
167664,2019-10-29 00:00:00+03:00,in,False,920874,False,2,319,368,49
167664,2019-10-30 00:00:00+03:00,in,False,-1,True,1,0,86,86
167664,2019-10-30 00:00:00+03:00,in,False,920874,False,2,164,194,30
167664,2019-11-01 00:00:00+03:00,in,False,-1,True,1,0,2,2
167664,2019-11-03 00:00:00+03:00,in,False,-1,True,1,0,2,2
167664,2019-11-05 00:00:00+03:00,in,False,920874,False,2,49,109,60
167664,2019-11-07 00:00:00+03:00,in,False,-1,True,1,0,11,11
167664,2019-11-08 00:00:00+03:00,in,False,920874,False,2,373,427,54
167664,2019-11-11 00:00:00+03:00,in,False,-1,True,1,0,62,62
167664,2019-11-11 00:00:00+03:00,in,False,-1,True,1,0,62,62
167664,2019-11-12 00:00:00+03:00,in,False,920874,False,1,38,66,28
167664,2019-11-15 00:00:00+03:00,in,False,920874,False,1,28,59,31
167664,2019-11-18 00:00:00+03:00,in,False,920874,False,1,71,90,19
167664,2019-11-19 00:00:00+03:00,in,False,920874,False,3,512,647,135
167664,2019-11-22 00:00:00+03:00,in,False,920874,False,1,166,200,34
167664,2019-11-25 00:00:00+03:00,in,False,920874,False,2,446,520,74
167664,2019-11-26 00:00:00+03:00,in,False,-1,True,1,0,2,2
167664,2019-11-27 00:00:00+03:00,in,False,-1,True,2,0,4,4
167664,2019-11-27 00:00:00+03:00,in,False,920874,False,3,449,511,62
167664,2019-11-28 00:00:00+03:00,in,False,-1,True,1,0,2,2
167664,2019-11-28 00:00:00+03:00,in,False,920874,False,4,760,844,84
167682,2019-09-27 00:00:00+03:00,in,False,922154,False,1,39,48,9
167682,2019-10-23 00:00:00+03:00,in,False,922154,False,1,61,70,9
167715,2019-10-02 00:00:00+03:00,in,False,-1,True,1,0,60,60
167715,2019-10-02 00:00:00+03:00,in,False,926214,False,3,277,304,27
167715,2019-10-03 00:00:00+03:00,in,False,-1,True,2,0,37,37
167715,2019-10-03 00:00:00+03:00,out,False,926184,False,1,16,17,1
167715,2019-10-03 00:00:00+03:00,in,False,926184,False,8,2612,2672,60
167715,2019-10-04 00:00:00+03:00,in,False,926184,False,6,442,550,108
167715,2019-10-04 00:00:00+03:00,in,False,926184,False,6,442,550,108
167715,2019-10-08 00:00:00+03:00,in,False,926184,False,1,298,308,10
167715,2019-10-10 00:00:00+03:00,in,False,926184,False,2,514,553,39
167715,2019-10-11 00:00:00+03:00,in,False,926184,False,1,48,89,41
167715,2019-10-14 00:00:00+03:00,in,False,-1,True,5,0,203,203
167715,2019-10-14 00:00:00+03:00,in,False,-1,True,7,0,95,95
167715,2019-10-14 00:00:00+03:00,in,False,-1,True,5,0,203,203
167715,2019-10-15 00:00:00+03:00,in,True,935958,False,2,53,116,63
167715,2019-10-15 00:00:00+03:00,in,True,935958,True,1,0,8,8
167715,2019-10-15 00:00:00+03:00,in,False,-1,True,5,0,219,219
167715,2019-10-15 00:00:00+03:00,in,False,-1,True,3,0,138,138
167715,2019-10-16 00:00:00+03:00,in,False,-1,True,1,0,22,22
167715,2019-10-16 00:00:00+03:00,in,False,-1,True,1,0,30,30
167715,2019-10-16 00:00:00+03:00,in,False,935958,False,4,291,420,129
167715,2019-10-17 00:00:00+03:00,in,True,926184,False,1,101,109,8
167715,2019-10-17 00:00:00+03:00,out,False,926184,False,1,584,585,1
167715,2019-10-18 00:00:00+03:00,in,False,926184,False,3,69,95,26
167715,2019-10-18 00:00:00+03:00,in,True,926184,False,1,30,38,8
167715,2019-10-19 00:00:00+03:00,in,False,935958,False,1,290,363,73
167715,2019-10-21 00:00:00+03:00,in,False,-1,True,1,0,33,33
167715,2019-10-22 00:00:00+03:00,in,False,935958,False,1,155,169,14
167715,2019-10-24 00:00:00+03:00,in,False,935958,False,1,218,233,15
167715,2019-10-25 00:00:00+03:00,in,False,926184,False,3,170,191,21
167715,2019-10-28 00:00:00+03:00,in,False,-1,True,1,0,22,22
167715,2019-10-29 00:00:00+03:00,in,False,935958,False,1,56,127,71
167715,2019-10-30 00:00:00+03:00,in,False,935958,False,2,617,637,20
167715,2019-10-31 00:00:00+03:00,in,False,935958,False,3,2202,2249,47
167715,2019-11-01 00:00:00+03:00,out,False,926184,False,3,606,628,22
167715,2019-11-01 00:00:00+03:00,in,False,-1,True,1,0,54,54
167715,2019-11-01 00:00:00+03:00,in,False,926184,False,1,12,20,8
167715,2019-11-01 00:00:00+03:00,in,False,935958,False,1,6,23,17
167715,2019-11-01 00:00:00+03:00,out,False,926184,True,9,0,55,55
167715,2019-11-01 00:00:00+03:00,in,False,-1,True,1,0,6,6
167715,2019-11-01 00:00:00+03:00,in,False,-1,True,1,0,6,6
167715,2019-11-05 00:00:00+03:00,in,False,935958,False,2,54,90,36
167715,2019-11-06 00:00:00+03:00,in,False,-1,True,1,0,15,15
167715,2019-11-06 00:00:00+03:00,in,False,935958,False,1,30,43,13
167715,2019-11-08 00:00:00+03:00,in,True,926184,False,1,17,23,6
167715,2019-11-08 00:00:00+03:00,in,False,926184,False,4,345,367,22
167715,2019-11-08 00:00:00+03:00,out,False,926184,False,1,110,114,4
167715,2019-11-12 00:00:00+03:00,in,False,935958,False,1,44,67,23
167715,2019-11-14 00:00:00+03:00,in,False,935958,False,1,201,225,24
167715,2019-11-15 00:00:00+03:00,in,True,935958,False,1,26,38,12
167715,2019-11-15 00:00:00+03:00,out,False,926184,False,9,486,604,118
167715,2019-11-15 00:00:00+03:00,in,True,926184,False,1,3,8,5
167715,2019-11-15 00:00:00+03:00,in,False,926184,False,2,92,111,19
167715,2019-11-15 00:00:00+03:00,out,False,926184,True,2,0,63,63
167715,2019-11-15 00:00:00+03:00,in,False,-1,True,1,0,3,3
167715,2019-11-17 00:00:00+03:00,in,False,-1,True,1,0,41,41
167715,2019-11-18 00:00:00+03:00,in,False,935958,False,1,151,169,18
167715,2019-11-18 00:00:00+03:00,in,False,-1,True,4,0,137,137
167715,2019-11-20 00:00:00+03:00,in,False,935958,False,1,123,138,15
167715,2019-11-20 00:00:00+03:00,in,False,-1,True,1,0,33,33
167715,2019-11-22 00:00:00+03:00,out,False,926184,False,1,114,120,6
167715,2019-11-22 00:00:00+03:00,in,False,926184,False,1,53,59,6
167715,2019-11-22 00:00:00+03:00,out,False,926184,True,1,0,29,29
167715,2019-11-25 00:00:00+03:00,in,False,-1,True,1,0,36,36
167715,2019-11-25 00:00:00+03:00,in,False,935958,False,3,313,371,58
167715,2019-11-26 00:00:00+03:00,out,False,926184,False,1,118,135,17
167715,2019-11-26 00:00:00+03:00,in,False,935958,False,3,197,260,63
167715,2019-11-27 00:00:00+03:00,out,False,926184,False,1,42,54,12
167715,2019-11-27 00:00:00+03:00,out,False,926184,True,1,0,50,50
167715,2019-11-27 00:00:00+03:00,in,False,935958,False,4,800,860,60
167715,2019-11-27 00:00:00+03:00,out,False,926184,False,1,42,54,12
167716,2019-09-27 00:00:00+03:00,out,False,922142,False,3,153,244,91
167716,2019-09-27 00:00:00+03:00,in,False,-1,True,1,0,10,10
167716,2019-09-27 00:00:00+03:00,out,False,922142,True,4,0,97,97
167716,2019-09-27 00:00:00+03:00,out,False,922142,True,4,0,97,97
167716,2019-09-28 00:00:00+03:00,out,False,922142,True,12,0,171,171
167716,2019-09-28 00:00:00+03:00,out,False,922142,False,6,781,933,152
167716,2019-09-28 00:00:00+03:00,out,False,922142,True,12,0,171,171
167716,2019-09-29 00:00:00+03:00,out,False,922142,False,7,674,840,166
167716,2019-09-29 00:00:00+03:00,out,False,922142,True,4,0,154,154
167716,2019-09-29 00:00:00+03:00,in,False,-1,True,6,0,42,42
167716,2019-09-30 00:00:00+03:00,out,False,922142,True,4,0,125,125
167716,2019-09-30 00:00:00+03:00,out,False,922142,False,4,342,405,63
167716,2019-10-01 00:00:00+03:00,in,False,-1,True,1,0,4,4
167716,2019-10-02 00:00:00+03:00,out,False,922142,True,6,0,157,157
167716,2019-10-02 00:00:00+03:00,out,False,922142,False,3,236,300,64
167716,2019-10-03 00:00:00+03:00,out,False,922142,True,13,0,391,391
167716,2019-10-03 00:00:00+03:00,out,False,922142,False,9,1155,1341,186
167716,2019-10-04 00:00:00+03:00,out,False,922142,True,6,0,256,256
167716,2019-10-04 00:00:00+03:00,out,False,922142,False,3,748,810,62
167716,2019-10-04 00:00:00+03:00,out,False,922142,True,6,0,256,256
167716,2019-10-05 00:00:00+03:00,out,False,922142,False,2,8,62,54
167716,2019-10-05 00:00:00+03:00,out,False,922142,True,3,0,89,89
167716,2019-10-08 00:00:00+03:00,out,False,922142,False,14,1675,1967,292
167716,2019-10-08 00:00:00+03:00,out,False,922142,True,8,0,340,340
167716,2019-10-08 00:00:00+03:00,in,False,-1,True,1,0,5,5
167716,2019-10-08 00:00:00+03:00,out,False,922142,True,8,0,340,340
167716,2019-10-09 00:00:00+03:00,out,False,922142,True,12,0,300,300
167716,2019-10-09 00:00:00+03:00,out,False,922142,False,7,714,821,107
167716,2019-10-10 00:00:00+03:00,out,False,922142,True,5,0,90,90
167716,2019-10-10 00:00:00+03:00,out,False,922142,False,2,112,137,25
167716,2019-10-11 00:00:00+03:00,out,False,922142,True,3,0,23,23
167716,2019-10-11 00:00:00+03:00,in,False,-1,True,3,0,19,19
167716,2019-10-11 00:00:00+03:00,out,False,922142,False,7,783,957,174
167716,2019-10-11 00:00:00+03:00,out,False,922142,True,3,0,23,23
167716,2019-10-13 00:00:00+03:00,out,False,922142,False,2,57,100,43
167716,2019-10-13 00:00:00+03:00,out,False,922142,True,4,0,106,106
167716,2019-10-14 00:00:00+03:00,out,True,922142,False,1,1,23,22
167716,2019-10-14 00:00:00+03:00,out,False,922142,False,9,542,696,154
167716,2019-10-14 00:00:00+03:00,out,False,922142,True,14,0,290,290
167716,2019-10-15 00:00:00+03:00,out,False,922142,False,7,862,987,125
167716,2019-10-15 00:00:00+03:00,out,False,922142,True,2,0,43,43
167716,2019-10-15 00:00:00+03:00,in,False,-1,True,3,0,19,19
167716,2019-10-16 00:00:00+03:00,out,False,922142,True,1,0,41,41
167716,2019-10-17 00:00:00+03:00,out,False,922142,True,4,0,67,67
167716,2019-10-17 00:00:00+03:00,out,False,922142,False,6,760,884,124
167716,2019-10-18 00:00:00+03:00,out,False,922142,True,1,0,5,5
167716,2019-10-18 00:00:00+03:00,out,False,922142,False,7,1393,1560,167
167716,2019-10-19 00:00:00+03:00,out,False,922142,False,5,525,628,103
167716,2019-10-19 00:00:00+03:00,out,False,922142,True,4,0,151,151
167716,2019-10-19 00:00:00+03:00,out,False,922142,True,4,0,151,151
167716,2019-10-21 00:00:00+03:00,out,False,922142,False,3,291,355,64
167716,2019-10-21 00:00:00+03:00,out,False,922142,True,3,0,15,15
167716,2019-10-22 00:00:00+03:00,out,False,922142,False,1,44,62,18
167716,2019-10-22 00:00:00+03:00,out,False,922142,True,1,0,6,6
167716,2019-10-22 00:00:00+03:00,out,False,922142,True,1,0,6,6
167716,2019-10-23 00:00:00+03:00,out,False,922142,False,3,12,113,101
167716,2019-10-24 00:00:00+03:00,out,False,922142,True,1,0,1,1
167716,2019-10-25 00:00:00+03:00,out,False,922142,True,14,0,288,288
167716,2019-10-25 00:00:00+03:00,out,False,922142,False,29,2175,2799,624
167716,2019-10-25 00:00:00+03:00,in,False,-1,True,2,0,7,7
167716,2019-10-28 00:00:00+03:00,out,False,922142,True,13,0,356,356
167716,2019-10-28 00:00:00+03:00,out,False,922142,False,26,2065,2545,480
167716,2019-10-29 00:00:00+03:00,out,True,922142,True,1,0,0,0
167716,2019-10-29 00:00:00+03:00,out,False,922142,True,8,0,229,229
167716,2019-10-29 00:00:00+03:00,out,False,922142,False,14,1067,1359,292
167716,2019-10-30 00:00:00+03:00,out,False,922142,True,19,0,501,501
167716,2019-10-30 00:00:00+03:00,out,False,922142,False,9,1325,1523,198
167716,2019-10-30 00:00:00+03:00,in,False,-1,True,1,0,6,6
167716,2019-10-31 00:00:00+03:00,in,False,-1,True,3,0,18,18
167716,2019-10-31 00:00:00+03:00,out,False,922142,False,13,644,918,274
167716,2019-10-31 00:00:00+03:00,out,False,922142,True,9,0,281,281
167716,2019-11-01 00:00:00+03:00,in,False,-1,True,2,0,13,13
167716,2019-11-01 00:00:00+03:00,out,False,922142,True,4,0,173,173
167716,2019-11-01 00:00:00+03:00,out,False,922142,False,5,296,414,118
167716,2019-11-02 00:00:00+03:00,out,False,922142,False,2,210,248,38
167716,2019-11-02 00:00:00+03:00,out,False,922142,True,2,0,73,73
167716,2019-11-04 00:00:00+03:00,out,False,922142,True,14,0,441,441
167716,2019-11-04 00:00:00+03:00,in,False,-1,True,2,0,13,13
167716,2019-11-04 00:00:00+03:00,out,False,922142,False,18,2324,2644,320
167716,2019-11-04 00:00:00+03:00,out,False,922142,False,18,2324,2644,320
167716,2019-11-06 00:00:00+03:00,out,False,922142,True,9,0,283,283
167716,2019-11-06 00:00:00+03:00,out,False,922142,False,17,1351,1665,314
167716,2019-11-06 00:00:00+03:00,in,False,-1,True,2,0,8,8
167716,2019-11-07 00:00:00+03:00,out,False,922142,True,5,0,154,154
167716,2019-11-07 00:00:00+03:00,out,False,922142,False,4,323,415,92
167716,2019-11-08 00:00:00+03:00,out,False,922142,True,8,0,212,212
167716,2019-11-08 00:00:00+03:00,in,False,-1,True,5,0,37,37
167716,2019-11-08 00:00:00+03:00,out,False,922142,False,11,1543,1734,191
167716,2019-11-09 00:00:00+03:00,out,False,922142,True,4,0,119,119
167716,2019-11-09 00:00:00+03:00,out,False,922142,False,3,170,230,60
167716,2019-11-09 00:00:00+03:00,out,False,922142,False,3,170,230,60
167716,2019-11-11 00:00:00+03:00,out,False,922142,True,6,0,167,167
167716,2019-11-11 00:00:00+03:00,out,False,922142,False,3,227,270,43
167716,2019-11-12 00:00:00+03:00,out,False,922142,False,16,1168,1514,346
167716,2019-11-12 00:00:00+03:00,out,False,922142,True,19,0,454,454
167716,2019-11-13 00:00:00+03:00,in,False,-1,True,1,0,4,4
167716,2019-11-13 00:00:00+03:00,out,False,922142,True,11,0,312,312
167716,2019-11-13 00:00:00+03:00,out,False,922142,False,18,1563,2008,445
167716,2019-11-14 00:00:00+03:00,out,False,922142,False,16,1760,2087,327
167716,2019-11-14 00:00:00+03:00,out,True,922142,True,1,0,0,0
167716,2019-11-14 00:00:00+03:00,out,False,922142,True,8,0,310,310
167716,2019-11-14 00:00:00+03:00,in,False,-1,True,1,0,6,6
167716,2019-11-15 00:00:00+03:00,out,False,922142,False,15,1059,1280,221
167716,2019-11-15 00:00:00+03:00,out,False,922142,True,7,0,249,249
167716,2019-11-15 00:00:00+03:00,in,False,-1,True,3,0,15,15
167716,2019-11-16 00:00:00+03:00,in,False,-1,True,1,0,5,5
167716,2019-11-16 00:00:00+03:00,out,False,922142,True,3,0,101,101
167716,2019-11-16 00:00:00+03:00,out,False,922142,False,8,545,695,150
167716,2019-11-16 00:00:00+03:00,in,False,-1,True,1,0,5,5
167716,2019-11-17 00:00:00+03:00,in,False,-1,True,1,0,5,5
167716,2019-11-17 00:00:00+03:00,out,False,922142,False,1,5,35,30
167716,2019-11-17 00:00:00+03:00,out,False,922142,True,3,0,115,115
167716,2019-11-18 00:00:00+03:00,out,False,922142,True,6,0,196,196
167716,2019-11-18 00:00:00+03:00,out,False,922142,False,7,909,1048,139
167716,2019-11-19 00:00:00+03:00,out,False,922142,False,4,670,768,98
167716,2019-11-19 00:00:00+03:00,out,False,922142,True,2,0,95,95
167716,2019-11-20 00:00:00+03:00,out,False,922142,False,5,401,490,89
167716,2019-11-20 00:00:00+03:00,out,False,922142,True,1,0,36,36
167716,2019-11-21 00:00:00+03:00,out,False,922142,False,7,824,952,128
167716,2019-11-21 00:00:00+03:00,out,False,922142,True,6,0,166,166
167716,2019-11-22 00:00:00+03:00,out,False,922142,False,2,259,285,26
167716,2019-11-22 00:00:00+03:00,out,False,922142,True,4,0,139,139
167716,2019-11-22 00:00:00+03:00,in,False,-1,True,2,0,12,12
167716,2019-11-24 00:00:00+03:00,out,False,922142,True,6,0,118,118
167716,2019-11-24 00:00:00+03:00,out,False,922142,False,4,245,293,48
167716,2019-11-25 00:00:00+03:00,out,False,922142,True,9,0,330,330
167716,2019-11-25 00:00:00+03:00,out,False,922142,False,5,562,659,97
167716,2019-11-25 00:00:00+03:00,in,False,-1,True,1,0,5,5
167716,2019-11-26 00:00:00+03:00,out,False,922142,False,17,1001,1325,324
167716,2019-11-26 00:00:00+03:00,out,False,922142,True,8,0,193,193
167716,2019-11-27 00:00:00+03:00,out,False,922142,False,9,856,1023,167
167716,2019-11-27 00:00:00+03:00,out,False,922142,True,5,0,158,158
167716,2019-11-28 00:00:00+03:00,out,False,922142,True,1,0,35,35
167716,2019-11-28 00:00:00+03:00,out,False,922142,False,3,267,313,46
167721,2019-09-30 00:00:00+03:00,in,False,-1,True,1,0,4,4
167721,2019-10-28 00:00:00+03:00,in,False,-1,True,1,0,2,2
167721,2019-10-28 00:00:00+03:00,in,False,-1,True,1,0,2,2
167721,2019-10-29 00:00:00+03:00,in,False,-1,True,1,0,2,2
167721,2019-11-07 00:00:00+03:00,in,False,-1,True,3,0,6,6
167721,2019-11-08 00:00:00+03:00,in,False,-1,True,1,0,2,2
167727,2019-09-29 00:00:00+03:00,in,False,-1,True,1,0,2,2
167727,2019-10-02 00:00:00+03:00,in,False,-1,True,1,0,0,0
167727,2019-10-03 00:00:00+03:00,in,False,-1,True,2,0,27,27
167727,2019-10-03 00:00:00+03:00,in,False,926486,False,1,98,103,5
167727,2019-10-03 00:00:00+03:00,out,False,926486,True,26,0,217,217
167727,2019-10-03 00:00:00+03:00,out,False,926486,False,12,1709,1894,185
167727,2019-10-04 00:00:00+03:00,out,False,926486,False,17,1414,1804,390
167727,2019-10-04 00:00:00+03:00,in,False,-1,True,1,0,15,15
167727,2019-10-04 00:00:00+03:00,out,False,926486,True,17,0,224,224
167727,2019-10-05 00:00:00+03:00,out,False,926486,False,1,467,480,13
167727,2019-10-07 00:00:00+03:00,out,False,926486,True,1,0,46,46
167727,2019-10-08 00:00:00+03:00,out,False,926486,False,8,3121,3266,145
167727,2019-10-08 00:00:00+03:00,in,False,-1,True,1,0,14,14
167727,2019-10-09 00:00:00+03:00,out,False,926486,True,1,0,4,4
167727,2019-10-10 00:00:00+03:00,out,False,926486,True,2,0,120,120
167727,2019-10-10 00:00:00+03:00,in,False,-1,True,1,0,30,30
167727,2019-10-10 00:00:00+03:00,out,False,926486,False,4,976,1065,89
167727,2019-10-10 00:00:00+03:00,out,False,926486,False,4,976,1065,89
167727,2019-10-11 00:00:00+03:00,out,False,926486,False,2,96,141,45
167727,2019-10-14 00:00:00+03:00,out,False,926486,True,1,0,41,41
167727,2019-10-14 00:00:00+03:00,out,False,926486,False,2,577,599,22
167727,2019-10-15 00:00:00+03:00,in,False,-1,True,1,0,20,20
167727,2019-10-15 00:00:00+03:00,out,False,926486,False,37,6832,7460,628
167727,2019-10-15 00:00:00+03:00,out,False,926486,True,34,0,549,549
167727,2019-10-16 00:00:00+03:00,out,False,926486,False,27,2451,3041,590
167727,2019-10-16 00:00:00+03:00,out,False,926486,True,29,0,1008,1008
167727,2019-10-16 00:00:00+03:00,out,False,926486,False,27,2451,3041,590
167727,2019-10-16 00:00:00+03:00,out,False,926486,True,29,0,1008,1008
167727,2019-10-17 00:00:00+03:00,out,False,926486,False,23,4487,4986,499
167727,2019-10-17 00:00:00+03:00,out,False,926486,True,29,0,539,539
167727,2019-10-17 00:00:00+03:00,in,False,-1,True,3,0,43,43
167727,2019-10-18 00:00:00+03:00,in,False,-1,True,1,0,30,30
167727,2019-10-18 00:00:00+03:00,out,False,926486,False,8,905,1062,157
167727,2019-10-18 00:00:00+03:00,out,False,926486,True,14,0,242,242
167727,2019-10-18 00:00:00+03:00,out,False,926486,True,14,0,242,242
167727,2019-10-19 00:00:00+03:00,out,False,926486,True,2,0,60,60
167727,2019-10-19 00:00:00+03:00,out,False,926486,False,1,185,201,16
167727,2019-10-19 00:00:00+03:00,out,False,926486,True,2,0,60,60
167727,2019-10-21 00:00:00+03:00,out,False,926486,True,13,0,509,509
167727,2019-10-21 00:00:00+03:00,in,False,926486,False,1,6,19,13
167727,2019-10-21 00:00:00+03:00,out,False,926486,False,37,6082,6747,665
167727,2019-10-21 00:00:00+03:00,in,False,-1,True,6,0,139,139
167727,2019-10-22 00:00:00+03:00,out,False,926486,True,14,0,391,391
167727,2019-10-22 00:00:00+03:00,in,False,-1,True,3,0,45,45
167727,2019-10-22 00:00:00+03:00,out,False,926486,False,38,5881,6543,662
167727,2019-10-23 00:00:00+03:00,out,False,926486,False,58,8465,9488,1023
167727,2019-10-23 00:00:00+03:00,in,False,-1,True,3,0,72,72
167727,2019-10-23 00:00:00+03:00,out,False,926486,True,26,0,930,930
167727,2019-10-23 00:00:00+03:00,in,False,-1,True,3,0,72,72
167727,2019-10-24 00:00:00+03:00,in,False,-1,True,2,0,60,60
167727,2019-10-24 00:00:00+03:00,out,False,926486,False,11,2590,2816,226
167727,2019-10-24 00:00:00+03:00,out,False,926486,True,10,0,361,361
167727,2019-10-24 00:00:00+03:00,out,False,926486,True,10,0,361,361
167727,2019-10-25 00:00:00+03:00,in,False,-1,True,4,0,111,111
167727,2019-10-25 00:00:00+03:00,out,False,926486,True,16,0,671,671
167727,2019-10-25 00:00:00+03:00,out,False,926486,False,21,6318,6724,406
167727,2019-10-28 00:00:00+03:00,out,False,926486,False,22,5702,6114,412
167727,2019-10-28 00:00:00+03:00,out,False,926486,True,16,0,563,563
167727,2019-10-28 00:00:00+03:00,in,False,-1,True,1,0,19,19
167727,2019-10-29 00:00:00+03:00,out,False,926486,False,17,3459,3833,374
167727,2019-10-29 00:00:00+03:00,in,False,926486,False,1,40,54,14
167727,2019-10-29 00:00:00+03:00,out,False,926486,True,18,0,509,509
167727,2019-10-29 00:00:00+03:00,in,False,-1,True,12,0,244,244
167727,2019-10-29 00:00:00+03:00,out,False,926486,False,17,3459,3833,374
167727,2019-10-30 00:00:00+03:00,in,False,-1,True,1,0,2,2
167727,2019-10-30 00:00:00+03:00,out,False,926486,True,18,0,298,298
167727,2019-10-30 00:00:00+03:00,out,False,926486,False,15,3094,3368,274
167727,2019-10-30 00:00:00+03:00,in,False,-1,True,1,0,2,2
167727,2019-10-31 00:00:00+03:00,in,False,-1,True,3,0,10,10
167727,2019-10-31 00:00:00+03:00,out,False,926486,False,41,9258,10022,764
167727,2019-10-31 00:00:00+03:00,in,False,926486,False,1,194,201,7
167727,2019-10-31 00:00:00+03:00,out,False,926486,True,47,0,1347,1347
167727,2019-10-31 00:00:00+03:00,in,False,926486,False,1,194,201,7
167727,2019-11-01 00:00:00+03:00,out,False,926486,True,61,0,1670,1670
167727,2019-11-01 00:00:00+03:00,out,False,926486,False,23,5186,5604,418
167727,2019-11-02 00:00:00+03:00,out,False,926486,True,18,0,396,396
167727,2019-11-02 00:00:00+03:00,out,False,926486,False,14,3661,3927,266
167727,2019-11-04 00:00:00+03:00,in,False,-1,True,1,0,30,30
167727,2019-11-04 00:00:00+03:00,out,False,926486,True,70,0,1933,1933
167727,2019-11-04 00:00:00+03:00,out,False,926486,False,52,6337,7475,1138
167727,2019-11-04 00:00:00+03:00,out,False,926486,True,70,0,1933,1933
167727,2019-11-05 00:00:00+03:00,out,False,926486,False,49,4750,5562,812
167727,2019-11-05 00:00:00+03:00,out,False,926486,True,40,0,857,857
167727,2019-11-06 00:00:00+03:00,in,False,-1,True,4,0,40,40
167727,2019-11-06 00:00:00+03:00,out,False,926486,False,37,7514,8225,711
167727,2019-11-06 00:00:00+03:00,out,False,926486,True,66,0,934,934
167727,2019-11-07 00:00:00+03:00,out,False,926486,False,54,9637,10629,992
167727,2019-11-07 00:00:00+03:00,out,False,926486,True,83,0,2316,2316
167727,2019-11-07 00:00:00+03:00,in,False,-1,True,8,0,15,15
167727,2019-11-07 00:00:00+03:00,in,False,926486,False,1,29,37,8
167727,2019-11-07 00:00:00+03:00,in,False,926486,False,1,29,37,8
167727,2019-11-08 00:00:00+03:00,out,False,926486,False,42,13215,13963,748
167727,2019-11-08 00:00:00+03:00,out,False,926486,True,32,0,818,818
167727,2019-11-08 00:00:00+03:00,in,False,926486,False,2,49,66,17
167727,2019-11-08 00:00:00+03:00,out,False,926486,True,32,0,818,818
167727,2019-11-11 00:00:00+03:00,out,False,926486,True,66,0,2068,2068
167727,2019-11-11 00:00:00+03:00,in,False,-1,True,1,0,4,4
167727,2019-11-11 00:00:00+03:00,in,False,926486,False,1,35,48,13
167727,2019-11-11 00:00:00+03:00,out,False,926486,False,43,6304,7139,835
167727,2019-11-12 00:00:00+03:00,out,False,926486,True,20,0,488,488
167727,2019-11-12 00:00:00+03:00,in,False,-1,True,2,0,31,31
167727,2019-11-12 00:00:00+03:00,out,False,926486,False,19,3803,4109,306
167727,2019-11-13 00:00:00+03:00,out,False,926486,False,40,9364,10010,646
167727,2019-11-13 00:00:00+03:00,in,False,926486,False,2,16,36,20
167727,2019-11-13 00:00:00+03:00,out,False,926486,True,30,0,699,699
167727,2019-11-13 00:00:00+03:00,out,False,926486,True,30,0,699,699
167727,2019-11-14 00:00:00+03:00,in,False,926486,False,1,286,291,5
167727,2019-11-14 00:00:00+03:00,out,False,926486,False,27,4093,4516,423
167727,2019-11-14 00:00:00+03:00,in,False,-1,True,1,0,20,20
167727,2019-11-14 00:00:00+03:00,out,False,926486,True,37,0,1269,1269
167727,2019-11-15 00:00:00+03:00,out,False,926486,True,52,0,1789,1789
167727,2019-11-15 00:00:00+03:00,out,False,926486,False,36,3572,4313,741
167727,2019-11-15 00:00:00+03:00,in,False,926486,False,2,8,19,11
167727,2019-11-16 00:00:00+03:00,out,False,926486,False,5,1159,1244,85
167727,2019-11-16 00:00:00+03:00,out,False,926486,True,5,0,116,116
167727,2019-11-16 00:00:00+03:00,out,False,926486,False,5,1159,1244,85
167727,2019-11-18 00:00:00+03:00,out,False,926486,False,9,1261,1403,142
167727,2019-11-18 00:00:00+03:00,out,False,926486,True,11,0,410,410
167727,2019-11-19 00:00:00+03:00,out,False,926486,False,37,2069,2730,661
167727,2019-11-19 00:00:00+03:00,in,False,-1,True,3,0,42,42
167727,2019-11-19 00:00:00+03:00,out,False,926486,True,25,0,582,582
167727,2019-11-20 00:00:00+03:00,out,False,926486,True,31,0,776,776
167727,2019-11-20 00:00:00+03:00,in,False,-1,True,4,0,35,35
167727,2019-11-20 00:00:00+03:00,out,False,926486,False,35,7661,8304,643
167727,2019-11-20 00:00:00+03:00,out,False,926486,False,35,7661,8304,643
167727,2019-11-21 00:00:00+03:00,in,False,926486,False,1,19,24,5
167727,2019-11-21 00:00:00+03:00,out,False,926486,False,27,3082,3549,467
167727,2019-11-21 00:00:00+03:00,in,False,-1,True,3,0,12,12
167727,2019-11-21 00:00:00+03:00,out,False,926486,True,32,0,1056,1056
167727,2019-11-21 00:00:00+03:00,in,False,-1,True,3,0,12,12
167727,2019-11-22 00:00:00+03:00,in,False,-1,True,1,0,30,30
167727,2019-11-22 00:00:00+03:00,out,False,926486,False,6,924,1008,84
167727,2019-11-22 00:00:00+03:00,out,False,926486,True,14,0,571,571
167727,2019-11-23 00:00:00+03:00,in,False,-1,True,2,0,45,45
167727,2019-11-23 00:00:00+03:00,out,False,926486,True,43,0,914,914
167727,2019-11-23 00:00:00+03:00,out,False,926486,False,37,5776,6380,604
167727,2019-11-23 00:00:00+03:00,out,False,926486,False,37,5776,6380,604
167727,2019-11-25 00:00:00+03:00,out,False,926486,False,20,3077,3424,347
167727,2019-11-25 00:00:00+03:00,in,False,-1,True,4,0,37,37
167727,2019-11-25 00:00:00+03:00,out,False,926486,True,54,0,1265,1265
167727,2019-11-25 00:00:00+03:00,in,False,-1,True,4,0,37,37
167727,2019-11-26 00:00:00+03:00,out,False,926486,True,18,0,470,470
167727,2019-11-26 00:00:00+03:00,out,False,926486,False,18,6512,6816,304
167727,2019-11-26 00:00:00+03:00,out,False,926486,False,18,6512,6816,304
167727,2019-11-27 00:00:00+03:00,out,False,926486,True,22,0,464,464
167727,2019-11-27 00:00:00+03:00,out,False,926486,False,28,3557,4028,471
167727,2019-11-27 00:00:00+03:00,in,False,-1,True,1,0,26,26
167727,2019-11-28 00:00:00+03:00,out,False,926486,False,37,5767,6342,575
167727,2019-11-28 00:00:00+03:00,in,False,-1,True,4,0,96,96
167727,2019-11-28 00:00:00+03:00,out,False,926486,True,19,0,573,573
167742,2019-10-12 00:00:00+03:00,in,False,-1,True,1,0,2,2
167742,2019-10-16 00:00:00+03:00,in,False,-1,True,2,0,4,4
167742,2019-10-17 00:00:00+03:00,in,False,-1,True,7,0,14,14
167742,2019-10-19 00:00:00+03:00,in,False,-1,True,1,0,2,2
167742,2019-10-21 00:00:00+03:00,in,False,-1,True,4,0,8,8
167742,2019-10-22 00:00:00+03:00,in,False,-1,True,2,0,4,4
167742,2019-10-28 00:00:00+03:00,in,False,-1,True,2,0,4,4
167742,2019-10-29 00:00:00+03:00,in,False,-1,True,2,0,4,4
167742,2019-10-31 00:00:00+03:00,in,False,-1,True,1,0,13,13
167742,2019-10-31 00:00:00+03:00,in,False,951526,False,1,355,363,8
167742,2019-10-31 00:00:00+03:00,in,False,951526,False,1,355,363,8
167742,2019-11-01 00:00:00+03:00,in,False,951526,False,2,190,231,41
167742,2019-11-02 00:00:00+03:00,in,False,-1,True,1,0,30,30
167742,2019-11-04 00:00:00+03:00,in,False,951526,False,2,35,68,33
167742,2019-11-06 00:00:00+03:00,out,False,955164,True,1,0,9,9
167742,2019-11-07 00:00:00+03:00,in,False,951526,False,1,38,48,10
167742,2019-11-07 00:00:00+03:00,out,False,955032,False,1,43,65,22
167742,2019-11-08 00:00:00+03:00,in,False,951526,False,1,26,35,9
167742,2019-11-09 00:00:00+03:00,in,False,951526,False,2,247,267,20
167742,2019-11-09 00:00:00+03:00,in,False,-1,True,1,0,29,29
167742,2019-11-13 00:00:00+03:00,in,False,951526,False,2,27,48,21
167742,2019-11-15 00:00:00+03:00,in,False,-1,True,3,0,65,65
167742,2019-11-16 00:00:00+03:00,in,False,951526,False,1,15,29,14
167742,2019-11-16 00:00:00+03:00,in,False,951526,False,1,15,29,14
167742,2019-11-17 00:00:00+03:00,in,False,-1,True,2,0,36,36
167742,2019-11-18 00:00:00+03:00,in,False,951526,False,1,81,104,23
167742,2019-11-18 00:00:00+03:00,in,False,955032,False,5,308,342,34
167742,2019-11-18 00:00:00+03:00,in,False,-1,True,2,0,45,45
167742,2019-11-19 00:00:00+03:00,out,False,955032,True,1,0,10,10
167742,2019-11-19 00:00:00+03:00,in,False,955032,False,3,92,119,27
167742,2019-11-20 00:00:00+03:00,in,True,955032,False,1,3,13,10
167742,2019-11-20 00:00:00+03:00,in,False,955032,False,3,278,305,27
167742,2019-11-20 00:00:00+03:00,out,False,955032,True,4,0,13,13
167742,2019-11-20 00:00:00+03:00,in,False,-1,True,2,0,9,9
167742,2019-11-21 00:00:00+03:00,in,False,951526,False,1,1,20,19
167742,2019-11-21 00:00:00+03:00,out,False,955032,True,2,0,84,84
167742,2019-11-21 00:00:00+03:00,in,False,955032,False,3,211,234,23
167742,2019-11-21 00:00:00+03:00,out,False,955032,False,2,114,160,46
167742,2019-11-22 00:00:00+03:00,out,False,955032,True,1,0,22,22
167742,2019-11-22 00:00:00+03:00,out,False,955032,False,2,29,80,51
167742,2019-11-22 00:00:00+03:00,in,False,955032,False,2,89,110,21
167742,2019-11-22 00:00:00+03:00,out,False,955164,False,1,33,57,24
167742,2019-11-22 00:00:00+03:00,in,False,955164,False,1,11,37,26
167742,2019-11-22 00:00:00+03:00,out,False,955032,False,2,29,80,51
167742,2019-11-23 00:00:00+03:00,out,False,955032,False,3,31,70,39
167742,2019-11-23 00:00:00+03:00,in,False,-1,True,1,0,42,42
167742,2019-11-23 00:00:00+03:00,in,False,955032,True,1,1,12,11
167742,2019-11-23 00:00:00+03:00,in,False,955032,False,2,66,81,15
167742,2019-11-24 00:00:00+03:00,in,False,955032,False,2,1041,1054,13
167742,2019-11-24 00:00:00+03:00,out,False,955032,False,1,72,80,8
167742,2019-11-25 00:00:00+03:00,out,False,955032,False,1,4,50,46
167742,2019-11-25 00:00:00+03:00,in,False,-1,True,1,0,4,4
167742,2019-11-25 00:00:00+03:00,in,False,951526,False,1,20,41,21
167742,2019-11-25 00:00:00+03:00,in,False,955032,False,1,21,35,14
167742,2019-11-25 00:00:00+03:00,in,False,951526,False,1,20,41,21
167742,2019-11-26 00:00:00+03:00,out,False,955032,False,2,46,80,34
167742,2019-11-27 00:00:00+03:00,out,False,955032,True,1,0,5,5
167742,2019-11-27 00:00:00+03:00,in,False,955032,False,9,959,1029,70
167742,2019-11-27 00:00:00+03:00,out,False,955032,False,2,88,115,27
167742,2019-11-28 00:00:00+03:00,in,False,-1,True,1,0,6,6
167742,2019-11-28 00:00:00+03:00,out,False,955032,False,3,132,167,35
167742,2019-11-28 00:00:00+03:00,out,False,955032,True,8,0,196,196
167742,2019-11-28 00:00:00+03:00,out,False,955164,False,1,10,23,13
167742,2019-11-28 00:00:00+03:00,in,False,955032,False,6,236,299,63
167742,2019-11-28 00:00:00+03:00,in,False,955164,False,1,81,107,26
167744,2019-09-27 00:00:00+03:00,in,False,-1,True,1,0,2,2
167744,2019-09-29 00:00:00+03:00,in,False,-1,True,1,0,2,2
167744,2019-10-04 00:00:00+03:00,in,False,-1,True,34,0,13,13
167744,2019-10-07 00:00:00+03:00,in,False,-1,True,36,0,127,127
167744,2019-10-07 00:00:00+03:00,in,False,928022,False,3,123,169,46
167744,2019-10-07 00:00:00+03:00,in,False,928022,False,3,123,169,46
167744,2019-10-18 00:00:00+03:00,in,False,-1,True,1,0,20,20
167744,2019-11-06 00:00:00+03:00,in,False,-1,True,1,0,11,11
167744,2019-11-08 00:00:00+03:00,in,False,-1,True,2,0,48,48
167744,2019-11-11 00:00:00+03:00,in,False,928022,False,1,25,41,16
167744,2019-11-11 00:00:00+03:00,in,False,928022,False,1,25,41,16
167747,2019-10-04 00:00:00+03:00,in,False,922486,False,1,263,271,8
167747,2019-10-04 00:00:00+03:00,in,False,-1,True,2,0,25,25
167747,2019-10-05 00:00:00+03:00,in,False,-1,True,1,0,8,8
167747,2019-10-07 00:00:00+03:00,in,False,-1,True,1,0,9,9
167747,2019-10-18 00:00:00+03:00,in,False,-1,True,1,0,8,8
167747,2019-10-23 00:00:00+03:00,in,False,-1,True,3,0,43,43
167747,2019-10-26 00:00:00+03:00,in,False,-1,True,1,0,2,2
167747,2019-10-28 00:00:00+03:00,in,False,-1,True,1,0,2,2
167747,2019-10-29 00:00:00+03:00,in,False,-1,True,1,0,4,4
167747,2019-10-29 00:00:00+03:00,out,False,922428,True,6,0,96,96
167747,2019-10-29 00:00:00+03:00,in,False,922428,False,2,290,306,16
167747,2019-10-29 00:00:00+03:00,out,False,922428,False,7,1554,1659,105
167747,2019-10-29 00:00:00+03:00,out,True,922428,True,2,0,10,10
167747,2019-10-30 00:00:00+03:00,out,False,922428,True,2,0,55,55
167747,2019-10-30 00:00:00+03:00,in,False,-1,True,2,0,48,48
167747,2019-10-30 00:00:00+03:00,out,False,922428,False,10,1167,1313,146
167747,2019-10-30 00:00:00+03:00,out,True,922428,False,1,42,42,0
167747,2019-10-30 00:00:00+03:00,out,False,922428,True,2,0,55,55
167747,2019-10-30 00:00:00+03:00,out,True,922428,False,1,42,42,0
167747,2019-10-31 00:00:00+03:00,in,False,-1,True,1,0,34,34
167747,2019-10-31 00:00:00+03:00,out,False,922428,False,3,153,193,40
167747,2019-11-01 00:00:00+03:00,out,False,922428,False,1,161,176,15
167747,2019-11-01 00:00:00+03:00,in,False,922428,False,1,85,95,10
167747,2019-11-01 00:00:00+03:00,out,False,922428,True,2,0,47,47
167747,2019-11-02 00:00:00+03:00,out,False,922428,False,6,824,937,113
167747,2019-11-03 00:00:00+03:00,in,False,-1,True,2,0,57,57
167747,2019-11-03 00:00:00+03:00,out,False,922428,False,4,166,209,43
167747,2019-11-05 00:00:00+03:00,out,False,922428,False,7,1503,1576,73
167747,2019-11-05 00:00:00+03:00,out,False,922428,True,1,0,37,37
167747,2019-11-05 00:00:00+03:00,out,True,922428,True,1,0,0,0
167747,2019-11-05 00:00:00+03:00,in,False,922428,False,1,12,21,9
167747,2019-11-06 00:00:00+03:00,in,False,-1,True,2,0,37,37
167747,2019-11-06 00:00:00+03:00,out,False,922476,False,1,61,69,8
167747,2019-11-06 00:00:00+03:00,out,True,922476,False,1,15,24,9
167747,2019-11-06 00:00:00+03:00,out,False,922428,False,14,2091,2238,147
167747,2019-11-06 00:00:00+03:00,out,False,922476,True,1,0,26,26
167747,2019-11-06 00:00:00+03:00,out,True,922428,True,8,0,49,49
167747,2019-11-06 00:00:00+03:00,in,False,922428,False,2,202,226,24
167747,2019-11-06 00:00:00+03:00,out,False,922428,True,4,0,43,43
167747,2019-11-06 00:00:00+03:00,out,False,922428,False,14,2091,2238,147
167747,2019-11-07 00:00:00+03:00,out,True,922476,True,2,0,0,0
167747,2019-11-07 00:00:00+03:00,out,False,922428,True,5,0,202,202
167747,2019-11-07 00:00:00+03:00,out,False,922428,False,9,942,1052,110
167747,2019-11-07 00:00:00+03:00,in,False,922428,False,4,377,413,36
167747,2019-11-07 00:00:00+03:00,out,False,922476,False,3,1191,1225,34
167747,2019-11-07 00:00:00+03:00,out,True,922428,True,1,0,0,0
167747,2019-11-07 00:00:00+03:00,out,True,922476,False,1,155,163,8
167747,2019-11-08 00:00:00+03:00,out,False,922476,True,16,0,310,310
167747,2019-11-08 00:00:00+03:00,in,False,922474,False,1,48,59,11
167747,2019-11-08 00:00:00+03:00,out,True,922474,False,1,11,14,3
167747,2019-11-08 00:00:00+03:00,out,True,922476,False,6,228,269,41
167747,2019-11-08 00:00:00+03:00,out,True,922474,True,1,0,0,0
167747,2019-11-08 00:00:00+03:00,out,True,922476,True,5,0,42,42
167747,2019-11-08 00:00:00+03:00,out,True,922486,True,1,0,0,0
167747,2019-11-08 00:00:00+03:00,out,False,922476,False,27,3212,3459,247
167747,2019-11-08 00:00:00+03:00,out,False,922428,False,1,75,78,3
167747,2019-11-08 00:00:00+03:00,in,False,-1,True,2,0,24,24
167747,2019-11-09 00:00:00+03:00,out,False,922428,True,1,0,42,42
167747,2019-11-09 00:00:00+03:00,in,False,922474,False,1,22,31,9
167747,2019-11-09 00:00:00+03:00,out,True,922428,False,1,14,21,7
167747,2019-11-10 00:00:00+03:00,in,False,-1,True,2,0,37,37
167747,2019-11-11 00:00:00+03:00,out,False,922428,False,15,3287,3411,124
167747,2019-11-11 00:00:00+03:00,out,False,922428,True,2,0,38,38
167747,2019-11-11 00:00:00+03:00,out,True,922476,False,3,124,141,17
167747,2019-11-11 00:00:00+03:00,out,False,922476,True,1,0,3,3
167747,2019-11-11 00:00:00+03:00,out,True,922474,True,2,0,34,34
167747,2019-11-11 00:00:00+03:00,out,False,922474,False,8,397,453,56
167747,2019-11-11 00:00:00+03:00,in,False,922474,False,2,100,121,21
167747,2019-11-11 00:00:00+03:00,out,True,922476,True,4,0,50,50
167747,2019-11-11 00:00:00+03:00,out,True,922428,False,1,14,19,5
167747,2019-11-11 00:00:00+03:00,out,False,922476,False,4,735,759,24
167747,2019-11-11 00:00:00+03:00,in,False,922428,False,1,193,200,7
167747,2019-11-11 00:00:00+03:00,out,True,922474,False,1,28,32,4
167747,2019-11-11 00:00:00+03:00,out,False,922474,False,8,397,453,56
167747,2019-11-11 00:00:00+03:00,out,False,922476,False,4,735,759,24
167747,2019-11-12 00:00:00+03:00,out,True,922476,False,3,132,165,33
167747,2019-11-12 00:00:00+03:00,out,False,922474,True,2,0,4,4
167747,2019-11-12 00:00:00+03:00,out,False,922476,False,10,4287,4418,131
167747,2019-11-12 00:00:00+03:00,out,False,922474,False,13,1493,1601,108
167747,2019-11-12 00:00:00+03:00,out,True,922474,True,1,0,27,27
167747,2019-11-12 00:00:00+03:00,out,True,922428,False,2,546,566,20
167747,2019-11-12 00:00:00+03:00,out,True,922428,True,1,0,0,0
167747,2019-11-12 00:00:00+03:00,out,False,922428,False,2,283,323,40
167747,2019-11-12 00:00:00+03:00,out,True,922476,True,1,0,0,0
167747,2019-11-12 00:00:00+03:00,out,False,922476,True,4,0,79,79
167747,2019-11-12 00:00:00+03:00,out,True,922474,False,1,58,61,3
167747,2019-11-12 00:00:00+03:00,out,False,922476,True,4,0,79,79
167747,2019-11-13 00:00:00+03:00,out,False,922474,True,1,0,51,51
167747,2019-11-13 00:00:00+03:00,out,False,922476,False,2,630,657,27
167747,2019-11-13 00:00:00+03:00,out,True,922428,True,1,0,5,5
167747,2019-11-13 00:00:00+03:00,out,False,922428,True,2,0,25,25
167747,2019-11-13 00:00:00+03:00,in,False,922474,False,2,76,91,15
167747,2019-11-13 00:00:00+03:00,out,False,922428,False,7,799,898,99
167747,2019-11-13 00:00:00+03:00,out,False,922476,True,1,0,18,18
167747,2019-11-13 00:00:00+03:00,out,True,922474,True,11,0,14,14
167747,2019-11-13 00:00:00+03:00,out,True,922474,False,1,8,10,2
167747,2019-11-13 00:00:00+03:00,out,True,922476,True,6,0,48,48
167747,2019-11-13 00:00:00+03:00,out,True,922476,False,3,94,115,21
167747,2019-11-13 00:00:00+03:00,in,False,922428,False,1,15,23,8
167747,2019-11-13 00:00:00+03:00,out,False,922474,False,9,2281,2301,20
167747,2019-11-13 00:00:00+03:00,out,False,922428,True,2,0,25,25
167747,2019-11-14 00:00:00+03:00,in,False,922428,False,1,43,50,7
167747,2019-11-14 00:00:00+03:00,in,False,-1,True,1,0,7,7
167747,2019-11-14 00:00:00+03:00,out,False,922474,False,3,641,655,14
167747,2019-11-14 00:00:00+03:00,out,True,922474,False,13,475,515,40
167747,2019-11-14 00:00:00+03:00,out,False,922428,False,2,72,76,4
167747,2019-11-14 00:00:00+03:00,out,False,922474,True,3,0,77,77
167747,2019-11-14 00:00:00+03:00,out,False,922428,True,1,0,3,3
167747,2019-11-14 00:00:00+03:00,out,True,922474,True,3,0,25,25
167747,2019-11-14 00:00:00+03:00,out,False,922476,True,5,0,131,131
167747,2019-11-14 00:00:00+03:00,in,False,922474,False,7,344,390,46
167747,2019-11-14 00:00:00+03:00,out,False,922476,False,22,5005,5238,233
167747,2019-11-14 00:00:00+03:00,out,True,922476,False,7,197,243,46
167747,2019-11-14 00:00:00+03:00,out,True,922476,True,1,0,0,0
167747,2019-11-15 00:00:00+03:00,out,False,922474,False,4,854,863,9
167747,2019-11-15 00:00:00+03:00,out,False,922474,True,1,0,2,2
167747,2019-11-15 00:00:00+03:00,out,False,922428,False,1,61,80,19
167747,2019-11-15 00:00:00+03:00,in,False,922474,False,3,307,332,25
167747,2019-11-17 00:00:00+03:00,in,False,922474,False,2,117,140,23
167747,2019-11-17 00:00:00+03:00,out,False,922474,True,1,0,2,2
167747,2019-11-18 00:00:00+03:00,out,False,922428,False,4,668,698,30
167747,2019-11-18 00:00:00+03:00,out,False,922476,False,11,3395,3537,142
167747,2019-11-18 00:00:00+03:00,out,False,922428,True,3,0,119,119
167747,2019-11-18 00:00:00+03:00,out,False,922474,False,4,287,355,68
167747,2019-11-18 00:00:00+03:00,in,False,-1,True,1,0,30,30
167747,2019-11-18 00:00:00+03:00,in,False,922428,False,3,725,748,23
167747,2019-11-18 00:00:00+03:00,in,False,922474,False,7,480,534,54
167747,2019-11-18 00:00:00+03:00,out,True,922474,False,1,1,15,14
167747,2019-11-18 00:00:00+03:00,out,False,922476,True,2,0,24,24
167747,2019-11-18 00:00:00+03:00,out,True,922476,False,2,24,40,16
167747,2019-11-18 00:00:00+03:00,out,True,922474,True,1,0,31,31
167747,2019-11-18 00:00:00+03:00,out,True,922476,True,2,0,1,1
167747,2019-11-18 00:00:00+03:00,out,True,922476,False,2,24,40,16
167747,2019-11-19 00:00:00+03:00,in,False,922428,False,1,93,105,12
167747,2019-11-19 00:00:00+03:00,in,False,922474,False,10,561,633,72
167747,2019-11-19 00:00:00+03:00,out,False,922476,True,1,0,60,60
167747,2019-11-19 00:00:00+03:00,out,False,922476,False,2,105,127,22
167747,2019-11-19 00:00:00+03:00,out,False,922474,True,12,0,293,293
167747,2019-11-19 00:00:00+03:00,out,True,922474,True,1,0,1,1
167747,2019-11-19 00:00:00+03:00,out,False,922474,False,20,1814,2029,215
167747,2019-11-19 00:00:00+03:00,out,True,922474,False,1,12,24,12
167747,2019-11-19 00:00:00+03:00,in,False,922474,False,10,561,633,72
167747,2019-11-19 00:00:00+03:00,out,False,922476,True,1,0,60,60
167747,2019-11-20 00:00:00+03:00,out,False,922476,False,5,1089,1141,52
167747,2019-11-20 00:00:00+03:00,out,True,922474,True,1,0,0,0
167747,2019-11-20 00:00:00+03:00,out,False,922474,True,2,0,4,4
167747,2019-11-20 00:00:00+03:00,out,False,922476,True,1,0,11,11
167747,2019-11-20 00:00:00+03:00,out,False,922474,False,11,1043,1171,128
167747,2019-11-20 00:00:00+03:00,out,False,922428,False,6,2352,2399,47
167747,2019-11-20 00:00:00+03:00,out,True,922474,False,1,49,54,5
167747,2019-11-21 00:00:00+03:00,in,False,-1,True,2,0,71,71
167747,2019-11-21 00:00:00+03:00,out,False,922474,False,10,1176,1313,137
167747,2019-11-21 00:00:00+03:00,in,False,922474,False,2,89,102,13
167747,2019-11-21 00:00:00+03:00,out,False,922428,False,12,1791,1928,137
167747,2019-11-21 00:00:00+03:00,out,False,922428,True,1,0,49,49
167747,2019-11-21 00:00:00+03:00,out,True,922428,False,1,34,44,10
167747,2019-11-21 00:00:00+03:00,out,False,922474,True,4,0,134,134
167747,2019-11-21 00:00:00+03:00,in,False,922428,False,3,397,416,19
167747,2019-11-21 00:00:00+03:00,out,False,922474,False,10,1176,1313,137
167747,2019-11-22 00:00:00+03:00,out,False,922428,True,1,0,3,3
167747,2019-11-22 00:00:00+03:00,in,False,922428,False,3,256,279,23
167747,2019-11-22 00:00:00+03:00,in,False,922474,False,1,19,33,14
167747,2019-11-22 00:00:00+03:00,out,False,922428,False,7,844,937,93
167747,2019-11-22 00:00:00+03:00,out,False,922476,True,1,0,44,44
167747,2019-11-22 00:00:00+03:00,in,False,-1,True,1,0,21,21
167747,2019-11-22 00:00:00+03:00,out,False,922474,False,1,38,40,2
167747,2019-11-22 00:00:00+03:00,out,False,922428,False,7,844,937,93
167747,2019-11-22 00:00:00+03:00,in,False,922428,False,3,256,279,23
167747,2019-11-23 00:00:00+03:00,in,False,-1,True,1,0,34,34
167747,2019-11-23 00:00:00+03:00,out,True,922486,True,1,0,0,0
167747,2019-11-24 00:00:00+03:00,in,False,922474,False,4,432,458,26
167747,2019-11-24 00:00:00+03:00,out,True,922486,True,2,0,0,0
167747,2019-11-24 00:00:00+03:00,out,False,922474,True,2,0,41,41
167747,2019-11-24 00:00:00+03:00,out,False,922474,False,4,573,575,2
167747,2019-11-24 00:00:00+03:00,in,False,922428,False,1,13,21,8
167747,2019-11-24 00:00:00+03:00,out,True,922486,True,2,0,0,0
167747,2019-11-24 00:00:00+03:00,in,False,922474,False,4,432,458,26
167747,2019-11-25 00:00:00+03:00,out,False,922476,False,16,2909,3087,178
167747,2019-11-25 00:00:00+03:00,out,False,922474,False,7,812,897,85
167747,2019-11-25 00:00:00+03:00,out,False,922428,False,3,829,881,52
167747,2019-11-25 00:00:00+03:00,in,False,922428,False,1,172,181,9
167747,2019-11-25 00:00:00+03:00,out,True,922474,False,2,263,274,11
167747,2019-11-25 00:00:00+03:00,in,False,922474,False,6,400,453,53
167747,2019-11-25 00:00:00+03:00,out,True,922476,True,2,0,7,7
167747,2019-11-25 00:00:00+03:00,out,False,922476,True,2,0,89,89
167747,2019-11-25 00:00:00+03:00,out,True,922476,False,2,93,104,11
167747,2019-11-25 00:00:00+03:00,out,True,922474,False,2,263,274,11
167747,2019-11-25 00:00:00+03:00,in,False,922474,False,6,400,453,53
167747,2019-11-26 00:00:00+03:00,out,True,922474,True,1,0,2,2
167747,2019-11-26 00:00:00+03:00,in,False,922474,False,8,1427,1481,54
167747,2019-11-26 00:00:00+03:00,out,False,922474,True,5,0,63,63
167747,2019-11-26 00:00:00+03:00,out,True,922474,False,1,18,21,3
167747,2019-11-26 00:00:00+03:00,out,False,922428,False,12,2941,3138,197
167747,2019-11-26 00:00:00+03:00,out,False,922474,False,10,1014,1113,99
167747,2019-11-26 00:00:00+03:00,in,False,922428,False,1,254,262,8
167747,2019-11-26 00:00:00+03:00,out,True,922428,False,1,59,64,5
167747,2019-11-26 00:00:00+03:00,out,False,922428,True,1,0,3,3
167747,2019-11-26 00:00:00+03:00,in,False,922474,False,8,1427,1481,54
167747,2019-11-27 00:00:00+03:00,out,False,922486,False,1,12,24,12
167747,2019-11-27 00:00:00+03:00,in,False,922428,False,1,301,310,9
167747,2019-11-27 00:00:00+03:00,out,False,922474,False,3,266,303,37
167747,2019-11-27 00:00:00+03:00,out,False,922428,True,4,0,139,139
167747,2019-11-27 00:00:00+03:00,out,False,922428,False,7,1653,1704,51
167747,2019-11-27 00:00:00+03:00,in,False,922474,False,4,54,100,46
167747,2019-11-28 00:00:00+03:00,out,False,922474,False,19,1903,2146,243
167747,2019-11-28 00:00:00+03:00,out,True,922474,False,3,250,258,8
167747,2019-11-28 00:00:00+03:00,out,False,922476,True,1,0,53,53
167747,2019-11-28 00:00:00+03:00,out,False,922476,False,3,854,874,20
167747,2019-11-28 00:00:00+03:00,out,True,922474,True,2,0,5,5
167747,2019-11-28 00:00:00+03:00,out,False,922474,True,2,0,12,12
167747,2019-11-28 00:00:00+03:00,in,False,-1,True,2,0,57,57
167747,2019-11-28 00:00:00+03:00,out,True,922476,False,3,80,100,20
167747,2019-11-28 00:00:00+03:00,out,False,922428,True,2,0,102,102
167747,2019-11-28 00:00:00+03:00,out,True,922428,False,1,93,97,4
167747,2019-11-28 00:00:00+03:00,in,False,922474,False,3,459,484,25
167747,2019-11-28 00:00:00+03:00,out,False,922428,False,4,359,443,84
167756,2019-10-17 00:00:00+03:00,out,False,938896,True,2,0,0,0
167756,2019-10-17 00:00:00+03:00,out,True,938896,True,1,0,0,0
167756,2019-10-18 00:00:00+03:00,out,False,938896,True,5,0,133,133
167756,2019-10-18 00:00:00+03:00,out,False,938896,False,15,759,1017,258
167756,2019-10-18 00:00:00+03:00,in,False,-1,True,3,0,58,58
167756,2019-10-18 00:00:00+03:00,in,False,938896,False,6,116,174,58
167756,2019-10-19 00:00:00+03:00,out,False,938896,True,15,0,395,395
167756,2019-10-19 00:00:00+03:00,in,False,-1,True,7,0,110,110
167756,2019-10-19 00:00:00+03:00,out,False,938896,False,30,1502,1993,491
167756,2019-10-19 00:00:00+03:00,in,False,938896,False,14,960,1077,117
167756,2019-10-20 00:00:00+03:00,in,False,938896,False,19,1381,1544,163
167756,2019-10-20 00:00:00+03:00,out,False,938896,False,44,2044,2931,887
167756,2019-10-20 00:00:00+03:00,out,False,938896,True,14,0,383,383
167756,2019-10-20 00:00:00+03:00,in,False,-1,True,1,0,3,3
167756,2019-10-20 00:00:00+03:00,out,False,938896,True,14,0,383,383
167756,2019-10-21 00:00:00+03:00,in,False,938896,False,19,1753,1955,202
167756,2019-10-21 00:00:00+03:00,out,False,938896,False,65,2637,3724,1087
167756,2019-10-21 00:00:00+03:00,in,False,-1,True,3,0,40,40
167756,2019-10-21 00:00:00+03:00,out,False,938896,True,21,0,516,516
167756,2019-10-21 00:00:00+03:00,in,False,938896,False,19,1753,1955,202
167756,2019-10-22 00:00:00+03:00,in,False,938896,False,23,1410,1617,207
167756,2019-10-22 00:00:00+03:00,out,False,938896,True,12,0,424,424
167756,2019-10-22 00:00:00+03:00,in,False,938896,True,1,0,4,4
167756,2019-10-22 00:00:00+03:00,in,False,-1,True,3,0,61,61
167756,2019-10-22 00:00:00+03:00,out,False,938896,False,38,1315,2033,718
167756,2019-10-23 00:00:00+03:00,in,False,938896,False,20,2007,2177,170
167756,2019-10-23 00:00:00+03:00,in,False,-1,True,4,0,72,72
167756,2019-10-23 00:00:00+03:00,out,False,938896,False,51,2092,3123,1031
167756,2019-10-23 00:00:00+03:00,out,False,938896,True,11,0,307,307
167756,2019-10-24 00:00:00+03:00,out,False,938896,False,47,2270,3100,830
167756,2019-10-24 00:00:00+03:00,in,False,938896,False,21,1540,1725,185
167756,2019-10-24 00:00:00+03:00,out,False,938896,True,26,0,732,732
167756,2019-10-24 00:00:00+03:00,in,False,-1,True,2,0,18,18
167756,2019-10-25 00:00:00+03:00,in,False,-1,True,4,0,9,9
167756,2019-10-25 00:00:00+03:00,in,False,938896,False,20,1378,1515,137
167756,2019-10-25 00:00:00+03:00,out,False,938896,True,8,0,310,310
167756,2019-10-25 00:00:00+03:00,out,False,938896,False,45,1707,2573,866
167756,2019-10-25 00:00:00+03:00,in,False,938896,False,20,1378,1515,137
167756,2019-10-26 00:00:00+03:00,out,False,938896,True,7,0,266,266
167756,2019-10-26 00:00:00+03:00,in,False,938896,False,16,1182,1346,164
167756,2019-10-26 00:00:00+03:00,out,False,938896,False,39,1596,2392,796
167756,2019-10-26 00:00:00+03:00,in,False,-1,True,2,0,41,41
167756,2019-10-27 00:00:00+03:00,out,False,938896,True,4,0,101,101
167756,2019-10-27 00:00:00+03:00,out,False,938896,False,21,912,1268,356
167756,2019-10-27 00:00:00+03:00,in,False,938896,False,6,372,421,49
167756,2019-10-27 00:00:00+03:00,in,False,938896,False,6,372,421,49
167756,2019-10-28 00:00:00+03:00,out,False,938896,True,18,0,617,617
167756,2019-10-28 00:00:00+03:00,in,False,-1,True,4,0,25,25
167756,2019-10-28 00:00:00+03:00,out,False,938896,False,32,1286,1813,527
167756,2019-10-28 00:00:00+03:00,in,False,938896,False,18,1193,1331,138
167756,2019-10-28 00:00:00+03:00,in,False,938896,False,18,1193,1331,138
167756,2019-10-28 00:00:00+03:00,out,False,938896,True,18,0,617,617
167756,2019-10-29 00:00:00+03:00,in,False,938896,False,24,1438,1607,169
167756,2019-10-29 00:00:00+03:00,in,False,-1,True,4,0,44,44
167756,2019-10-29 00:00:00+03:00,out,False,938896,False,39,1368,2116,748
167756,2019-10-29 00:00:00+03:00,out,False,938896,True,11,0,287,287
167756,2019-10-30 00:00:00+03:00,out,False,938896,False,39,1575,2305,730
167756,2019-10-30 00:00:00+03:00,in,False,938896,False,10,770,841,71
167756,2019-10-30 00:00:00+03:00,out,True,938896,True,1,0,3,3
167756,2019-10-30 00:00:00+03:00,out,False,938896,True,10,0,343,343
167756,2019-10-30 00:00:00+03:00,in,False,-1,True,1,0,4,4
167756,2019-10-31 00:00:00+03:00,out,False,938896,False,34,2271,2848,577
167756,2019-10-31 00:00:00+03:00,in,False,-1,True,1,0,2,2
167756,2019-10-31 00:00:00+03:00,in,False,938896,False,20,1708,1863,155
167756,2019-10-31 00:00:00+03:00,out,False,938896,True,7,0,193,193
167756,2019-11-01 00:00:00+03:00,out,False,938896,False,18,734,1037,303
167756,2019-11-01 00:00:00+03:00,in,False,938896,False,7,361,411,50
167756,2019-11-01 00:00:00+03:00,in,False,-1,True,13,0,18,18
167756,2019-11-01 00:00:00+03:00,out,False,938896,True,4,0,98,98
167756,2019-11-01 00:00:00+03:00,in,False,938896,False,7,361,411,50
167756,2019-11-02 00:00:00+03:00,out,False,938896,True,19,0,502,502
167756,2019-11-02 00:00:00+03:00,in,False,938896,False,16,1080,1242,162
167756,2019-11-02 00:00:00+03:00,out,False,938896,False,41,1934,2672,738
167756,2019-11-02 00:00:00+03:00,in,False,-1,True,2,0,31,31
167756,2019-11-03 00:00:00+03:00,out,False,938896,False,29,1234,1751,517
167756,2019-11-03 00:00:00+03:00,out,False,938896,True,12,0,409,409
167756,2019-11-03 00:00:00+03:00,in,False,-1,True,4,0,38,38
167756,2019-11-03 00:00:00+03:00,in,False,938896,False,11,712,791,79
167756,2019-11-04 00:00:00+03:00,in,False,938896,False,10,825,901,76
167756,2019-11-04 00:00:00+03:00,out,False,938896,True,10,0,318,318
167756,2019-11-04 00:00:00+03:00,in,False,-1,True,4,0,14,14
167756,2019-11-04 00:00:00+03:00,out,False,938896,False,32,1181,1838,657
167756,2019-11-05 00:00:00+03:00,in,False,-1,True,10,0,184,184
167756,2019-11-05 00:00:00+03:00,out,False,938896,False,41,1850,2589,739
167756,2019-11-05 00:00:00+03:00,in,False,938896,False,16,2637,2740,103
167756,2019-11-05 00:00:00+03:00,out,False,938896,True,16,0,418,418
167756,2019-11-06 00:00:00+03:00,in,False,-1,True,3,0,12,12
167756,2019-11-06 00:00:00+03:00,out,False,938896,True,12,0,375,375
167756,2019-11-06 00:00:00+03:00,out,False,938896,False,24,1058,1498,440
167756,2019-11-06 00:00:00+03:00,in,False,938896,False,13,669,768,99
167756,2019-11-07 00:00:00+03:00,out,False,938896,False,36,2070,2647,577
167756,2019-11-07 00:00:00+03:00,in,False,938896,False,23,1630,1790,160
167756,2019-11-07 00:00:00+03:00,in,False,938896,True,1,1,9,8
167756,2019-11-07 00:00:00+03:00,in,False,-1,True,1,0,6,6
167756,2019-11-07 00:00:00+03:00,out,False,938896,True,9,0,313,313
167756,2019-11-08 00:00:00+03:00,out,False,938896,False,73,3084,4636,1552
167756,2019-11-08 00:00:00+03:00,out,False,938896,True,20,0,416,416
167756,2019-11-08 00:00:00+03:00,in,False,938896,False,28,2374,2651,277
167756,2019-11-08 00:00:00+03:00,in,False,-1,True,3,0,18,18
167756,2019-11-08 00:00:00+03:00,out,False,938896,False,73,3084,4636,1552
167756,2019-11-09 00:00:00+03:00,in,False,-1,True,4,0,86,86
167756,2019-11-09 00:00:00+03:00,out,False,938896,False,48,1606,2596,990
167756,2019-11-09 00:00:00+03:00,out,False,938896,True,12,0,435,435
167756,2019-11-09 00:00:00+03:00,in,False,938896,False,32,1807,2178,371
167756,2019-11-10 00:00:00+03:00,out,False,938896,False,60,2015,3174,1159
167756,2019-11-10 00:00:00+03:00,in,False,938896,False,20,1468,1634,166
167756,2019-11-10 00:00:00+03:00,out,False,938896,True,31,0,843,843
167756,2019-11-10 00:00:00+03:00,in,False,-1,True,7,0,66,66
167756,2019-11-10 00:00:00+03:00,in,False,938896,False,20,1468,1634,166
167756,2019-11-11 00:00:00+03:00,in,False,938896,False,21,1526,1654,128
167756,2019-11-11 00:00:00+03:00,out,False,938896,True,5,0,222,222
167756,2019-11-11 00:00:00+03:00,in,False,-1,True,6,0,131,131
167756,2019-11-11 00:00:00+03:00,out,False,938896,False,23,1147,1572,425
167756,2019-11-12 00:00:00+03:00,in,False,-1,True,7,0,79,79
167756,2019-11-12 00:00:00+03:00,out,False,938896,True,14,0,342,342
167756,2019-11-12 00:00:00+03:00,out,True,938896,True,1,0,0,0
167756,2019-11-12 00:00:00+03:00,in,False,938896,False,31,1978,2166,188
167756,2019-11-12 00:00:00+03:00,out,False,938896,False,42,1700,2416,716
167756,2019-11-13 00:00:00+03:00,in,False,938896,False,24,1373,1526,153
167756,2019-11-13 00:00:00+03:00,out,False,938896,False,48,2036,2887,851
167756,2019-11-13 00:00:00+03:00,out,False,938896,True,7,0,212,212
167756,2019-11-13 00:00:00+03:00,in,False,-1,True,3,0,21,21
167756,2019-11-14 00:00:00+03:00,out,False,938896,True,10,0,300,300
167756,2019-11-14 00:00:00+03:00,out,False,938896,False,32,1845,2274,429
167756,2019-11-14 00:00:00+03:00,in,False,-1,True,2,0,3,3
167756,2019-11-14 00:00:00+03:00,in,False,938896,False,35,1906,2128,222
167756,2019-11-14 00:00:00+03:00,in,False,-1,True,2,0,3,3
167756,2019-11-15 00:00:00+03:00,out,False,938896,True,19,0,542,542
167756,2019-11-15 00:00:00+03:00,out,False,938896,False,37,2099,2732,633
167756,2019-11-15 00:00:00+03:00,in,False,938896,False,23,1302,1457,155
167756,2019-11-15 00:00:00+03:00,in,False,-1,True,4,0,4,4
167756,2019-11-16 00:00:00+03:00,in,False,938896,False,27,1730,1931,201
167756,2019-11-16 00:00:00+03:00,in,False,-1,True,5,0,62,62
167756,2019-11-16 00:00:00+03:00,out,False,938896,False,31,1028,1643,615
167756,2019-11-16 00:00:00+03:00,out,False,938896,True,5,0,168,168
167756,2019-11-16 00:00:00+03:00,in,False,938896,False,27,1730,1931,201
167756,2019-11-16 00:00:00+03:00,in,False,-1,True,5,0,62,62
167756,2019-11-17 00:00:00+03:00,in,False,938896,False,33,1748,1978,230
167756,2019-11-17 00:00:00+03:00,in,False,-1,True,21,0,144,144
167756,2019-11-17 00:00:00+03:00,out,False,938896,False,28,1376,1830,454
167756,2019-11-17 00:00:00+03:00,out,False,938896,True,10,0,103,103
167756,2019-11-17 00:00:00+03:00,in,False,-1,True,21,0,144,144
167756,2019-11-18 00:00:00+03:00,out,False,938896,False,51,2634,3520,886
167756,2019-11-18 00:00:00+03:00,in,False,938896,False,49,3433,3722,289
167756,2019-11-18 00:00:00+03:00,out,False,938896,True,21,0,607,607
167756,2019-11-18 00:00:00+03:00,in,False,938896,False,49,3433,3722,289
167756,2019-11-19 00:00:00+03:00,out,False,938896,False,55,2111,3028,917
167756,2019-11-19 00:00:00+03:00,in,False,-1,True,4,0,60,60
167756,2019-11-19 00:00:00+03:00,in,False,938896,False,36,3107,3429,322
167756,2019-11-19 00:00:00+03:00,in,False,938896,True,1,1,9,8
167756,2019-11-19 00:00:00+03:00,out,False,938896,True,16,0,444,444
167756,2019-11-20 00:00:00+03:00,in,False,938896,False,29,2111,2342,231
167756,2019-11-20 00:00:00+03:00,out,False,938896,True,15,0,338,338
167756,2019-11-20 00:00:00+03:00,out,False,938896,False,43,2029,2824,795
167756,2019-11-20 00:00:00+03:00,in,False,938896,True,1,0,29,29
167756,2019-11-20 00:00:00+03:00,in,False,-1,True,6,0,15,15
167756,2019-11-21 00:00:00+03:00,out,True,938896,True,1,0,2,2
167756,2019-11-21 00:00:00+03:00,in,False,938896,False,48,3957,4292,335
167756,2019-11-21 00:00:00+03:00,in,False,-1,True,7,0,89,89
167756,2019-11-21 00:00:00+03:00,out,False,938896,False,74,3261,4442,1181
167756,2019-11-21 00:00:00+03:00,out,False,938896,True,37,0,960,960
167756,2019-11-22 00:00:00+03:00,out,True,938896,True,1,0,0,0
167756,2019-11-22 00:00:00+03:00,out,False,938896,False,34,1898,2523,625
167756,2019-11-22 00:00:00+03:00,out,False,938896,True,18,0,310,310
167756,2019-11-22 00:00:00+03:00,in,False,938896,False,40,2808,3124,316
167756,2019-11-22 00:00:00+03:00,in,False,-1,True,7,0,114,114
167756,2019-11-23 00:00:00+03:00,out,False,938896,False,26,821,1402,581
167756,2019-11-23 00:00:00+03:00,out,False,938896,True,12,0,389,389
167756,2019-11-23 00:00:00+03:00,out,True,938896,True,1,0,2,2
167756,2019-11-23 00:00:00+03:00,in,False,938896,False,29,1750,1962,212
167756,2019-11-23 00:00:00+03:00,in,False,-1,True,2,0,33,33
167756,2019-11-24 00:00:00+03:00,out,False,938896,False,16,718,1071,353
167756,2019-11-24 00:00:00+03:00,out,False,938896,True,6,0,237,237
167756,2019-11-24 00:00:00+03:00,in,False,938896,False,29,1953,2220,267
167756,2019-11-24 00:00:00+03:00,in,False,-1,True,1,0,35,35
167756,2019-11-24 00:00:00+03:00,out,False,938896,False,16,718,1071,353
167756,2019-11-25 00:00:00+03:00,out,False,938896,True,18,0,458,458
167756,2019-11-25 00:00:00+03:00,in,False,938896,True,1,0,3,3
167756,2019-11-25 00:00:00+03:00,out,False,938896,False,59,2926,3979,1053
167756,2019-11-25 00:00:00+03:00,in,False,-1,True,3,0,46,46
167756,2019-11-25 00:00:00+03:00,in,False,938896,False,47,3874,4156,282
167756,2019-11-26 00:00:00+03:00,in,False,938896,False,45,2862,3208,346
167756,2019-11-26 00:00:00+03:00,out,False,938896,True,27,0,731,731
167756,2019-11-26 00:00:00+03:00,in,False,-1,True,2,0,47,47
167756,2019-11-26 00:00:00+03:00,out,False,938896,False,51,1871,2839,968
167756,2019-11-27 00:00:00+03:00,in,False,938896,False,54,3539,3940,401
167756,2019-11-27 00:00:00+03:00,out,False,938896,False,39,2008,2705,697
167756,2019-11-27 00:00:00+03:00,out,False,938896,True,16,0,430,430
167756,2019-11-27 00:00:00+03:00,in,False,-1,True,4,0,31,31
167756,2019-11-28 00:00:00+03:00,out,False,938896,False,46,1686,2582,896
167756,2019-11-28 00:00:00+03:00,in,False,-1,True,2,0,46,46
167756,2019-11-28 00:00:00+03:00,in,False,938896,False,41,2488,2812,324
167756,2019-11-28 00:00:00+03:00,out,False,938896,True,18,0,428,428
167759,2019-09-28 00:00:00+03:00,out,True,922698,True,1,0,0,0
167759,2019-09-28 00:00:00+03:00,in,False,-1,True,2,0,4,4
167759,2019-09-28 00:00:00+03:00,out,False,922698,True,6,0,0,0
167759,2019-09-29 00:00:00+03:00,in,False,-1,True,1,0,2,2
167759,2019-09-29 00:00:00+03:00,out,False,922698,True,2,0,1,1
167759,2019-09-29 00:00:00+03:00,in,False,-1,True,1,0,2,2
167759,2019-09-29 00:00:00+03:00,in,False,-1,True,1,0,2,2
167759,2019-09-30 00:00:00+03:00,out,False,922698,False,2,66,78,12
167759,2019-09-30 00:00:00+03:00,in,False,922698,False,3,88,125,37
167759,2019-09-30 00:00:00+03:00,out,True,922698,True,1,0,15,15
167759,2019-09-30 00:00:00+03:00,in,True,922698,False,1,11,17,6
167768,2019-10-02 00:00:00+03:00,in,False,-1,True,9,0,1,1
167768,2019-10-03 00:00:00+03:00,in,False,-1,True,2,0,17,17
167781,2019-09-30 00:00:00+03:00,in,False,-1,True,1,0,12,12
167781,2019-10-04 00:00:00+03:00,in,False,923944,False,1,7,19,12
167781,2019-10-07 00:00:00+03:00,in,False,923944,False,6,221,287,66
167781,2019-10-07 00:00:00+03:00,in,False,-1,True,1,0,11,11
167781,2019-10-09 00:00:00+03:00,in,False,923944,False,1,13,24,11
167781,2019-10-09 00:00:00+03:00,in,False,923944,False,1,13,24,11
167781,2019-10-10 00:00:00+03:00,in,False,923944,False,2,30,54,24
167781,2019-10-11 00:00:00+03:00,in,False,923944,False,2,46,63,17
167781,2019-10-14 00:00:00+03:00,in,False,-1,True,2,0,39,39
167781,2019-10-14 00:00:00+03:00,in,False,923944,False,1,17,26,9
167781,2019-10-15 00:00:00+03:00,in,False,923944,False,2,328,350,22
167781,2019-10-16 00:00:00+03:00,in,False,-1,True,9,0,193,193
167781,2019-10-17 00:00:00+03:00,in,False,923944,False,1,14,22,8
167781,2019-10-17 00:00:00+03:00,in,False,-1,True,3,0,54,54
167781,2019-10-21 00:00:00+03:00,in,False,923944,False,1,132,146,14
167781,2019-10-22 00:00:00+03:00,in,False,923944,False,1,75,91,16
167781,2019-10-22 00:00:00+03:00,in,False,-1,True,1,0,5,5
167781,2019-10-23 00:00:00+03:00,in,False,923944,False,2,116,141,25
167781,2019-10-23 00:00:00+03:00,in,False,-1,True,1,0,31,31
167781,2019-10-25 00:00:00+03:00,in,False,923944,False,1,26,36,10
167781,2019-10-25 00:00:00+03:00,in,False,-1,True,3,0,90,90
167781,2019-10-28 00:00:00+03:00,in,False,-1,True,1,0,30,30
167781,2019-10-28 00:00:00+03:00,in,False,923944,False,2,32,60,28
167781,2019-10-29 00:00:00+03:00,in,False,923944,False,1,78,86,8
167781,2019-10-29 00:00:00+03:00,in,False,-1,True,1,0,32,32
167781,2019-10-30 00:00:00+03:00,in,False,923944,False,1,107,121,14
167781,2019-10-31 00:00:00+03:00,in,False,923944,False,1,15,24,9
167781,2019-11-01 00:00:00+03:00,in,False,923944,False,1,60,71,11
167781,2019-11-02 00:00:00+03:00,in,False,-1,True,3,0,74,74
167781,2019-11-02 00:00:00+03:00,in,False,923944,False,1,25,46,21
167781,2019-11-05 00:00:00+03:00,in,False,923944,False,1,45,56,11
167781,2019-11-05 00:00:00+03:00,in,False,923944,False,1,45,56,11
167781,2019-11-06 00:00:00+03:00,in,False,-1,True,1,0,31,31
167781,2019-11-08 00:00:00+03:00,in,False,923944,False,1,6,15,9
167781,2019-11-11 00:00:00+03:00,in,False,-1,True,2,0,62,62
167781,2019-11-11 00:00:00+03:00,in,False,923944,False,2,228,252,24
167781,2019-11-12 00:00:00+03:00,in,False,923944,False,1,18,30,12
167781,2019-11-13 00:00:00+03:00,in,False,-1,True,1,0,30,30
167781,2019-11-13 00:00:00+03:00,in,False,923944,False,2,194,231,37
167781,2019-11-14 00:00:00+03:00,in,False,-1,True,2,0,38,38
167781,2019-11-15 00:00:00+03:00,in,False,923944,False,1,41,54,13
167781,2019-11-19 00:00:00+03:00,in,False,923944,False,1,1,14,13
167781,2019-11-19 00:00:00+03:00,in,False,-1,True,1,0,1,1
167781,2019-11-20 00:00:00+03:00,in,False,-1,True,1,0,4,4
167781,2019-11-20 00:00:00+03:00,in,False,923944,False,1,82,93,11
167781,2019-11-20 00:00:00+03:00,in,False,-1,True,1,0,4,4
167781,2019-11-21 00:00:00+03:00,in,False,923944,False,1,40,48,8
167781,2019-11-26 00:00:00+03:00,in,False,923944,False,2,111,130,19
167792,2019-10-04 00:00:00+03:00,in,False,-1,True,2,0,4,4
167792,2019-10-07 00:00:00+03:00,in,False,-1,True,5,0,11,11
167792,2019-10-11 00:00:00+03:00,in,False,933832,False,2,52,78,26
167792,2019-10-15 00:00:00+03:00,in,False,933832,False,1,15,32,17
167792,2019-10-21 00:00:00+03:00,in,False,933832,False,2,75,100,25
167792,2019-10-21 00:00:00+03:00,in,False,933832,False,2,75,100,25
167792,2019-10-23 00:00:00+03:00,in,False,933832,False,1,92,107,15
167792,2019-10-24 00:00:00+03:00,in,False,-1,True,1,0,41,41
167792,2019-10-25 00:00:00+03:00,in,False,-1,True,1,0,44,44
167792,2019-10-28 00:00:00+03:00,in,False,-1,True,1,0,10,10
167792,2019-10-28 00:00:00+03:00,in,False,933832,False,1,55,82,27
167792,2019-10-28 00:00:00+03:00,in,False,933832,False,1,55,82,27
167792,2019-10-29 00:00:00+03:00,in,False,933832,False,2,320,398,78
167792,2019-10-29 00:00:00+03:00,in,False,933832,False,2,320,398,78
167792,2019-11-01 00:00:00+03:00,in,False,933832,False,3,333,392,59
167792,2019-11-05 00:00:00+03:00,in,False,933832,False,1,114,137,23
167792,2019-11-06 00:00:00+03:00,in,False,-1,True,1,0,8,8
167792,2019-11-08 00:00:00+03:00,in,False,933832,False,1,100,116,16
167792,2019-11-11 00:00:00+03:00,in,False,-1,True,1,0,48,48
167792,2019-11-13 00:00:00+03:00,in,False,933832,False,1,66,83,17
167792,2019-11-14 00:00:00+03:00,in,False,933832,False,1,182,213,31
167792,2019-11-18 00:00:00+03:00,in,False,933832,False,2,135,180,45
167792,2019-11-18 00:00:00+03:00,in,False,-1,True,1,0,16,16
167792,2019-11-18 00:00:00+03:00,in,False,-1,True,1,0,16,16
167792,2019-11-19 00:00:00+03:00,in,False,933832,False,2,105,155,50
167792,2019-11-20 00:00:00+03:00,in,False,933832,False,1,54,81,27
167792,2019-11-26 00:00:00+03:00,in,False,-1,True,3,0,56,56
167792,2019-11-27 00:00:00+03:00,in,False,933832,False,1,45,115,70
167792,2019-11-28 00:00:00+03:00,in,False,933832,False,1,269,333,64
167799,2019-10-01 00:00:00+03:00,in,False,925104,False,1,44,51,7
167799,2019-10-01 00:00:00+03:00,in,False,-1,True,3,0,28,28
167799,2019-10-01 00:00:00+03:00,out,False,925104,True,4,0,0,0
167799,2019-10-02 00:00:00+03:00,in,False,925104,False,9,508,583,75
167799,2019-10-02 00:00:00+03:00,in,False,-1,True,16,0,35,35
167799,2019-10-02 00:00:00+03:00,out,False,925104,True,2,0,0,0
167799,2019-10-03 00:00:00+03:00,in,False,925104,False,1,39,47,8
167799,2019-10-03 00:00:00+03:00,in,False,-1,True,6,0,8,8
167799,2019-10-03 00:00:00+03:00,in,False,-1,True,6,0,8,8
167799,2019-10-04 00:00:00+03:00,in,False,-1,True,4,0,0,0
167799,2019-10-04 00:00:00+03:00,in,False,925104,False,4,107,138,31
167799,2019-10-05 00:00:00+03:00,out,False,925104,True,5,0,117,117
167799,2019-10-05 00:00:00+03:00,out,False,925104,False,6,607,642,35
167799,2019-10-05 00:00:00+03:00,in,False,-1,True,2,0,17,17
167799,2019-10-05 00:00:00+03:00,in,False,925104,False,12,1034,1151,117
167799,2019-10-06 00:00:00+03:00,out,False,925104,False,1,8,13,5
167799,2019-10-06 00:00:00+03:00,in,False,925104,False,3,202,225,23
167799,2019-10-06 00:00:00+03:00,in,False,-1,True,4,0,11,11
167799,2019-10-07 00:00:00+03:00,in,False,925104,False,10,1532,1598,66
167799,2019-10-07 00:00:00+03:00,in,False,-1,True,1,0,6,6
167799,2019-10-07 00:00:00+03:00,out,False,925104,False,4,72,122,50
167799,2019-10-08 00:00:00+03:00,out,False,925104,False,6,198,292,94
167799,2019-10-08 00:00:00+03:00,out,False,925104,True,2,0,43,43
167799,2019-10-08 00:00:00+03:00,in,False,925104,False,5,831,866,35
167799,2019-10-09 00:00:00+03:00,out,False,925104,False,13,504,696,192
167799,2019-10-09 00:00:00+03:00,in,False,925104,False,11,1517,1617,100
167799,2019-10-09 00:00:00+03:00,out,False,925104,True,14,0,342,342
167799,2019-10-09 00:00:00+03:00,out,False,925104,True,14,0,342,342
167799,2019-10-10 00:00:00+03:00,out,False,925104,True,6,0,138,138
167799,2019-10-10 00:00:00+03:00,out,False,925104,False,13,494,629,135
167799,2019-10-10 00:00:00+03:00,in,False,-1,True,2,0,8,8
167799,2019-10-10 00:00:00+03:00,in,False,925104,False,11,775,848,73
167799,2019-10-11 00:00:00+03:00,out,False,925104,False,5,139,213,74
167799,2019-10-11 00:00:00+03:00,in,False,925104,False,6,888,948,60
167799,2019-10-11 00:00:00+03:00,out,False,925104,True,1,0,2,2
167799,2019-10-11 00:00:00+03:00,in,False,-1,True,1,0,18,18
167799,2019-10-12 00:00:00+03:00,in,False,925104,False,7,446,523,77
167799,2019-10-12 00:00:00+03:00,out,False,925104,False,4,141,253,112
167799,2019-10-12 00:00:00+03:00,in,False,-1,True,1,0,45,45
167799,2019-10-12 00:00:00+03:00,out,False,925104,True,1,0,46,46
167799,2019-10-13 00:00:00+03:00,in,False,-1,True,3,0,40,40
167799,2019-10-13 00:00:00+03:00,in,False,925104,False,9,1142,1223,81
167799,2019-10-13 00:00:00+03:00,out,False,925104,False,6,407,505,98
167799,2019-10-13 00:00:00+03:00,out,False,925104,True,2,0,55,55
167799,2019-10-13 00:00:00+03:00,out,False,925104,True,2,0,55,55
167799,2019-10-14 00:00:00+03:00,out,False,925104,True,6,0,212,212
167799,2019-10-14 00:00:00+03:00,in,False,925104,False,20,1645,1811,166
167799,2019-10-14 00:00:00+03:00,out,False,925104,False,4,196,247,51
167799,2019-10-14 00:00:00+03:00,in,False,-1,True,3,0,23,23
167799,2019-10-15 00:00:00+03:00,out,False,925104,False,4,226,276,50
167799,2019-10-15 00:00:00+03:00,in,False,925104,False,11,1319,1392,73
167799,2019-10-15 00:00:00+03:00,out,False,925104,True,1,0,12,12
167799,2019-10-15 00:00:00+03:00,out,False,925104,False,4,226,276,50
167799,2019-10-16 00:00:00+03:00,out,False,925104,False,22,1080,1345,265
167799,2019-10-16 00:00:00+03:00,in,False,925104,False,13,1480,1568,88
167799,2019-10-16 00:00:00+03:00,out,False,925104,True,10,0,189,189
167799,2019-10-17 00:00:00+03:00,in,False,925104,False,13,2062,2140,78
167799,2019-10-17 00:00:00+03:00,out,False,925104,False,10,673,836,163
167799,2019-10-17 00:00:00+03:00,in,False,-1,True,1,0,54,54
167799,2019-10-17 00:00:00+03:00,out,False,925104,True,4,0,139,139
167799,2019-10-17 00:00:00+03:00,in,False,-1,True,1,0,54,54
167799,2019-10-17 00:00:00+03:00,out,False,925104,True,4,0,139,139
167799,2019-10-18 00:00:00+03:00,out,False,925104,True,10,0,321,321
167799,2019-10-18 00:00:00+03:00,in,False,925104,False,9,1052,1110,58
167799,2019-10-18 00:00:00+03:00,in,False,-1,True,1,0,80,80
167799,2019-10-18 00:00:00+03:00,out,False,925104,False,9,255,413,158
167799,2019-10-18 00:00:00+03:00,out,False,925104,False,9,255,413,158
167799,2019-10-18 00:00:00+03:00,in,False,925104,False,9,1052,1110,58
167799,2019-10-19 00:00:00+03:00,out,False,925104,True,12,0,293,293
167799,2019-10-19 00:00:00+03:00,in,False,925104,False,10,670,758,88
167799,2019-10-19 00:00:00+03:00,out,False,925104,False,10,281,465,184
167799,2019-10-20 00:00:00+03:00,out,False,925104,True,2,0,45,45
167799,2019-10-20 00:00:00+03:00,out,False,925104,False,8,275,374,99
167799,2019-10-20 00:00:00+03:00,in,False,-1,True,3,0,38,38
167799,2019-10-20 00:00:00+03:00,in,False,925104,False,6,417,458,41
167799,2019-10-21 00:00:00+03:00,out,False,925104,True,6,0,136,136
167799,2019-10-21 00:00:00+03:00,out,False,925104,False,13,491,705,214
167799,2019-10-21 00:00:00+03:00,in,False,925104,False,18,1209,1328,119
167799,2019-10-21 00:00:00+03:00,in,False,-1,True,1,0,10,10
167799,2019-10-21 00:00:00+03:00,out,False,925104,False,13,491,705,214
167799,2019-10-22 00:00:00+03:00,out,False,925104,False,8,1835,1930,95
167799,2019-10-22 00:00:00+03:00,out,True,925104,True,1,0,0,0
167799,2019-10-22 00:00:00+03:00,out,False,925104,True,4,0,119,119
167799,2019-10-22 00:00:00+03:00,in,False,-1,True,3,0,172,172
167799,2019-10-22 00:00:00+03:00,in,False,925104,False,14,1720,1817,97
167799,2019-10-23 00:00:00+03:00,out,False,925104,False,10,306,435,129
167799,2019-10-23 00:00:00+03:00,in,False,925104,False,12,1233,1316,83
167799,2019-10-23 00:00:00+03:00,out,False,925104,True,7,0,173,173
167799,2019-10-24 00:00:00+03:00,in,False,925104,False,16,1685,1789,104
167799,2019-10-24 00:00:00+03:00,out,False,925104,False,13,513,702,189
167799,2019-10-24 00:00:00+03:00,in,False,-1,True,2,0,34,34
167799,2019-10-24 00:00:00+03:00,out,False,925104,True,12,0,161,161
167799,2019-10-25 00:00:00+03:00,out,False,925104,False,8,162,295,133
167799,2019-10-25 00:00:00+03:00,in,False,925104,False,11,1669,1778,109
167799,2019-10-25 00:00:00+03:00,out,False,925104,True,2,0,32,32
167799,2019-10-25 00:00:00+03:00,in,False,-1,True,2,0,121,121
167799,2019-10-25 00:00:00+03:00,in,False,925104,False,11,1669,1778,109
167799,2019-10-26 00:00:00+03:00,in,False,-1,True,1,0,19,19
167799,2019-10-26 00:00:00+03:00,in,False,925104,False,10,1233,1306,73
167799,2019-10-26 00:00:00+03:00,out,False,925104,False,11,335,462,127
167799,2019-10-26 00:00:00+03:00,out,False,925104,True,3,0,81,81
167799,2019-10-26 00:00:00+03:00,in,False,-1,True,1,0,19,19
167799,2019-10-27 00:00:00+03:00,out,False,925104,False,9,276,451,175
167799,2019-10-27 00:00:00+03:00,in,False,925104,False,6,399,437,38
167799,2019-10-27 00:00:00+03:00,in,False,-1,True,2,0,73,73
167799,2019-10-27 00:00:00+03:00,out,False,925104,True,7,0,214,214
167799,2019-10-28 00:00:00+03:00,out,False,925104,False,23,952,1246,294
167799,2019-10-28 00:00:00+03:00,out,False,925104,True,22,0,590,590
167799,2019-10-28 00:00:00+03:00,in,False,-1,True,5,0,110,110
167799,2019-10-28 00:00:00+03:00,in,False,925104,False,26,2347,2537,190
167799,2019-10-28 00:00:00+03:00,out,False,925104,True,22,0,590,590
167799,2019-10-29 00:00:00+03:00,in,False,925104,False,19,2043,2155,112
167799,2019-10-29 00:00:00+03:00,out,False,925104,False,25,645,1015,370
167799,2019-10-29 00:00:00+03:00,in,False,-1,True,1,0,0,0
167799,2019-10-29 00:00:00+03:00,out,False,925104,True,9,0,203,203
167799,2019-10-30 00:00:00+03:00,in,False,925104,False,23,1929,2082,153
167799,2019-10-30 00:00:00+03:00,out,False,925104,True,11,0,296,296
167799,2019-10-30 00:00:00+03:00,in,False,-1,True,4,0,136,136
167799,2019-10-30 00:00:00+03:00,out,False,925104,False,19,528,821,293
167799,2019-10-30 00:00:00+03:00,out,False,925104,True,11,0,296,296
167799,2019-10-31 00:00:00+03:00,out,False,925104,False,14,692,851,159
167799,2019-10-31 00:00:00+03:00,in,False,925104,False,15,1399,1495,96
167799,2019-10-31 00:00:00+03:00,out,False,925104,True,6,0,172,172
167799,2019-10-31 00:00:00+03:00,out,False,925104,False,14,692,851,159
167799,2019-11-01 00:00:00+03:00,in,False,925104,False,21,1726,1865,139
167799,2019-11-01 00:00:00+03:00,in,False,-1,True,3,0,88,88
167799,2019-11-01 00:00:00+03:00,out,False,925104,True,9,0,185,185
167799,2019-11-01 00:00:00+03:00,out,False,925104,False,14,872,1061,189
167799,2019-11-02 00:00:00+03:00,out,False,925104,False,4,200,252,52
167799,2019-11-02 00:00:00+03:00,out,False,925104,True,1,0,8,8
167799,2019-11-02 00:00:00+03:00,in,False,925104,False,10,1054,1115,61
167799,2019-11-03 00:00:00+03:00,in,False,-1,True,19,0,3,3
167799,2019-11-04 00:00:00+03:00,out,False,925104,False,28,1364,1750,386
167799,2019-11-04 00:00:00+03:00,in,False,-1,True,10,0,53,53
167799,2019-11-04 00:00:00+03:00,in,False,925104,False,16,1080,1203,123
167799,2019-11-04 00:00:00+03:00,out,False,925104,True,13,0,377,377
167799,2019-11-04 00:00:00+03:00,out,False,925104,True,13,0,377,377
167799,2019-11-05 00:00:00+03:00,out,False,925104,False,22,3714,4010,296
167799,2019-11-05 00:00:00+03:00,in,False,925104,False,28,2538,2771,233
167799,2019-11-05 00:00:00+03:00,out,False,925104,True,5,0,164,164
167799,2019-11-05 00:00:00+03:00,in,False,-1,True,9,0,173,173
167799,2019-11-06 00:00:00+03:00,out,False,925104,False,23,1071,1397,326
167799,2019-11-06 00:00:00+03:00,in,False,-1,True,7,0,106,106
167799,2019-11-06 00:00:00+03:00,in,False,925104,False,27,2536,2700,164
167799,2019-11-06 00:00:00+03:00,out,False,925104,True,8,0,221,221
167799,2019-11-07 00:00:00+03:00,out,False,925104,True,9,0,286,286
167799,2019-11-07 00:00:00+03:00,out,False,925104,False,13,474,660,186
167799,2019-11-07 00:00:00+03:00,in,False,925104,False,15,1226,1307,81
167799,2019-11-07 00:00:00+03:00,in,False,-1,True,2,0,27,27
167799,2019-11-07 00:00:00+03:00,out,False,925104,True,9,0,286,286
167799,2019-11-08 00:00:00+03:00,out,False,925104,True,8,0,139,139
167799,2019-11-08 00:00:00+03:00,out,False,925104,False,13,864,1063,199
167799,2019-11-08 00:00:00+03:00,in,False,-1,True,3,0,48,48
167799,2019-11-08 00:00:00+03:00,in,False,925104,False,20,2223,2363,140
167799,2019-11-08 00:00:00+03:00,in,False,-1,True,3,0,48,48
167799,2019-11-09 00:00:00+03:00,in,False,-1,True,3,0,13,13
167799,2019-11-09 00:00:00+03:00,in,False,925104,False,10,1144,1203,59
167799,2019-11-09 00:00:00+03:00,out,False,925104,False,13,927,1085,158
167799,2019-11-09 00:00:00+03:00,out,False,925104,True,5,0,88,88
167799,2019-11-10 00:00:00+03:00,in,False,-1,True,3,0,27,27
167799,2019-11-10 00:00:00+03:00,out,False,925104,False,18,556,818,262
167799,2019-11-10 00:00:00+03:00,in,False,925104,False,5,375,400,25
167799,2019-11-10 00:00:00+03:00,out,False,925104,True,7,0,143,143
167799,2019-11-11 00:00:00+03:00,out,False,925104,False,15,408,571,163
167799,2019-11-11 00:00:00+03:00,out,False,925104,True,7,0,190,190
167799,2019-11-11 00:00:00+03:00,in,False,925104,False,18,1637,1745,108
167799,2019-11-11 00:00:00+03:00,in,False,-1,True,1,0,25,25
167799,2019-11-12 00:00:00+03:00,out,False,925104,False,17,594,826,232
167799,2019-11-12 00:00:00+03:00,in,False,925104,False,27,2404,2612,208
167799,2019-11-12 00:00:00+03:00,in,False,-1,True,1,0,38,38
167799,2019-11-12 00:00:00+03:00,out,False,925104,True,3,0,101,101
167799,2019-11-12 00:00:00+03:00,out,False,925104,False,17,594,826,232
167799,2019-11-13 00:00:00+03:00,in,False,-1,True,6,0,142,142
167799,2019-11-13 00:00:00+03:00,out,False,925104,True,14,0,389,389
167799,2019-11-13 00:00:00+03:00,in,False,925104,False,32,2486,2754,268
167799,2019-11-13 00:00:00+03:00,out,False,925104,False,34,1570,2114,544
167799,2019-11-14 00:00:00+03:00,out,False,925104,True,9,0,283,283
167799,2019-11-14 00:00:00+03:00,out,False,925104,False,14,435,658,223
167799,2019-11-14 00:00:00+03:00,in,False,925104,False,27,2997,3163,166
167799,2019-11-15 00:00:00+03:00,in,False,-1,True,4,0,221,221
167799,2019-11-15 00:00:00+03:00,in,False,925104,False,21,1857,2007,150
167799,2019-11-15 00:00:00+03:00,out,False,925104,False,22,1090,1364,274
167799,2019-11-15 00:00:00+03:00,out,False,925104,True,9,0,183,183
167799,2019-11-16 00:00:00+03:00,in,False,925104,False,7,362,426,64
167799,2019-11-16 00:00:00+03:00,out,False,925104,False,14,273,493,220
167799,2019-11-16 00:00:00+03:00,out,False,925104,True,10,0,242,242
167799,2019-11-17 00:00:00+03:00,in,False,925104,False,12,1265,1328,63
167799,2019-11-17 00:00:00+03:00,out,False,925104,False,11,238,419,181
167799,2019-11-17 00:00:00+03:00,out,False,925104,True,6,0,117,117
167799,2019-11-17 00:00:00+03:00,out,False,925104,False,11,238,419,181
167799,2019-11-18 00:00:00+03:00,out,False,925104,False,16,268,473,205
167799,2019-11-18 00:00:00+03:00,out,False,925104,True,5,0,144,144
167799,2019-11-18 00:00:00+03:00,in,False,925104,False,18,1985,2101,116
167799,2019-11-19 00:00:00+03:00,in,False,-1,True,2,0,34,34
167799,2019-11-19 00:00:00+03:00,out,False,925104,False,21,699,1042,343
167799,2019-11-19 00:00:00+03:00,in,False,925104,False,17,1441,1639,198
167799,2019-11-19 00:00:00+03:00,out,False,925104,True,7,0,212,212
167799,2019-11-20 00:00:00+03:00,in,False,925104,False,30,3552,3824,272
167799,2019-11-20 00:00:00+03:00,out,False,925104,False,28,1154,1536,382
167799,2019-11-20 00:00:00+03:00,in,False,-1,True,6,0,166,166
167799,2019-11-20 00:00:00+03:00,out,False,925104,True,3,0,50,50
167799,2019-11-21 00:00:00+03:00,out,False,925104,True,7,0,129,129
167799,2019-11-21 00:00:00+03:00,out,False,925104,False,23,911,1230,319
167799,2019-11-21 00:00:00+03:00,in,False,925104,False,29,2389,2631,242
167799,2019-11-21 00:00:00+03:00,in,False,-1,True,5,0,59,59
167799,2019-11-21 00:00:00+03:00,out,False,925104,True,7,0,129,129
167799,2019-11-22 00:00:00+03:00,out,False,925104,True,18,0,395,395
167799,2019-11-22 00:00:00+03:00,out,False,925104,False,24,800,1125,325
167799,2019-11-22 00:00:00+03:00,in,False,925104,False,35,2510,2721,211
167799,2019-11-22 00:00:00+03:00,in,False,-1,True,4,0,105,105
167799,2019-11-23 00:00:00+03:00,out,False,925104,True,12,0,390,390
167799,2019-11-23 00:00:00+03:00,in,False,-1,True,1,0,1,1
167799,2019-11-23 00:00:00+03:00,out,False,925104,False,14,352,577,225
167799,2019-11-23 00:00:00+03:00,in,False,925104,False,12,994,1060,66
167799,2019-11-24 00:00:00+03:00,out,False,925104,True,11,0,316,316
167799,2019-11-24 00:00:00+03:00,in,False,925104,False,16,1179,1309,130
167799,2019-11-24 00:00:00+03:00,out,False,925104,False,17,366,692,326
167799,2019-11-25 00:00:00+03:00,out,False,925104,True,11,0,211,211
167799,2019-11-25 00:00:00+03:00,in,False,925104,False,20,2089,2220,131
167799,2019-11-25 00:00:00+03:00,out,False,925104,False,27,1133,1514,381
167799,2019-11-25 00:00:00+03:00,in,False,-1,True,2,0,54,54
167799,2019-11-25 00:00:00+03:00,out,False,925104,False,27,1133,1514,381
167799,2019-11-26 00:00:00+03:00,in,False,925104,False,26,2517,2799,282
167799,2019-11-26 00:00:00+03:00,in,False,-1,True,1,0,3,3
167799,2019-11-26 00:00:00+03:00,out,False,925104,True,7,0,257,257
167799,2019-11-26 00:00:00+03:00,out,False,925104,False,23,1169,1540,371
167799,2019-11-26 00:00:00+03:00,out,False,925104,True,7,0,257,257
167799,2019-11-26 00:00:00+03:00,in,False,925104,False,26,2517,2799,282
167799,2019-11-27 00:00:00+03:00,in,False,925104,False,14,1604,1772,168
167799,2019-11-27 00:00:00+03:00,in,False,-1,True,5,0,152,152
167799,2019-11-27 00:00:00+03:00,out,False,925104,False,27,951,1371,420
167799,2019-11-27 00:00:00+03:00,out,False,925104,True,6,0,185,185
167799,2019-11-28 00:00:00+03:00,out,False,925104,False,20,631,897,266
167799,2019-11-28 00:00:00+03:00,in,False,925104,False,19,1664,1780,116
167799,2019-11-28 00:00:00+03:00,out,False,925104,True,8,0,195,195
167799,2019-11-28 00:00:00+03:00,in,False,-1,True,2,0,64,64
167805,2019-10-01 00:00:00+03:00,in,False,-1,True,7,0,2,2
167805,2019-10-01 00:00:00+03:00,in,False,924614,False,3,49,59,10
167805,2019-10-01 00:00:00+03:00,out,False,924614,True,14,0,2,2
167805,2019-10-12 00:00:00+03:00,in,False,924614,False,1,8,22,14
167805,2019-10-12 00:00:00+03:00,in,False,-1,True,1,0,13,13
167805,2019-10-24 00:00:00+03:00,in,False,-1,True,1,0,2,2
167805,2019-11-01 00:00:00+03:00,in,False,-1,True,1,0,2,2
167805,2019-11-06 00:00:00+03:00,in,False,924614,False,1,174,181,7
167805,2019-11-12 00:00:00+03:00,in,False,924614,False,1,2,8,6
167805,2019-11-12 00:00:00+03:00,out,False,924614,True,2,0,14,14
167805,2019-11-12 00:00:00+03:00,in,False,924614,False,1,2,8,6
167816,2019-10-03 00:00:00+03:00,in,False,-1,True,1,0,3,3
167816,2019-10-04 00:00:00+03:00,in,False,-1,True,1,0,17,17
167816,2019-10-04 00:00:00+03:00,in,False,928312,False,1,58,67,9
167816,2019-10-07 00:00:00+03:00,out,False,928312,True,12,0,146,146
167816,2019-10-07 00:00:00+03:00,out,False,928312,False,16,893,1032,139
167816,2019-10-07 00:00:00+03:00,in,False,928312,False,2,206,223,17
167816,2019-10-08 00:00:00+03:00,in,False,928312,False,1,32,39,7
167816,2019-10-08 00:00:00+03:00,out,False,928312,True,13,0,230,230
167816,2019-10-08 00:00:00+03:00,out,False,928312,False,16,973,1182,209
167816,2019-10-09 00:00:00+03:00,in,False,-1,True,4,0,41,41
167816,2019-10-09 00:00:00+03:00,out,False,928312,True,13,0,204,204
167816,2019-10-09 00:00:00+03:00,out,False,928312,False,21,1684,1824,140
167816,2019-10-09 00:00:00+03:00,in,False,928312,False,1,26,36,10
167816,2019-10-10 00:00:00+03:00,out,False,928312,True,22,0,389,389
167816,2019-10-10 00:00:00+03:00,in,False,-1,True,1,0,1,1
167816,2019-10-10 00:00:00+03:00,out,False,928312,False,22,1214,1427,213
167816,2019-10-10 00:00:00+03:00,in,False,928312,False,2,54,71,17
167816,2019-10-11 00:00:00+03:00,out,True,928312,True,1,0,0,0
167816,2019-10-11 00:00:00+03:00,out,False,928312,False,32,1750,2074,324
167816,2019-10-11 00:00:00+03:00,in,False,-1,True,1,0,1,1
167816,2019-10-11 00:00:00+03:00,out,False,928312,True,25,0,469,469
167816,2019-10-11 00:00:00+03:00,in,False,928312,False,1,763,771,8
167816,2019-10-14 00:00:00+03:00,out,False,928312,False,14,502,649,147
167816,2019-10-14 00:00:00+03:00,out,False,928312,True,8,0,171,171
167816,2019-10-14 00:00:00+03:00,in,False,-1,True,1,0,13,13
167816,2019-10-14 00:00:00+03:00,in,False,-1,True,1,0,13,13
167816,2019-10-14 00:00:00+03:00,out,False,928312,False,14,502,649,147
167816,2019-10-15 00:00:00+03:00,out,False,928312,False,26,725,988,263
167816,2019-10-15 00:00:00+03:00,in,False,-1,True,1,0,25,25
167816,2019-10-15 00:00:00+03:00,out,False,928312,True,24,0,354,354
167816,2019-10-16 00:00:00+03:00,out,False,928312,False,7,767,823,56
167816,2019-10-16 00:00:00+03:00,in,False,-1,True,2,0,20,20
167816,2019-10-17 00:00:00+03:00,in,False,-1,True,2,0,14,14
167816,2019-10-17 00:00:00+03:00,out,True,928312,True,2,0,0,0
167816,2019-10-17 00:00:00+03:00,out,False,928312,False,48,1550,1949,399
167816,2019-10-17 00:00:00+03:00,out,False,928312,True,29,0,448,448
167816,2019-10-18 00:00:00+03:00,out,False,928312,False,5,125,182,57
167816,2019-10-18 00:00:00+03:00,out,False,928312,True,1,0,34,34
167816,2019-10-20 00:00:00+03:00,out,False,928312,False,2,294,305,11
167816,2019-10-21 00:00:00+03:00,out,False,928312,True,12,0,204,204
167816,2019-10-21 00:00:00+03:00,in,False,-1,True,1,0,6,6
167816,2019-10-21 00:00:00+03:00,out,False,928312,False,17,730,922,192
167816,2019-10-22 00:00:00+03:00,out,False,928312,True,7,0,86,86
167816,2019-10-22 00:00:00+03:00,out,False,928312,False,24,979,1225,246
167816,2019-10-22 00:00:00+03:00,in,False,-1,True,1,0,9,9
167816,2019-10-23 00:00:00+03:00,out,False,928312,False,62,2097,2656,559
167816,2019-10-23 00:00:00+03:00,out,False,928312,True,36,0,547,547
167816,2019-10-23 00:00:00+03:00,in,False,-1,True,2,0,13,13
167816,2019-10-24 00:00:00+03:00,in,False,-1,True,3,0,42,42
167816,2019-10-24 00:00:00+03:00,out,True,928312,True,1,0,0,0
167816,2019-10-24 00:00:00+03:00,out,False,928312,False,24,1502,1699,197
167816,2019-10-24 00:00:00+03:00,out,False,928312,True,12,0,188,188
167816,2019-10-24 00:00:00+03:00,out,False,928312,False,24,1502,1699,197
167816,2019-10-25 00:00:00+03:00,in,False,-1,True,2,0,18,18
167816,2019-10-25 00:00:00+03:00,out,False,928312,True,9,0,127,127
167816,2019-10-25 00:00:00+03:00,out,False,928312,False,8,272,358,86
167816,2019-10-25 00:00:00+03:00,in,False,928312,False,1,25,41,16
167816,2019-10-28 00:00:00+03:00,in,False,-1,True,1,0,8,8
167816,2019-10-28 00:00:00+03:00,out,False,928312,False,23,703,945,242
167816,2019-10-28 00:00:00+03:00,out,False,928312,True,20,0,309,309
167816,2019-10-29 00:00:00+03:00,out,False,928312,True,4,0,45,45
167816,2019-10-29 00:00:00+03:00,out,False,928312,False,3,111,132,21
167816,2019-10-30 00:00:00+03:00,out,False,928312,True,31,0,500,500
167816,2019-10-30 00:00:00+03:00,out,False,928312,False,41,2206,2667,461
167816,2019-10-30 00:00:00+03:00,in,False,-1,True,5,0,48,48
167816,2019-10-30 00:00:00+03:00,in,False,928312,False,1,22,36,14
167816,2019-10-30 00:00:00+03:00,in,False,928312,False,1,22,36,14
167816,2019-10-31 00:00:00+03:00,out,False,928312,True,4,0,89,89
167816,2019-10-31 00:00:00+03:00,out,False,928312,False,13,905,1000,95
167816,2019-10-31 00:00:00+03:00,in,False,-1,True,3,0,43,43
167816,2019-11-01 00:00:00+03:00,out,False,928312,False,64,2442,3096,654
167816,2019-11-01 00:00:00+03:00,in,False,-1,True,2,0,18,18
167816,2019-11-01 00:00:00+03:00,out,False,928312,True,25,0,447,447
167816,2019-11-01 00:00:00+03:00,out,True,928312,True,1,0,0,0
167816,2019-11-01 00:00:00+03:00,in,False,-1,True,2,0,18,18
167816,2019-11-05 00:00:00+03:00,out,True,928312,True,2,0,0,0
167816,2019-11-05 00:00:00+03:00,out,False,928312,False,67,2896,3505,609
167816,2019-11-05 00:00:00+03:00,in,False,-1,True,3,0,21,21
167816,2019-11-05 00:00:00+03:00,out,False,928312,True,69,0,979,979
167816,2019-11-06 00:00:00+03:00,in,False,-1,True,3,0,27,27
167816,2019-11-07 00:00:00+03:00,in,False,928312,False,1,343,361,18
167816,2019-11-07 00:00:00+03:00,out,False,928312,False,7,560,644,84
167816,2019-11-08 00:00:00+03:00,out,False,928312,False,43,2113,2519,406
167816,2019-11-08 00:00:00+03:00,in,False,928312,False,1,232,250,18
167816,2019-11-08 00:00:00+03:00,out,False,928312,True,25,0,429,429
167816,2019-11-08 00:00:00+03:00,in,False,-1,True,4,0,52,52
167816,2019-11-11 00:00:00+03:00,in,False,-1,True,4,0,22,22
167816,2019-11-11 00:00:00+03:00,out,False,928312,True,16,0,353,353
167816,2019-11-11 00:00:00+03:00,out,False,928312,False,38,2183,2553,370
167816,2019-11-11 00:00:00+03:00,in,False,-1,True,4,0,22,22
167816,2019-11-12 00:00:00+03:00,out,False,928312,True,40,0,507,507
167816,2019-11-12 00:00:00+03:00,in,False,-1,True,3,0,58,58
167816,2019-11-12 00:00:00+03:00,out,False,928312,False,51,1704,2148,444
167816,2019-11-13 00:00:00+03:00,in,False,-1,True,2,0,13,13
167816,2019-11-13 00:00:00+03:00,out,True,928312,True,1,0,0,0
167816,2019-11-13 00:00:00+03:00,out,False,928312,False,32,1830,2090,260
167816,2019-11-13 00:00:00+03:00,out,False,928312,True,16,0,235,235
167816,2019-11-14 00:00:00+03:00,out,False,928312,False,10,1185,1303,118
167816,2019-11-14 00:00:00+03:00,out,False,928312,True,5,0,49,49
167816,2019-11-15 00:00:00+03:00,out,False,928312,True,11,0,192,192
167816,2019-11-15 00:00:00+03:00,in,False,-1,True,2,0,21,21
167816,2019-11-15 00:00:00+03:00,in,False,928312,False,2,127,166,39
167816,2019-11-15 00:00:00+03:00,out,False,928312,False,25,1080,1329,249
167816,2019-11-18 00:00:00+03:00,out,False,928312,True,12,0,162,162
167816,2019-11-18 00:00:00+03:00,in,False,-1,True,1,0,9,9
167816,2019-11-18 00:00:00+03:00,out,False,928312,False,32,1260,1671,411
167816,2019-11-19 00:00:00+03:00,out,False,928312,False,35,1618,1891,273
167816,2019-11-19 00:00:00+03:00,out,False,928312,True,9,0,179,179
167816,2019-11-19 00:00:00+03:00,in,False,-1,True,1,0,5,5
167816,2019-11-19 00:00:00+03:00,in,False,-1,True,1,0,5,5
167816,2019-11-20 00:00:00+03:00,in,False,-1,True,1,0,25,25
167816,2019-11-20 00:00:00+03:00,out,False,928312,True,23,0,589,589
167816,2019-11-20 00:00:00+03:00,out,False,928312,False,54,2064,2485,421
167816,2019-11-20 00:00:00+03:00,out,True,928312,True,2,0,0,0
167816,2019-11-21 00:00:00+03:00,out,False,928312,False,55,2447,2849,402
167816,2019-11-21 00:00:00+03:00,out,False,928312,True,47,0,786,786
167816,2019-11-21 00:00:00+03:00,out,True,928312,True,2,0,0,0
167816,2019-11-21 00:00:00+03:00,in,False,928312,False,1,31,48,17
167816,2019-11-22 00:00:00+03:00,in,False,-1,True,1,0,5,5
167816,2019-11-22 00:00:00+03:00,out,False,928312,True,14,0,325,325
167816,2019-11-22 00:00:00+03:00,out,False,928312,False,39,1808,2171,363
167816,2019-11-25 00:00:00+03:00,out,False,928312,True,34,0,578,578
167816,2019-11-25 00:00:00+03:00,out,False,928312,False,67,2775,3326,551
167816,2019-11-25 00:00:00+03:00,in,False,-1,True,2,0,35,35
167816,2019-11-25 00:00:00+03:00,out,False,928312,False,67,2775,3326,551
167816,2019-11-26 00:00:00+03:00,out,False,928312,False,15,1856,2036,180
167816,2019-11-26 00:00:00+03:00,out,False,928312,True,4,0,85,85
167816,2019-11-26 00:00:00+03:00,in,False,928312,False,2,66,120,54
167816,2019-11-26 00:00:00+03:00,in,False,-1,True,7,0,97,97
167816,2019-11-27 00:00:00+03:00,out,False,928312,False,39,1788,2134,346
167816,2019-11-27 00:00:00+03:00,in,False,928312,False,1,24,41,17
167816,2019-11-27 00:00:00+03:00,out,False,928312,True,21,0,359,359
167816,2019-11-27 00:00:00+03:00,out,True,928312,True,3,0,0,0
167816,2019-11-27 00:00:00+03:00,in,False,-1,True,2,0,20,20
167816,2019-11-28 00:00:00+03:00,in,False,-1,True,2,0,8,8
167816,2019-11-28 00:00:00+03:00,out,False,928312,True,36,0,701,701
167816,2019-11-28 00:00:00+03:00,out,True,928312,True,2,0,0,0
167816,2019-11-28 00:00:00+03:00,out,False,928312,False,48,2181,2741,560
167819,2019-10-03 00:00:00+03:00,in,False,-1,True,1,0,4,4
167819,2019-10-04 00:00:00+03:00,in,False,-1,True,4,0,5,5
167819,2019-10-08 00:00:00+03:00,out,False,927916,True,5,0,68,68
167819,2019-10-08 00:00:00+03:00,in,False,-1,True,4,0,3,3
167819,2019-10-08 00:00:00+03:00,out,False,927916,False,22,490,769,279
167819,2019-10-09 00:00:00+03:00,in,False,-1,True,22,0,17,17
167819,2019-10-09 00:00:00+03:00,out,False,927916,False,16,232,373,141
167819,2019-10-09 00:00:00+03:00,out,False,927916,True,3,0,81,81
167819,2019-10-10 00:00:00+03:00,in,False,927910,False,4,235,247,12
167819,2019-10-10 00:00:00+03:00,in,False,927908,False,3,759,768,9
167819,2019-10-10 00:00:00+03:00,in,False,927912,False,1,145,148,3
167819,2019-10-10 00:00:00+03:00,in,False,-1,True,13,0,17,17
167819,2019-10-11 00:00:00+03:00,out,False,927916,True,17,0,273,273
167819,2019-10-11 00:00:00+03:00,out,False,927916,False,58,2520,3151,631
167819,2019-10-11 00:00:00+03:00,in,False,927916,False,7,644,663,19
167819,2019-10-11 00:00:00+03:00,in,False,927912,False,2,355,361,6
167819,2019-10-11 00:00:00+03:00,in,False,927910,False,6,938,954,16
167819,2019-10-11 00:00:00+03:00,in,False,927910,False,6,938,954,16
167819,2019-10-11 00:00:00+03:00,in,False,927916,False,7,644,663,19
167819,2019-10-12 00:00:00+03:00,in,False,927916,False,1,10,12,2
167819,2019-10-12 00:00:00+03:00,out,False,927916,False,4,217,298,81
167819,2019-10-12 00:00:00+03:00,in,False,927908,False,1,130,133,3
167819,2019-10-12 00:00:00+03:00,in,False,927910,False,2,158,163,5
167819,2019-10-12 00:00:00+03:00,out,False,927916,True,1,0,26,26
167819,2019-10-12 00:00:00+03:00,in,False,927912,False,2,105,110,5
167819,2019-10-12 00:00:00+03:00,out,False,927916,True,1,0,26,26
167819,2019-10-13 00:00:00+03:00,in,False,-1,True,2,0,4,4
167819,2019-10-13 00:00:00+03:00,in,False,927910,False,2,391,396,5
167819,2019-10-13 00:00:00+03:00,in,False,927916,False,1,210,213,3
167819,2019-10-14 00:00:00+03:00,in,False,927910,False,2,64,70,6
167819,2019-10-14 00:00:00+03:00,in,False,927912,False,1,515,518,3
167819,2019-10-14 00:00:00+03:00,out,False,927916,True,7,0,268,268
167819,2019-10-14 00:00:00+03:00,out,False,927916,False,30,2544,3008,464
167819,2019-10-14 00:00:00+03:00,in,False,927912,True,1,0,4,4
167819,2019-10-14 00:00:00+03:00,in,False,927916,False,8,670,695,25
167819,2019-10-15 00:00:00+03:00,in,False,927916,False,5,277,290,13
167819,2019-10-15 00:00:00+03:00,out,False,927916,False,20,1725,2054,329
167819,2019-10-15 00:00:00+03:00,in,False,927910,False,2,191,197,6
167819,2019-10-15 00:00:00+03:00,in,False,927912,False,5,658,673,15
167819,2019-10-15 00:00:00+03:00,out,False,927916,True,2,0,69,69
167819,2019-10-15 00:00:00+03:00,out,False,927916,False,20,1725,2054,329
167819,2019-10-16 00:00:00+03:00,in,False,927912,False,3,714,720,6
167819,2019-10-16 00:00:00+03:00,out,False,927916,False,12,960,1129,169
167819,2019-10-16 00:00:00+03:00,in,False,927910,False,2,341,347,6
167819,2019-10-16 00:00:00+03:00,in,False,927916,False,16,2641,2682,41
167819,2019-10-16 00:00:00+03:00,out,False,927916,True,3,0,87,87
167819,2019-10-16 00:00:00+03:00,in,False,927910,False,2,341,347,6
167819,2019-10-17 00:00:00+03:00,out,False,927916,True,7,0,99,99
167819,2019-10-17 00:00:00+03:00,in,False,927912,False,2,48,52,4
167819,2019-10-17 00:00:00+03:00,in,False,927910,False,2,37,39,2
167819,2019-10-17 00:00:00+03:00,in,False,927910,True,1,0,1,1
167819,2019-10-17 00:00:00+03:00,in,False,927916,False,13,105,119,14
167819,2019-10-17 00:00:00+03:00,out,False,927916,False,9,1396,1527,131
167819,2019-10-18 00:00:00+03:00,out,False,927916,True,6,0,156,156
167819,2019-10-18 00:00:00+03:00,in,False,-1,True,1,0,2,2
167819,2019-10-18 00:00:00+03:00,in,False,927916,False,6,66,72,6
167819,2019-10-18 00:00:00+03:00,out,False,927916,False,12,1409,1668,259
167819,2019-10-18 00:00:00+03:00,out,False,927916,False,12,1409,1668,259
167819,2019-10-18 00:00:00+03:00,in,False,927916,False,6,66,72,6
167819,2019-10-19 00:00:00+03:00,in,False,927916,False,4,55,59,4
167819,2019-10-19 00:00:00+03:00,out,False,927916,True,10,0,270,270
167819,2019-10-19 00:00:00+03:00,out,False,927916,False,27,2288,2694,406
167819,2019-10-20 00:00:00+03:00,out,False,927916,False,3,196,235,39
167819,2019-10-20 00:00:00+03:00,out,False,927916,True,1,0,38,38
167819,2019-10-21 00:00:00+03:00,in,False,927916,False,7,114,125,11
167819,2019-10-21 00:00:00+03:00,out,False,927916,False,14,1663,1868,205
167819,2019-10-21 00:00:00+03:00,in,False,927908,False,1,9,10,1
167819,2019-10-21 00:00:00+03:00,out,False,927916,True,4,0,165,165
167819,2019-10-22 00:00:00+03:00,in,False,927916,False,16,131,149,18
167819,2019-10-22 00:00:00+03:00,out,False,927916,True,6,0,233,233
167819,2019-10-22 00:00:00+03:00,out,False,927916,False,15,1564,1785,221
167819,2019-10-22 00:00:00+03:00,in,False,-1,True,2,0,5,5
167819,2019-10-23 00:00:00+03:00,out,False,927916,True,6,0,233,233
167819,2019-10-23 00:00:00+03:00,out,False,927916,False,14,1450,1644,194
167819,2019-10-23 00:00:00+03:00,in,False,-1,True,3,0,6,6
167819,2019-10-23 00:00:00+03:00,in,False,927916,False,12,164,179,15
167819,2019-10-24 00:00:00+03:00,out,False,927916,False,7,1310,1419,109
167819,2019-10-24 00:00:00+03:00,in,False,927916,False,7,88,96,8
167819,2019-10-24 00:00:00+03:00,out,False,927916,True,6,0,154,154
167819,2019-10-25 00:00:00+03:00,out,False,927916,True,5,0,139,139
167819,2019-10-25 00:00:00+03:00,out,False,927916,False,11,1032,1257,225
167819,2019-10-25 00:00:00+03:00,in,False,927916,False,6,355,369,14
167819,2019-10-25 00:00:00+03:00,out,False,927916,False,11,1032,1257,225
167819,2019-10-26 00:00:00+03:00,out,False,927916,False,8,1086,1174,88
167819,2019-10-26 00:00:00+03:00,out,False,927916,True,4,0,159,159
167819,2019-10-27 00:00:00+03:00,out,False,927916,False,9,1154,1259,105
167819,2019-10-27 00:00:00+03:00,in,False,927916,False,3,280,287,7
167819,2019-10-27 00:00:00+03:00,out,False,927916,True,10,0,236,236
167819,2019-10-27 00:00:00+03:00,out,False,927916,False,9,1154,1259,105
167819,2019-10-28 00:00:00+03:00,in,False,-1,False,5,302,372,70
167819,2019-10-28 00:00:00+03:00,out,False,927916,False,10,1127,1237,110
167819,2019-10-28 00:00:00+03:00,in,False,927916,False,8,409,443,34
167819,2019-10-28 00:00:00+03:00,out,False,927916,True,1,0,34,34
167819,2019-10-28 00:00:00+03:00,in,False,-1,True,3,0,29,29
167819,2019-10-28 00:00:00+03:00,out,False,927916,True,1,0,34,34
167819,2019-10-29 00:00:00+03:00,in,False,927916,False,5,662,676,14
167819,2019-10-29 00:00:00+03:00,out,False,927916,True,1,0,27,27
167819,2019-10-29 00:00:00+03:00,out,False,927916,False,11,1484,1665,181
167819,2019-10-29 00:00:00+03:00,in,False,-1,True,1,0,2,2
167819,2019-10-30 00:00:00+03:00,out,False,927916,False,8,1023,1142,119
167819,2019-10-30 00:00:00+03:00,in,False,-1,True,1,0,2,2
167819,2019-10-30 00:00:00+03:00,out,False,927916,True,1,0,31,31
167819,2019-10-30 00:00:00+03:00,in,False,927916,False,9,1478,1505,27
167819,2019-10-30 00:00:00+03:00,out,False,927916,False,8,1023,1142,119
167827,2019-10-07 00:00:00+03:00,out,False,929424,False,1,20,31,11
167827,2019-10-08 00:00:00+03:00,out,False,929424,False,7,1792,1852,60
167827,2019-10-08 00:00:00+03:00,out,False,929424,True,2,0,26,26
167827,2019-10-08 00:00:00+03:00,out,False,929426,False,1,34,44,10
167827,2019-10-09 00:00:00+03:00,out,False,929426,True,34,0,780,780
167827,2019-10-09 00:00:00+03:00,out,True,929424,True,1,0,3,3
167827,2019-10-09 00:00:00+03:00,out,False,929426,False,46,3427,4278,851
167827,2019-10-09 00:00:00+03:00,out,False,929424,True,3,0,92,92
167827,2019-10-09 00:00:00+03:00,in,False,-1,True,7,0,14,14
167827,2019-10-09 00:00:00+03:00,out,False,929424,False,10,2390,2513,123
167827,2019-10-09 00:00:00+03:00,out,True,929424,True,1,0,3,3
167827,2019-10-10 00:00:00+03:00,out,False,929424,True,495,0,10489,10489
167827,2019-10-10 00:00:00+03:00,in,False,-1,True,3,0,68,68
167827,2019-10-10 00:00:00+03:00,out,False,929428,False,8,337,419,82
167827,2019-10-10 00:00:00+03:00,out,False,929426,True,36,0,773,773
167827,2019-10-10 00:00:00+03:00,out,False,929426,False,43,2329,2778,449
167827,2019-10-10 00:00:00+03:00,in,False,929424,False,26,259,298,39
167827,2019-10-10 00:00:00+03:00,out,False,929424,False,970,41344,52466,11122
167827,2019-10-11 00:00:00+03:00,out,False,929426,False,570,22503,29276,6773
167827,2019-10-11 00:00:00+03:00,in,False,-1,True,17,0,34,34
167827,2019-10-11 00:00:00+03:00,out,False,929424,True,498,0,9794,9794
167827,2019-10-11 00:00:00+03:00,out,False,929428,False,2,45,62,17
167827,2019-10-11 00:00:00+03:00,out,False,929428,True,5,0,86,86
167827,2019-10-11 00:00:00+03:00,in,False,929424,False,54,557,636,79
167827,2019-10-11 00:00:00+03:00,out,False,929424,False,538,26153,32481,6328
167827,2019-10-11 00:00:00+03:00,out,False,929426,True,356,0,7051,7051
167827,2019-10-12 00:00:00+03:00,in,False,-1,True,1,0,1,1
167827,2019-10-12 00:00:00+03:00,out,False,929428,False,75,6119,7517,1398
167827,2019-10-12 00:00:00+03:00,out,False,929428,True,80,0,1888,1888
167827,2019-10-12 00:00:00+03:00,out,False,929424,True,3,0,30,30
167827,2019-10-12 00:00:00+03:00,out,False,929426,False,140,8165,10749,2584
167827,2019-10-12 00:00:00+03:00,out,False,929424,False,1,83,102,19
167827,2019-10-12 00:00:00+03:00,in,False,929424,False,29,365,404,39
167827,2019-10-12 00:00:00+03:00,out,False,929426,True,179,0,4401,4401
167827,2019-10-12 00:00:00+03:00,in,False,-1,True,1,0,1,1
167827,2019-10-13 00:00:00+03:00,in,False,929424,False,11,142,154,12
167827,2019-10-13 00:00:00+03:00,in,False,-1,True,1,0,1,1
167827,2019-10-14 00:00:00+03:00,out,False,929428,True,231,0,5047,5047
167827,2019-10-14 00:00:00+03:00,out,False,929426,True,214,0,4929,4929
167827,2019-10-14 00:00:00+03:00,out,False,929428,False,158,9571,12636,3065
167827,2019-10-14 00:00:00+03:00,out,False,929424,False,208,11027,14562,3535
167827,2019-10-14 00:00:00+03:00,out,False,929426,False,147,14190,16895,2705
167827,2019-10-14 00:00:00+03:00,in,False,-1,True,32,0,69,69
167827,2019-10-14 00:00:00+03:00,out,False,929424,True,252,0,5387,5387
167827,2019-10-14 00:00:00+03:00,out,False,-1,True,1,0,2,2
167827,2019-10-14 00:00:00+03:00,in,False,929424,False,64,922,1025,103
167827,2019-10-15 00:00:00+03:00,out,False,929424,False,52,5610,6322,712
167827,2019-10-15 00:00:00+03:00,out,False,929424,True,79,0,1625,1625
167827,2019-10-15 00:00:00+03:00,in,False,-1,True,10,0,20,20
167827,2019-10-15 00:00:00+03:00,out,False,929426,False,10,1210,1406,196
167827,2019-10-15 00:00:00+03:00,in,False,929424,False,27,451,494,43
167827,2019-10-15 00:00:00+03:00,out,False,929428,True,174,0,4283,4283
167827,2019-10-15 00:00:00+03:00,out,False,929426,True,19,0,416,416
167827,2019-10-15 00:00:00+03:00,out,False,929428,False,84,8381,10046,1665
167827,2019-10-16 00:00:00+03:00,out,False,929426,True,239,0,5751,5751
167827,2019-10-16 00:00:00+03:00,out,False,929424,True,202,0,4052,4052
167827,2019-10-16 00:00:00+03:00,out,False,929428,True,303,0,7114,7114
167827,2019-10-16 00:00:00+03:00,out,False,929426,False,206,11374,15227,3853
167827,2019-10-16 00:00:00+03:00,in,False,929424,False,63,1031,1124,93
167827,2019-10-16 00:00:00+03:00,out,False,929424,False,50,2781,3841,1060
167827,2019-10-16 00:00:00+03:00,out,False,929428,False,191,13193,17099,3906
167827,2019-10-16 00:00:00+03:00,in,False,-1,True,40,0,101,101
167827,2019-10-17 00:00:00+03:00,out,False,929426,False,195,9613,13217,3604
167827,2019-10-17 00:00:00+03:00,in,False,929424,False,91,1395,1549,154
167827,2019-10-17 00:00:00+03:00,out,False,929428,False,206,13125,17227,4102
167827,2019-10-17 00:00:00+03:00,in,False,929424,True,2,0,4,4
167827,2019-10-17 00:00:00+03:00,out,False,929424,False,55,3235,3998,763
167827,2019-10-17 00:00:00+03:00,out,False,929424,True,49,0,994,994
167827,2019-10-17 00:00:00+03:00,out,False,929426,True,215,0,4865,4865
167827,2019-10-17 00:00:00+03:00,in,False,-1,True,20,0,50,50
167827,2019-10-17 00:00:00+03:00,out,False,929428,True,351,0,8032,8032
167827,2019-10-17 00:00:00+03:00,out,False,929426,True,215,0,4865,4865
167827,2019-10-18 00:00:00+03:00,out,False,929426,True,171,0,3148,3148
167827,2019-10-18 00:00:00+03:00,in,False,929424,False,33,368,417,49
167827,2019-10-18 00:00:00+03:00,in,False,-1,True,11,0,22,22
167827,2019-10-18 00:00:00+03:00,out,False,929428,False,95,7651,9323,1672
167827,2019-10-18 00:00:00+03:00,out,False,929424,True,24,0,515,515
167827,2019-10-18 00:00:00+03:00,out,False,929428,True,130,0,3035,3035
167827,2019-10-18 00:00:00+03:00,out,False,929426,False,115,11784,13690,1906
167827,2019-10-18 00:00:00+03:00,out,False,929424,False,17,2415,2621,206
167827,2019-10-19 00:00:00+03:00,out,False,929426,False,78,7091,8561,1470
167827,2019-10-19 00:00:00+03:00,in,False,929424,False,49,849,919,70
167827,2019-10-19 00:00:00+03:00,out,False,929424,True,10,0,243,243
167827,2019-10-19 00:00:00+03:00,out,False,929428,True,181,0,4475,4475
167827,2019-10-19 00:00:00+03:00,out,False,929424,False,5,285,369,84
167827,2019-10-19 00:00:00+03:00,out,False,929428,False,62,4250,5514,1264
167827,2019-10-19 00:00:00+03:00,out,False,929426,True,121,0,2966,2966
167827,2019-10-19 00:00:00+03:00,in,False,929424,False,49,849,919,70
167827,2019-10-19 00:00:00+03:00,out,False,929424,False,5,285,369,84
167827,2019-10-19 00:00:00+03:00,out,False,929426,False,78,7091,8561,1470
167827,2019-10-20 00:00:00+03:00,in,False,-1,True,1,0,1,1
167827,2019-10-20 00:00:00+03:00,in,False,929424,False,7,115,123,8
167827,2019-10-20 00:00:00+03:00,in,False,929424,False,7,115,123,8
167827,2019-10-21 00:00:00+03:00,out,False,929426,True,237,0,3499,3499
167827,2019-10-21 00:00:00+03:00,in,False,-1,True,15,0,34,34
167827,2019-10-21 00:00:00+03:00,out,False,929428,False,80,5193,6469,1276
167827,2019-10-21 00:00:00+03:00,out,False,929426,False,161,14649,17446,2797
167827,2019-10-21 00:00:00+03:00,out,False,929424,True,2,0,5,5
167827,2019-10-21 00:00:00+03:00,out,False,929428,True,110,0,1700,1700
167827,2019-10-21 00:00:00+03:00,out,False,929424,False,1,247,270,23
167827,2019-10-21 00:00:00+03:00,in,False,929424,False,19,159,185,26
167827,2019-10-21 00:00:00+03:00,in,False,-1,True,15,0,34,34
167827,2019-10-22 00:00:00+03:00,out,False,929424,True,1,0,24,24
167827,2019-10-22 00:00:00+03:00,in,False,-1,True,16,0,30,30
167827,2019-10-22 00:00:00+03:00,out,False,929426,False,172,13933,16573,2640
167827,2019-10-22 00:00:00+03:00,out,False,929428,True,25,0,798,798
167827,2019-10-22 00:00:00+03:00,in,False,929424,False,24,212,249,37
167827,2019-10-22 00:00:00+03:00,out,False,929426,True,98,0,2462,2462
167827,2019-10-22 00:00:00+03:00,out,False,929428,False,63,6440,7392,952
167827,2019-10-23 00:00:00+03:00,out,False,929428,False,216,10701,14431,3730
167827,2019-10-23 00:00:00+03:00,out,False,929426,False,179,11596,14775,3179
167827,2019-10-23 00:00:00+03:00,in,False,929424,False,40,503,567,64
167827,2019-10-23 00:00:00+03:00,out,False,929426,True,164,0,3778,3778
167827,2019-10-23 00:00:00+03:00,out,False,929428,True,288,0,6634,6634
167827,2019-10-23 00:00:00+03:00,out,False,929424,True,7,0,95,95
167827,2019-10-23 00:00:00+03:00,in,False,929424,True,2,1,4,3
167827,2019-10-23 00:00:00+03:00,in,False,-1,True,14,0,28,28
167827,2019-10-23 00:00:00+03:00,in,False,929424,False,40,503,567,64
167827,2019-10-24 00:00:00+03:00,out,False,929428,False,157,10474,13372,2898
167827,2019-10-24 00:00:00+03:00,out,False,929424,False,1,42,64,22
167827,2019-10-24 00:00:00+03:00,out,False,929426,True,8,0,125,125
167827,2019-10-24 00:00:00+03:00,in,False,929424,False,27,405,452,47
167827,2019-10-24 00:00:00+03:00,out,False,929426,False,2,117,146,29
167827,2019-10-24 00:00:00+03:00,in,False,-1,True,3,0,4,4
167827,2019-10-24 00:00:00+03:00,out,False,929424,True,5,0,100,100
167827,2019-10-24 00:00:00+03:00,out,False,929428,True,359,0,7588,7588
167827,2019-10-25 00:00:00+03:00,out,False,929428,True,360,0,8116,8116
167827,2019-10-25 00:00:00+03:00,out,False,929426,False,1,30,52,22
167827,2019-10-25 00:00:00+03:00,out,False,929428,False,273,22270,27204,4934
167827,2019-10-25 00:00:00+03:00,in,False,-1,True,20,0,36,36
167827,2019-10-25 00:00:00+03:00,in,False,929424,False,25,496,534,38
167827,2019-10-25 00:00:00+03:00,out,False,929424,False,1,15,29,14
167827,2019-10-25 00:00:00+03:00,out,False,929426,True,5,0,69,69
167827,2019-10-25 00:00:00+03:00,in,False,-1,True,20,0,36,36
167827,2019-10-26 00:00:00+03:00,out,False,929424,True,1,0,9,9
167827,2019-10-26 00:00:00+03:00,in,False,929424,False,21,382,411,29
167827,2019-10-26 00:00:00+03:00,out,False,929428,False,130,10632,13078,2446
167827,2019-10-26 00:00:00+03:00,out,False,929428,True,145,0,3756,3756
167827,2019-10-26 00:00:00+03:00,out,False,929428,True,145,0,3756,3756
167827,2019-10-27 00:00:00+03:00,in,False,929424,False,14,138,153,15
167827,2019-10-28 00:00:00+03:00,out,False,929424,True,7,0,140,140
167827,2019-10-28 00:00:00+03:00,out,False,929426,True,4,0,69,69
167827,2019-10-28 00:00:00+03:00,out,False,929428,True,383,0,8752,8752
167827,2019-10-28 00:00:00+03:00,out,False,929428,False,240,17037,21536,4499
167827,2019-10-28 00:00:00+03:00,in,False,-1,True,25,0,58,58
167827,2019-10-28 00:00:00+03:00,out,False,929424,False,10,401,516,115
167827,2019-10-28 00:00:00+03:00,in,False,929424,False,12,201,216,15
167827,2019-10-29 00:00:00+03:00,out,False,929426,True,69,0,1274,1274
167827,2019-10-29 00:00:00+03:00,out,False,929426,False,66,4469,5397,928
167827,2019-10-29 00:00:00+03:00,in,False,929424,False,26,244,282,38
167827,2019-10-29 00:00:00+03:00,out,False,929424,False,7,494,565,71
167827,2019-10-29 00:00:00+03:00,out,False,929424,True,4,0,128,128
167827,2019-10-29 00:00:00+03:00,out,False,929428,True,593,0,10177,10177
167827,2019-10-29 00:00:00+03:00,in,False,-1,True,4,0,7,7
167827,2019-10-29 00:00:00+03:00,out,False,929428,False,69,1767,2895,1128
167827,2019-10-30 00:00:00+03:00,out,False,929424,False,12,1596,1738,142
167827,2019-10-30 00:00:00+03:00,in,False,-1,True,7,0,14,14
167827,2019-10-30 00:00:00+03:00,out,False,929428,True,437,0,8370,8370
167827,2019-10-30 00:00:00+03:00,in,False,929424,False,9,103,113,10
167827,2019-10-30 00:00:00+03:00,out,False,929428,False,112,6821,8463,1642
167827,2019-10-30 00:00:00+03:00,out,False,929424,True,4,0,66,66
167827,2019-10-30 00:00:00+03:00,out,False,929424,False,12,1596,1738,142
167827,2019-10-31 00:00:00+03:00,out,False,929424,False,36,4315,4575,260
167827,2019-10-31 00:00:00+03:00,in,False,-1,True,9,0,13,13
167827,2019-10-31 00:00:00+03:00,out,False,929426,True,57,0,1049,1049
167827,2019-10-31 00:00:00+03:00,in,False,929424,False,25,202,241,39
167827,2019-10-31 00:00:00+03:00,out,False,929424,True,17,0,199,199
167827,2019-10-31 00:00:00+03:00,out,False,929428,True,2614,0,45312,45312
167827,2019-10-31 00:00:00+03:00,out,False,929426,False,64,5599,6626,1027
167827,2019-10-31 00:00:00+03:00,out,False,929428,False,116,2644,4447,1803
167827,2019-10-31 00:00:00+03:00,out,False,929426,True,57,0,1049,1049
167827,2019-10-31 00:00:00+03:00,in,False,929424,False,25,202,241,39
167827,2019-10-31 00:00:00+03:00,out,False,929426,False,64,5599,6626,1027
167827,2019-11-01 00:00:00+03:00,in,False,929424,False,33,327,368,41
167827,2019-11-01 00:00:00+03:00,in,False,-1,True,19,0,38,38
167827,2019-11-01 00:00:00+03:00,out,False,929426,False,79,8522,9685,1163
167827,2019-11-01 00:00:00+03:00,out,False,929428,True,1529,0,28017,28017
167827,2019-11-01 00:00:00+03:00,out,False,929424,False,20,1599,1823,224
167827,2019-11-01 00:00:00+03:00,out,False,929424,True,11,0,168,168
167827,2019-11-01 00:00:00+03:00,out,False,929428,False,273,14584,19081,4497
167827,2019-11-01 00:00:00+03:00,out,False,929426,True,30,0,632,632
167827,2019-11-02 00:00:00+03:00,in,False,929424,False,6,72,78,6
167827,2019-11-02 00:00:00+03:00,in,False,-1,True,1,0,1,1
167827,2019-11-04 00:00:00+03:00,in,False,-1,True,4,0,9,9
167827,2019-11-05 00:00:00+03:00,out,False,929424,False,6,1343,1430,87
167827,2019-11-05 00:00:00+03:00,in,False,-1,True,8,0,16,16
167827,2019-11-05 00:00:00+03:00,out,False,929428,True,1533,0,27889,27889
167827,2019-11-05 00:00:00+03:00,out,False,929426,True,31,0,775,775
167827,2019-11-05 00:00:00+03:00,out,False,929424,True,2,0,23,23
167827,2019-11-05 00:00:00+03:00,in,False,929424,False,21,249,279,30
167827,2019-11-05 00:00:00+03:00,out,False,929428,False,172,8881,11640,2759
167827,2019-11-05 00:00:00+03:00,out,False,929426,False,68,5573,6766,1193
167827,2019-11-05 00:00:00+03:00,out,False,929428,False,172,8881,11640,2759
167827,2019-11-05 00:00:00+03:00,out,False,929426,True,31,0,775,775
167827,2019-11-05 00:00:00+03:00,in,False,929424,False,21,249,279,30
167827,2019-11-05 00:00:00+03:00,in,False,-1,True,8,0,16,16
167827,2019-11-06 00:00:00+03:00,out,False,929424,True,2,0,24,24
167827,2019-11-06 00:00:00+03:00,out,False,929428,True,1045,0,18978,18978
167827,2019-11-06 00:00:00+03:00,out,False,929424,False,21,3038,3188,150
167827,2019-11-06 00:00:00+03:00,in,False,-1,True,7,0,13,13
167827,2019-11-06 00:00:00+03:00,in,False,929424,False,29,213,256,43
167827,2019-11-06 00:00:00+03:00,out,False,929428,False,170,6257,8865,2608
167827,2019-11-07 00:00:00+03:00,in,False,929424,True,1,0,2,2
167827,2019-11-07 00:00:00+03:00,in,False,929424,False,20,192,221,29
167827,2019-11-07 00:00:00+03:00,out,False,929428,True,1365,0,24450,24450
167827,2019-11-07 00:00:00+03:00,out,False,929424,False,15,2327,2513,186
167827,2019-11-07 00:00:00+03:00,in,False,-1,True,15,0,29,29
167827,2019-11-07 00:00:00+03:00,out,False,929428,False,223,11488,14830,3342
167827,2019-11-07 00:00:00+03:00,out,False,929424,True,1,0,60,60
167827,2019-11-08 00:00:00+03:00,out,False,929428,False,241,13101,17201,4100
167827,2019-11-08 00:00:00+03:00,in,False,929424,False,32,310,339,29
167827,2019-11-08 00:00:00+03:00,in,False,-1,True,15,0,1111,1111
167827,2019-11-08 00:00:00+03:00,out,False,929424,True,29,0,481,481
167827,2019-11-08 00:00:00+03:00,out,False,929424,False,19,1239,1389,150
167827,2019-11-08 00:00:00+03:00,out,False,929428,True,685,0,12423,12423
167827,2019-11-09 00:00:00+03:00,out,False,929428,False,129,10383,12732,2349
167827,2019-11-09 00:00:00+03:00,in,False,-1,True,1,0,0,0
167827,2019-11-09 00:00:00+03:00,out,False,929428,True,338,0,7150,7150
167827,2019-11-09 00:00:00+03:00,in,False,929424,False,24,327,345,18
167827,2019-11-09 00:00:00+03:00,out,False,929424,False,3,168,217,49
167827,2019-11-09 00:00:00+03:00,out,False,929424,True,3,0,48,48
167827,2019-11-09 00:00:00+03:00,in,False,929424,False,24,327,345,18
167827,2019-11-09 00:00:00+03:00,out,False,929424,True,3,0,48,48
167827,2019-11-10 00:00:00+03:00,in,False,929424,False,5,104,108,4
167827,2019-11-11 00:00:00+03:00,in,False,-1,True,6,0,229,229
167827,2019-11-11 00:00:00+03:00,out,False,929424,False,17,2821,2948,127
167827,2019-11-11 00:00:00+03:00,out,False,929424,True,28,0,64,64
167827,2019-11-11 00:00:00+03:00,out,False,929428,False,205,9320,13171,3851
167827,2019-11-11 00:00:00+03:00,in,False,929424,False,16,212,227,15
167827,2019-11-11 00:00:00+03:00,out,False,929428,True,4817,0,5529,5529
167827,2019-11-12 00:00:00+03:00,in,False,929424,False,2,41,43,2
167827,2019-11-12 00:00:00+03:00,in,False,-1,True,3,0,373,373
167827,2019-11-13 00:00:00+03:00,out,False,929428,True,106,0,2633,2633
167827,2019-11-13 00:00:00+03:00,in,False,929424,False,8,234,239,5
167827,2019-11-13 00:00:00+03:00,in,False,-1,True,6,0,187,187
167827,2019-11-13 00:00:00+03:00,out,False,929428,False,84,5448,7013,1565
167827,2019-11-13 00:00:00+03:00,out,False,929424,False,3,163,200,37
167827,2019-11-13 00:00:00+03:00,out,False,929424,True,1,0,6,6
167827,2019-11-14 00:00:00+03:00,in,False,-1,True,1,0,28,28
167827,2019-11-14 00:00:00+03:00,in,False,-1,True,1,0,28,28
167827,2019-11-15 00:00:00+03:00,out,False,929428,False,126,7601,9398,1797
167827,2019-11-15 00:00:00+03:00,in,False,929424,False,3,46,49,3
167827,2019-11-15 00:00:00+03:00,out,False,929428,True,100,0,2150,2150
167827,2019-11-15 00:00:00+03:00,in,False,-1,True,4,0,131,131
167827,2019-11-15 00:00:00+03:00,out,False,929424,False,5,697,737,40
167827,2019-11-15 00:00:00+03:00,out,False,929424,True,3,0,64,64
167827,2019-11-15 00:00:00+03:00,out,False,929428,False,126,7601,9398,1797
167827,2019-11-16 00:00:00+03:00,out,False,929424,True,1,0,60,60
167827,2019-11-16 00:00:00+03:00,in,False,929424,False,22,425,440,15
167827,2019-11-16 00:00:00+03:00,out,False,929424,False,1,24,39,15
167827,2019-11-16 00:00:00+03:00,in,False,-1,True,1,0,0,0
167827,2019-11-16 00:00:00+03:00,out,False,929428,False,163,11756,14786,3030
167827,2019-11-16 00:00:00+03:00,out,False,929428,True,293,0,7011,7011
167827,2019-11-16 00:00:00+03:00,out,False,929428,True,293,0,7011,7011
167827,2019-11-17 00:00:00+03:00,in,False,929424,False,2,68,70,2
167827,2019-11-18 00:00:00+03:00,out,False,929424,False,6,615,635,20
167827,2019-11-18 00:00:00+03:00,in,False,-1,True,9,0,370,370
167827,2019-11-18 00:00:00+03:00,out,False,929426,False,35,1822,2454,632
167827,2019-11-18 00:00:00+03:00,out,False,929428,False,126,5139,6191,1052
167827,2019-11-18 00:00:00+03:00,in,False,929424,False,2,8,10,2
167827,2019-11-18 00:00:00+03:00,out,False,929426,True,16,0,396,396
167827,2019-11-18 00:00:00+03:00,out,False,929428,True,82,0,1373,1373
167827,2019-11-18 00:00:00+03:00,out,False,929428,True,82,0,1373,1373
167827,2019-11-19 00:00:00+03:00,out,False,929424,True,3,0,51,51
167827,2019-11-19 00:00:00+03:00,in,False,-1,True,2,0,56,56
167827,2019-11-19 00:00:00+03:00,out,False,929426,True,180,0,2944,2944
167827,2019-11-19 00:00:00+03:00,out,False,929426,False,91,5979,7343,1364
167827,2019-11-19 00:00:00+03:00,out,False,929424,False,27,3665,3819,154
167827,2019-11-19 00:00:00+03:00,in,False,929424,False,12,146,156,10
167827,2019-11-20 00:00:00+03:00,in,False,929424,False,11,97,107,10
167827,2019-11-20 00:00:00+03:00,out,False,929424,False,3,680,697,17
167827,2019-11-20 00:00:00+03:00,out,False,929426,True,246,0,3763,3763
167827,2019-11-20 00:00:00+03:00,out,False,929426,False,86,5554,6876,1322
167827,2019-11-20 00:00:00+03:00,in,False,-1,True,2,0,83,83
167827,2019-11-20 00:00:00+03:00,in,False,-1,True,2,0,83,83
167827,2019-11-21 00:00:00+03:00,out,False,929426,False,326,13854,18872,5018
167827,2019-11-21 00:00:00+03:00,out,False,929424,False,9,1894,2012,118
167827,2019-11-21 00:00:00+03:00,in,False,-1,True,16,0,550,550
167827,2019-11-21 00:00:00+03:00,out,False,929424,True,3,0,58,58
167827,2019-11-21 00:00:00+03:00,out,False,929428,False,78,3721,4533,812
167827,2019-11-21 00:00:00+03:00,out,False,929426,True,507,0,8475,8475
167827,2019-11-21 00:00:00+03:00,out,False,929428,True,168,0,2170,2170
167827,2019-11-21 00:00:00+03:00,in,False,929424,False,22,245,265,20
167827,2019-11-21 00:00:00+03:00,in,False,-1,True,16,0,550,550
167827,2019-11-22 00:00:00+03:00,out,False,929426,False,355,16922,22736,5814
167827,2019-11-22 00:00:00+03:00,in,False,-1,True,20,0,583,583
167827,2019-11-22 00:00:00+03:00,out,False,929424,False,12,2644,2725,81
167827,2019-11-22 00:00:00+03:00,in,False,929424,False,63,754,806,52
167827,2019-11-22 00:00:00+03:00,out,False,929426,True,1020,0,16942,16942
167827,2019-11-22 00:00:00+03:00,out,False,929424,True,1,0,40,40
167827,2019-11-22 00:00:00+03:00,out,False,929428,True,201,0,2426,2426
167827,2019-11-22 00:00:00+03:00,out,False,929428,False,240,10157,12685,2528
167827,2019-11-22 00:00:00+03:00,out,False,929424,False,12,2644,2725,81
167827,2019-11-23 00:00:00+03:00,in,False,-1,True,34,0,862,862
167827,2019-11-23 00:00:00+03:00,out,False,929426,True,422,0,7051,7051
167827,2019-11-23 00:00:00+03:00,out,False,929426,False,133,5905,8181,2276
167827,2019-11-23 00:00:00+03:00,out,False,929424,False,1,447,468,21
167827,2019-11-23 00:00:00+03:00,out,False,929424,True,1,0,33,33
167827,2019-11-24 00:00:00+03:00,out,False,929426,True,2,0,24,24
167827,2019-11-24 00:00:00+03:00,in,False,-1,True,14,0,711,711
167827,2019-11-24 00:00:00+03:00,out,False,929426,False,4,18,49,31
167827,2019-11-25 00:00:00+03:00,out,False,929424,False,5,277,335,58
167827,2019-11-25 00:00:00+03:00,in,False,-1,True,12,0,535,535
167827,2019-11-25 00:00:00+03:00,out,False,929426,False,414,16746,24130,7384
167827,2019-11-25 00:00:00+03:00,out,False,929426,True,407,0,9335,9335
167827,2019-11-25 00:00:00+03:00,out,False,929424,True,3,0,31,31
167827,2019-11-25 00:00:00+03:00,in,False,929424,False,62,810,865,55
167827,2019-11-25 00:00:00+03:00,out,False,929428,True,87,0,1141,1141
167827,2019-11-25 00:00:00+03:00,out,False,929428,False,69,2631,3437,806
167827,2019-11-25 00:00:00+03:00,out,False,929426,True,407,0,9335,9335
167827,2019-11-26 00:00:00+03:00,out,False,929426,False,263,10120,14862,4742
167827,2019-11-26 00:00:00+03:00,in,False,929424,False,59,666,718,52
167827,2019-11-26 00:00:00+03:00,in,False,-1,True,7,0,205,205
167827,2019-11-26 00:00:00+03:00,out,False,929424,True,2,0,7,7
167827,2019-11-26 00:00:00+03:00,out,False,929426,True,333,0,7609,7609
167827,2019-11-26 00:00:00+03:00,out,False,929424,False,1,231,242,11
167827,2019-11-27 00:00:00+03:00,out,False,929426,False,441,20560,28432,7872
167827,2019-11-27 00:00:00+03:00,in,False,-1,True,21,0,704,704
167827,2019-11-27 00:00:00+03:00,in,False,929424,False,60,551,664,113
167827,2019-11-27 00:00:00+03:00,out,False,929424,True,10,0,95,95
167827,2019-11-27 00:00:00+03:00,out,False,929424,False,5,662,674,12
167827,2019-11-27 00:00:00+03:00,out,False,929426,True,499,0,11784,11784
167827,2019-11-28 00:00:00+03:00,in,False,929424,False,50,483,530,47
167827,2019-11-28 00:00:00+03:00,out,False,929426,False,351,13413,19635,6222
167827,2019-11-28 00:00:00+03:00,in,False,-1,True,16,0,390,390
167827,2019-11-28 00:00:00+03:00,out,False,929424,False,22,2080,2309,229
167827,2019-11-28 00:00:00+03:00,out,False,929424,True,10,0,255,255
167827,2019-11-28 00:00:00+03:00,out,False,929426,True,428,0,9814,9814
167827,2019-11-28 00:00:00+03:00,out,False,929424,True,10,0,255,255
167828,2019-10-02 00:00:00+03:00,in,False,-1,True,1,0,2,2
167828,2019-10-03 00:00:00+03:00,in,False,-1,True,3,0,6,6
167828,2019-10-07 00:00:00+03:00,in,False,-1,True,1,0,2,2
167828,2019-10-09 00:00:00+03:00,in,False,-1,True,3,0,6,6
167828,2019-10-11 00:00:00+03:00,in,False,-1,True,1,0,2,2
167828,2019-10-14 00:00:00+03:00,in,False,-1,True,1,0,2,2
167828,2019-10-16 00:00:00+03:00,in,False,-1,True,2,0,14,14
167828,2019-10-17 00:00:00+03:00,in,False,-1,True,7,0,6,6
167828,2019-10-18 00:00:00+03:00,in,False,940430,False,1,24,25,1
167828,2019-10-18 00:00:00+03:00,out,False,940442,False,2,38,42,4
167828,2019-10-18 00:00:00+03:00,in,False,-1,True,1,0,8,8
167828,2019-10-21 00:00:00+03:00,out,False,940434,True,3,0,42,42
167828,2019-10-21 00:00:00+03:00,in,False,940434,False,2,289,316,27
167828,2019-10-21 00:00:00+03:00,in,False,940430,False,2,89,90,1
167828,2019-10-22 00:00:00+03:00,in,False,940432,False,1,10,14,4
167828,2019-10-22 00:00:00+03:00,in,False,-1,True,8,0,257,257
167828,2019-10-22 00:00:00+03:00,out,False,940438,False,3,17,26,9
167828,2019-10-22 00:00:00+03:00,out,False,940432,True,2,0,25,25
167828,2019-10-22 00:00:00+03:00,out,False,940434,False,13,911,972,61
167828,2019-10-22 00:00:00+03:00,out,False,940438,True,4,0,107,107
167828,2019-10-22 00:00:00+03:00,out,False,940434,True,6,0,38,38
167828,2019-10-22 00:00:00+03:00,in,False,940430,False,1,13,14,1
167828,2019-10-23 00:00:00+03:00,out,False,940430,True,13,0,226,226
167828,2019-10-23 00:00:00+03:00,out,False,940434,True,1,0,1,1
167828,2019-10-23 00:00:00+03:00,out,False,940438,False,5,688,733,45
167828,2019-10-23 00:00:00+03:00,in,False,-1,True,17,0,116,116
167828,2019-10-23 00:00:00+03:00,in,False,940438,False,3,171,182,11
167828,2019-10-23 00:00:00+03:00,out,False,940432,False,2,169,177,8
167828,2019-10-23 00:00:00+03:00,out,False,940430,False,14,1866,1969,103
167828,2019-10-23 00:00:00+03:00,out,False,940434,False,2,136,146,10
167828,2019-10-23 00:00:00+03:00,out,False,940432,True,4,0,65,65
167828,2019-10-23 00:00:00+03:00,out,False,940438,True,11,0,172,172
167828,2019-10-23 00:00:00+03:00,in,False,940438,False,3,171,182,11
167828,2019-10-23 00:00:00+03:00,out,False,940438,False,5,688,733,45
167828,2019-10-24 00:00:00+03:00,out,False,940442,True,2,0,19,19
167828,2019-10-24 00:00:00+03:00,out,False,940438,True,6,0,106,106
167828,2019-10-24 00:00:00+03:00,in,False,940442,False,3,3,3,0
167828,2019-10-24 00:00:00+03:00,out,False,940438,False,5,355,393,38
167828,2019-10-24 00:00:00+03:00,in,False,940432,False,6,369,422,53
167828,2019-10-24 00:00:00+03:00,in,False,-1,True,18,0,239,239
167828,2019-10-24 00:00:00+03:00,out,False,940440,True,1,0,11,11
167828,2019-10-24 00:00:00+03:00,out,False,940434,False,2,276,286,10
167828,2019-10-24 00:00:00+03:00,in,False,940442,True,2,0,2,2
167828,2019-10-25 00:00:00+03:00,in,False,940438,False,5,343,380,37
167828,2019-10-25 00:00:00+03:00,out,False,940442,False,3,305,333,28
167828,2019-10-25 00:00:00+03:00,in,False,940432,False,2,39,58,19
167828,2019-10-25 00:00:00+03:00,out,False,940434,False,2,177,185,8
167828,2019-10-25 00:00:00+03:00,out,False,940438,False,16,2573,2710,137
167828,2019-10-25 00:00:00+03:00,in,False,940442,False,21,279,291,12
167828,2019-10-25 00:00:00+03:00,out,False,940438,True,3,0,33,33
167828,2019-10-25 00:00:00+03:00,out,False,940442,True,2,0,51,51
167828,2019-10-25 00:00:00+03:00,out,False,940434,False,2,177,185,8
167828,2019-10-25 00:00:00+03:00,in,False,940442,False,21,279,291,12
167828,2019-10-28 00:00:00+03:00,out,False,940434,False,2,224,239,15
167828,2019-10-28 00:00:00+03:00,out,False,940442,False,2,127,144,17
167828,2019-10-28 00:00:00+03:00,in,False,940430,False,1,7,7,0
167828,2019-10-28 00:00:00+03:00,in,False,940442,False,3,26,29,3
167828,2019-10-28 00:00:00+03:00,out,False,940438,False,9,2805,2864,59
167828,2019-10-28 00:00:00+03:00,out,False,940442,True,4,0,10,10
167828,2019-10-28 00:00:00+03:00,in,False,940438,False,5,456,493,37
167828,2019-10-28 00:00:00+03:00,in,False,940430,False,1,7,7,0
167828,2019-10-29 00:00:00+03:00,out,False,940438,True,4,0,24,24
167828,2019-10-29 00:00:00+03:00,out,False,940434,False,6,1309,1405,96
167828,2019-10-29 00:00:00+03:00,in,False,-1,True,1,0,19,19
167828,2019-10-29 00:00:00+03:00,out,False,940442,False,4,293,330,37
167828,2019-10-29 00:00:00+03:00,in,False,940442,False,6,213,217,4
167828,2019-10-29 00:00:00+03:00,out,False,940438,False,5,548,594,46
167828,2019-10-29 00:00:00+03:00,in,False,940438,False,1,59,64,5
167828,2019-10-29 00:00:00+03:00,out,False,940442,True,1,0,5,5
167828,2019-10-29 00:00:00+03:00,out,False,940434,True,7,0,28,28
167828,2019-10-29 00:00:00+03:00,out,False,940442,True,1,0,5,5
167828,2019-10-29 00:00:00+03:00,out,False,940434,True,7,0,28,28
167828,2019-10-29 00:00:00+03:00,out,False,940442,False,4,293,330,37
167828,2019-10-30 00:00:00+03:00,out,False,940438,False,20,3225,3461,236
167828,2019-10-30 00:00:00+03:00,in,False,940430,False,1,84,85,1
167828,2019-10-30 00:00:00+03:00,out,False,940438,True,6,0,149,149
167828,2019-10-30 00:00:00+03:00,in,False,-1,True,1,0,31,31
167828,2019-10-30 00:00:00+03:00,in,False,940442,False,4,84,84,0
167828,2019-10-30 00:00:00+03:00,out,False,940434,False,4,205,226,21
167828,2019-10-30 00:00:00+03:00,in,False,940438,False,5,369,399,30
167828,2019-10-30 00:00:00+03:00,in,False,940438,False,5,369,399,30
167828,2019-10-31 00:00:00+03:00,in,False,940432,False,2,16,32,16
167828,2019-10-31 00:00:00+03:00,in,False,940434,False,8,697,746,49
167828,2019-10-31 00:00:00+03:00,in,False,-1,True,10,0,282,282
167828,2019-10-31 00:00:00+03:00,out,False,940438,True,4,0,111,111
167828,2019-10-31 00:00:00+03:00,out,False,940438,False,20,2638,2829,191
167828,2019-10-31 00:00:00+03:00,out,False,940434,False,6,562,593,31
167828,2019-10-31 00:00:00+03:00,in,False,938614,True,1,0,12,12
167828,2019-10-31 00:00:00+03:00,in,False,938614,False,1,12,14,2
167828,2019-10-31 00:00:00+03:00,in,False,940438,False,4,563,583,20
167828,2019-10-31 00:00:00+03:00,out,False,940434,True,1,0,5,5
167828,2019-10-31 00:00:00+03:00,out,False,940442,False,3,95,156,61
167828,2019-10-31 00:00:00+03:00,in,False,940442,False,7,244,248,4
167828,2019-10-31 00:00:00+03:00,out,False,940442,True,2,0,36,36
167828,2019-11-01 00:00:00+03:00,out,False,940432,True,2,0,79,79
167828,2019-11-01 00:00:00+03:00,in,False,940434,False,7,691,720,29
167828,2019-11-01 00:00:00+03:00,out,False,940438,False,12,1441,1605,164
167828,2019-11-01 00:00:00+03:00,out,False,940442,False,8,442,521,79
167828,2019-11-01 00:00:00+03:00,in,False,940438,False,4,544,563,19
167828,2019-11-01 00:00:00+03:00,out,False,940442,True,2,0,71,71
167828,2019-11-01 00:00:00+03:00,out,False,940434,True,1,0,7,7
167828,2019-11-01 00:00:00+03:00,out,False,940432,False,5,509,549,40
167828,2019-11-01 00:00:00+03:00,in,False,940442,False,4,1344,1348,4
167828,2019-11-01 00:00:00+03:00,out,False,940434,False,4,657,691,34
167828,2019-11-01 00:00:00+03:00,out,False,940438,True,1,0,10,10
167828,2019-11-01 00:00:00+03:00,in,False,940430,False,2,50,52,2
167828,2019-11-01 00:00:00+03:00,out,False,940442,True,2,0,71,71
167828,2019-11-05 00:00:00+03:00,in,False,940430,False,4,347,351,4
167828,2019-11-05 00:00:00+03:00,out,False,940442,True,3,0,27,27
167828,2019-11-05 00:00:00+03:00,in,False,-1,True,3,0,47,47
167828,2019-11-05 00:00:00+03:00,in,False,940442,True,1,0,1,1
167828,2019-11-05 00:00:00+03:00,in,False,940442,False,6,69,72,3
167828,2019-11-05 00:00:00+03:00,out,False,940434,False,3,383,399,16
167828,2019-11-05 00:00:00+03:00,out,False,940438,False,8,1004,1122,118
167828,2019-11-05 00:00:00+03:00,in,False,940438,False,2,205,218,13
167828,2019-11-05 00:00:00+03:00,out,False,940432,True,1,0,7,7
167828,2019-11-05 00:00:00+03:00,in,False,940434,False,14,2208,2288,80
167828,2019-11-05 00:00:00+03:00,out,False,940442,False,10,3465,3566,101
167828,2019-11-05 00:00:00+03:00,out,False,940440,False,2,351,372,21
167828,2019-11-05 00:00:00+03:00,out,False,938612,False,8,496,532,36
167828,2019-11-05 00:00:00+03:00,out,False,940434,True,1,0,37,37
167828,2019-11-05 00:00:00+03:00,in,False,940432,False,2,112,123,11
167828,2019-11-05 00:00:00+03:00,in,False,938612,False,2,142,152,10
167828,2019-11-05 00:00:00+03:00,out,False,940438,False,8,1004,1122,118
167828,2019-11-05 00:00:00+03:00,in,False,-1,True,3,0,47,47
167828,2019-11-06 00:00:00+03:00,out,False,940442,False,16,765,937,172
167828,2019-11-06 00:00:00+03:00,in,False,940440,False,2,113,126,13
167828,2019-11-06 00:00:00+03:00,out,False,940438,True,1,0,16,16
167828,2019-11-06 00:00:00+03:00,out,False,940442,True,7,0,155,155
167828,2019-11-06 00:00:00+03:00,out,False,940434,False,3,444,464,20
167828,2019-11-06 00:00:00+03:00,out,False,940438,False,15,1297,1448,151
167828,2019-11-06 00:00:00+03:00,in,False,-1,True,12,0,141,141
167828,2019-11-06 00:00:00+03:00,out,False,940440,True,1,0,32,32
167828,2019-11-06 00:00:00+03:00,in,False,940434,False,13,1608,1688,80
167828,2019-11-06 00:00:00+03:00,in,False,940442,False,3,448,450,2
167828,2019-11-06 00:00:00+03:00,out,False,940434,True,1,0,50,50
167828,2019-11-06 00:00:00+03:00,out,False,938612,True,5,0,52,52
167828,2019-11-06 00:00:00+03:00,in,False,940436,False,1,1,11,10
167828,2019-11-06 00:00:00+03:00,in,False,938612,False,8,545,599,54
167828,2019-11-06 00:00:00+03:00,in,False,-1,True,12,0,141,141
167828,2019-11-07 00:00:00+03:00,in,False,940442,False,22,1513,1529,16
167828,2019-11-07 00:00:00+03:00,out,False,940434,False,3,84,131,47
167828,2019-11-07 00:00:00+03:00,out,False,940432,False,3,741,753,12
167828,2019-11-07 00:00:00+03:00,in,False,940430,False,4,249,253,4
167828,2019-11-07 00:00:00+03:00,out,False,940442,False,27,2962,3277,315
167828,2019-11-07 00:00:00+03:00,out,False,940438,False,6,1210,1282,72
167828,2019-11-07 00:00:00+03:00,in,False,938612,False,2,195,214,19
167828,2019-11-07 00:00:00+03:00,in,False,940432,False,7,437,485,48
167828,2019-11-07 00:00:00+03:00,in,False,-1,True,24,0,307,307
167828,2019-11-07 00:00:00+03:00,in,False,940438,False,2,168,182,14
167828,2019-11-07 00:00:00+03:00,out,False,940442,True,16,0,431,431
167828,2019-11-07 00:00:00+03:00,in,False,938614,False,2,141,153,12
167828,2019-11-07 00:00:00+03:00,in,False,940440,False,2,200,231,31
167828,2019-11-07 00:00:00+03:00,out,False,940438,True,2,0,78,78
167828,2019-11-07 00:00:00+03:00,out,False,938612,False,6,552,597,45
167828,2019-11-07 00:00:00+03:00,in,False,940434,False,5,917,950,33
167828,2019-11-07 00:00:00+03:00,out,False,940442,True,16,0,431,431
167828,2019-11-07 00:00:00+03:00,out,False,938612,False,6,552,597,45
167828,2019-11-07 00:00:00+03:00,in,False,940430,False,4,249,253,4
167828,2019-11-08 00:00:00+03:00,out,False,940442,False,7,503,581,78
167828,2019-11-08 00:00:00+03:00,out,False,938612,False,5,291,333,42
167828,2019-11-08 00:00:00+03:00,in,False,940442,False,6,395,398,3
167828,2019-11-08 00:00:00+03:00,in,False,940436,False,1,48,70,22
167828,2019-11-08 00:00:00+03:00,in,False,940434,False,5,371,391,20
167828,2019-11-08 00:00:00+03:00,in,False,940430,False,4,302,306,4
167828,2019-11-08 00:00:00+03:00,out,False,940438,False,13,1478,1607,129
167828,2019-11-08 00:00:00+03:00,in,False,-1,True,16,0,328,328
167828,2019-11-08 00:00:00+03:00,in,False,938612,False,3,432,444,12
167828,2019-11-08 00:00:00+03:00,out,False,940434,False,4,746,808,62
167828,2019-11-08 00:00:00+03:00,out,False,938612,True,2,0,35,35
167828,2019-11-08 00:00:00+03:00,in,False,938614,False,4,384,406,22
167828,2019-11-08 00:00:00+03:00,in,False,940438,False,3,235,249,14
167828,2019-11-08 00:00:00+03:00,out,False,940442,True,1,0,3,3
167828,2019-11-08 00:00:00+03:00,in,False,940440,False,2,436,472,36
167828,2019-11-08 00:00:00+03:00,out,False,940434,False,4,746,808,62
167828,2019-11-08 00:00:00+03:00,in,False,938612,False,3,432,444,12
167828,2019-11-09 00:00:00+03:00,in,False,940430,False,1,82,83,1
167828,2019-11-09 00:00:00+03:00,in,False,-1,True,2,0,31,31
167828,2019-11-10 00:00:00+03:00,in,False,-1,True,3,0,43,43
167828,2019-11-10 00:00:00+03:00,in,False,940430,False,1,54,54,0
167828,2019-11-11 00:00:00+03:00,in,False,940438,False,1,39,44,5
167828,2019-11-11 00:00:00+03:00,out,False,938612,False,1,47,51,4
167828,2019-11-11 00:00:00+03:00,in,False,940442,False,6,809,814,5
167828,2019-11-11 00:00:00+03:00,in,False,940434,False,2,651,659,8
167828,2019-11-11 00:00:00+03:00,in,False,938614,False,8,374,410,36
167828,2019-11-11 00:00:00+03:00,in,False,938612,False,5,393,418,25
167828,2019-11-11 00:00:00+03:00,in,False,940430,False,4,662,666,4
167828,2019-11-11 00:00:00+03:00,out,False,940442,False,5,411,455,44
167828,2019-11-11 00:00:00+03:00,out,False,940438,True,5,0,93,93
167828,2019-11-11 00:00:00+03:00,out,False,940434,True,1,0,38,38
167828,2019-11-11 00:00:00+03:00,out,False,940438,False,13,2366,2544,178
167828,2019-11-11 00:00:00+03:00,in,False,940440,False,5,380,406,26
167828,2019-11-11 00:00:00+03:00,in,False,-1,True,13,0,101,101
167828,2019-11-11 00:00:00+03:00,out,False,940434,False,3,1475,1508,33
167828,2019-11-11 00:00:00+03:00,out,False,940442,True,1,0,1,1
167828,2019-11-11 00:00:00+03:00,in,False,938614,False,8,374,410,36
167828,2019-11-11 00:00:00+03:00,out,False,940434,False,3,1475,1508,33
167828,2019-11-12 00:00:00+03:00,out,False,940442,True,5,0,118,118
167828,2019-11-12 00:00:00+03:00,in,False,940440,False,2,56,101,45
167828,2019-11-12 00:00:00+03:00,in,False,940434,False,5,613,643,30
167828,2019-11-12 00:00:00+03:00,out,False,940432,True,1,0,0,0
167828,2019-11-12 00:00:00+03:00,in,False,940438,False,2,57,67,10
167828,2019-11-12 00:00:00+03:00,out,False,940438,True,4,0,109,109
167828,2019-11-12 00:00:00+03:00,in,False,938614,False,1,32,35,3
167828,2019-11-12 00:00:00+03:00,out,False,940434,False,1,280,282,2
167828,2019-11-12 00:00:00+03:00,out,False,940442,False,9,637,728,91
167828,2019-11-12 00:00:00+03:00,out,False,940434,True,2,0,36,36
167828,2019-11-12 00:00:00+03:00,out,False,940440,False,1,4,16,12
167828,2019-11-12 00:00:00+03:00,in,False,940442,False,6,569,573,4
167828,2019-11-12 00:00:00+03:00,out,False,938612,False,2,238,260,22
167828,2019-11-12 00:00:00+03:00,in,False,-1,True,9,0,65,65
167828,2019-11-12 00:00:00+03:00,in,False,938612,False,3,291,314,23
167828,2019-11-12 00:00:00+03:00,out,False,940438,False,8,594,655,61
167828,2019-11-12 00:00:00+03:00,out,False,940442,True,5,0,118,118
167828,2019-11-12 00:00:00+03:00,in,False,940438,False,2,57,67,10
167828,2019-11-13 00:00:00+03:00,out,False,940442,False,11,1128,1246,118
167828,2019-11-13 00:00:00+03:00,in,False,940442,False,7,1012,1016,4
167828,2019-11-13 00:00:00+03:00,in,False,938612,False,2,533,545,12
167828,2019-11-13 00:00:00+03:00,in,False,938614,False,1,143,148,5
167828,2019-11-13 00:00:00+03:00,out,False,940434,False,5,586,634,48
167828,2019-11-13 00:00:00+03:00,in,False,940438,False,3,296,308,12
167828,2019-11-13 00:00:00+03:00,out,False,940438,True,2,0,4,4
167828,2019-11-13 00:00:00+03:00,in,False,940430,False,1,73,74,1
167828,2019-11-13 00:00:00+03:00,in,False,940434,False,1,9,13,4
167828,2019-11-13 00:00:00+03:00,in,False,940440,False,1,147,168,21
167828,2019-11-13 00:00:00+03:00,in,False,-1,True,36,0,63,63
167828,2019-11-13 00:00:00+03:00,out,False,940438,False,10,784,879,95
167828,2019-11-13 00:00:00+03:00,out,False,940442,True,3,0,133,133
167828,2019-11-13 00:00:00+03:00,out,False,940434,True,5,0,92,92
167828,2019-11-14 00:00:00+03:00,in,False,938614,False,3,274,294,20
167828,2019-11-14 00:00:00+03:00,out,False,940442,False,16,810,1013,203
167828,2019-11-14 00:00:00+03:00,out,False,940438,False,10,1010,1149,139
167828,2019-11-14 00:00:00+03:00,out,False,940432,True,5,0,30,30
167828,2019-11-14 00:00:00+03:00,in,False,-1,True,3,0,31,31
167828,2019-11-14 00:00:00+03:00,out,False,940442,True,7,0,192,192
167828,2019-11-14 00:00:00+03:00,in,False,940440,False,2,141,175,34
167828,2019-11-14 00:00:00+03:00,out,False,940438,True,5,0,99,99
167828,2019-11-14 00:00:00+03:00,in,False,940432,False,4,478,508,30
167828,2019-11-14 00:00:00+03:00,in,False,940434,False,5,1058,1080,22
167828,2019-11-14 00:00:00+03:00,in,False,940442,False,12,1202,1210,8
167828,2019-11-14 00:00:00+03:00,out,False,940432,False,2,180,215,35
167828,2019-11-14 00:00:00+03:00,in,False,940430,False,3,69,72,3
167828,2019-11-14 00:00:00+03:00,in,False,940438,False,5,120,145,25
167828,2019-11-14 00:00:00+03:00,in,False,938614,False,3,274,294,20
167828,2019-11-15 00:00:00+03:00,out,False,940438,True,1,0,2,2
167828,2019-11-15 00:00:00+03:00,out,False,940434,False,1,481,493,12
167828,2019-11-15 00:00:00+03:00,in,False,940434,False,4,393,415,22
167828,2019-11-15 00:00:00+03:00,out,False,940434,True,3,0,40,40
167828,2019-11-15 00:00:00+03:00,in,False,940442,False,5,494,497,3
167828,2019-11-15 00:00:00+03:00,in,False,940438,False,3,123,136,13
167828,2019-11-15 00:00:00+03:00,out,False,940442,False,6,424,497,73
167828,2019-11-15 00:00:00+03:00,in,False,938612,False,2,305,316,11
167828,2019-11-15 00:00:00+03:00,in,False,940430,False,3,434,438,4
167828,2019-11-15 00:00:00+03:00,in,False,940430,True,1,79,80,1
167828,2019-11-15 00:00:00+03:00,out,False,940438,False,9,756,835,79
167828,2019-11-15 00:00:00+03:00,in,False,940432,False,2,20,39,19
167828,2019-11-15 00:00:00+03:00,out,False,940438,False,9,756,835,79
167828,2019-11-15 00:00:00+03:00,out,False,940438,True,1,0,2,2
167828,2019-11-15 00:00:00+03:00,in,False,938612,False,2,305,316,11
167828,2019-11-16 00:00:00+03:00,in,False,940430,False,1,57,57,0
167828,2019-11-18 00:00:00+03:00,out,False,940442,True,2,0,96,96
167828,2019-11-18 00:00:00+03:00,in,False,940438,False,2,228,238,10
167828,2019-11-18 00:00:00+03:00,out,False,938612,True,2,0,37,37
167828,2019-11-18 00:00:00+03:00,in,False,938612,False,4,973,993,20
167828,2019-11-18 00:00:00+03:00,out,False,940432,True,1,0,13,13
167828,2019-11-18 00:00:00+03:00,out,False,938612,False,4,466,498,32
167828,2019-11-18 00:00:00+03:00,out,False,940434,False,1,130,132,2
167828,2019-11-18 00:00:00+03:00,in,False,940442,False,11,1173,1183,10
167828,2019-11-18 00:00:00+03:00,out,False,940432,False,12,1585,1701,116
167828,2019-11-18 00:00:00+03:00,in,False,940440,False,1,30,70,40
167828,2019-11-18 00:00:00+03:00,in,False,-1,True,7,0,60,60
167828,2019-11-18 00:00:00+03:00,out,False,940442,False,7,1199,1255,56
167828,2019-11-18 00:00:00+03:00,out,False,940438,True,19,0,202,202
167828,2019-11-18 00:00:00+03:00,in,False,940434,False,6,508,527,19
167828,2019-11-18 00:00:00+03:00,out,False,940438,False,13,1128,1286,158
167828,2019-11-18 00:00:00+03:00,in,False,938614,False,2,56,68,12
167828,2019-11-18 00:00:00+03:00,in,False,940430,False,6,337,342,5
167828,2019-11-18 00:00:00+03:00,in,False,940432,False,5,563,606,43
167828,2019-11-18 00:00:00+03:00,out,False,940432,False,12,1585,1701,116
167828,2019-11-18 00:00:00+03:00,in,False,940432,False,5,563,606,43
167828,2019-11-19 00:00:00+03:00,in,False,940432,False,7,675,718,43
167828,2019-11-19 00:00:00+03:00,out,False,938614,True,3,0,34,34
167828,2019-11-19 00:00:00+03:00,out,False,938612,False,1,3,15,12
167828,2019-11-19 00:00:00+03:00,in,False,938612,False,7,758,793,35
167828,2019-11-19 00:00:00+03:00,out,False,938612,True,3,0,9,9
167828,2019-11-19 00:00:00+03:00,in,False,940438,False,2,71,78,7
167828,2019-11-19 00:00:00+03:00,out,False,940432,False,17,2950,3178,228
167828,2019-11-19 00:00:00+03:00,out,False,940434,False,1,148,150,2
167828,2019-11-19 00:00:00+03:00,in,False,-1,True,20,0,504,504
167828,2019-11-19 00:00:00+03:00,in,False,940440,False,5,494,573,79
167828,2019-11-19 00:00:00+03:00,out,False,940438,True,4,0,114,114
167828,2019-11-19 00:00:00+03:00,in,False,940430,False,4,653,658,5
167828,2019-11-19 00:00:00+03:00,out,False,940438,False,14,1374,1587,213
167828,2019-11-19 00:00:00+03:00,in,False,940434,False,9,1622,1654,32
167828,2019-11-19 00:00:00+03:00,out,False,940432,True,6,0,39,39
167828,2019-11-19 00:00:00+03:00,in,False,940442,False,10,632,642,10
167828,2019-11-19 00:00:00+03:00,out,False,940442,False,7,956,1052,96
167828,2019-11-19 00:00:00+03:00,out,False,940442,True,2,0,26,26
167828,2019-11-19 00:00:00+03:00,out,False,940438,True,4,0,114,114
167828,2019-11-19 00:00:00+03:00,in,False,940430,False,4,653,658,5
167828,2019-11-20 00:00:00+03:00,in,False,940442,False,6,1064,1067,3
167828,2019-11-20 00:00:00+03:00,out,False,940438,True,3,0,61,61
167828,2019-11-20 00:00:00+03:00,in,False,938614,False,1,14,18,4
167828,2019-11-20 00:00:00+03:00,in,False,940430,False,1,92,93,1
167828,2019-11-20 00:00:00+03:00,in,False,-1,True,9,0,111,111
167828,2019-11-20 00:00:00+03:00,out,False,940434,False,7,324,393,69
167828,2019-11-20 00:00:00+03:00,out,False,940432,False,15,2302,2571,269
167828,2019-11-20 00:00:00+03:00,out,False,940434,True,2,0,56,56
167828,2019-11-20 00:00:00+03:00,in,False,940440,False,2,213,231,18
167828,2019-11-20 00:00:00+03:00,out,False,940438,False,8,709,790,81
167828,2019-11-20 00:00:00+03:00,out,False,940442,False,5,550,622,72
167828,2019-11-20 00:00:00+03:00,in,False,940436,False,1,13,31,18
167828,2019-11-20 00:00:00+03:00,out,False,940436,False,1,118,132,14
167828,2019-11-20 00:00:00+03:00,out,False,940436,True,1,0,11,11
167828,2019-11-20 00:00:00+03:00,in,False,940438,False,1,298,303,5
167828,2019-11-20 00:00:00+03:00,in,False,940432,False,7,456,503,47
167828,2019-11-20 00:00:00+03:00,in,False,938612,False,6,360,389,29
167828,2019-11-20 00:00:00+03:00,out,False,940432,True,3,0,67,67
167828,2019-11-20 00:00:00+03:00,in,False,940434,False,8,765,807,42
167828,2019-11-20 00:00:00+03:00,in,False,940438,False,1,298,303,5
167828,2019-11-20 00:00:00+03:00,out,False,940436,False,1,118,132,14
167828,2019-11-20 00:00:00+03:00,out,False,940438,True,3,0,61,61
167828,2019-11-21 00:00:00+03:00,out,False,938614,False,6,564,663,99
167828,2019-11-21 00:00:00+03:00,out,False,938614,True,1,0,2,2
167828,2019-11-21 00:00:00+03:00,out,False,938612,False,15,1370,1521,151
167828,2019-11-21 00:00:00+03:00,in,False,940436,False,7,223,333,110
167828,2019-11-21 00:00:00+03:00,out,False,940432,False,13,2518,2676,158
167828,2019-11-21 00:00:00+03:00,in,False,938612,False,3,249,263,14
167828,2019-11-21 00:00:00+03:00,in,False,-1,True,23,0,484,484
167828,2019-11-21 00:00:00+03:00,out,False,940442,True,7,0,90,90
167828,2019-11-21 00:00:00+03:00,out,False,940438,False,12,723,854,131
167828,2019-11-21 00:00:00+03:00,out,False,940436,False,2,1197,1215,18
167828,2019-11-21 00:00:00+03:00,in,False,940432,False,18,1798,1926,128
167828,2019-11-21 00:00:00+03:00,in,False,940440,False,7,1136,1195,59
167828,2019-11-21 00:00:00+03:00,out,False,940432,True,5,0,160,160
167828,2019-11-21 00:00:00+03:00,out,False,940438,True,9,0,282,282
167828,2019-11-21 00:00:00+03:00,out,False,940442,False,10,760,881,121
167828,2019-11-21 00:00:00+03:00,in,False,940434,False,5,1110,1136,26
167828,2019-11-21 00:00:00+03:00,in,False,940442,False,8,621,627,6
167828,2019-11-21 00:00:00+03:00,out,False,940438,False,12,723,854,131
167828,2019-11-21 00:00:00+03:00,out,False,940442,True,7,0,90,90
167828,2019-11-22 00:00:00+03:00,out,False,938614,True,1,0,18,18
167828,2019-11-22 00:00:00+03:00,out,False,938612,True,7,0,25,25
167828,2019-11-22 00:00:00+03:00,in,False,940434,False,3,192,202,10
167828,2019-11-22 00:00:00+03:00,in,False,940430,False,3,304,307,3
167828,2019-11-22 00:00:00+03:00,in,False,-1,True,8,0,140,140
167828,2019-11-22 00:00:00+03:00,out,False,940434,False,1,107,110,3
167828,2019-11-22 00:00:00+03:00,in,False,940432,False,4,345,367,22
167828,2019-11-22 00:00:00+03:00,in,False,940440,False,3,510,530,20
167828,2019-11-22 00:00:00+03:00,out,False,940438,True,1,0,36,36
167828,2019-11-22 00:00:00+03:00,out,False,940442,True,3,0,66,66
167828,2019-11-22 00:00:00+03:00,out,False,940432,False,4,275,338,63
167828,2019-11-22 00:00:00+03:00,out,False,940438,False,14,1237,1438,201
167828,2019-11-22 00:00:00+03:00,in,False,940442,False,7,692,695,3
167828,2019-11-22 00:00:00+03:00,out,False,938612,False,8,769,820,51
167828,2019-11-22 00:00:00+03:00,in,False,940438,False,1,42,47,5
167828,2019-11-22 00:00:00+03:00,out,False,940436,True,1,0,13,13
167828,2019-11-22 00:00:00+03:00,in,False,938612,False,3,357,374,17
167828,2019-11-22 00:00:00+03:00,in,False,940436,False,4,321,343,22
167828,2019-11-22 00:00:00+03:00,out,False,940442,False,10,2736,2880,144
167828,2019-11-22 00:00:00+03:00,in,False,940430,False,3,304,307,3
167828,2019-11-22 00:00:00+03:00,out,False,938612,True,7,0,25,25
167828,2019-11-22 00:00:00+03:00,out,False,938614,True,1,0,18,18
167828,2019-11-23 00:00:00+03:00,in,False,-1,True,2,0,35,35
167828,2019-11-25 00:00:00+03:00,out,False,938614,False,3,101,155,54
167828,2019-11-25 00:00:00+03:00,out,False,940440,True,1,0,10,10
167828,2019-11-25 00:00:00+03:00,out,False,940442,False,6,1691,1770,79
167828,2019-11-25 00:00:00+03:00,in,False,940440,False,3,832,859,27
167828,2019-11-25 00:00:00+03:00,out,False,940438,False,7,2271,2353,82
167828,2019-11-25 00:00:00+03:00,out,False,938614,True,1,0,60,60
167828,2019-11-25 00:00:00+03:00,in,False,940438,False,4,853,877,24
167828,2019-11-25 00:00:00+03:00,out,False,940432,False,5,705,800,95
167828,2019-11-25 00:00:00+03:00,in,False,940436,False,2,84,102,18
167828,2019-11-25 00:00:00+03:00,out,False,940438,True,1,0,30,30
167828,2019-11-25 00:00:00+03:00,in,False,940432,False,30,4129,4358,229
167828,2019-11-25 00:00:00+03:00,in,False,938614,False,1,96,100,4
167828,2019-11-25 00:00:00+03:00,out,False,938612,False,4,411,478,67
167828,2019-11-25 00:00:00+03:00,in,False,940442,False,11,1092,1100,8
167828,2019-11-25 00:00:00+03:00,out,False,940434,False,8,627,670,43
167828,2019-11-25 00:00:00+03:00,out,False,940432,True,1,0,38,38
167828,2019-11-25 00:00:00+03:00,in,False,938612,False,4,235,249,14
167828,2019-11-25 00:00:00+03:00,in,False,-1,True,7,0,131,131
167828,2019-11-25 00:00:00+03:00,in,False,940434,False,5,905,922,17
167828,2019-11-25 00:00:00+03:00,out,False,940434,True,4,0,29,29
167828,2019-11-25 00:00:00+03:00,in,False,938612,False,4,235,249,14
167828,2019-11-25 00:00:00+03:00,in,False,940436,False,2,84,102,18
167828,2019-11-26 00:00:00+03:00,in,False,940432,False,21,3459,3605,146
167828,2019-11-26 00:00:00+03:00,out,False,938614,False,9,512,599,87
167828,2019-11-26 00:00:00+03:00,in,False,940434,False,7,1002,1029,27
167828,2019-11-26 00:00:00+03:00,in,False,940436,False,7,1257,1316,59
167828,2019-11-26 00:00:00+03:00,out,False,938614,True,3,0,85,85
167828,2019-11-26 00:00:00+03:00,out,False,938612,False,23,1302,1634,332
167828,2019-11-26 00:00:00+03:00,out,False,940442,False,7,1723,1801,78
167828,2019-11-26 00:00:00+03:00,out,False,940442,True,1,0,3,3
167828,2019-11-26 00:00:00+03:00,out,False,940438,True,5,0,38,38
167828,2019-11-26 00:00:00+03:00,in,False,940430,False,5,1168,1173,5
167828,2019-11-26 00:00:00+03:00,out,False,940440,True,5,0,68,68
167828,2019-11-26 00:00:00+03:00,out,False,940438,False,4,530,603,73
167828,2019-11-26 00:00:00+03:00,in,False,940440,False,2,193,212,19
167828,2019-11-26 00:00:00+03:00,out,False,940434,False,7,571,610,39
167828,2019-11-26 00:00:00+03:00,out,False,940432,False,16,3264,3526,262
167828,2019-11-26 00:00:00+03:00,out,False,940432,True,2,0,44,44
167828,2019-11-26 00:00:00+03:00,out,False,938612,True,10,0,133,133
167828,2019-11-26 00:00:00+03:00,out,False,940434,True,1,0,24,24
167828,2019-11-26 00:00:00+03:00,in,False,-1,True,16,0,346,346
167828,2019-11-26 00:00:00+03:00,out,False,940440,False,2,329,347,18
167828,2019-11-26 00:00:00+03:00,in,False,940442,False,5,1342,1345,3
167828,2019-11-26 00:00:00+03:00,in,False,938612,False,4,497,517,20
167828,2019-11-26 00:00:00+03:00,out,False,940434,False,7,571,610,39
167828,2019-11-27 00:00:00+03:00,in,False,940432,False,12,1593,1676,83
167828,2019-11-27 00:00:00+03:00,in,False,940436,False,5,784,827,43
167828,2019-11-27 00:00:00+03:00,out,False,938612,False,5,570,599,29
167828,2019-11-27 00:00:00+03:00,in,False,940434,False,3,76,88,12
167828,2019-11-27 00:00:00+03:00,out,False,940438,False,5,620,670,50
167828,2019-11-27 00:00:00+03:00,out,False,940434,False,2,156,180,24
167828,2019-11-27 00:00:00+03:00,in,False,938614,False,2,297,309,12
167828,2019-11-27 00:00:00+03:00,out,False,940442,True,3,0,95,95
167828,2019-11-27 00:00:00+03:00,out,False,940432,True,2,0,5,5
167828,2019-11-27 00:00:00+03:00,in,False,940430,False,5,440,446,6
167828,2019-11-27 00:00:00+03:00,in,False,-1,True,2,0,45,45
167828,2019-11-27 00:00:00+03:00,in,False,940442,False,6,477,483,6
167828,2019-11-27 00:00:00+03:00,in,False,940438,False,1,38,45,7
167828,2019-11-27 00:00:00+03:00,out,False,940432,False,17,1382,1580,198
167828,2019-11-27 00:00:00+03:00,in,False,940440,False,4,590,621,31
167828,2019-11-27 00:00:00+03:00,out,False,940438,True,2,0,43,43
167828,2019-11-27 00:00:00+03:00,in,False,938612,False,2,273,283,10
167828,2019-11-27 00:00:00+03:00,out,False,940434,True,2,0,2,2
167828,2019-11-27 00:00:00+03:00,out,False,940442,False,16,1094,1278,184
167828,2019-11-27 00:00:00+03:00,in,False,940442,False,6,477,483,6
167828,2019-11-28 00:00:00+03:00,out,False,940434,False,1,128,135,7
167828,2019-11-28 00:00:00+03:00,in,False,940436,False,2,158,181,23
167828,2019-11-28 00:00:00+03:00,out,False,940438,False,7,1264,1309,45
167828,2019-11-28 00:00:00+03:00,in,False,940438,False,3,309,324,15
167828,2019-11-28 00:00:00+03:00,out,False,938612,False,12,1663,1768,105
167828,2019-11-28 00:00:00+03:00,in,False,-1,True,12,0,184,184
167828,2019-11-28 00:00:00+03:00,out,False,940440,False,1,60,67,7
167828,2019-11-28 00:00:00+03:00,out,False,938612,True,2,0,44,44
167828,2019-11-28 00:00:00+03:00,in,False,938614,False,6,325,386,61
167828,2019-11-28 00:00:00+03:00,in,False,940430,False,4,241,244,3
167828,2019-11-28 00:00:00+03:00,in,False,938612,False,4,472,489,17
167828,2019-11-28 00:00:00+03:00,out,False,940442,True,5,0,126,126
167828,2019-11-28 00:00:00+03:00,out,False,940432,False,16,663,836,173
167828,2019-11-28 00:00:00+03:00,in,False,940442,False,8,533,540,7
167828,2019-11-28 00:00:00+03:00,out,False,940432,True,4,0,18,18
167828,2019-11-28 00:00:00+03:00,in,False,940434,False,9,1053,1087,34
167828,2019-11-28 00:00:00+03:00,in,False,940432,False,9,890,977,87
167828,2019-11-28 00:00:00+03:00,out,False,940442,False,21,1213,1442,229
167828,2019-11-28 00:00:00+03:00,in,False,940440,False,3,781,801,20
167828,2019-11-28 00:00:00+03:00,out,False,940436,True,1,0,0,0
167828,2019-11-28 00:00:00+03:00,out,False,938614,False,1,63,73,10
167828,2019-11-28 00:00:00+03:00,out,False,938614,True,1,0,13,13
167828,2019-11-28 00:00:00+03:00,out,False,940442,False,21,1213,1442,229
167829,2019-11-22 00:00:00+03:00,in,False,969272,False,7,396,635,239
167829,2019-11-22 00:00:00+03:00,out,False,969272,False,6,207,290,83
167829,2019-11-22 00:00:00+03:00,out,True,969272,True,1,0,9,9
167829,2019-11-22 00:00:00+03:00,out,False,969272,True,11,0,125,125
167829,2019-11-22 00:00:00+03:00,in,False,-1,True,1,0,22,22
167829,2019-11-23 00:00:00+03:00,in,False,969272,False,6,486,684,198
167829,2019-11-23 00:00:00+03:00,out,False,969272,False,10,451,600,149
167829,2019-11-23 00:00:00+03:00,out,False,969272,True,5,0,103,103
167829,2019-11-23 00:00:00+03:00,out,True,969272,True,1,0,6,6
167829,2019-11-23 00:00:00+03:00,in,False,-1,True,3,0,75,75
167829,2019-11-24 00:00:00+03:00,out,False,969272,True,7,0,204,204
167829,2019-11-24 00:00:00+03:00,out,False,969272,False,9,354,493,139
167829,2019-11-24 00:00:00+03:00,in,False,969272,False,8,503,776,273
167829,2019-11-24 00:00:00+03:00,in,False,-1,True,6,0,181,181
167829,2019-11-24 00:00:00+03:00,out,False,969272,True,7,0,204,204
167829,2019-11-25 00:00:00+03:00,in,False,969272,False,32,1638,2323,685
167829,2019-11-25 00:00:00+03:00,out,False,969272,False,12,696,902,206
167829,2019-11-25 00:00:00+03:00,out,False,969272,True,13,0,436,436
167829,2019-11-25 00:00:00+03:00,in,False,969272,True,1,1,40,39
167829,2019-11-25 00:00:00+03:00,in,False,-1,True,8,0,234,234
167829,2019-11-25 00:00:00+03:00,out,True,969272,False,1,0,4,4
167829,2019-11-25 00:00:00+03:00,out,True,969272,True,12,0,57,57
167829,2019-11-26 00:00:00+03:00,out,True,969272,True,1,0,0,0
167829,2019-11-26 00:00:00+03:00,in,False,969272,False,29,1574,1694,120
167829,2019-11-26 00:00:00+03:00,out,False,969272,False,42,831,1373,542
167829,2019-11-26 00:00:00+03:00,out,True,969272,False,1,37,47,10
167829,2019-11-26 00:00:00+03:00,in,False,-1,True,3,0,52,52
167829,2019-11-26 00:00:00+03:00,out,False,969272,True,14,0,278,278
167829,2019-11-27 00:00:00+03:00,in,False,-1,True,4,0,27,27
167829,2019-11-27 00:00:00+03:00,out,False,969272,False,30,1301,1719,418
167829,2019-11-27 00:00:00+03:00,in,False,969272,False,38,2494,2663,169
167829,2019-11-27 00:00:00+03:00,out,True,969272,False,4,24,70,46
167829,2019-11-27 00:00:00+03:00,out,False,969272,True,17,0,305,305
167829,2019-11-27 00:00:00+03:00,in,False,969272,False,38,2494,2663,169
167829,2019-11-28 00:00:00+03:00,in,False,969272,False,33,1896,2040,144
167829,2019-11-28 00:00:00+03:00,in,False,-1,True,1,0,23,23
167829,2019-11-28 00:00:00+03:00,out,False,969272,True,6,0,203,203
167829,2019-11-28 00:00:00+03:00,out,False,969272,False,23,657,1025,368
167829,2019-11-28 00:00:00+03:00,out,True,969272,False,2,70,101,31
167829,2019-11-28 00:00:00+03:00,out,False,969272,True,6,0,203,203
167829,2019-11-28 00:00:00+03:00,in,False,969272,False,33,1896,2040,144
167840,2019-11-01 00:00:00+03:00,in,False,952968,False,1,12,18,6
167840,2019-11-01 00:00:00+03:00,in,False,-1,True,3,0,24,24
167840,2019-11-01 00:00:00+03:00,in,False,-1,True,3,0,24,24
167840,2019-11-03 00:00:00+03:00,in,False,-1,True,3,0,23,23
167840,2019-11-07 00:00:00+03:00,in,False,-1,True,3,0,27,27
167840,2019-11-08 00:00:00+03:00,in,False,-1,True,5,0,10,10
167840,2019-11-11 00:00:00+03:00,in,False,-1,True,1,0,6,6
167840,2019-11-22 00:00:00+03:00,in,False,-1,True,1,0,2,2
167840,2019-11-26 00:00:00+03:00,in,False,952968,False,1,13,17,4
167840,2019-11-26 00:00:00+03:00,in,False,-1,True,1,0,6,6
167840,2019-11-26 00:00:00+03:00,out,False,952968,False,1,5,8,3
167840,2019-11-26 00:00:00+03:00,out,False,952968,False,1,5,8,3
167847,2019-10-03 00:00:00+03:00,in,False,-1,True,2,0,4,4
167847,2019-10-04 00:00:00+03:00,in,False,-1,True,6,0,6,6
167847,2019-10-04 00:00:00+03:00,in,False,928142,False,1,23,30,7
167847,2019-10-04 00:00:00+03:00,in,False,-1,True,6,0,6,6
167847,2019-10-08 00:00:00+03:00,in,False,928142,False,1,59,68,9
167847,2019-10-11 00:00:00+03:00,in,False,928142,False,1,12,35,23
167847,2019-10-21 00:00:00+03:00,in,False,928142,False,1,22,39,17
167847,2019-10-28 00:00:00+03:00,in,False,928142,False,1,22,37,15
167847,2019-11-01 00:00:00+03:00,in,False,-1,True,1,0,1,1
167847,2019-11-11 00:00:00+03:00,in,False,-1,True,1,0,9,9
167847,2019-11-12 00:00:00+03:00,in,False,928142,False,1,13,27,14
167847,2019-11-12 00:00:00+03:00,in,False,928142,False,1,13,27,14
167847,2019-11-15 00:00:00+03:00,in,False,-1,True,1,0,26,26
167847,2019-11-15 00:00:00+03:00,in,False,-1,True,1,0,26,26
167847,2019-11-21 00:00:00+03:00,in,False,928142,False,1,19,30,11
167847,2019-11-21 00:00:00+03:00,in,False,-1,True,1,0,25,25
167847,2019-11-21 00:00:00+03:00,in,False,-1,True,1,0,25,25
167852,2019-10-10 00:00:00+03:00,in,False,932798,False,1,280,285,5
167852,2019-10-10 00:00:00+03:00,in,False,-1,True,2,0,6,6
167852,2019-10-11 00:00:00+03:00,out,False,932798,False,2,135,160,25
167852,2019-10-11 00:00:00+03:00,in,False,-1,True,1,0,5,5
167852,2019-10-11 00:00:00+03:00,in,False,932798,False,1,21,30,9
167852,2019-10-12 00:00:00+03:00,in,False,-1,True,1,0,4,4
167852,2019-10-14 00:00:00+03:00,in,False,932798,False,4,459,498,39
167852,2019-10-14 00:00:00+03:00,in,False,-1,True,4,0,59,59
167852,2019-10-14 00:00:00+03:00,out,False,932798,True,1,0,12,12
167852,2019-10-14 00:00:00+03:00,in,False,932798,False,4,459,498,39
167852,2019-10-15 00:00:00+03:00,in,False,-1,True,1,0,31,31
167852,2019-10-17 00:00:00+03:00,in,False,932798,False,2,400,424,24
167852,2019-10-17 00:00:00+03:00,in,False,932798,False,2,400,424,24
167852,2019-10-18 00:00:00+03:00,in,False,932798,False,3,228,256,28
167852,2019-10-18 00:00:00+03:00,out,False,932798,True,1,0,5,5
167852,2019-10-18 00:00:00+03:00,in,False,-1,True,15,0,15,15
167852,2019-10-18 00:00:00+03:00,out,False,932798,True,1,0,5,5
167852,2019-10-21 00:00:00+03:00,out,False,932798,False,1,154,154,0
167852,2019-10-21 00:00:00+03:00,in,False,932798,False,6,765,819,54
167852,2019-10-21 00:00:00+03:00,in,False,-1,True,4,0,121,121
167852,2019-10-22 00:00:00+03:00,in,False,-1,True,1,0,2,2
167852,2019-10-22 00:00:00+03:00,in,False,932798,False,4,206,267,61
167852,2019-10-23 00:00:00+03:00,in,False,-1,True,1,0,31,31
167852,2019-10-23 00:00:00+03:00,in,False,-1,True,6,0,127,127
167852,2019-10-23 00:00:00+03:00,out,False,932798,True,2,0,62,62
167852,2019-10-23 00:00:00+03:00,in,False,932798,False,10,1202,1291,89
167852,2019-10-23 00:00:00+03:00,out,True,932798,True,1,0,2,2
167852,2019-10-24 00:00:00+03:00,in,False,932798,False,4,386,433,47
167852,2019-10-25 00:00:00+03:00,out,False,930690,False,2,4,6,2
167852,2019-10-25 00:00:00+03:00,in,False,-1,True,14,0,176,176
167852,2019-10-25 00:00:00+03:00,in,False,932798,False,6,546,595,49
167852,2019-10-25 00:00:00+03:00,out,False,930692,False,6,58,63,5
167852,2019-10-25 00:00:00+03:00,out,False,932798,False,1,2,3,1
167852,2019-10-25 00:00:00+03:00,in,False,932798,False,6,546,595,49
167852,2019-10-26 00:00:00+03:00,in,False,-1,True,1,0,24,24
167852,2019-10-27 00:00:00+03:00,in,False,-1,True,1,0,17,17
167852,2019-10-28 00:00:00+03:00,in,False,932798,False,4,444,477,33
167852,2019-10-29 00:00:00+03:00,in,False,932798,False,10,808,906,98
167852,2019-10-29 00:00:00+03:00,in,False,932798,False,10,808,906,98
167852,2019-10-30 00:00:00+03:00,in,False,932798,False,10,1054,1173,119
167852,2019-10-30 00:00:00+03:00,in,False,-1,True,4,0,73,73
167852,2019-10-31 00:00:00+03:00,in,False,932798,False,4,721,762,41
167852,2019-11-01 00:00:00+03:00,in,False,932798,False,5,553,598,45
167852,2019-11-01 00:00:00+03:00,in,False,-1,True,2,0,62,62
167852,2019-11-05 00:00:00+03:00,in,False,932798,False,5,525,586,61
167852,2019-11-05 00:00:00+03:00,in,False,-1,True,3,0,39,39
167852,2019-11-07 00:00:00+03:00,in,False,932798,True,1,0,15,15
167852,2019-11-07 00:00:00+03:00,in,False,-1,True,1,0,4,4
167852,2019-11-07 00:00:00+03:00,in,False,932798,False,5,375,410,35
167852,2019-11-07 00:00:00+03:00,in,False,-1,True,4,0,125,125
167852,2019-11-08 00:00:00+03:00,in,False,932798,False,1,88,92,4
167852,2019-11-10 00:00:00+03:00,in,False,-1,True,1,0,31,31
167852,2019-11-11 00:00:00+03:00,in,False,930690,False,1,29,34,5
167852,2019-11-11 00:00:00+03:00,in,False,932798,False,3,157,179,22
167852,2019-11-12 00:00:00+03:00,in,False,-1,True,3,0,6,6
167852,2019-11-14 00:00:00+03:00,in,False,-1,True,1,0,31,31
167852,2019-11-15 00:00:00+03:00,out,False,930690,True,1,0,45,45
167852,2019-11-18 00:00:00+03:00,in,False,-1,True,1,0,31,31
167852,2019-11-20 00:00:00+03:00,in,False,932798,False,3,110,143,33
167852,2019-11-24 00:00:00+03:00,in,False,-1,True,2,0,62,62
167852,2019-11-27 00:00:00+03:00,out,False,930690,True,1,0,0,0
167852,2019-11-27 00:00:00+03:00,in,False,932798,False,2,299,314,15
167852,2019-11-28 00:00:00+03:00,in,False,930690,False,1,14,22,8
167852,2019-11-28 00:00:00+03:00,out,False,932798,True,1,0,0,0
167852,2019-11-28 00:00:00+03:00,in,False,932798,False,1,59,64,5
167852,2019-11-28 00:00:00+03:00,out,False,932798,True,1,0,0,0
167870,2019-10-15 00:00:00+03:00,in,False,936110,False,5,281,342,61
167870,2019-10-16 00:00:00+03:00,in,False,936110,False,1,68,90,22
167870,2019-10-16 00:00:00+03:00,in,False,-1,True,1,0,54,54
167870,2019-10-17 00:00:00+03:00,in,False,936110,False,9,1213,1342,129
167870,2019-10-18 00:00:00+03:00,in,False,-1,True,5,0,239,239
167870,2019-10-18 00:00:00+03:00,in,False,936110,False,7,709,791,82
167870,2019-10-19 00:00:00+03:00,in,False,936110,False,7,524,618,94
167870,2019-10-19 00:00:00+03:00,in,False,-1,True,4,0,108,108
167870,2019-10-20 00:00:00+03:00,in,False,936110,False,5,516,604,88
167870,2019-10-20 00:00:00+03:00,in,False,-1,True,1,0,35,35
167870,2019-10-20 00:00:00+03:00,in,False,936110,False,5,516,604,88
167870,2019-10-21 00:00:00+03:00,in,False,-1,True,1,0,60,60
167870,2019-10-21 00:00:00+03:00,in,False,936110,False,2,61,119,58
167870,2019-10-22 00:00:00+03:00,in,False,936110,False,5,1138,1246,108
167870,2019-10-23 00:00:00+03:00,in,False,-1,True,2,0,174,174
167870,2019-10-24 00:00:00+03:00,in,False,936110,False,3,457,508,51
167870,2019-10-25 00:00:00+03:00,in,False,936110,False,3,331,382,51
167870,2019-10-25 00:00:00+03:00,in,False,936110,False,3,331,382,51
167870,2019-10-26 00:00:00+03:00,in,False,936110,False,1,51,68,17
167870,2019-10-26 00:00:00+03:00,in,False,-1,True,1,0,33,33
167870,2019-10-26 00:00:00+03:00,in,False,936110,False,1,51,68,17
167870,2019-10-27 00:00:00+03:00,in,False,936110,False,6,564,634,70
167870,2019-10-28 00:00:00+03:00,in,False,-1,True,2,0,101,101
167870,2019-10-28 00:00:00+03:00,in,False,936110,False,1,93,112,19
167870,2019-10-28 00:00:00+03:00,in,False,-1,True,2,0,101,101
167870,2019-10-29 00:00:00+03:00,in,False,936110,False,4,266,317,51
167870,2019-10-30 00:00:00+03:00,in,False,936110,False,3,730,772,42
167870,2019-10-30 00:00:00+03:00,in,False,936110,False,3,730,772,42
167870,2019-10-31 00:00:00+03:00,in,False,936110,False,6,585,674,89
167870,2019-10-31 00:00:00+03:00,in,False,-1,True,1,0,15,15
167870,2019-11-01 00:00:00+03:00,in,False,-1,True,1,0,27,27
167870,2019-11-01 00:00:00+03:00,in,False,936110,False,3,137,173,36
167870,2019-11-02 00:00:00+03:00,in,False,936110,False,3,131,165,34
167870,2019-11-03 00:00:00+03:00,in,False,-1,True,3,0,17,17
167870,2019-11-04 00:00:00+03:00,in,False,936110,False,1,320,332,12
167870,2019-11-05 00:00:00+03:00,in,False,936110,False,2,249,284,35
167870,2019-11-06 00:00:00+03:00,in,False,936110,False,4,506,573,67
167870,2019-11-07 00:00:00+03:00,in,False,936110,False,2,396,427,31
167870,2019-11-07 00:00:00+03:00,in,False,-1,True,2,0,56,56
167870,2019-11-08 00:00:00+03:00,in,False,936110,False,6,970,1084,114
167870,2019-11-09 00:00:00+03:00,in,False,-1,True,2,0,170,170
167870,2019-11-10 00:00:00+03:00,in,False,936110,False,2,129,161,32
167870,2019-11-11 00:00:00+03:00,in,False,936110,False,13,1727,1950,223
167870,2019-11-11 00:00:00+03:00,in,False,-1,True,3,0,64,64
167870,2019-11-12 00:00:00+03:00,in,False,936110,False,4,320,373,53
167870,2019-11-13 00:00:00+03:00,in,False,936110,False,3,441,476,35
167870,2019-11-13 00:00:00+03:00,in,False,-1,True,2,0,74,74
167870,2019-11-14 00:00:00+03:00,in,False,936110,False,3,104,192,88
167870,2019-11-15 00:00:00+03:00,in,False,-1,True,3,0,106,106
167870,2019-11-15 00:00:00+03:00,in,False,936110,False,3,317,361,44
167870,2019-11-16 00:00:00+03:00,in,False,-1,True,1,0,86,86
167870,2019-11-16 00:00:00+03:00,in,False,936110,False,1,65,75,10
167870,2019-11-17 00:00:00+03:00,in,False,936110,False,1,53,68,15
167870,2019-11-18 00:00:00+03:00,in,False,936110,False,3,570,605,35
167870,2019-11-18 00:00:00+03:00,in,False,-1,True,2,0,64,64
167870,2019-11-19 00:00:00+03:00,in,False,936110,False,2,291,320,29
167870,2019-11-19 00:00:00+03:00,in,False,-1,True,1,0,0,0
167870,2019-11-20 00:00:00+03:00,in,False,936110,False,9,976,1117,141
167870,2019-11-20 00:00:00+03:00,in,False,-1,True,4,0,176,176
167870,2019-11-20 00:00:00+03:00,in,False,-1,True,4,0,176,176
167870,2019-11-21 00:00:00+03:00,in,False,-1,True,2,0,254,254
167870,2019-11-21 00:00:00+03:00,in,False,936110,False,5,322,392,70
167870,2019-11-22 00:00:00+03:00,in,False,936110,False,3,241,278,37
167870,2019-11-23 00:00:00+03:00,in,False,-1,True,3,0,49,49
167870,2019-11-24 00:00:00+03:00,in,False,-1,True,7,0,410,410
167870,2019-11-24 00:00:00+03:00,in,False,-1,True,7,0,410,410
167870,2019-11-25 00:00:00+03:00,in,False,936110,False,5,757,827,70
167870,2019-11-26 00:00:00+03:00,in,False,936110,False,6,528,675,147
167870,2019-11-27 00:00:00+03:00,in,False,936110,False,2,110,144,34
167870,2019-11-27 00:00:00+03:00,in,False,-1,True,1,0,125,125
167870,2019-11-28 00:00:00+03:00,in,False,936110,False,1,130,140,10
167888,2019-10-07 00:00:00+03:00,out,True,930020,True,1,0,4,4
167888,2019-10-07 00:00:00+03:00,out,False,930020,True,1,0,6,6
167888,2019-10-07 00:00:00+03:00,out,False,928888,True,1,0,8,8
167888,2019-10-07 00:00:00+03:00,in,False,-1,True,1,0,6,6
167888,2019-10-07 00:00:00+03:00,out,True,928888,True,2,0,7,7
167888,2019-10-08 00:00:00+03:00,out,True,928888,True,2,0,0,0
167888,2019-10-08 00:00:00+03:00,out,False,928886,False,19,5879,6276,397
167888,2019-10-08 00:00:00+03:00,in,False,-1,True,15,0,102,102
167888,2019-10-08 00:00:00+03:00,out,False,928888,True,1,0,1,1
167888,2019-10-08 00:00:00+03:00,out,False,928886,True,17,0,514,514
167888,2019-10-08 00:00:00+03:00,out,False,930020,False,10,4067,4329,262
167888,2019-10-08 00:00:00+03:00,in,False,928888,False,11,861,966,105
167888,2019-10-08 00:00:00+03:00,out,False,928888,False,6,1594,1654,60
167888,2019-10-08 00:00:00+03:00,out,False,930020,True,17,0,597,597
167888,2019-10-08 00:00:00+03:00,out,False,928886,True,17,0,514,514
167888,2019-10-09 00:00:00+03:00,out,False,930020,False,4,5035,5108,73
167888,2019-10-09 00:00:00+03:00,out,False,928886,False,5,2793,2897,104
167888,2019-10-09 00:00:00+03:00,out,False,930020,True,2,0,89,89
167888,2019-10-09 00:00:00+03:00,out,False,928886,True,3,0,61,61
167888,2019-10-09 00:00:00+03:00,in,False,928888,False,14,2567,2700,133
167888,2019-10-09 00:00:00+03:00,out,False,928888,False,4,374,465,91
167888,2019-10-09 00:00:00+03:00,in,False,-1,True,28,0,432,432
167888,2019-10-09 00:00:00+03:00,out,False,928888,True,2,0,95,95
167888,2019-10-09 00:00:00+03:00,out,False,928886,False,5,2793,2897,104
167888,2019-10-10 00:00:00+03:00,out,False,928888,True,6,0,124,124
167888,2019-10-10 00:00:00+03:00,in,False,-1,True,28,0,429,429
167888,2019-10-10 00:00:00+03:00,out,False,928886,False,9,7769,7922,153
167888,2019-10-10 00:00:00+03:00,in,False,928888,False,11,1177,1265,88
167888,2019-10-10 00:00:00+03:00,in,False,928888,True,1,0,7,7
167888,2019-10-10 00:00:00+03:00,out,False,930020,False,9,6732,6848,116
167888,2019-10-10 00:00:00+03:00,out,False,930020,True,7,0,87,87
167888,2019-10-10 00:00:00+03:00,out,False,928886,True,8,0,369,369
167888,2019-10-10 00:00:00+03:00,out,False,928888,False,16,2679,2983,304
167888,2019-10-10 00:00:00+03:00,out,True,930020,True,1,0,5,5
167888,2019-10-10 00:00:00+03:00,out,False,928888,False,16,2679,2983,304
167888,2019-10-11 00:00:00+03:00,in,False,928886,False,4,303,333,30
167888,2019-10-11 00:00:00+03:00,out,False,930020,False,12,5689,5888,199
167888,2019-10-11 00:00:00+03:00,in,False,928888,False,13,1232,1339,107
167888,2019-10-11 00:00:00+03:00,in,False,930020,False,3,469,520,51
167888,2019-10-11 00:00:00+03:00,out,False,-1,True,1,0,0,0
167888,2019-10-11 00:00:00+03:00,out,False,930020,True,1,0,19,19
167888,2019-10-11 00:00:00+03:00,out,False,928886,False,15,7477,7730,253
167888,2019-10-11 00:00:00+03:00,in,False,-1,True,14,0,366,366
167888,2019-10-11 00:00:00+03:00,out,False,928888,True,5,0,115,115
167888,2019-10-11 00:00:00+03:00,out,False,928888,False,5,430,530,100
167888,2019-10-11 00:00:00+03:00,out,False,928886,True,6,0,140,140
167888,2019-10-11 00:00:00+03:00,in,False,-1,True,14,0,366,366
167888,2019-10-12 00:00:00+03:00,in,False,-1,True,32,0,902,902
167888,2019-10-13 00:00:00+03:00,in,False,-1,True,14,0,368,368
167888,2019-10-13 00:00:00+03:00,in,False,-1,True,14,0,368,368
167888,2019-10-14 00:00:00+03:00,in,False,930020,False,5,438,477,39
167888,2019-10-14 00:00:00+03:00,in,False,928888,False,7,739,794,55
167888,2019-10-14 00:00:00+03:00,out,False,928888,False,21,2541,2997,456
167888,2019-10-14 00:00:00+03:00,in,False,928886,False,1,313,317,4
167888,2019-10-14 00:00:00+03:00,out,False,928886,False,11,8591,8793,202
167888,2019-10-14 00:00:00+03:00,out,False,928888,True,21,0,785,785
167888,2019-10-14 00:00:00+03:00,in,False,-1,True,16,0,347,347
167888,2019-10-14 00:00:00+03:00,out,False,-1,True,4,0,0,0
167888,2019-10-14 00:00:00+03:00,out,False,930020,False,19,9500,9835,335
167888,2019-10-14 00:00:00+03:00,out,False,930020,True,8,0,295,295
167888,2019-10-14 00:00:00+03:00,out,False,928886,True,16,0,190,190
167888,2019-10-14 00:00:00+03:00,in,False,-1,True,16,0,347,347
167888,2019-10-15 00:00:00+03:00,in,False,928886,False,1,37,52,15
167888,2019-10-15 00:00:00+03:00,out,False,928888,False,3,143,238,95
167888,2019-10-15 00:00:00+03:00,in,False,-1,True,20,0,534,534
167888,2019-10-15 00:00:00+03:00,out,False,928886,True,19,0,268,268
167888,2019-10-15 00:00:00+03:00,out,False,930020,True,10,0,409,409
167888,2019-10-15 00:00:00+03:00,in,False,930020,False,2,94,103,9
167888,2019-10-15 00:00:00+03:00,out,False,928886,False,6,5644,5736,92
167888,2019-10-15 00:00:00+03:00,out,False,930020,False,7,5286,5434,148
167888,2019-10-15 00:00:00+03:00,in,False,928888,False,5,121,166,45
167888,2019-10-15 00:00:00+03:00,out,False,928888,True,8,0,301,301
167888,2019-10-15 00:00:00+03:00,out,False,928888,True,8,0,301,301
167888,2019-10-15 00:00:00+03:00,out,False,928886,True,19,0,268,268
167888,2019-10-16 00:00:00+03:00,out,False,-1,True,1,0,0,0
167888,2019-10-16 00:00:00+03:00,out,False,930020,False,13,5293,5577,284
167888,2019-10-16 00:00:00+03:00,out,False,928886,True,9,0,176,176
167888,2019-10-16 00:00:00+03:00,out,False,930020,True,2,0,3,3
167888,2019-10-16 00:00:00+03:00,in,False,-1,True,14,0,339,339
167888,2019-10-16 00:00:00+03:00,out,False,928888,True,8,0,55,55
167888,2019-10-16 00:00:00+03:00,in,False,928888,False,5,344,395,51
167888,2019-10-16 00:00:00+03:00,out,False,928888,False,10,1314,1539,225
167888,2019-10-16 00:00:00+03:00,out,False,928886,False,13,6531,6784,253
167888,2019-10-17 00:00:00+03:00,out,False,-1,True,1,0,0,0
167888,2019-10-17 00:00:00+03:00,in,False,928888,False,11,852,949,97
167888,2019-10-17 00:00:00+03:00,out,False,930020,False,20,5941,6419,478
167888,2019-10-17 00:00:00+03:00,out,False,928888,True,7,0,299,299
167888,2019-10-17 00:00:00+03:00,out,False,930020,True,24,0,916,916
167888,2019-10-17 00:00:00+03:00,out,False,928888,False,12,1533,1718,185
167888,2019-10-17 00:00:00+03:00,out,False,928886,False,19,10263,10563,300
167888,2019-10-17 00:00:00+03:00,out,False,928886,True,31,0,754,754
167888,2019-10-17 00:00:00+03:00,in,False,930020,False,5,184,223,39
167888,2019-10-17 00:00:00+03:00,in,False,928886,False,2,223,243,20
167888,2019-10-17 00:00:00+03:00,in,False,-1,True,11,0,286,286
167888,2019-10-18 00:00:00+03:00,out,False,928886,False,15,12353,12618,265
167888,2019-10-18 00:00:00+03:00,in,False,930020,False,10,696,766,70
167888,2019-10-18 00:00:00+03:00,out,False,930020,False,17,10648,11050,402
167888,2019-10-18 00:00:00+03:00,in,False,928886,False,1,318,322,4
167888,2019-10-18 00:00:00+03:00,out,False,928886,True,14,0,463,463
167888,2019-10-18 00:00:00+03:00,out,False,928888,True,6,0,68,68
167888,2019-10-18 00:00:00+03:00,in,False,928888,False,14,2085,2194,109
167888,2019-10-18 00:00:00+03:00,out,False,930020,True,5,0,172,172
167888,2019-10-18 00:00:00+03:00,out,False,928888,False,12,2625,2841,216
167888,2019-10-18 00:00:00+03:00,in,False,-1,True,14,0,361,361
167888,2019-10-18 00:00:00+03:00,out,False,928886,True,14,0,463,463
167888,2019-10-18 00:00:00+03:00,in,False,928886,False,1,318,322,4
167888,2019-10-18 00:00:00+03:00,out,False,928886,False,15,12353,12618,265
167888,2019-10-19 00:00:00+03:00,in,False,-1,True,23,0,595,595
167888,2019-10-20 00:00:00+03:00,in,False,-1,True,30,0,721,721
167888,2019-10-21 00:00:00+03:00,out,False,930020,False,14,10105,10348,243
167888,2019-10-21 00:00:00+03:00,in,False,930020,True,1,0,7,7
167888,2019-10-21 00:00:00+03:00,out,False,928888,True,15,0,450,450
167888,2019-10-21 00:00:00+03:00,out,False,928888,False,28,2355,2933,578
167888,2019-10-21 00:00:00+03:00,in,False,928886,False,3,248,267,19
167888,2019-10-21 00:00:00+03:00,out,False,928886,True,8,0,259,259
167888,2019-10-21 00:00:00+03:00,in,False,930020,False,6,620,665,45
167888,2019-10-21 00:00:00+03:00,out,False,930020,True,5,0,164,164
167888,2019-10-21 00:00:00+03:00,in,False,928888,False,18,1614,1746,132
167888,2019-10-21 00:00:00+03:00,out,False,928886,False,22,16339,16667,328
167888,2019-10-21 00:00:00+03:00,in,False,-1,True,12,0,273,273
167888,2019-10-21 00:00:00+03:00,out,False,-1,True,2,0,0,0
167888,2019-10-21 00:00:00+03:00,out,False,930020,False,14,10105,10348,243
167888,2019-10-21 00:00:00+03:00,out,False,-1,True,2,0,0,0
167888,2019-10-22 00:00:00+03:00,out,False,930020,True,3,0,78,78
167888,2019-10-22 00:00:00+03:00,in,False,930020,False,3,244,264,20
167888,2019-10-22 00:00:00+03:00,in,False,930020,True,1,0,17,17
167888,2019-10-22 00:00:00+03:00,in,False,-1,True,3,0,84,84
167888,2019-10-22 00:00:00+03:00,out,False,928888,False,5,1667,1730,63
167888,2019-10-22 00:00:00+03:00,out,False,928886,False,16,8782,9066,284
167888,2019-10-22 00:00:00+03:00,in,False,928886,False,2,48,65,17
167888,2019-10-22 00:00:00+03:00,out,False,928886,True,7,0,91,91
167888,2019-10-22 00:00:00+03:00,out,False,928888,True,3,0,121,121
167888,2019-10-22 00:00:00+03:00,out,False,930020,False,21,9401,9844,443
167888,2019-10-22 00:00:00+03:00,in,False,928888,False,12,1194,1302,108
167888,2019-10-22 00:00:00+03:00,out,False,930020,True,3,0,78,78
167888,2019-10-23 00:00:00+03:00,out,False,928886,True,7,0,187,187
167888,2019-10-23 00:00:00+03:00,in,False,928886,False,3,517,536,19
167888,2019-10-23 00:00:00+03:00,out,False,-1,True,2,0,0,0
167888,2019-10-23 00:00:00+03:00,in,False,-1,True,8,0,187,187
167888,2019-10-23 00:00:00+03:00,in,False,930020,False,2,76,86,10
167888,2019-10-23 00:00:00+03:00,out,False,928888,False,2,651,675,24
167888,2019-10-23 00:00:00+03:00,out,False,930020,False,13,4149,4395,246
167888,2019-10-23 00:00:00+03:00,in,False,928888,False,11,1143,1223,80
167888,2019-10-23 00:00:00+03:00,out,False,930020,True,4,0,34,34
167888,2019-10-23 00:00:00+03:00,out,False,928886,False,14,7329,7621,292
167888,2019-10-23 00:00:00+03:00,out,False,930020,True,4,0,34,34
167888,2019-10-24 00:00:00+03:00,out,False,928886,True,3,0,97,97
167888,2019-10-24 00:00:00+03:00,out,False,928888,False,10,294,404,110
167888,2019-10-24 00:00:00+03:00,in,False,928888,False,7,582,635,53
167888,2019-10-24 00:00:00+03:00,out,False,930020,True,4,0,172,172
167888,2019-10-24 00:00:00+03:00,in,False,-1,True,18,0,515,515
167888,2019-10-24 00:00:00+03:00,out,False,930020,False,9,5324,5524,200
167888,2019-10-24 00:00:00+03:00,out,False,928888,True,5,0,145,145
167888,2019-10-24 00:00:00+03:00,out,False,928886,False,5,2426,2536,110
167888,2019-10-25 00:00:00+03:00,out,True,928886,True,1,0,0,0
167888,2019-10-25 00:00:00+03:00,out,False,928888,True,5,0,258,258
167888,2019-10-25 00:00:00+03:00,out,False,928886,True,1,0,60,60
167888,2019-10-25 00:00:00+03:00,out,False,930020,True,4,0,99,99
167888,2019-10-25 00:00:00+03:00,out,False,930020,False,12,7994,8192,198
167888,2019-10-25 00:00:00+03:00,out,False,928888,False,10,994,1199,205
167888,2019-10-25 00:00:00+03:00,in,False,930020,False,4,375,397,22
167888,2019-10-25 00:00:00+03:00,in,False,928888,False,3,300,325,25
167888,2019-10-25 00:00:00+03:00,out,False,928886,False,1,105,120,15
167888,2019-10-25 00:00:00+03:00,in,False,-1,True,19,0,464,464
167888,2019-10-25 00:00:00+03:00,out,False,930020,True,4,0,99,99
167888,2019-10-25 00:00:00+03:00,out,False,928888,False,10,994,1199,205
167888,2019-10-26 00:00:00+03:00,in,False,-1,True,6,0,167,167
167888,2019-10-27 00:00:00+03:00,in,False,-1,True,3,0,91,91
167888,2019-10-28 00:00:00+03:00,out,False,930020,False,8,1597,1703,106
167888,2019-10-28 00:00:00+03:00,in,False,930020,True,1,1,8,7
167888,2019-10-28 00:00:00+03:00,in,False,928886,False,6,461,508,47
167888,2019-10-28 00:00:00+03:00,out,False,928886,True,17,0,499,499
167888,2019-10-28 00:00:00+03:00,in,False,-1,True,12,0,289,289
167888,2019-10-28 00:00:00+03:00,in,False,928888,False,6,395,444,49
167888,2019-10-28 00:00:00+03:00,out,False,928888,True,7,0,252,252
167888,2019-10-28 00:00:00+03:00,out,False,928886,False,9,5881,6033,152
167888,2019-10-28 00:00:00+03:00,out,False,930020,True,2,0,44,44
167888,2019-10-28 00:00:00+03:00,in,False,930020,False,2,30,45,15
167888,2019-10-28 00:00:00+03:00,out,False,928888,False,12,1142,1360,218
167888,2019-10-28 00:00:00+03:00,out,False,928888,False,12,1142,1360,218
167888,2019-10-28 00:00:00+03:00,in,False,928888,False,6,395,444,49
167888,2019-10-28 00:00:00+03:00,out,False,928888,True,7,0,252,252
167888,2019-10-29 00:00:00+03:00,in,False,-1,True,61,0,1452,1452
167888,2019-10-30 00:00:00+03:00,in,False,928888,False,8,588,680,92
167888,2019-10-30 00:00:00+03:00,out,False,928888,False,16,1959,2280,321
167888,2019-10-30 00:00:00+03:00,out,False,928888,True,4,0,113,113
167888,2019-10-30 00:00:00+03:00,out,False,928886,False,21,8555,8889,334
167888,2019-10-30 00:00:00+03:00,in,False,928886,False,3,420,444,24
167888,2019-10-30 00:00:00+03:00,out,False,928886,True,20,0,532,532
167888,2019-10-30 00:00:00+03:00,in,False,930020,False,5,125,175,50
167888,2019-10-30 00:00:00+03:00,out,False,930020,False,4,4966,5013,47
167888,2019-10-30 00:00:00+03:00,in,False,-1,True,24,0,619,619
167888,2019-10-31 00:00:00+03:00,out,False,928888,False,6,1046,1154,108
167888,2019-10-31 00:00:00+03:00,in,False,930020,False,6,384,439,55
167888,2019-10-31 00:00:00+03:00,out,False,928886,False,15,9753,9962,209
167888,2019-10-31 00:00:00+03:00,in,False,-1,True,34,0,798,798
167888,2019-10-31 00:00:00+03:00,out,False,930020,False,11,6104,6294,190
167888,2019-10-31 00:00:00+03:00,in,False,930020,True,1,0,5,5
167888,2019-10-31 00:00:00+03:00,in,False,928888,False,15,1184,1316,132
167888,2019-10-31 00:00:00+03:00,out,False,928888,True,5,0,168,168
167888,2019-10-31 00:00:00+03:00,in,False,928886,False,1,301,305,4
167888,2019-10-31 00:00:00+03:00,out,False,-1,True,1,0,0,0
167888,2019-10-31 00:00:00+03:00,out,False,930020,True,6,0,219,219
167888,2019-10-31 00:00:00+03:00,out,False,928886,True,14,0,400,400
167888,2019-11-01 00:00:00+03:00,out,False,928886,False,17,9459,9788,329
167888,2019-11-01 00:00:00+03:00,in,False,-1,True,10,0,301,301
167888,2019-11-01 00:00:00+03:00,out,False,-1,True,1,0,0,0
167888,2019-11-01 00:00:00+03:00,out,False,928888,True,5,0,197,197
167888,2019-11-01 00:00:00+03:00,out,False,928886,True,16,0,522,522
167888,2019-11-01 00:00:00+03:00,in,False,928888,False,21,1367,1493,126
167888,2019-11-01 00:00:00+03:00,out,False,930020,True,12,0,492,492
167888,2019-11-01 00:00:00+03:00,out,False,928888,False,8,2228,2362,134
167888,2019-11-01 00:00:00+03:00,in,False,928886,False,1,112,116,4
167888,2019-11-01 00:00:00+03:00,out,False,930020,False,14,7487,7706,219
167888,2019-11-01 00:00:00+03:00,in,False,928886,False,1,112,116,4
167888,2019-11-02 00:00:00+03:00,in,False,-1,True,17,0,472,472
167888,2019-11-03 00:00:00+03:00,in,False,-1,True,6,0,174,174
167888,2019-11-04 00:00:00+03:00,in,False,-1,True,5,0,144,144
167888,2019-11-05 00:00:00+03:00,in,False,-1,True,10,0,264,264
167888,2019-11-05 00:00:00+03:00,out,False,928888,True,12,0,525,525
167888,2019-11-05 00:00:00+03:00,out,False,928886,False,9,6392,6569,177
167888,2019-11-05 00:00:00+03:00,out,False,930020,False,10,4596,4796,200
167888,2019-11-05 00:00:00+03:00,in,False,930020,False,2,34,47,13
167888,2019-11-05 00:00:00+03:00,out,False,928888,False,18,1809,2167,358
167888,2019-11-05 00:00:00+03:00,in,False,928888,False,4,444,475,31
167888,2019-11-05 00:00:00+03:00,out,True,930020,True,1,0,0,0
167888,2019-11-05 00:00:00+03:00,out,False,930020,True,4,0,96,96
167888,2019-11-05 00:00:00+03:00,in,False,928886,False,1,243,248,5
167888,2019-11-05 00:00:00+03:00,out,False,928886,True,6,0,158,158
167888,2019-11-05 00:00:00+03:00,out,False,930020,False,10,4596,4796,200
167888,2019-11-06 00:00:00+03:00,in,False,928886,False,2,156,175,19
167888,2019-11-06 00:00:00+03:00,out,False,928888,True,1,0,4,4
167888,2019-11-06 00:00:00+03:00,out,False,930020,True,3,0,35,35
167888,2019-11-06 00:00:00+03:00,out,False,928888,False,2,84,123,39
167888,2019-11-06 00:00:00+03:00,out,False,928886,False,8,3730,3876,146
167888,2019-11-06 00:00:00+03:00,out,False,930020,False,5,4285,4349,64
167888,2019-11-06 00:00:00+03:00,in,False,928888,False,3,187,205,18
167888,2019-11-06 00:00:00+03:00,in,False,-1,True,6,0,184,184
167888,2019-11-06 00:00:00+03:00,out,False,928886,True,4,0,153,153
167888,2019-11-06 00:00:00+03:00,in,False,-1,True,6,0,184,184
167888,2019-11-06 00:00:00+03:00,in,False,928888,False,3,187,205,18
167888,2019-11-07 00:00:00+03:00,out,False,928888,False,5,1509,1546,37
167888,2019-11-07 00:00:00+03:00,out,False,928886,False,4,2294,2389,95
167888,2019-11-07 00:00:00+03:00,out,False,-1,True,1,0,0,0
167888,2019-11-07 00:00:00+03:00,in,False,928888,False,3,256,281,25
167888,2019-11-07 00:00:00+03:00,out,False,928888,True,6,0,144,144
167888,2019-11-07 00:00:00+03:00,in,False,928886,False,1,176,182,6
167888,2019-11-07 00:00:00+03:00,out,False,928886,True,1,0,20,20
167888,2019-11-07 00:00:00+03:00,in,False,-1,True,22,0,437,437
167888,2019-11-08 00:00:00+03:00,in,False,-1,True,13,0,331,331
167888,2019-11-09 00:00:00+03:00,in,False,-1,True,1,0,30,30
167888,2019-11-09 00:00:00+03:00,in,False,-1,True,1,0,30,30
167888,2019-11-10 00:00:00+03:00,in,False,-1,True,1,0,5,5
167888,2019-11-11 00:00:00+03:00,out,False,-1,True,2,0,0,0
167888,2019-11-11 00:00:00+03:00,in,False,930020,False,3,295,327,32
167888,2019-11-11 00:00:00+03:00,in,False,-1,True,11,0,233,233
167888,2019-11-11 00:00:00+03:00,out,False,928888,False,10,554,746,192
167888,2019-11-11 00:00:00+03:00,in,False,928886,False,3,96,117,21
167888,2019-11-11 00:00:00+03:00,in,False,928888,False,6,479,520,41
167888,2019-11-11 00:00:00+03:00,out,False,930020,False,18,4892,5189,297
167888,2019-11-11 00:00:00+03:00,out,False,928886,False,4,5518,5588,70
167888,2019-11-11 00:00:00+03:00,out,False,930020,True,10,0,317,317
167888,2019-11-11 00:00:00+03:00,out,False,928888,True,10,0,454,454
167888,2019-11-11 00:00:00+03:00,out,True,930020,True,1,0,0,0
167888,2019-11-11 00:00:00+03:00,out,False,928886,True,5,0,70,70
167888,2019-11-11 00:00:00+03:00,out,False,928888,True,10,0,454,454
167888,2019-11-12 00:00:00+03:00,in,False,-1,True,30,0,868,868
167888,2019-11-13 00:00:00+03:00,out,False,930020,False,11,5670,5803,133
167888,2019-11-13 00:00:00+03:00,in,False,928888,False,8,513,589,76
167888,2019-11-13 00:00:00+03:00,out,False,930020,True,2,0,17,17
167888,2019-11-13 00:00:00+03:00,out,False,928888,True,3,0,142,142
167888,2019-11-13 00:00:00+03:00,out,False,928886,False,14,7327,7577,250
167888,2019-11-13 00:00:00+03:00,in,False,-1,True,9,0,266,266
167888,2019-11-13 00:00:00+03:00,in,False,928886,False,2,98,141,43
167888,2019-11-13 00:00:00+03:00,out,False,928886,True,3,0,78,78
167888,2019-11-13 00:00:00+03:00,out,False,928888,False,10,484,600,116
167888,2019-11-13 00:00:00+03:00,in,False,930020,False,3,156,173,17
167888,2019-11-14 00:00:00+03:00,out,False,930020,False,12,829,916,87
167888,2019-11-14 00:00:00+03:00,in,False,-1,True,37,0,953,953
167888,2019-11-14 00:00:00+03:00,out,False,928888,True,9,0,305,305
167888,2019-11-14 00:00:00+03:00,in,False,928888,False,8,579,637,58
167888,2019-11-14 00:00:00+03:00,out,True,928888,True,1,0,0,0
167888,2019-11-14 00:00:00+03:00,out,False,930020,True,3,0,95,95
167888,2019-11-14 00:00:00+03:00,in,False,928886,False,1,38,59,21
167888,2019-11-14 00:00:00+03:00,out,False,928886,True,2,0,83,83
167888,2019-11-14 00:00:00+03:00,in,False,930020,False,2,44,60,16
167888,2019-11-14 00:00:00+03:00,out,False,928886,False,5,2019,2107,88
167888,2019-11-14 00:00:00+03:00,out,False,-1,True,1,0,0,0
167888,2019-11-14 00:00:00+03:00,out,False,928888,False,2,87,152,65
167888,2019-11-14 00:00:00+03:00,out,True,928888,True,1,0,0,0
167888,2019-11-14 00:00:00+03:00,out,False,928888,False,2,87,152,65
167888,2019-11-15 00:00:00+03:00,out,False,928886,False,17,9426,9729,303
167888,2019-11-15 00:00:00+03:00,out,False,928888,True,2,0,54,54
167888,2019-11-15 00:00:00+03:00,out,False,928886,True,4,0,213,213
167888,2019-11-15 00:00:00+03:00,in,False,930020,False,2,75,94,19
167888,2019-11-15 00:00:00+03:00,out,False,930020,False,11,6742,6895,153
167888,2019-11-15 00:00:00+03:00,out,False,928888,False,11,618,814,196
167888,2019-11-15 00:00:00+03:00,in,False,-1,True,13,0,287,287
167888,2019-11-15 00:00:00+03:00,out,False,-1,True,2,0,0,0
167888,2019-11-15 00:00:00+03:00,out,True,928888,True,1,0,0,0
167888,2019-11-15 00:00:00+03:00,in,False,928888,False,15,796,919,123
167888,2019-11-15 00:00:00+03:00,out,False,930020,True,3,0,101,101
167888,2019-11-15 00:00:00+03:00,out,False,930020,False,11,6742,6895,153
167888,2019-11-16 00:00:00+03:00,in,False,-1,True,36,0,777,777
167888,2019-11-17 00:00:00+03:00,in,False,-1,True,14,0,341,341
167888,2019-11-18 00:00:00+03:00,in,False,930020,False,3,221,244,23
167888,2019-11-18 00:00:00+03:00,in,False,928886,False,4,249,285,36
167888,2019-11-18 00:00:00+03:00,out,False,928886,False,8,4161,4295,134
167888,2019-11-18 00:00:00+03:00,out,False,928888,False,23,1206,1617,411
167888,2019-11-18 00:00:00+03:00,out,False,928886,True,1,0,3,3
167888,2019-11-18 00:00:00+03:00,out,False,930020,False,8,4980,5145,165
167888,2019-11-18 00:00:00+03:00,out,False,928888,True,10,0,295,295
167888,2019-11-18 00:00:00+03:00,in,False,928888,False,5,195,243,48
167888,2019-11-18 00:00:00+03:00,in,False,-1,True,25,0,549,549
167888,2019-11-18 00:00:00+03:00,out,False,930020,True,4,0,48,48
167888,2019-11-19 00:00:00+03:00,out,False,928886,True,1,0,48,48
167888,2019-11-19 00:00:00+03:00,out,False,930020,True,6,0,120,120
167888,2019-11-19 00:00:00+03:00,out,False,928886,False,6,1504,1620,116
167888,2019-11-19 00:00:00+03:00,in,False,928886,False,3,446,479,33
167888,2019-11-19 00:00:00+03:00,out,False,930020,False,7,1784,1894,110
167888,2019-11-19 00:00:00+03:00,out,False,928888,True,4,0,164,164
167888,2019-11-19 00:00:00+03:00,in,False,928888,False,5,167,197,30
167888,2019-11-19 00:00:00+03:00,out,False,928888,False,9,583,734,151
167888,2019-11-19 00:00:00+03:00,in,False,-1,True,6,0,181,181
167888,2019-11-19 00:00:00+03:00,out,False,928886,False,6,1504,1620,116
167888,2019-11-19 00:00:00+03:00,in,False,928886,False,3,446,479,33
167888,2019-11-19 00:00:00+03:00,out,False,928888,False,9,583,734,151
167888,2019-11-20 00:00:00+03:00,in,False,930020,False,1,22,47,25
167888,2019-11-20 00:00:00+03:00,out,False,928888,True,1,0,8,8
167888,2019-11-20 00:00:00+03:00,in,False,928888,False,10,1002,1073,71
167888,2019-11-20 00:00:00+03:00,out,False,930020,True,2,0,5,5
167888,2019-11-20 00:00:00+03:00,out,False,928886,False,13,5226,5481,255
167888,2019-11-20 00:00:00+03:00,in,False,-1,True,50,0,1037,1037
167888,2019-11-20 00:00:00+03:00,out,False,930020,False,5,4694,4783,89
167888,2019-11-20 00:00:00+03:00,out,False,928886,True,11,0,397,397
167888,2019-11-20 00:00:00+03:00,out,False,928888,False,1,91,109,18
167888,2019-11-21 00:00:00+03:00,out,False,928886,True,5,0,120,120
167888,2019-11-21 00:00:00+03:00,out,False,928888,False,7,230,336,106
167888,2019-11-21 00:00:00+03:00,out,False,928886,False,8,6665,6815,150
167888,2019-11-21 00:00:00+03:00,out,False,928888,True,6,0,78,78
167888,2019-11-21 00:00:00+03:00,out,False,930020,False,8,6480,6610,130
167888,2019-11-21 00:00:00+03:00,in,False,930020,False,1,20,27,7
167888,2019-11-21 00:00:00+03:00,in,False,-1,True,13,0,371,371
167888,2019-11-21 00:00:00+03:00,in,False,928888,False,10,848,905,57
167888,2019-11-21 00:00:00+03:00,in,False,928888,False,10,848,905,57
167888,2019-11-21 00:00:00+03:00,in,False,930020,False,1,20,27,7
167888,2019-11-21 00:00:00+03:00,out,False,928886,False,8,6665,6815,150
167888,2019-11-22 00:00:00+03:00,out,False,928886,True,4,0,134,134
167888,2019-11-22 00:00:00+03:00,out,False,928888,False,14,997,1186,189
167888,2019-11-22 00:00:00+03:00,in,False,928886,False,1,135,143,8
167888,2019-11-22 00:00:00+03:00,out,False,928888,True,11,0,311,311
167888,2019-11-22 00:00:00+03:00,out,False,930020,False,11,6586,6679,93
167888,2019-11-22 00:00:00+03:00,in,False,930020,False,5,273,313,40
167888,2019-11-22 00:00:00+03:00,out,False,928886,False,8,6680,6806,126
167888,2019-11-22 00:00:00+03:00,in,False,928888,False,9,626,719,93
167888,2019-11-22 00:00:00+03:00,out,False,930020,True,9,0,153,153
167888,2019-11-22 00:00:00+03:00,in,False,-1,True,9,0,238,238
167888,2019-11-22 00:00:00+03:00,out,False,928888,True,11,0,311,311
167888,2019-11-22 00:00:00+03:00,out,False,928886,False,8,6680,6806,126
167888,2019-11-23 00:00:00+03:00,in,False,-1,True,40,0,722,722
167888,2019-11-24 00:00:00+03:00,in,False,-1,True,23,0,610,610
167888,2019-11-25 00:00:00+03:00,out,False,928888,True,14,0,559,559
167888,2019-11-25 00:00:00+03:00,out,False,930020,True,7,0,196,196
167888,2019-11-25 00:00:00+03:00,in,False,-1,True,16,0,376,376
167888,2019-11-25 00:00:00+03:00,in,False,930020,False,3,212,231,19
167888,2019-11-25 00:00:00+03:00,in,False,928888,False,11,613,684,71
167888,2019-11-25 00:00:00+03:00,out,False,930020,False,17,4280,4566,286
167888,2019-11-25 00:00:00+03:00,out,False,928886,False,20,5365,5660,295
167888,2019-11-25 00:00:00+03:00,in,False,928886,False,2,42,55,13
167888,2019-11-25 00:00:00+03:00,out,False,928886,True,9,0,358,358
167888,2019-11-25 00:00:00+03:00,out,False,928888,False,14,1090,1307,217
167888,2019-11-25 00:00:00+03:00,out,False,928888,True,14,0,559,559
167888,2019-11-25 00:00:00+03:00,in,False,930020,False,3,212,231,19
167888,2019-11-26 00:00:00+03:00,out,False,928888,True,1,0,5,5
167888,2019-11-26 00:00:00+03:00,out,False,928888,False,7,412,588,176
167888,2019-11-26 00:00:00+03:00,out,False,930020,False,3,2647,2676,29
167888,2019-11-26 00:00:00+03:00,out,False,928886,True,1,0,1,1
167888,2019-11-26 00:00:00+03:00,in,False,930020,False,1,24,28,4
167888,2019-11-26 00:00:00+03:00,in,False,-1,True,15,0,337,337
167888,2019-11-26 00:00:00+03:00,in,False,928888,False,7,1151,1208,57
167888,2019-11-26 00:00:00+03:00,out,False,928886,False,7,8475,8610,135
167888,2019-11-26 00:00:00+03:00,in,False,928888,False,7,1151,1208,57
167888,2019-11-27 00:00:00+03:00,in,False,928888,False,8,905,963,58
167888,2019-11-27 00:00:00+03:00,in,False,928886,False,2,188,198,10
167888,2019-11-27 00:00:00+03:00,in,False,930020,True,1,0,21,21
167888,2019-11-27 00:00:00+03:00,out,False,928888,True,6,0,151,151
167888,2019-11-27 00:00:00+03:00,out,False,928886,True,10,0,284,284
167888,2019-11-27 00:00:00+03:00,in,False,-1,True,27,0,687,687
167888,2019-11-27 00:00:00+03:00,in,False,928886,True,1,1,17,16
167888,2019-11-27 00:00:00+03:00,out,False,928888,False,4,1444,1499,55
167888,2019-11-27 00:00:00+03:00,out,False,930020,True,5,0,217,217
167888,2019-11-27 00:00:00+03:00,out,False,930020,False,14,8549,8760,211
167888,2019-11-27 00:00:00+03:00,out,True,930020,True,1,0,0,0
167888,2019-11-27 00:00:00+03:00,in,False,930020,False,1,38,44,6
167888,2019-11-27 00:00:00+03:00,out,False,928886,False,19,4880,5202,322
167888,2019-11-27 00:00:00+03:00,out,True,930020,True,1,0,0,0
167888,2019-11-27 00:00:00+03:00,in,False,928886,False,2,188,198,10
167888,2019-11-28 00:00:00+03:00,out,False,928888,True,6,0,39,39
167888,2019-11-28 00:00:00+03:00,in,False,-1,True,19,0,476,476
167888,2019-11-28 00:00:00+03:00,in,False,928886,False,2,211,227,16
167888,2019-11-28 00:00:00+03:00,out,True,930020,True,1,0,0,0
167888,2019-11-28 00:00:00+03:00,out,False,928888,False,8,1030,1195,165
167888,2019-11-28 00:00:00+03:00,out,False,930020,False,10,5810,5996,186
167888,2019-11-28 00:00:00+03:00,out,False,928886,True,5,0,229,229
167888,2019-11-28 00:00:00+03:00,out,False,930020,True,7,0,366,366
167888,2019-11-28 00:00:00+03:00,out,False,928886,False,10,6020,6198,178
167888,2019-11-28 00:00:00+03:00,in,False,928888,False,9,1144,1217,73
167888,2019-11-28 00:00:00+03:00,in,False,-1,True,19,0,476,476
167888,2019-11-28 00:00:00+03:00,in,False,928888,False,9,1144,1217,73
167888,2019-11-28 00:00:00+03:00,out,False,928888,True,6,0,39,39
167906,2019-10-04 00:00:00+03:00,in,False,928404,False,2,103,126,23
167906,2019-10-07 00:00:00+03:00,in,False,-1,True,1,0,0,0
167906,2019-10-16 00:00:00+03:00,in,False,-1,True,1,0,10,10
167906,2019-10-18 00:00:00+03:00,in,False,939698,False,1,20,29,9
167906,2019-10-18 00:00:00+03:00,out,False,939698,False,1,17,31,14
167906,2019-10-18 00:00:00+03:00,in,False,-1,True,2,0,46,46
167906,2019-10-22 00:00:00+03:00,in,False,-1,True,4,0,47,47
167906,2019-10-22 00:00:00+03:00,in,False,-1,True,4,0,67,67
167906,2019-10-22 00:00:00+03:00,in,False,928404,False,2,173,211,38
167906,2019-10-22 00:00:00+03:00,in,False,-1,True,4,0,67,67
167906,2019-10-23 00:00:00+03:00,in,False,928404,False,1,10,26,16
167906,2019-10-23 00:00:00+03:00,in,False,-1,True,1,0,10,10
167906,2019-10-23 00:00:00+03:00,in,False,-1,True,1,0,18,18
167906,2019-10-26 00:00:00+03:00,in,False,-1,True,1,0,18,18
167906,2019-10-26 00:00:00+03:00,in,False,-1,True,1,0,18,18
167906,2019-10-29 00:00:00+03:00,in,False,-1,True,1,0,17,17
167906,2019-10-29 00:00:00+03:00,in,False,-1,True,1,0,17,17
167906,2019-10-30 00:00:00+03:00,in,False,-1,True,3,0,35,35
167906,2019-11-06 00:00:00+03:00,in,False,-1,True,1,0,9,9
167906,2019-11-06 00:00:00+03:00,in,False,-1,True,1,0,17,17
167906,2019-11-12 00:00:00+03:00,in,False,-1,True,1,0,17,17
167906,2019-11-15 00:00:00+03:00,in,False,939698,False,1,17,34,17
167906,2019-11-15 00:00:00+03:00,in,False,-1,True,1,0,36,36
167908,2019-10-10 00:00:00+03:00,in,False,-1,True,1,0,2,2
167908,2019-10-11 00:00:00+03:00,in,False,-1,True,2,0,4,4
167908,2019-10-15 00:00:00+03:00,in,False,-1,True,1,0,2,2
167908,2019-10-18 00:00:00+03:00,in,False,-1,True,1,0,2,2
167908,2019-10-19 00:00:00+03:00,in,False,-1,True,2,0,4,4
167908,2019-10-29 00:00:00+03:00,in,False,-1,True,1,0,2,2
167908,2019-10-30 00:00:00+03:00,in,False,-1,True,1,0,2,2
167908,2019-11-01 00:00:00+03:00,in,False,-1,True,1,0,2,2
167908,2019-11-02 00:00:00+03:00,in,False,-1,True,1,0,2,2
167908,2019-11-04 00:00:00+03:00,in,False,-1,True,1,0,2,2
167908,2019-11-05 00:00:00+03:00,in,False,-1,True,1,0,2,2
167908,2019-11-07 00:00:00+03:00,in,False,-1,True,1,0,2,2
167908,2019-11-10 00:00:00+03:00,in,False,-1,True,2,0,4,4
167908,2019-11-13 00:00:00+03:00,in,False,-1,True,2,0,4,4
167908,2019-11-15 00:00:00+03:00,in,False,-1,True,1,0,2,2
167908,2019-11-21 00:00:00+03:00,in,False,-1,True,1,0,2,2
167908,2019-11-24 00:00:00+03:00,in,False,-1,True,2,0,4,4
167908,2019-11-26 00:00:00+03:00,in,False,971354,False,1,63,76,13
167908,2019-11-26 00:00:00+03:00,in,False,-1,True,3,0,8,8
167908,2019-11-27 00:00:00+03:00,in,False,-1,True,2,0,0,0
167908,2019-11-27 00:00:00+03:00,in,False,971354,False,5,680,751,71
167908,2019-11-27 00:00:00+03:00,in,False,-1,True,2,0,0,0
167923,2019-10-27 00:00:00+03:00,in,False,-1,True,3,0,6,6
167923,2019-10-27 00:00:00+03:00,out,False,928926,True,1,0,0,0
167923,2019-10-28 00:00:00+03:00,out,False,928926,False,3,135,191,56
167923,2019-10-28 00:00:00+03:00,in,False,928926,False,1,86,91,5
167923,2019-10-30 00:00:00+03:00,out,False,928926,True,1,0,60,60
167923,2019-10-31 00:00:00+03:00,out,False,951408,True,4,0,14,14
167923,2019-10-31 00:00:00+03:00,out,False,928926,False,3,133,171,38
167923,2019-10-31 00:00:00+03:00,out,False,951408,False,6,318,362,44
167923,2019-10-31 00:00:00+03:00,out,False,928926,True,7,0,31,31
167923,2019-10-31 00:00:00+03:00,out,False,951408,True,4,0,14,14
167923,2019-10-31 00:00:00+03:00,out,False,951408,False,6,318,362,44
167923,2019-11-01 00:00:00+03:00,out,False,951408,False,1,92,94,2
167923,2019-11-05 00:00:00+03:00,out,False,951408,False,3,255,260,5
167923,2019-11-06 00:00:00+03:00,out,False,951408,False,3,517,526,9
167923,2019-11-07 00:00:00+03:00,out,False,951408,False,2,235,239,4
167923,2019-11-12 00:00:00+03:00,out,False,951408,False,1,81,83,2
167923,2019-11-12 00:00:00+03:00,out,False,951408,True,1,0,18,18
167923,2019-11-15 00:00:00+03:00,out,False,951408,True,1,0,17,17
167923,2019-11-15 00:00:00+03:00,out,False,951408,False,1,197,199,2
167923,2019-11-18 00:00:00+03:00,out,False,951408,True,3,0,20,20
167923,2019-11-25 00:00:00+03:00,out,False,951408,True,2,0,5,5
167923,2019-11-27 00:00:00+03:00,in,False,-1,True,2,0,0,0
167923,2019-11-27 00:00:00+03:00,out,False,973120,True,2,0,1,1
167923,2019-11-27 00:00:00+03:00,out,False,951408,True,2,0,9,9
167923,2019-11-27 00:00:00+03:00,out,False,973120,False,1,5,24,19
167927,2019-10-07 00:00:00+03:00,in,False,-1,True,5,0,18,18
167927,2019-10-07 00:00:00+03:00,out,False,929626,True,2,0,26,26
167927,2019-10-07 00:00:00+03:00,out,False,929622,True,1,0,6,6
167927,2019-10-18 00:00:00+03:00,in,False,929626,False,2,74,98,24
167927,2019-10-18 00:00:00+03:00,in,False,929626,False,2,74,98,24
167927,2019-10-23 00:00:00+03:00,in,False,-1,True,1,0,6,6
167927,2019-10-24 00:00:00+03:00,in,False,-1,True,3,0,42,42
167927,2019-10-25 00:00:00+03:00,in,False,-1,True,1,0,27,27
167927,2019-10-25 00:00:00+03:00,in,False,929626,False,2,372,425,53
167927,2019-10-28 00:00:00+03:00,in,False,929626,False,2,66,90,24
167927,2019-10-29 00:00:00+03:00,out,False,929626,True,4,0,17,17
167927,2019-10-29 00:00:00+03:00,out,True,929626,True,1,0,0,0
167927,2019-11-01 00:00:00+03:00,in,False,929622,False,1,58,82,24
167927,2019-11-01 00:00:00+03:00,in,False,929626,False,1,35,46,11
167927,2019-11-01 00:00:00+03:00,in,False,929622,False,1,58,82,24
167927,2019-11-05 00:00:00+03:00,out,False,929626,False,1,241,242,1
167927,2019-11-05 00:00:00+03:00,in,False,929626,False,4,630,686,56
167927,2019-11-05 00:00:00+03:00,in,False,929622,False,1,298,317,19
167927,2019-11-06 00:00:00+03:00,in,False,929626,False,1,156,166,10
167927,2019-11-06 00:00:00+03:00,out,False,929626,False,1,595,598,3
167927,2019-11-07 00:00:00+03:00,in,False,929626,False,1,114,124,10
167927,2019-11-08 00:00:00+03:00,in,False,929626,False,2,40,64,24
167927,2019-11-09 00:00:00+03:00,in,False,929626,False,1,27,36,9
167927,2019-11-11 00:00:00+03:00,in,False,-1,True,1,0,26,26
167927,2019-11-12 00:00:00+03:00,out,False,929626,False,1,23,26,3
167927,2019-11-12 00:00:00+03:00,in,False,929626,False,5,123,180,57
167927,2019-11-12 00:00:00+03:00,in,False,929626,False,5,123,180,57
167927,2019-11-13 00:00:00+03:00,in,False,929626,False,1,48,58,10
167927,2019-11-13 00:00:00+03:00,in,False,-1,True,1,0,9,9
167927,2019-11-14 00:00:00+03:00,out,False,929626,False,1,222,224,2
167927,2019-11-14 00:00:00+03:00,in,False,929626,False,1,12,20,8
167927,2019-11-15 00:00:00+03:00,in,False,929626,False,4,395,455,60
167927,2019-11-15 00:00:00+03:00,in,False,929622,False,1,15,25,10
167927,2019-11-18 00:00:00+03:00,out,False,929626,False,1,39,41,2
167927,2019-11-18 00:00:00+03:00,in,False,-1,True,1,0,1,1
167927,2019-11-19 00:00:00+03:00,in,False,929622,False,1,10,27,17
167927,2019-11-19 00:00:00+03:00,in,False,929626,False,2,160,186,26
167927,2019-11-19 00:00:00+03:00,in,False,929622,False,1,10,27,17
167927,2019-11-20 00:00:00+03:00,in,False,929622,False,1,21,31,10
167927,2019-11-22 00:00:00+03:00,in,False,929626,False,1,73,82,9
167927,2019-11-22 00:00:00+03:00,out,False,929626,False,1,332,344,12
167927,2019-11-22 00:00:00+03:00,out,False,929626,False,1,332,344,12
167927,2019-11-25 00:00:00+03:00,in,False,929622,False,2,453,468,15
167927,2019-11-25 00:00:00+03:00,in,False,929626,False,3,109,136,27
167927,2019-11-25 00:00:00+03:00,out,False,929622,False,2,75,84,9
167927,2019-11-25 00:00:00+03:00,out,False,929626,True,2,0,49,49
167927,2019-11-25 00:00:00+03:00,out,False,929626,False,4,721,756,35
167927,2019-11-26 00:00:00+03:00,out,False,929626,False,1,20,56,36
167927,2019-11-26 00:00:00+03:00,in,False,929622,False,2,169,202,33
167927,2019-11-27 00:00:00+03:00,in,False,-1,True,1,0,5,5
167927,2019-11-27 00:00:00+03:00,in,False,929626,False,1,276,283,7
167927,2019-11-28 00:00:00+03:00,in,False,-1,True,1,0,15,15
167927,2019-11-28 00:00:00+03:00,out,False,929622,False,1,8,11,3
167927,2019-11-28 00:00:00+03:00,in,False,929626,False,1,15,28,13
167927,2019-11-28 00:00:00+03:00,in,False,929622,False,3,541,575,34
167930,2019-10-11 00:00:00+03:00,out,False,930814,False,1,355,359,4
167930,2019-10-11 00:00:00+03:00,in,False,930814,False,1,151,163,12
167930,2019-10-11 00:00:00+03:00,in,False,930820,False,1,99,114,15
167930,2019-10-11 00:00:00+03:00,out,False,930814,True,2,0,66,66
167930,2019-10-14 00:00:00+03:00,in,False,930814,False,1,30,46,16
167930,2019-10-18 00:00:00+03:00,in,False,930814,False,1,203,218,15
167930,2019-10-21 00:00:00+03:00,in,False,930814,False,1,175,188,13
167930,2019-10-22 00:00:00+03:00,in,False,930820,False,1,60,76,16
167930,2019-10-24 00:00:00+03:00,in,False,930814,False,3,238,306,68
167930,2019-10-28 00:00:00+03:00,in,False,930818,False,1,267,284,17
167930,2019-10-29 00:00:00+03:00,in,False,930818,False,1,57,69,12
167930,2019-10-30 00:00:00+03:00,in,False,930820,False,1,58,73,15
167930,2019-11-05 00:00:00+03:00,in,False,930816,False,1,106,121,15
167930,2019-11-10 00:00:00+03:00,in,False,930816,False,1,9,16,7
167930,2019-11-12 00:00:00+03:00,in,False,930816,False,1,325,340,15
167930,2019-11-13 00:00:00+03:00,in,False,930814,False,1,180,194,14
167930,2019-11-14 00:00:00+03:00,in,False,930816,False,1,127,141,14
167930,2019-11-15 00:00:00+03:00,out,False,930816,False,1,8,26,18
167930,2019-11-15 00:00:00+03:00,out,False,930820,False,1,9,21,12
167930,2019-11-15 00:00:00+03:00,in,False,930814,False,1,29,41,12
167930,2019-11-15 00:00:00+03:00,out,False,930820,False,1,9,21,12
167930,2019-11-15 00:00:00+03:00,in,False,930814,False,1,29,41,12
167930,2019-11-18 00:00:00+03:00,in,False,930820,False,1,47,58,11
167930,2019-11-18 00:00:00+03:00,in,False,930814,False,1,20,33,13
167930,2019-11-19 00:00:00+03:00,in,False,930814,False,1,180,192,12
167930,2019-11-21 00:00:00+03:00,in,False,-1,True,8,0,52,52
167930,2019-11-22 00:00:00+03:00,in,False,-1,True,4,0,26,26
167930,2019-11-24 00:00:00+03:00,in,False,930820,False,1,78,92,14
167930,2019-11-24 00:00:00+03:00,in,False,930818,False,1,99,111,12
167936,2019-10-08 00:00:00+03:00,in,False,-1,True,1,0,2,2
167936,2019-10-08 00:00:00+03:00,in,False,-1,True,1,0,2,2
167936,2019-10-09 00:00:00+03:00,in,False,931914,False,4,248,298,50
167936,2019-10-11 00:00:00+03:00,in,False,931914,False,2,286,307,21
167936,2019-10-14 00:00:00+03:00,in,False,931914,False,1,50,63,13
167936,2019-10-15 00:00:00+03:00,in,False,931914,False,1,38,52,14
167936,2019-10-16 00:00:00+03:00,in,False,931914,False,2,543,571,28
167936,2019-10-21 00:00:00+03:00,in,False,931914,False,1,42,66,24
167936,2019-10-22 00:00:00+03:00,in,False,931914,False,1,40,54,14
167936,2019-10-24 00:00:00+03:00,in,False,931914,False,1,145,155,10
167936,2019-10-25 00:00:00+03:00,in,False,931914,False,3,182,226,44
167936,2019-10-28 00:00:00+03:00,in,False,-1,True,10,0,331,331
167936,2019-11-01 00:00:00+03:00,in,False,931914,False,3,384,432,48
167936,2019-11-01 00:00:00+03:00,in,False,-1,True,1,0,34,34
167936,2019-11-05 00:00:00+03:00,in,False,931914,False,1,4,20,16
167936,2019-11-05 00:00:00+03:00,in,False,931914,False,1,4,20,16
167936,2019-11-06 00:00:00+03:00,in,False,931914,False,1,50,66,16
167936,2019-11-06 00:00:00+03:00,in,False,931914,False,1,50,66,16
167936,2019-11-10 00:00:00+03:00,in,False,931914,False,1,450,467,17
167936,2019-11-15 00:00:00+03:00,in,False,931914,False,2,94,130,36
167936,2019-11-15 00:00:00+03:00,in,False,-1,True,1,0,25,25
167936,2019-11-24 00:00:00+03:00,in,False,931914,False,1,8,26,18
167936,2019-11-25 00:00:00+03:00,in,False,931914,False,2,57,98,41
167936,2019-11-26 00:00:00+03:00,in,False,931914,False,1,45,65,20
167936,2019-11-27 00:00:00+03:00,in,False,931914,False,3,659,739,80
167939,2019-10-15 00:00:00+03:00,in,False,-1,True,2,0,3,3
167939,2019-10-21 00:00:00+03:00,in,False,-1,True,1,0,2,2
167947,2019-10-08 00:00:00+03:00,out,False,930594,False,2,34,75,41
167947,2019-10-08 00:00:00+03:00,in,False,-1,True,2,0,2,2
167947,2019-10-10 00:00:00+03:00,out,False,930586,False,2,406,451,45
167947,2019-10-10 00:00:00+03:00,out,False,930594,False,1,326,350,24
167947,2019-10-10 00:00:00+03:00,in,False,-1,True,4,0,7,7
167947,2019-10-10 00:00:00+03:00,out,False,930586,True,5,0,160,160
167947,2019-10-11 00:00:00+03:00,out,False,930586,True,3,0,59,59
167947,2019-10-11 00:00:00+03:00,out,False,930594,False,1,994,1015,21
167947,2019-10-11 00:00:00+03:00,out,False,930586,False,10,792,942,150
167947,2019-10-11 00:00:00+03:00,out,False,930590,False,1,32,49,17
167947,2019-10-11 00:00:00+03:00,out,False,930590,True,3,0,35,35
167947,2019-10-11 00:00:00+03:00,out,False,930594,False,1,994,1015,21
167947,2019-10-12 00:00:00+03:00,out,False,930594,True,1,0,2,2
167947,2019-10-12 00:00:00+03:00,out,False,930590,False,3,142,235,93
167947,2019-10-12 00:00:00+03:00,out,False,930594,False,3,2235,2295,60
167947,2019-10-12 00:00:00+03:00,out,False,930590,True,2,0,70,70
167947,2019-10-13 00:00:00+03:00,out,False,930590,True,1,0,17,17
167947,2019-10-13 00:00:00+03:00,out,False,930586,False,3,2117,2159,42
167947,2019-10-13 00:00:00+03:00,in,False,-1,True,1,0,1,1
167947,2019-10-13 00:00:00+03:00,out,False,930590,False,2,1616,1655,39
167947,2019-10-13 00:00:00+03:00,out,False,930594,True,1,0,24,24
167947,2019-10-13 00:00:00+03:00,out,False,930590,False,2,1616,1655,39
167947,2019-10-14 00:00:00+03:00,out,False,930590,False,13,1098,1296,198
167947,2019-10-14 00:00:00+03:00,out,False,930594,False,2,1347,1379,32
167947,2019-10-14 00:00:00+03:00,out,False,930594,True,2,0,45,45
167947,2019-10-14 00:00:00+03:00,out,False,930590,True,1,0,18,18
167947,2019-10-15 00:00:00+03:00,out,False,930590,True,2,0,61,61
167947,2019-10-15 00:00:00+03:00,out,False,930586,False,2,924,950,26
167947,2019-10-15 00:00:00+03:00,out,True,930590,True,1,0,0,0
167947,2019-10-15 00:00:00+03:00,out,False,930590,False,8,2087,2230,143
167947,2019-10-16 00:00:00+03:00,out,False,930590,False,1,164,183,19
167947,2019-10-16 00:00:00+03:00,out,False,930586,True,1,0,24,24
167947,2019-10-16 00:00:00+03:00,out,False,930590,True,1,0,60,60
167947,2019-10-17 00:00:00+03:00,out,False,930594,False,4,2626,2671,45
167947,2019-10-17 00:00:00+03:00,out,False,930586,False,3,1527,1561,34
167947,2019-10-17 00:00:00+03:00,out,False,930586,True,3,0,117,117
167947,2019-10-17 00:00:00+03:00,out,False,930594,True,3,0,121,121
167947,2019-10-18 00:00:00+03:00,out,False,930586,True,2,0,95,95
167947,2019-10-18 00:00:00+03:00,out,False,930586,False,1,21,35,14
167947,2019-10-18 00:00:00+03:00,out,False,930594,False,1,767,783,16
167947,2019-10-19 00:00:00+03:00,out,False,930594,False,1,3,39,36
167947,2019-10-20 00:00:00+03:00,out,False,930586,False,2,830,865,35
167947,2019-10-20 00:00:00+03:00,out,False,930586,True,1,0,24,24
167947,2019-10-20 00:00:00+03:00,in,False,-1,True,1,0,1,1
167947,2019-10-20 00:00:00+03:00,in,False,-1,True,1,0,1,1
167947,2019-10-21 00:00:00+03:00,out,False,930594,False,1,10,28,18
167947,2019-10-22 00:00:00+03:00,out,False,930586,True,2,0,53,53
167947,2019-10-22 00:00:00+03:00,in,False,-1,True,1,0,0,0
167947,2019-10-22 00:00:00+03:00,out,False,930594,False,1,1233,1242,9
167947,2019-10-22 00:00:00+03:00,out,True,930586,True,1,0,0,0
167947,2019-10-22 00:00:00+03:00,out,False,930586,False,5,639,738,99
167947,2019-10-23 00:00:00+03:00,out,False,930586,True,5,0,20,20
167947,2019-10-23 00:00:00+03:00,out,False,930586,False,6,379,487,108
167947,2019-10-23 00:00:00+03:00,out,False,930590,True,1,0,44,44
167947,2019-10-24 00:00:00+03:00,out,False,930586,True,1,0,4,4
167947,2019-10-24 00:00:00+03:00,out,False,930594,True,1,0,0,0
167947,2019-10-24 00:00:00+03:00,out,False,930590,True,1,0,3,3
167947,2019-10-24 00:00:00+03:00,out,False,930590,False,1,39,52,13
167947,2019-10-24 00:00:00+03:00,out,False,930594,False,1,58,78,20
167947,2019-10-24 00:00:00+03:00,in,False,-1,True,1,0,1,1
167947,2019-10-25 00:00:00+03:00,in,False,-1,True,1,0,2,2
167947,2019-10-25 00:00:00+03:00,out,False,930594,False,3,47,152,105
167947,2019-10-25 00:00:00+03:00,in,False,930594,False,2,589,610,21
167947,2019-10-25 00:00:00+03:00,in,False,-1,True,1,0,2,2
167947,2019-10-28 00:00:00+03:00,out,False,930590,False,1,262,280,18
167947,2019-10-28 00:00:00+03:00,out,False,930586,False,1,30,41,11
167947,2019-10-29 00:00:00+03:00,out,False,930586,False,2,32,83,51
167947,2019-10-30 00:00:00+03:00,in,False,-1,True,3,0,3,3
167947,2019-10-31 00:00:00+03:00,in,False,-1,True,2,0,2,2
167947,2019-11-01 00:00:00+03:00,in,False,-1,True,2,0,2,2
167947,2019-11-04 00:00:00+03:00,out,False,930586,False,10,1203,1352,149
167947,2019-11-04 00:00:00+03:00,in,False,-1,True,2,0,2,2
167947,2019-11-04 00:00:00+03:00,out,False,930586,True,4,0,42,42
167947,2019-11-05 00:00:00+03:00,out,False,930590,True,1,0,51,51
167947,2019-11-05 00:00:00+03:00,out,False,930594,False,3,35,123,88
167947,2019-11-05 00:00:00+03:00,in,False,-1,True,1,0,1,1
167947,2019-11-05 00:00:00+03:00,out,False,930590,False,3,1141,1186,45
167947,2019-11-05 00:00:00+03:00,out,False,930594,True,1,0,60,60
167947,2019-11-05 00:00:00+03:00,in,False,930582,False,1,62,78,16
167947,2019-11-06 00:00:00+03:00,out,False,930590,True,1,0,17,17
167947,2019-11-06 00:00:00+03:00,out,False,930590,False,2,1127,1181,54
167947,2019-11-06 00:00:00+03:00,out,False,930594,True,5,0,43,43
167947,2019-11-06 00:00:00+03:00,out,False,930586,True,6,0,103,103
167947,2019-11-06 00:00:00+03:00,out,False,930594,False,5,2387,2499,112
167947,2019-11-06 00:00:00+03:00,out,False,930586,False,3,119,179,60
167947,2019-11-07 00:00:00+03:00,out,False,930594,True,1,0,60,60
167947,2019-11-07 00:00:00+03:00,out,False,930586,True,5,0,69,69
167947,2019-11-07 00:00:00+03:00,out,False,930586,False,3,378,471,93
167947,2019-11-07 00:00:00+03:00,out,False,930590,False,3,17,93,76
167947,2019-11-07 00:00:00+03:00,out,False,930594,False,3,222,264,42
167947,2019-11-08 00:00:00+03:00,out,False,930586,False,2,856,886,30
167947,2019-11-08 00:00:00+03:00,out,False,930594,False,2,1770,1793,23
167947,2019-11-08 00:00:00+03:00,out,False,930594,True,2,0,112,112
167947,2019-11-08 00:00:00+03:00,out,False,930586,True,3,0,81,81
167947,2019-11-08 00:00:00+03:00,out,False,930590,False,2,287,350,63
167947,2019-11-10 00:00:00+03:00,in,False,-1,True,1,0,1,1
167947,2019-11-11 00:00:00+03:00,out,False,930594,True,1,0,43,43
167947,2019-11-11 00:00:00+03:00,out,False,930590,True,1,0,51,51
167947,2019-11-11 00:00:00+03:00,out,False,930590,False,4,244,307,63
167947,2019-11-11 00:00:00+03:00,out,False,930586,True,6,0,174,174
167947,2019-11-11 00:00:00+03:00,in,False,-1,True,1,0,1,1
167947,2019-11-11 00:00:00+03:00,out,False,930586,False,6,528,696,168
167947,2019-11-11 00:00:00+03:00,out,False,930594,False,1,159,173,14
167947,2019-11-11 00:00:00+03:00,out,False,930590,False,4,244,307,63
167947,2019-11-12 00:00:00+03:00,out,False,930590,False,2,548,580,32
167947,2019-11-12 00:00:00+03:00,out,False,930586,True,2,0,24,24
167947,2019-11-12 00:00:00+03:00,out,False,930586,False,1,29,49,20
167947,2019-11-12 00:00:00+03:00,in,False,-1,True,1,0,1,1
167947,2019-11-13 00:00:00+03:00,in,False,-1,True,2,0,2,2
167947,2019-11-14 00:00:00+03:00,out,False,930586,True,3,0,74,74
167947,2019-11-14 00:00:00+03:00,out,False,930586,False,6,776,884,108
167947,2019-11-15 00:00:00+03:00,out,False,930586,True,4,0,96,96
167947,2019-11-15 00:00:00+03:00,in,False,-1,True,1,0,1,1
167947,2019-11-15 00:00:00+03:00,out,False,930586,False,8,1457,1581,124
167947,2019-11-18 00:00:00+03:00,in,False,-1,True,3,0,18,18
167947,2019-11-18 00:00:00+03:00,out,False,930586,False,5,1998,2072,74
167947,2019-11-18 00:00:00+03:00,out,False,930586,True,8,0,277,277
167947,2019-11-19 00:00:00+03:00,out,False,930586,True,10,0,250,250
167947,2019-11-19 00:00:00+03:00,out,False,930586,False,10,2863,3067,204
167947,2019-11-19 00:00:00+03:00,in,False,-1,True,1,0,1,1
167947,2019-11-20 00:00:00+03:00,out,False,930586,True,10,0,203,203
167947,2019-11-20 00:00:00+03:00,in,False,-1,True,4,0,4,4
167947,2019-11-20 00:00:00+03:00,out,False,930586,False,13,4958,5133,175
167947,2019-11-21 00:00:00+03:00,out,False,930586,False,5,2470,2545,75
167947,2019-11-21 00:00:00+03:00,out,False,930586,True,5,0,107,107
167947,2019-11-21 00:00:00+03:00,out,False,930586,False,5,2470,2545,75
167947,2019-11-22 00:00:00+03:00,in,False,-1,True,1,0,1,1
167947,2019-11-22 00:00:00+03:00,out,False,930586,True,4,0,98,98
167947,2019-11-22 00:00:00+03:00,out,False,930586,False,5,974,1093,119
167947,2019-11-25 00:00:00+03:00,out,False,930586,False,5,478,577,99
167947,2019-11-25 00:00:00+03:00,out,False,930586,True,1,0,20,20
167947,2019-11-25 00:00:00+03:00,out,False,930586,True,1,0,20,20
167947,2019-11-26 00:00:00+03:00,in,False,-1,True,2,0,2,2
167947,2019-11-26 00:00:00+03:00,out,False,930586,False,4,2123,2191,68
167947,2019-11-26 00:00:00+03:00,out,False,930586,True,6,0,167,167
167948,2019-10-07 00:00:00+03:00,in,False,-1,True,1,0,2,2
167948,2019-10-08 00:00:00+03:00,in,False,-1,True,1,0,13,13
167948,2019-10-08 00:00:00+03:00,in,False,930326,False,1,80,93,13
167948,2019-10-08 00:00:00+03:00,in,False,930326,False,1,80,93,13
167948,2019-10-08 00:00:00+03:00,in,False,-1,True,1,0,13,13
167948,2019-10-11 00:00:00+03:00,in,False,-1,True,1,0,12,12
167948,2019-10-25 00:00:00+03:00,in,False,930326,False,1,62,68,6
167948,2019-10-25 00:00:00+03:00,in,False,-1,True,1,0,29,29
167948,2019-10-25 00:00:00+03:00,in,False,-1,True,1,0,29,29
167948,2019-10-28 00:00:00+03:00,out,False,930326,False,1,683,698,15
167948,2019-10-28 00:00:00+03:00,in,False,930326,False,1,10,18,8
167948,2019-10-31 00:00:00+03:00,in,False,930326,False,2,94,113,19
167948,2019-11-01 00:00:00+03:00,in,False,930326,False,1,14,20,6
167948,2019-11-05 00:00:00+03:00,in,False,930326,False,1,229,235,6
167948,2019-11-06 00:00:00+03:00,in,False,930326,False,1,175,192,17
167948,2019-11-07 00:00:00+03:00,in,False,-1,True,1,0,28,28
167948,2019-11-14 00:00:00+03:00,in,False,-1,True,3,0,128,128
167948,2019-11-25 00:00:00+03:00,in,False,-1,True,1,0,2,2
167948,2019-11-28 00:00:00+03:00,in,False,-1,True,2,0,39,39
167948,2019-11-28 00:00:00+03:00,in,False,930326,False,2,63,105,42
167949,2019-10-08 00:00:00+03:00,out,True,929876,False,3,1515,1535,20
167949,2019-10-08 00:00:00+03:00,in,False,929876,False,3,110,148,38
167949,2019-10-08 00:00:00+03:00,out,False,929876,True,3,0,1,1
167949,2019-10-08 00:00:00+03:00,in,False,929884,False,4,30,62,32
167949,2019-10-09 00:00:00+03:00,out,True,929884,False,1,251,268,17
167949,2019-10-09 00:00:00+03:00,in,False,929876,False,1,9,22,13
167949,2019-10-09 00:00:00+03:00,out,True,929876,False,1,22,28,6
167949,2019-10-09 00:00:00+03:00,out,True,929876,True,1,0,13,13
167949,2019-10-18 00:00:00+03:00,out,False,929876,True,4,0,183,183
167949,2019-10-18 00:00:00+03:00,out,True,929876,True,1,0,10,10
167949,2019-10-18 00:00:00+03:00,out,False,929884,False,3,85,153,68
167949,2019-10-18 00:00:00+03:00,out,False,929876,False,3,106,176,70
167949,2019-10-18 00:00:00+03:00,in,False,-1,True,9,0,43,43
167949,2019-10-18 00:00:00+03:00,in,False,929884,False,12,222,362,140
167949,2019-10-18 00:00:00+03:00,in,False,929876,False,6,88,153,65
167949,2019-10-18 00:00:00+03:00,in,False,929876,True,1,0,11,11
167949,2019-10-21 00:00:00+03:00,out,False,929884,False,4,279,359,80
167949,2019-10-21 00:00:00+03:00,out,False,929884,True,1,0,47,47
167949,2019-10-21 00:00:00+03:00,out,False,929876,False,6,2104,2198,94
167949,2019-10-21 00:00:00+03:00,in,False,929884,False,1,74,98,24
167949,2019-10-21 00:00:00+03:00,out,False,929876,True,2,0,65,65
167949,2019-10-21 00:00:00+03:00,in,False,929876,False,1,158,168,10
167949,2019-10-21 00:00:00+03:00,out,False,929876,True,2,0,65,65
167949,2019-10-22 00:00:00+03:00,in,False,-1,True,1,0,19,19
167949,2019-10-22 00:00:00+03:00,in,True,941384,False,1,9,25,16
167949,2019-10-22 00:00:00+03:00,in,False,929876,False,2,57,86,29
167949,2019-10-22 00:00:00+03:00,out,False,929876,True,4,0,105,105
167949,2019-10-22 00:00:00+03:00,out,False,941384,True,7,0,110,110
167949,2019-10-22 00:00:00+03:00,in,False,929884,False,1,2,31,29
167949,2019-10-22 00:00:00+03:00,out,False,929876,False,3,743,795,52
167949,2019-10-22 00:00:00+03:00,out,False,941384,False,3,116,154,38
167949,2019-10-22 00:00:00+03:00,out,True,941384,False,1,7,27,20
167949,2019-10-22 00:00:00+03:00,out,False,929876,True,4,0,105,105
167949,2019-10-22 00:00:00+03:00,in,False,929884,False,1,2,31,29
167949,2019-10-23 00:00:00+03:00,out,False,929884,False,1,142,151,9
167949,2019-10-23 00:00:00+03:00,out,False,941384,True,6,0,201,201
167949,2019-10-23 00:00:00+03:00,out,False,929876,True,3,0,98,98
167949,2019-10-23 00:00:00+03:00,in,False,941384,False,2,60,102,42
167949,2019-10-23 00:00:00+03:00,in,False,929876,False,1,145,151,6
167949,2019-10-23 00:00:00+03:00,out,False,941384,False,4,1094,1126,32
167949,2019-10-23 00:00:00+03:00,out,False,929876,False,4,310,392,82
167949,2019-10-24 00:00:00+03:00,out,False,941384,False,7,1817,1900,83
167949,2019-10-24 00:00:00+03:00,out,False,929876,True,1,0,17,17
167949,2019-10-24 00:00:00+03:00,out,True,929876,False,1,61,67,6
167949,2019-10-24 00:00:00+03:00,out,False,941384,True,1,0,14,14
167949,2019-10-24 00:00:00+03:00,in,False,941384,False,3,877,916,39
167949,2019-10-25 00:00:00+03:00,out,False,929876,False,1,42,52,10
167949,2019-10-25 00:00:00+03:00,out,False,941384,True,19,0,539,539
167949,2019-10-25 00:00:00+03:00,out,False,941384,False,8,2257,2383,126
167949,2019-10-27 00:00:00+03:00,out,False,941384,False,2,75,122,47
167949,2019-10-27 00:00:00+03:00,out,False,941384,True,5,0,29,29
167949,2019-10-28 00:00:00+03:00,out,False,941384,True,19,0,191,191
167949,2019-10-28 00:00:00+03:00,in,False,929884,False,1,38,46,8
167949,2019-10-28 00:00:00+03:00,out,False,941384,False,27,2099,2769,670
167949,2019-10-28 00:00:00+03:00,in,False,941384,False,1,141,147,6
167949,2019-10-28 00:00:00+03:00,out,False,929884,False,4,266,523,257
167949,2019-10-28 00:00:00+03:00,out,False,929884,True,1,0,31,31
167949,2019-10-29 00:00:00+03:00,in,False,929884,False,2,169,227,58
167949,2019-10-29 00:00:00+03:00,out,False,941384,True,12,0,290,290
167949,2019-10-29 00:00:00+03:00,out,False,941384,False,16,4094,4326,232
167949,2019-10-29 00:00:00+03:00,in,False,941384,False,1,821,829,8
167949,2019-10-29 00:00:00+03:00,out,False,929876,True,3,0,66,66
167949,2019-10-29 00:00:00+03:00,out,True,929876,False,1,76,87,11
167949,2019-10-29 00:00:00+03:00,out,False,929884,True,1,0,29,29
167949,2019-10-29 00:00:00+03:00,out,False,929876,False,1,19,35,16
167949,2019-10-29 00:00:00+03:00,in,False,929876,False,2,51,79,28
167949,2019-10-29 00:00:00+03:00,out,False,929884,False,1,59,79,20
167949,2019-10-29 00:00:00+03:00,in,False,-1,True,1,0,5,5
167949,2019-10-30 00:00:00+03:00,out,False,941384,True,16,0,571,571
167949,2019-10-30 00:00:00+03:00,in,False,929884,False,1,27,55,28
167949,2019-10-30 00:00:00+03:00,out,True,929876,False,1,28,37,9
167949,2019-10-30 00:00:00+03:00,in,False,-1,True,1,0,24,24
167949,2019-10-30 00:00:00+03:00,in,False,941384,False,1,16,25,9
167949,2019-10-30 00:00:00+03:00,out,False,941384,False,22,2301,2697,396
167949,2019-10-30 00:00:00+03:00,in,False,941384,False,1,16,25,9
167949,2019-10-31 00:00:00+03:00,out,False,929876,True,1,0,30,30
167949,2019-10-31 00:00:00+03:00,out,False,941384,False,4,601,701,100
167949,2019-10-31 00:00:00+03:00,in,False,941384,False,3,485,506,21
167949,2019-10-31 00:00:00+03:00,out,False,929876,False,1,23,39,16
167949,2019-10-31 00:00:00+03:00,out,False,929884,False,1,599,619,20
167949,2019-10-31 00:00:00+03:00,out,True,929876,False,1,10,16,6
167949,2019-10-31 00:00:00+03:00,out,False,941384,True,6,0,259,259
167949,2019-10-31 00:00:00+03:00,in,False,941384,False,3,485,506,21
167949,2019-10-31 00:00:00+03:00,out,False,941384,False,4,601,701,100
167949,2019-11-01 00:00:00+03:00,out,False,941384,True,4,0,140,140
167949,2019-11-01 00:00:00+03:00,out,False,941384,False,11,3610,3769,159
167949,2019-11-01 00:00:00+03:00,in,False,941384,False,2,976,991,15
167949,2019-11-01 00:00:00+03:00,out,False,929876,True,1,0,47,47
167949,2019-11-02 00:00:00+03:00,out,False,941384,False,1,29,53,24
167949,2019-11-02 00:00:00+03:00,out,False,941384,False,1,29,53,24
167949,2019-11-04 00:00:00+03:00,out,False,941384,False,1,205,211,6
167949,2019-11-04 00:00:00+03:00,out,False,941384,True,3,0,95,95
167949,2019-11-05 00:00:00+03:00,in,False,941384,False,1,94,104,10
167949,2019-11-05 00:00:00+03:00,in,False,-1,True,1,0,22,22
167949,2019-11-05 00:00:00+03:00,out,False,941384,True,10,0,325,325
167949,2019-11-05 00:00:00+03:00,out,True,929876,False,1,11,24,13
167949,2019-11-05 00:00:00+03:00,out,False,941384,False,18,1543,1821,278
167949,2019-11-05 00:00:00+03:00,out,False,929876,False,3,191,253,62
167949,2019-11-05 00:00:00+03:00,out,False,929876,False,3,191,253,62
167949,2019-11-05 00:00:00+03:00,out,False,941384,True,10,0,325,325
167949,2019-11-06 00:00:00+03:00,out,False,929884,False,2,144,165,21
167949,2019-11-06 00:00:00+03:00,in,False,941384,False,3,213,243,30
167949,2019-11-06 00:00:00+03:00,out,False,929876,True,1,0,33,33
167949,2019-11-06 00:00:00+03:00,in,False,929876,False,1,104,116,12
167949,2019-11-06 00:00:00+03:00,out,False,941384,False,11,1198,1315,117
167949,2019-11-06 00:00:00+03:00,out,False,941384,True,18,0,428,428
167949,2019-11-07 00:00:00+03:00,out,False,941384,False,13,2432,2579,147
167949,2019-11-07 00:00:00+03:00,out,False,929884,True,2,0,118,118
167949,2019-11-07 00:00:00+03:00,out,False,929884,False,2,164,200,36
167949,2019-11-07 00:00:00+03:00,out,False,941384,True,10,0,334,334
167949,2019-11-07 00:00:00+03:00,in,False,929876,False,2,135,183,48
167949,2019-11-07 00:00:00+03:00,in,False,941384,False,2,77,95,18
167949,2019-11-08 00:00:00+03:00,out,False,941384,True,5,0,196,196
167949,2019-11-08 00:00:00+03:00,out,False,929876,False,1,31,51,20
167949,2019-11-08 00:00:00+03:00,out,False,941384,False,4,195,281,86
167949,2019-11-08 00:00:00+03:00,out,False,929876,False,1,31,51,20
167949,2019-11-08 00:00:00+03:00,out,False,941384,False,4,195,281,86
167949,2019-11-11 00:00:00+03:00,out,False,941384,True,7,0,240,240
167949,2019-11-11 00:00:00+03:00,in,False,941384,False,4,126,191,65
167949,2019-11-11 00:00:00+03:00,in,False,929876,False,2,604,625,21
167949,2019-11-11 00:00:00+03:00,out,False,941384,False,14,2548,2750,202
167949,2019-11-11 00:00:00+03:00,out,False,929876,False,1,34,54,20
167949,2019-11-11 00:00:00+03:00,out,False,929876,True,1,0,48,48
167949,2019-11-11 00:00:00+03:00,in,False,929884,False,1,75,104,29
167949,2019-11-11 00:00:00+03:00,in,False,929884,False,1,75,104,29
167949,2019-11-11 00:00:00+03:00,out,False,941384,True,7,0,240,240
167949,2019-11-12 00:00:00+03:00,out,False,941384,True,7,0,227,227
167949,2019-11-12 00:00:00+03:00,in,False,-1,True,1,0,2,2
167949,2019-11-12 00:00:00+03:00,out,False,929876,False,1,568,586,18
167949,2019-11-12 00:00:00+03:00,out,False,941384,False,12,2548,2716,168
167949,2019-11-13 00:00:00+03:00,in,False,941384,False,2,93,115,22
167949,2019-11-13 00:00:00+03:00,out,False,941384,True,5,0,235,235
167949,2019-11-13 00:00:00+03:00,out,False,941384,False,7,850,1002,152
167949,2019-11-13 00:00:00+03:00,in,False,929876,False,1,18,29,11
167949,2019-11-14 00:00:00+03:00,out,False,941384,True,14,0,495,495
167949,2019-11-14 00:00:00+03:00,out,False,941384,False,29,2625,3087,462
167949,2019-11-14 00:00:00+03:00,in,False,929884,False,6,490,589,99
167949,2019-11-14 00:00:00+03:00,in,False,941384,False,2,686,734,48
167949,2019-11-14 00:00:00+03:00,out,False,929876,False,4,1134,1197,63
167949,2019-11-14 00:00:00+03:00,in,False,-1,True,1,0,35,35
167949,2019-11-14 00:00:00+03:00,out,False,929876,False,4,1134,1197,63
167949,2019-11-15 00:00:00+03:00,in,False,929876,False,1,36,66,30
167949,2019-11-15 00:00:00+03:00,out,False,941384,True,7,0,252,252
167949,2019-11-15 00:00:00+03:00,in,False,941384,False,3,225,256,31
167949,2019-11-15 00:00:00+03:00,out,False,941384,False,37,2451,2947,496
167949,2019-11-16 00:00:00+03:00,out,False,941384,False,1,46,61,15
167949,2019-11-16 00:00:00+03:00,out,False,941384,True,1,0,1,1
167949,2019-11-16 00:00:00+03:00,in,False,929884,False,1,11,27,16
167949,2019-11-18 00:00:00+03:00,out,False,941384,False,21,2211,2507,296
167949,2019-11-18 00:00:00+03:00,in,False,929876,False,5,828,910,82
167949,2019-11-18 00:00:00+03:00,out,False,929876,False,2,1652,1690,38
167949,2019-11-18 00:00:00+03:00,in,False,941384,False,3,1427,1453,26
167949,2019-11-18 00:00:00+03:00,out,False,941384,True,14,0,344,344
167949,2019-11-18 00:00:00+03:00,in,False,-1,True,1,0,2,2
167949,2019-11-19 00:00:00+03:00,in,False,-1,True,1,0,2,2
167949,2019-11-19 00:00:00+03:00,out,False,941384,False,18,2619,2906,287
167949,2019-11-19 00:00:00+03:00,out,False,941384,True,10,0,385,385
167949,2019-11-19 00:00:00+03:00,in,False,941384,False,2,130,148,18
167949,2019-11-19 00:00:00+03:00,out,False,929876,True,1,0,19,19
167949,2019-11-20 00:00:00+03:00,in,False,-1,True,1,0,30,30
167949,2019-11-20 00:00:00+03:00,out,False,941384,True,4,0,109,109
167949,2019-11-20 00:00:00+03:00,out,False,929876,False,3,1291,1352,61
167949,2019-11-20 00:00:00+03:00,out,False,941384,False,6,267,350,83
167949,2019-11-20 00:00:00+03:00,in,False,929876,False,1,4,13,9
167949,2019-11-20 00:00:00+03:00,out,False,929876,True,1,0,21,21
167949,2019-11-20 00:00:00+03:00,in,False,941384,False,1,31,39,8
167949,2019-11-20 00:00:00+03:00,out,False,941384,False,6,267,350,83
167949,2019-11-21 00:00:00+03:00,in,False,941384,False,1,72,83,11
167949,2019-11-21 00:00:00+03:00,out,False,941384,False,6,221,339,118
167949,2019-11-21 00:00:00+03:00,out,True,929876,False,1,99,114,15
167949,2019-11-21 00:00:00+03:00,in,False,929876,False,1,107,124,17
167949,2019-11-21 00:00:00+03:00,out,False,929876,True,1,0,57,57
167949,2019-11-21 00:00:00+03:00,out,False,941384,True,4,0,183,183
167949,2019-11-22 00:00:00+03:00,in,False,929884,False,1,11,38,27
167949,2019-11-22 00:00:00+03:00,in,False,941384,False,1,54,63,9
167949,2019-11-22 00:00:00+03:00,in,False,929876,False,2,8,40,32
167949,2019-11-22 00:00:00+03:00,out,False,941384,True,7,0,184,184
167949,2019-11-22 00:00:00+03:00,out,False,941384,False,15,1685,1924,239
167949,2019-11-22 00:00:00+03:00,out,False,929876,False,1,45,47,2
167949,2019-11-25 00:00:00+03:00,in,False,941384,False,1,48,54,6
167949,2019-11-25 00:00:00+03:00,out,False,941384,False,16,2524,2726,202
167949,2019-11-25 00:00:00+03:00,out,False,929876,False,2,174,197,23
167949,2019-11-25 00:00:00+03:00,out,False,929876,True,1,0,15,15
167949,2019-11-25 00:00:00+03:00,out,False,941384,True,13,0,560,560
167949,2019-11-25 00:00:00+03:00,in,False,929876,False,1,16,23,7
167949,2019-11-25 00:00:00+03:00,out,False,929876,True,1,0,15,15
167949,2019-11-26 00:00:00+03:00,in,False,-1,True,1,0,4,4
167949,2019-11-26 00:00:00+03:00,out,False,941384,True,8,0,283,283
167949,2019-11-26 00:00:00+03:00,out,False,941384,False,18,5242,5518,276
167949,2019-11-26 00:00:00+03:00,in,False,968232,False,1,114,127,13
167949,2019-11-26 00:00:00+03:00,in,False,929876,False,2,100,123,23
167949,2019-11-26 00:00:00+03:00,in,False,941384,False,3,58,87,29
167949,2019-11-27 00:00:00+03:00,out,False,929884,False,1,848,864,16
167949,2019-11-27 00:00:00+03:00,out,False,941384,True,12,0,408,408
167949,2019-11-27 00:00:00+03:00,in,False,941384,False,1,82,104,22
167949,2019-11-27 00:00:00+03:00,out,False,929876,True,1,0,52,52
167949,2019-11-27 00:00:00+03:00,out,False,941384,False,19,3180,3487,307
167949,2019-11-27 00:00:00+03:00,out,False,929884,False,1,848,864,16
167949,2019-11-27 00:00:00+03:00,out,False,941384,False,19,3180,3487,307
167949,2019-11-28 00:00:00+03:00,in,False,-1,True,3,0,30,30
167949,2019-11-28 00:00:00+03:00,in,False,941384,False,4,1135,1181,46
167949,2019-11-28 00:00:00+03:00,out,False,941384,False,14,1410,1607,197
167949,2019-11-28 00:00:00+03:00,out,False,941384,True,15,0,505,505
167955,2019-10-08 00:00:00+03:00,in,False,-1,True,2,0,4,4
167955,2019-10-10 00:00:00+03:00,out,False,930186,True,5,0,27,27
167955,2019-10-10 00:00:00+03:00,in,False,930186,False,1,231,240,9
167955,2019-10-14 00:00:00+03:00,in,False,-1,True,1,0,2,2
167955,2019-10-16 00:00:00+03:00,out,False,930186,True,4,0,0,0
167955,2019-10-17 00:00:00+03:00,in,False,930186,False,2,204,212,8
167955,2019-10-17 00:00:00+03:00,in,False,930186,False,2,204,212,8
167955,2019-10-18 00:00:00+03:00,out,False,930186,False,1,1179,1179,0
167955,2019-10-18 00:00:00+03:00,in,False,-1,True,1,0,0,0
167955,2019-10-24 00:00:00+03:00,out,False,930186,True,1,0,45,45
167955,2019-10-25 00:00:00+03:00,out,False,930186,False,5,230,338,108
167955,2019-10-25 00:00:00+03:00,in,False,-1,True,3,0,0,0
167955,2019-10-25 00:00:00+03:00,out,False,930186,True,17,0,659,659
167955,2019-10-25 00:00:00+03:00,in,False,930186,False,1,470,479,9
167955,2019-10-26 00:00:00+03:00,out,False,930186,False,1,523,539,16
167955,2019-10-26 00:00:00+03:00,out,False,930186,True,5,0,151,151
167955,2019-10-28 00:00:00+03:00,out,False,941192,False,8,813,920,107
167955,2019-10-28 00:00:00+03:00,out,False,941192,True,16,0,461,461
167955,2019-10-29 00:00:00+03:00,out,False,930186,True,1,0,1,1
167955,2019-10-29 00:00:00+03:00,out,False,941192,True,9,0,159,159
167955,2019-10-29 00:00:00+03:00,out,False,930186,False,3,1452,1468,16
167955,2019-10-29 00:00:00+03:00,out,False,941192,False,6,802,944,142
167955,2019-10-29 00:00:00+03:00,out,False,930186,False,3,1452,1468,16
167955,2019-10-30 00:00:00+03:00,out,False,941192,True,7,0,138,138
167955,2019-10-30 00:00:00+03:00,in,False,-1,True,3,0,5,5
167955,2019-10-30 00:00:00+03:00,out,False,941192,False,9,842,1046,204
167955,2019-10-30 00:00:00+03:00,out,False,941192,True,7,0,138,138
167955,2019-10-31 00:00:00+03:00,out,False,930186,False,1,275,275,0
167955,2019-10-31 00:00:00+03:00,out,False,941192,False,13,1001,1272,271
167955,2019-10-31 00:00:00+03:00,out,False,930186,True,1,0,3,3
167955,2019-10-31 00:00:00+03:00,in,False,-1,True,2,0,17,17
167955,2019-10-31 00:00:00+03:00,out,False,941192,True,8,0,220,220
167955,2019-11-01 00:00:00+03:00,out,False,941192,False,11,994,1296,302
167955,2019-11-01 00:00:00+03:00,in,False,930186,False,1,18,19,1
167955,2019-11-01 00:00:00+03:00,out,False,941192,True,9,0,445,445
167955,2019-11-01 00:00:00+03:00,out,False,930186,False,6,1938,1947,9
167955,2019-11-01 00:00:00+03:00,out,False,930186,True,1,0,25,25
167955,2019-11-01 00:00:00+03:00,out,False,941192,False,11,994,1296,302
167955,2019-11-02 00:00:00+03:00,in,False,-1,True,2,0,0,0
167955,2019-11-02 00:00:00+03:00,out,False,941192,True,5,0,102,102
167955,2019-11-02 00:00:00+03:00,out,False,941192,False,12,988,1211,223
167955,2019-11-04 00:00:00+03:00,out,False,941192,False,30,2164,2748,584
167955,2019-11-04 00:00:00+03:00,out,False,941192,True,15,0,502,502
167955,2019-11-05 00:00:00+03:00,out,False,941192,True,18,0,567,567
167955,2019-11-05 00:00:00+03:00,out,False,941192,False,13,947,1194,247
167955,2019-11-05 00:00:00+03:00,out,False,930186,False,1,445,447,2
167955,2019-11-05 00:00:00+03:00,in,False,-1,True,4,0,30,30
167955,2019-11-05 00:00:00+03:00,out,False,941192,True,18,0,567,567
167955,2019-11-05 00:00:00+03:00,in,False,-1,True,4,0,30,30
167955,2019-11-06 00:00:00+03:00,out,False,941192,True,10,0,242,242
167955,2019-11-06 00:00:00+03:00,in,False,-1,True,4,0,1,1
167955,2019-11-06 00:00:00+03:00,out,False,941192,False,14,1416,1686,270
167955,2019-11-07 00:00:00+03:00,in,False,-1,True,1,0,0,0
167955,2019-11-07 00:00:00+03:00,out,False,941192,True,10,0,305,305
167955,2019-11-07 00:00:00+03:00,out,False,941192,False,13,1085,1335,250
167955,2019-11-07 00:00:00+03:00,out,False,941192,False,13,1085,1335,250
167955,2019-11-08 00:00:00+03:00,out,False,941192,False,9,562,771,209
167955,2019-11-08 00:00:00+03:00,out,False,941192,True,7,0,134,134
167955,2019-11-10 00:00:00+03:00,in,False,-1,True,2,0,0,0
167955,2019-11-11 00:00:00+03:00,out,False,941192,True,19,0,481,481
167955,2019-11-11 00:00:00+03:00,out,False,941192,False,33,2771,3343,572
167955,2019-11-11 00:00:00+03:00,in,False,-1,True,20,0,17,17
167955,2019-11-12 00:00:00+03:00,out,False,941192,False,19,1278,1651,373
167955,2019-11-12 00:00:00+03:00,out,False,941192,True,22,0,460,460
167955,2019-11-12 00:00:00+03:00,in,False,-1,True,5,0,0,0
167955,2019-11-13 00:00:00+03:00,out,False,941192,False,22,1268,1769,501
167955,2019-11-13 00:00:00+03:00,out,False,941192,True,12,0,251,251
167955,2019-11-13 00:00:00+03:00,in,False,-1,True,2,0,1,1
167955,2019-11-14 00:00:00+03:00,out,False,941192,False,20,1826,2188,362
167955,2019-11-14 00:00:00+03:00,out,False,941192,True,16,0,361,361
167955,2019-11-14 00:00:00+03:00,in,False,-1,True,10,0,4,4
167955,2019-11-15 00:00:00+03:00,out,False,941192,False,5,374,481,107
167955,2019-11-15 00:00:00+03:00,in,False,-1,True,1,0,0,0
167955,2019-11-15 00:00:00+03:00,out,False,941192,True,16,0,342,342
167955,2019-11-15 00:00:00+03:00,in,False,-1,True,1,0,0,0
167955,2019-11-16 00:00:00+03:00,out,False,941192,False,18,1326,1702,376
167955,2019-11-16 00:00:00+03:00,out,False,941192,True,17,0,273,273
167955,2019-11-16 00:00:00+03:00,in,False,-1,True,5,0,2,2
167955,2019-11-17 00:00:00+03:00,in,False,-1,True,1,0,0,0
167955,2019-11-18 00:00:00+03:00,in,False,-1,True,4,0,1,1
167955,2019-11-18 00:00:00+03:00,out,False,941192,False,15,847,1091,244
167955,2019-11-18 00:00:00+03:00,out,False,941192,True,21,0,335,335
167955,2019-11-18 00:00:00+03:00,out,False,941192,False,15,847,1091,244
167955,2019-11-20 00:00:00+03:00,in,False,-1,True,2,0,0,0
167955,2019-11-20 00:00:00+03:00,out,False,941192,False,36,1990,2579,589
167955,2019-11-20 00:00:00+03:00,out,False,941192,True,43,0,777,777
167955,2019-11-20 00:00:00+03:00,out,False,941192,False,36,1990,2579,589
167955,2019-11-21 00:00:00+03:00,out,False,941192,True,67,0,812,812
167955,2019-11-21 00:00:00+03:00,in,False,-1,True,3,0,2,2
167955,2019-11-21 00:00:00+03:00,out,False,941192,False,20,1373,1729,356
167955,2019-11-22 00:00:00+03:00,out,False,941192,True,54,0,608,608
167955,2019-11-22 00:00:00+03:00,out,False,941192,False,19,1193,1522,329
167955,2019-11-23 00:00:00+03:00,out,False,941192,False,16,1237,1615,378
167955,2019-11-23 00:00:00+03:00,out,False,941192,True,44,0,575,575
167955,2019-11-23 00:00:00+03:00,in,False,-1,True,2,0,0,0
167955,2019-11-24 00:00:00+03:00,in,False,-1,True,1,0,0,0
167955,2019-11-25 00:00:00+03:00,out,False,941192,False,36,2638,3327,689
167955,2019-11-25 00:00:00+03:00,out,False,941192,True,88,0,863,863
167955,2019-11-25 00:00:00+03:00,in,False,-1,True,2,0,0,0
167955,2019-11-25 00:00:00+03:00,in,False,-1,True,2,0,0,0
167955,2019-11-26 00:00:00+03:00,in,False,-1,True,22,0,11,11
167955,2019-11-26 00:00:00+03:00,out,False,941192,False,20,2012,2395,383
167955,2019-11-26 00:00:00+03:00,out,False,941192,True,68,0,765,765
167955,2019-11-27 00:00:00+03:00,in,False,-1,True,4,0,3,3
167955,2019-11-27 00:00:00+03:00,out,False,941192,False,9,882,1029,147
167955,2019-11-27 00:00:00+03:00,out,False,941192,True,52,0,436,436
167955,2019-11-28 00:00:00+03:00,in,False,-1,True,14,0,6,6
167955,2019-11-28 00:00:00+03:00,out,False,941192,False,20,1734,2099,365
167955,2019-11-28 00:00:00+03:00,out,False,941192,True,40,0,558,558
167958,2019-10-12 00:00:00+03:00,in,False,-1,True,1,0,2,2
167958,2019-10-25 00:00:00+03:00,in,False,-1,True,2,0,4,4
167958,2019-10-30 00:00:00+03:00,out,False,951186,True,2,0,0,0
167958,2019-10-30 00:00:00+03:00,in,False,-1,True,14,0,88,88
167958,2019-10-31 00:00:00+03:00,in,False,-1,True,2,0,41,41
167958,2019-10-31 00:00:00+03:00,in,False,951186,False,1,8,18,10
167958,2019-11-01 00:00:00+03:00,in,False,951186,False,2,58,87,29
167958,2019-11-01 00:00:00+03:00,in,False,-1,True,2,0,38,38
167958,2019-11-01 00:00:00+03:00,out,False,951186,True,1,0,18,18
167958,2019-11-01 00:00:00+03:00,out,False,951186,True,1,0,18,18
167958,2019-11-06 00:00:00+03:00,in,False,951186,False,1,13,17,4
167958,2019-11-06 00:00:00+03:00,in,False,-1,True,3,0,22,22
167958,2019-11-10 00:00:00+03:00,in,False,-1,True,1,0,2,2
167958,2019-11-12 00:00:00+03:00,in,False,951186,False,1,79,96,17
167958,2019-11-19 00:00:00+03:00,in,False,-1,True,2,0,13,13
167958,2019-11-20 00:00:00+03:00,in,False,951186,False,17,1053,1198,145
167958,2019-11-20 00:00:00+03:00,in,False,-1,True,14,0,134,134
167958,2019-11-20 00:00:00+03:00,in,False,-1,True,14,0,134,134
167958,2019-11-21 00:00:00+03:00,in,False,951186,False,14,1669,1783,114
167958,2019-11-21 00:00:00+03:00,in,False,-1,True,6,0,40,40
167958,2019-11-22 00:00:00+03:00,in,False,951186,False,19,2021,2171,150
167958,2019-11-22 00:00:00+03:00,in,False,-1,True,7,0,92,92
167958,2019-11-23 00:00:00+03:00,in,False,951186,False,13,853,960,107
167958,2019-11-23 00:00:00+03:00,out,True,969294,True,1,0,1,1
167958,2019-11-23 00:00:00+03:00,out,True,951186,True,2,0,2,2
167958,2019-11-23 00:00:00+03:00,out,False,951186,True,1,0,1,1
167958,2019-11-23 00:00:00+03:00,in,False,-1,True,7,0,146,146
167958,2019-11-24 00:00:00+03:00,in,False,-1,True,2,0,4,4
167958,2019-11-25 00:00:00+03:00,in,False,951186,False,14,1177,1298,121
167958,2019-11-25 00:00:00+03:00,out,False,969294,True,4,0,7,7
167958,2019-11-25 00:00:00+03:00,out,True,969294,True,3,0,57,57
167958,2019-11-25 00:00:00+03:00,out,False,951186,True,2,0,5,5
167958,2019-11-25 00:00:00+03:00,in,False,-1,True,13,0,74,74
167958,2019-11-25 00:00:00+03:00,in,False,969294,False,18,1543,1731,188
167958,2019-11-26 00:00:00+03:00,out,False,969294,True,1,0,50,50
167958,2019-11-26 00:00:00+03:00,out,False,969294,False,2,56,82,26
167958,2019-11-26 00:00:00+03:00,in,False,951186,False,5,405,469,64
167958,2019-11-26 00:00:00+03:00,in,False,969294,False,27,2246,2462,216
167958,2019-11-26 00:00:00+03:00,out,False,969294,False,2,56,82,26
167958,2019-11-27 00:00:00+03:00,out,False,969294,False,1,53,66,13
167958,2019-11-27 00:00:00+03:00,in,False,951186,False,4,649,677,28
167958,2019-11-27 00:00:00+03:00,in,False,969294,False,23,2274,2442,168
167958,2019-11-27 00:00:00+03:00,in,False,-1,True,2,0,16,16
167958,2019-11-28 00:00:00+03:00,in,False,-1,True,2,0,6,6
167958,2019-11-28 00:00:00+03:00,in,False,951186,False,1,137,140,3
167958,2019-11-28 00:00:00+03:00,in,False,969294,False,16,1416,1554,138
167969,2019-10-10 00:00:00+03:00,in,False,932754,False,1,9,14,5
167969,2019-10-10 00:00:00+03:00,in,False,-1,True,8,0,136,136
167969,2019-10-10 00:00:00+03:00,in,False,932750,False,4,1806,1838,32
167969,2019-10-10 00:00:00+03:00,out,False,932754,False,1,14,24,10
167969,2019-10-10 00:00:00+03:00,out,False,932750,True,3,0,50,50
167969,2019-10-10 00:00:00+03:00,out,False,932750,False,5,89,177,88
167969,2019-10-15 00:00:00+03:00,out,False,932754,True,1,0,12,12
167969,2019-10-25 00:00:00+03:00,out,False,932750,True,2,0,9,9
167969,2019-10-27 00:00:00+03:00,out,False,932754,True,1,0,9,9
167969,2019-10-27 00:00:00+03:00,in,False,946582,False,1,23,24,1
167969,2019-10-30 00:00:00+03:00,out,False,946582,False,1,306,324,18
167969,2019-11-18 00:00:00+03:00,in,False,932754,False,1,45,51,6
167969,2019-11-18 00:00:00+03:00,out,False,946582,False,3,303,347,44
167969,2019-11-18 00:00:00+03:00,in,False,946582,False,2,42,44,2
167969,2019-11-18 00:00:00+03:00,out,False,932750,True,1,0,19,19
167969,2019-11-19 00:00:00+03:00,in,False,-1,True,13,0,545,545
167969,2019-11-19 00:00:00+03:00,out,False,946582,True,1,0,2,2
167969,2019-11-19 00:00:00+03:00,in,False,946582,False,1,40,41,1
167969,2019-11-19 00:00:00+03:00,out,False,932750,True,1,0,24,24
167969,2019-11-19 00:00:00+03:00,out,False,946582,False,4,81,206,125
167969,2019-11-19 00:00:00+03:00,in,False,932750,False,2,33,50,17
167969,2019-11-19 00:00:00+03:00,out,False,932750,False,2,147,176,29
167969,2019-11-19 00:00:00+03:00,out,False,946582,True,1,0,2,2
167969,2019-11-21 00:00:00+03:00,out,False,946582,False,2,6,20,14
167969,2019-11-21 00:00:00+03:00,in,False,946582,False,3,195,198,3
167969,2019-11-21 00:00:00+03:00,in,False,-1,True,1,0,1,1
167969,2019-11-21 00:00:00+03:00,out,False,946582,True,1,0,1,1
167969,2019-11-22 00:00:00+03:00,out,False,946582,True,2,0,23,23
167969,2019-11-22 00:00:00+03:00,in,False,946582,False,8,795,803,8
167969,2019-11-22 00:00:00+03:00,in,False,-1,True,1,0,28,28
167969,2019-11-22 00:00:00+03:00,in,False,932750,False,1,136,144,8
167969,2019-11-22 00:00:00+03:00,out,False,946582,False,3,366,414,48
167969,2019-11-23 00:00:00+03:00,in,False,946582,False,2,158,160,2
167969,2019-11-25 00:00:00+03:00,in,False,946582,False,1,179,180,1
167969,2019-11-26 00:00:00+03:00,in,False,946582,False,4,188,191,3
167969,2019-11-26 00:00:00+03:00,out,False,946582,True,1,0,7,7
167969,2019-11-26 00:00:00+03:00,out,False,946582,False,1,146,158,12
167969,2019-11-26 00:00:00+03:00,in,False,-1,True,5,0,134,134
167969,2019-11-26 00:00:00+03:00,in,False,932750,False,2,105,121,16
167969,2019-11-26 00:00:00+03:00,out,False,932750,False,1,151,160,9
167969,2019-11-26 00:00:00+03:00,in,False,-1,True,5,0,134,134
167969,2019-11-27 00:00:00+03:00,out,False,932750,False,2,66,93,27
167969,2019-11-27 00:00:00+03:00,out,False,946582,True,5,0,56,56
167969,2019-11-27 00:00:00+03:00,out,False,946582,False,2,225,251,26
167969,2019-11-27 00:00:00+03:00,in,False,932750,False,3,291,333,42
167969,2019-11-27 00:00:00+03:00,in,False,946582,False,18,1805,1860,55
167969,2019-11-27 00:00:00+03:00,out,False,946582,True,5,0,56,56
167969,2019-11-28 00:00:00+03:00,in,False,-1,True,4,0,179,179
167969,2019-11-28 00:00:00+03:00,out,False,946582,False,1,174,184,10
167969,2019-11-28 00:00:00+03:00,in,False,946582,False,4,396,400,4
167976,2019-10-11 00:00:00+03:00,in,False,934430,False,2,29,88,59
167976,2019-10-12 00:00:00+03:00,in,False,934430,False,1,15,33,18
167976,2019-10-12 00:00:00+03:00,in,False,-1,True,2,0,11,11
167976,2019-10-14 00:00:00+03:00,in,False,934428,False,4,74,169,95
167976,2019-10-14 00:00:00+03:00,in,False,934430,False,1,22,41,19
167976,2019-10-14 00:00:00+03:00,in,False,-1,True,3,0,49,49
167976,2019-10-15 00:00:00+03:00,in,False,934428,False,2,223,272,49
167976,2019-10-15 00:00:00+03:00,in,False,934430,False,1,410,451,41
167976,2019-10-15 00:00:00+03:00,in,False,-1,True,1,0,39,39
167976,2019-10-16 00:00:00+03:00,in,False,934428,False,1,10,31,21
167976,2019-10-16 00:00:00+03:00,in,False,934430,False,1,44,66,22
167976,2019-10-17 00:00:00+03:00,in,False,934428,False,2,81,129,48
167976,2019-10-19 00:00:00+03:00,in,False,934432,False,1,3,36,33
167976,2019-10-20 00:00:00+03:00,in,False,-1,True,1,0,46,46
167976,2019-10-22 00:00:00+03:00,in,False,934428,False,1,25,49,24
167976,2019-10-22 00:00:00+03:00,in,False,934424,False,1,48,75,27
167976,2019-10-22 00:00:00+03:00,in,False,-1,True,2,0,36,36
167976,2019-10-22 00:00:00+03:00,in,False,-1,True,2,0,36,36
167976,2019-10-22 00:00:00+03:00,in,False,934424,False,1,48,75,27
167976,2019-10-23 00:00:00+03:00,in,False,934430,False,1,103,128,25
167976,2019-10-23 00:00:00+03:00,in,False,934430,False,1,103,128,25
167976,2019-10-24 00:00:00+03:00,in,False,934430,False,2,143,228,85
167976,2019-10-24 00:00:00+03:00,in,False,934428,False,1,29,53,24
167976,2019-10-24 00:00:00+03:00,in,False,934424,False,1,27,52,25
167976,2019-10-25 00:00:00+03:00,in,False,934428,False,2,157,208,51
167976,2019-10-27 00:00:00+03:00,in,False,-1,True,1,0,2,2
167976,2019-10-28 00:00:00+03:00,in,False,934428,False,2,104,151,47
167976,2019-10-29 00:00:00+03:00,in,False,934428,False,2,153,198,45
167976,2019-10-29 00:00:00+03:00,in,False,934428,False,2,153,198,45
167976,2019-10-30 00:00:00+03:00,in,False,934428,False,2,139,185,46
167976,2019-10-30 00:00:00+03:00,in,False,934428,False,2,139,185,46
167976,2019-10-31 00:00:00+03:00,in,False,934430,False,1,1073,1092,19
167976,2019-10-31 00:00:00+03:00,in,False,-1,True,2,0,83,83
167976,2019-11-02 00:00:00+03:00,in,False,934430,False,1,610,627,17
167976,2019-11-04 00:00:00+03:00,in,False,-1,True,1,0,2,2
167976,2019-11-05 00:00:00+03:00,in,False,934430,False,1,42,66,24
167976,2019-11-06 00:00:00+03:00,in,False,934428,False,2,273,319,46
167976,2019-11-06 00:00:00+03:00,in,False,934424,False,1,29,59,30
167976,2019-11-06 00:00:00+03:00,in,False,934424,False,1,29,59,30
167976,2019-11-07 00:00:00+03:00,in,False,934428,False,2,540,587,47
167976,2019-11-08 00:00:00+03:00,in,False,934430,False,1,399,421,22
167976,2019-11-08 00:00:00+03:00,in,False,934428,False,2,306,355,49
167976,2019-11-09 00:00:00+03:00,in,False,934432,False,1,13,48,35
167976,2019-11-10 00:00:00+03:00,in,False,934432,False,1,4,38,34
167976,2019-11-10 00:00:00+03:00,in,False,-1,True,1,0,46,46
167976,2019-11-11 00:00:00+03:00,in,False,934428,False,3,416,488,72
167976,2019-11-11 00:00:00+03:00,in,False,934430,False,1,6,44,38
167976,2019-11-11 00:00:00+03:00,in,False,934424,False,2,131,188,57
167976,2019-11-12 00:00:00+03:00,in,False,934428,False,1,210,232,22
167976,2019-11-12 00:00:00+03:00,in,False,934424,False,1,4,29,25
167976,2019-11-12 00:00:00+03:00,in,False,934430,True,1,0,26,26
167976,2019-11-12 00:00:00+03:00,in,False,934430,True,1,0,26,26
167976,2019-11-13 00:00:00+03:00,in,False,934428,False,1,322,343,21
167976,2019-11-13 00:00:00+03:00,in,False,934430,False,1,15,26,11
167976,2019-11-13 00:00:00+03:00,in,False,-1,True,1,0,31,31
167976,2019-11-14 00:00:00+03:00,in,False,-1,True,2,0,55,55
167976,2019-11-14 00:00:00+03:00,in,False,934430,False,1,101,122,21
167976,2019-11-14 00:00:00+03:00,in,False,934428,False,2,455,502,47
167976,2019-11-14 00:00:00+03:00,in,False,934430,False,1,101,122,21
167976,2019-11-15 00:00:00+03:00,in,False,934428,False,1,25,51,26
167976,2019-11-15 00:00:00+03:00,in,False,934430,False,1,282,324,42
167976,2019-11-15 00:00:00+03:00,in,False,-1,True,1,0,2,2
167976,2019-11-15 00:00:00+03:00,in,False,934428,False,1,25,51,26
167976,2019-11-16 00:00:00+03:00,in,False,934432,False,1,362,403,41
167976,2019-11-17 00:00:00+03:00,in,False,934430,False,1,71,88,17
167976,2019-11-21 00:00:00+03:00,in,False,934430,False,1,76,94,18
167976,2019-11-21 00:00:00+03:00,in,False,934428,False,1,428,450,22
167976,2019-11-22 00:00:00+03:00,in,False,-1,True,1,0,40,40
167976,2019-11-22 00:00:00+03:00,in,False,934430,False,1,139,170,31
167976,2019-11-23 00:00:00+03:00,in,False,934430,False,2,245,278,33
167976,2019-11-23 00:00:00+03:00,in,False,-1,True,1,0,1,1
167976,2019-11-23 00:00:00+03:00,in,False,934432,False,3,224,331,107
167976,2019-11-24 00:00:00+03:00,in,False,934432,False,1,361,398,37
167976,2019-11-24 00:00:00+03:00,in,False,934432,False,1,361,398,37
167976,2019-11-25 00:00:00+03:00,in,False,934428,False,1,97,120,23
167976,2019-11-26 00:00:00+03:00,in,False,934430,False,4,42,207,165
167976,2019-11-27 00:00:00+03:00,in,False,934430,False,1,673,694,21
167976,2019-11-27 00:00:00+03:00,in,False,934428,False,1,1207,1232,25
167977,2019-10-10 00:00:00+03:00,in,False,-1,True,1,0,2,2
167977,2019-10-11 00:00:00+03:00,in,False,-1,True,1,0,2,2
167977,2019-10-12 00:00:00+03:00,in,False,-1,True,1,0,2,2
167977,2019-10-15 00:00:00+03:00,in,False,-1,True,2,0,5,5
167977,2019-10-16 00:00:00+03:00,in,False,-1,True,1,0,2,2
167977,2019-10-17 00:00:00+03:00,in,False,-1,True,1,0,2,2
167977,2019-10-18 00:00:00+03:00,in,False,-1,True,1,0,2,2
167977,2019-10-21 00:00:00+03:00,in,False,-1,True,1,0,2,2
167977,2019-10-22 00:00:00+03:00,in,False,-1,True,1,0,2,2
167977,2019-10-22 00:00:00+03:00,in,False,-1,True,1,0,2,2
167977,2019-10-23 00:00:00+03:00,in,False,-1,True,13,0,414,414
167977,2019-10-23 00:00:00+03:00,out,False,944220,True,1,0,2,2
167977,2019-10-23 00:00:00+03:00,in,False,944226,False,4,1235,1464,229
167977,2019-10-23 00:00:00+03:00,out,False,944226,False,7,536,619,83
167977,2019-10-23 00:00:00+03:00,in,False,944218,False,10,1446,1717,271
167977,2019-10-23 00:00:00+03:00,out,False,944226,True,1,0,9,9
167977,2019-10-23 00:00:00+03:00,in,False,944220,True,2,0,65,65
167977,2019-10-23 00:00:00+03:00,in,False,944220,False,7,968,1201,233
167977,2019-10-23 00:00:00+03:00,in,False,944220,False,7,968,1201,233
167977,2019-10-23 00:00:00+03:00,out,False,944226,False,7,536,619,83
167977,2019-10-24 00:00:00+03:00,out,False,944220,True,1,0,18,18
167977,2019-10-24 00:00:00+03:00,in,False,944218,True,2,0,80,80
167977,2019-10-24 00:00:00+03:00,out,False,944226,False,7,353,401,48
167977,2019-10-24 00:00:00+03:00,in,False,944226,True,4,0,163,163
167977,2019-10-24 00:00:00+03:00,in,False,-1,True,19,0,502,502
167977,2019-10-24 00:00:00+03:00,in,False,944222,True,1,0,16,16
167977,2019-10-24 00:00:00+03:00,in,False,944218,False,10,1054,1455,401
167977,2019-10-24 00:00:00+03:00,in,False,944226,False,8,588,929,341
167977,2019-10-24 00:00:00+03:00,in,False,944220,False,10,1008,1407,399
167977,2019-10-24 00:00:00+03:00,in,False,944222,False,2,121,196,75
167977,2019-10-24 00:00:00+03:00,in,False,944216,False,4,128,259,131
167977,2019-10-24 00:00:00+03:00,out,False,944220,False,1,378,386,8
167977,2019-10-24 00:00:00+03:00,out,False,944226,True,1,0,33,33
167977,2019-10-24 00:00:00+03:00,out,False,944226,False,7,353,401,48
167977,2019-10-24 00:00:00+03:00,in,False,944218,False,10,1054,1455,401
167977,2019-10-24 00:00:00+03:00,in,False,944220,False,10,1008,1407,399
167977,2019-10-24 00:00:00+03:00,out,False,944220,True,1,0,18,18
167977,2019-10-25 00:00:00+03:00,out,False,944216,False,1,566,576,10
167977,2019-10-25 00:00:00+03:00,out,False,944226,False,8,1195,1324,129
167977,2019-10-25 00:00:00+03:00,in,False,944218,False,5,928,1251,323
167977,2019-10-25 00:00:00+03:00,in,False,944216,False,5,329,553,224
167977,2019-10-25 00:00:00+03:00,in,False,944216,True,1,0,78,78
167977,2019-10-25 00:00:00+03:00,in,False,-1,True,10,0,385,385
167977,2019-10-25 00:00:00+03:00,out,False,944222,False,5,375,457,82
167977,2019-10-25 00:00:00+03:00,in,False,944226,True,1,0,17,17
167977,2019-10-25 00:00:00+03:00,in,False,944226,False,8,853,1183,330
167977,2019-10-25 00:00:00+03:00,in,False,944220,True,1,0,26,26
167977,2019-10-25 00:00:00+03:00,out,False,944226,True,5,0,173,173
167977,2019-10-25 00:00:00+03:00,in,False,944222,False,6,1388,1632,244
167977,2019-10-25 00:00:00+03:00,in,False,944220,False,5,385,533,148
167977,2019-10-25 00:00:00+03:00,in,False,944216,False,5,329,553,224
167977,2019-10-26 00:00:00+03:00,in,False,944220,False,7,687,968,281
167977,2019-10-26 00:00:00+03:00,out,False,944226,False,6,258,353,95
167977,2019-10-26 00:00:00+03:00,in,False,944222,True,1,0,63,63
167977,2019-10-26 00:00:00+03:00,in,False,944222,False,3,216,328,112
167977,2019-10-26 00:00:00+03:00,in,False,944216,False,3,292,414,122
167977,2019-10-26 00:00:00+03:00,in,False,944226,False,2,143,214,71
167977,2019-10-26 00:00:00+03:00,in,False,-1,True,4,0,177,177
167977,2019-10-26 00:00:00+03:00,out,False,944222,False,1,20,44,24
167977,2019-10-26 00:00:00+03:00,in,False,944218,False,5,713,859,146
167977,2019-10-26 00:00:00+03:00,out,False,944226,False,6,258,353,95
167977,2019-10-26 00:00:00+03:00,in,False,944220,False,7,687,968,281
167977,2019-10-27 00:00:00+03:00,out,False,944226,False,2,73,119,46
167977,2019-10-27 00:00:00+03:00,in,False,944220,True,2,0,104,104
167977,2019-10-27 00:00:00+03:00,in,False,944216,False,1,77,108,31
167977,2019-10-27 00:00:00+03:00,in,False,944226,False,4,622,801,179
167977,2019-10-27 00:00:00+03:00,in,False,-1,True,2,0,119,119
167977,2019-10-27 00:00:00+03:00,out,False,944226,True,2,0,51,51
167977,2019-10-27 00:00:00+03:00,in,False,944216,True,1,0,29,29
167977,2019-10-27 00:00:00+03:00,in,False,944218,False,3,869,1003,134
167977,2019-10-27 00:00:00+03:00,out,False,944216,False,1,78,90,12
167977,2019-10-27 00:00:00+03:00,in,False,944220,False,1,33,70,37
167977,2019-10-27 00:00:00+03:00,out,False,944220,False,1,3,40,37
167977,2019-10-27 00:00:00+03:00,in,False,944218,True,1,0,38,38
167977,2019-10-28 00:00:00+03:00,out,False,944222,True,21,0,365,365
167977,2019-10-28 00:00:00+03:00,out,False,944220,False,2,198,242,44
167977,2019-10-28 00:00:00+03:00,out,False,944216,False,3,159,192,33
167977,2019-10-28 00:00:00+03:00,out,False,944220,True,2,0,73,73
167977,2019-10-28 00:00:00+03:00,out,False,944226,False,2,46,66,20
167977,2019-10-28 00:00:00+03:00,in,False,944226,False,8,4062,4446,384
167977,2019-10-28 00:00:00+03:00,in,False,944222,False,2,454,541,87
167977,2019-10-28 00:00:00+03:00,out,False,944222,False,20,1345,1613,268
167977,2019-10-28 00:00:00+03:00,in,False,944220,False,4,464,602,138
167977,2019-10-28 00:00:00+03:00,in,False,-1,True,4,0,168,168
167977,2019-10-28 00:00:00+03:00,in,False,944218,False,5,1289,1511,222
167977,2019-10-28 00:00:00+03:00,in,False,944216,False,4,573,726,153
167977,2019-10-28 00:00:00+03:00,out,False,944218,False,4,432,475,43
167977,2019-10-28 00:00:00+03:00,out,False,944226,True,1,0,9,9
167977,2019-10-28 00:00:00+03:00,in,False,944218,False,5,1289,1511,222
167977,2019-10-28 00:00:00+03:00,out,False,944226,True,1,0,9,9
167977,2019-10-28 00:00:00+03:00,out,False,944220,False,2,198,242,44
167977,2019-10-29 00:00:00+03:00,out,False,944216,False,4,178,227,49
167977,2019-10-29 00:00:00+03:00,in,False,944218,False,5,295,488,193
167977,2019-10-29 00:00:00+03:00,out,False,944218,True,1,0,31,31
167977,2019-10-29 00:00:00+03:00,out,False,944220,False,4,348,416,68
167977,2019-10-29 00:00:00+03:00,out,False,944216,True,3,0,6,6
167977,2019-10-29 00:00:00+03:00,in,False,944216,False,5,342,494,152
167977,2019-10-29 00:00:00+03:00,out,False,944218,False,2,98,133,35
167977,2019-10-29 00:00:00+03:00,in,False,944220,False,10,1141,1586,445
167977,2019-10-29 00:00:00+03:00,in,False,944216,True,1,0,45,45
167977,2019-10-29 00:00:00+03:00,in,False,944218,True,1,0,31,31
167977,2019-10-29 00:00:00+03:00,out,False,944222,False,25,2383,2660,277
167977,2019-10-29 00:00:00+03:00,in,False,944220,True,2,0,67,67
167977,2019-10-29 00:00:00+03:00,out,False,944222,True,3,0,58,58
167977,2019-10-29 00:00:00+03:00,out,False,944226,False,1,31,48,17
167977,2019-10-29 00:00:00+03:00,out,False,944226,True,1,0,26,26
167977,2019-10-29 00:00:00+03:00,in,False,944226,True,2,0,87,87
167977,2019-10-29 00:00:00+03:00,in,False,944226,False,2,210,295,85
167977,2019-10-29 00:00:00+03:00,in,False,-1,True,6,0,168,168
167977,2019-10-29 00:00:00+03:00,out,False,944220,True,1,0,20,20
167977,2019-10-29 00:00:00+03:00,in,False,944222,False,7,1085,1353,268
167977,2019-10-29 00:00:00+03:00,out,False,944220,False,4,348,416,68
167977,2019-10-29 00:00:00+03:00,out,False,944226,False,1,31,48,17
167977,2019-10-29 00:00:00+03:00,in,False,944222,False,7,1085,1353,268
167977,2019-10-29 00:00:00+03:00,in,False,944216,False,5,342,494,152
167977,2019-10-29 00:00:00+03:00,out,False,944218,True,1,0,31,31
167977,2019-10-29 00:00:00+03:00,out,False,944222,True,3,0,58,58
167977,2019-10-30 00:00:00+03:00,in,False,944218,False,10,1812,2213,401
167977,2019-10-30 00:00:00+03:00,in,False,944222,True,3,0,53,53
167977,2019-10-30 00:00:00+03:00,out,False,944226,True,2,0,67,67
167977,2019-10-30 00:00:00+03:00,in,False,944216,True,1,46,72,26
167977,2019-10-30 00:00:00+03:00,in,False,944216,False,8,1854,2137,283
167977,2019-10-30 00:00:00+03:00,in,False,-1,True,10,0,383,383
167977,2019-10-30 00:00:00+03:00,in,False,944222,False,6,809,1053,244
167977,2019-10-30 00:00:00+03:00,in,False,944226,False,3,662,797,135
167977,2019-10-30 00:00:00+03:00,out,False,944220,False,1,8,22,14
167977,2019-10-30 00:00:00+03:00,in,False,944220,False,5,1191,1325,134
167977,2019-10-30 00:00:00+03:00,out,False,944222,False,3,284,330,46
167977,2019-10-30 00:00:00+03:00,out,False,944226,False,10,823,941,118
167977,2019-10-30 00:00:00+03:00,out,False,944218,False,1,33,55,22
167977,2019-10-30 00:00:00+03:00,in,False,944220,True,1,0,44,44
167977,2019-10-30 00:00:00+03:00,out,False,944216,False,1,49,66,17
167977,2019-10-30 00:00:00+03:00,in,False,944226,True,4,0,85,85
167977,2019-10-30 00:00:00+03:00,in,False,944220,False,5,1191,1325,134
167977,2019-10-31 00:00:00+03:00,out,False,944216,True,3,0,29,29
167977,2019-10-31 00:00:00+03:00,out,False,944222,False,9,1136,1268,132
167977,2019-10-31 00:00:00+03:00,out,False,944218,True,3,0,91,91
167977,2019-10-31 00:00:00+03:00,in,False,944220,False,12,1758,2300,542
167977,2019-10-31 00:00:00+03:00,in,False,944222,False,5,463,653,190
167977,2019-10-31 00:00:00+03:00,out,False,944222,True,1,0,20,20
167977,2019-10-31 00:00:00+03:00,in,False,944216,False,7,774,1011,237
167977,2019-10-31 00:00:00+03:00,in,False,944216,True,1,0,105,105
167977,2019-10-31 00:00:00+03:00,out,False,944220,True,1,0,60,60
167977,2019-10-31 00:00:00+03:00,in,False,-1,True,8,0,237,237
167977,2019-10-31 00:00:00+03:00,out,False,944216,False,6,635,687,52
167977,2019-10-31 00:00:00+03:00,in,False,944226,False,3,186,309,123
167977,2019-10-31 00:00:00+03:00,in,False,944218,False,7,749,1062,313
167977,2019-10-31 00:00:00+03:00,out,False,944220,False,3,1196,1222,26
167977,2019-10-31 00:00:00+03:00,out,False,944226,False,9,584,728,144
167977,2019-10-31 00:00:00+03:00,out,False,944218,False,3,882,910,28
167977,2019-10-31 00:00:00+03:00,out,False,944226,True,1,0,6,6
167977,2019-10-31 00:00:00+03:00,out,False,944220,False,3,1196,1222,26
167977,2019-11-01 00:00:00+03:00,out,False,944220,True,3,0,13,13
167977,2019-11-01 00:00:00+03:00,out,False,944218,False,6,748,810,62
167977,2019-11-01 00:00:00+03:00,in,False,944218,True,1,60,93,33
167977,2019-11-01 00:00:00+03:00,in,False,-1,True,9,0,241,241
167977,2019-11-01 00:00:00+03:00,in,False,944218,False,9,1663,2049,386
167977,2019-11-01 00:00:00+03:00,in,False,944226,False,8,1823,2063,240
167977,2019-11-01 00:00:00+03:00,out,False,944220,False,8,496,654,158
167977,2019-11-01 00:00:00+03:00,out,False,944216,True,2,0,42,42
167977,2019-11-01 00:00:00+03:00,out,False,944222,True,2,0,39,39
167977,2019-11-01 00:00:00+03:00,out,False,944222,False,11,729,902,173
167977,2019-11-01 00:00:00+03:00,out,False,944226,False,2,61,81,20
167977,2019-11-01 00:00:00+03:00,out,False,944216,False,4,837,883,46
167977,2019-11-01 00:00:00+03:00,in,False,944220,False,11,791,1170,379
167977,2019-11-01 00:00:00+03:00,in,False,944216,False,10,888,1234,346
167977,2019-11-01 00:00:00+03:00,in,False,944222,False,5,554,727,173
167977,2019-11-01 00:00:00+03:00,in,False,944218,True,1,60,93,33
167977,2019-11-02 00:00:00+03:00,in,False,-1,True,3,0,200,200
167977,2019-11-02 00:00:00+03:00,in,False,944226,False,1,29,64,35
167977,2019-11-02 00:00:00+03:00,out,False,944218,False,4,174,228,54
167977,2019-11-02 00:00:00+03:00,out,False,944220,True,3,0,113,113
167977,2019-11-02 00:00:00+03:00,out,False,944226,False,1,14,31,17
167977,2019-11-02 00:00:00+03:00,in,False,944216,False,5,362,558,196
167977,2019-11-02 00:00:00+03:00,in,False,944218,False,2,432,485,53
167977,2019-11-02 00:00:00+03:00,in,False,944220,False,2,1069,1174,105
167977,2019-11-02 00:00:00+03:00,out,False,944220,False,1,105,114,9
167977,2019-11-02 00:00:00+03:00,in,False,944222,False,1,359,395,36
167977,2019-11-02 00:00:00+03:00,out,False,944218,True,2,0,16,16
167977,2019-11-02 00:00:00+03:00,out,False,944220,False,1,105,114,9
167977,2019-11-02 00:00:00+03:00,in,False,-1,True,3,0,200,200
167977,2019-11-02 00:00:00+03:00,out,False,944218,True,2,0,16,16
167977,2019-11-03 00:00:00+03:00,in,False,944218,False,1,16,62,46
167977,2019-11-03 00:00:00+03:00,out,False,944220,True,2,0,101,101
167977,2019-11-03 00:00:00+03:00,in,False,944226,False,1,279,318,39
167977,2019-11-03 00:00:00+03:00,in,False,-1,True,3,0,149,149
167977,2019-11-03 00:00:00+03:00,in,False,944220,False,4,1199,1355,156
167977,2019-11-03 00:00:00+03:00,in,False,944218,True,1,0,40,40
167977,2019-11-03 00:00:00+03:00,in,False,944220,True,2,0,157,157
167977,2019-11-03 00:00:00+03:00,in,False,944216,True,2,0,120,120
167977,2019-11-03 00:00:00+03:00,in,False,944222,False,1,445,483,38
167977,2019-11-03 00:00:00+03:00,in,False,-1,True,3,0,149,149
167977,2019-11-04 00:00:00+03:00,in,False,-1,True,1,0,6,6
167977,2019-11-04 00:00:00+03:00,in,False,944226,False,1,108,143,35
167977,2019-11-04 00:00:00+03:00,out,False,944216,False,3,188,225,37
167977,2019-11-04 00:00:00+03:00,in,False,-1,True,1,0,12,12
167977,2019-11-04 00:00:00+03:00,out,False,944222,False,1,109,119,10
167977,2019-11-04 00:00:00+03:00,out,False,944220,False,2,40,97,57
167977,2019-11-04 00:00:00+03:00,in,False,944218,False,2,90,167,77
167977,2019-11-04 00:00:00+03:00,in,False,944222,False,1,242,269,27
167977,2019-11-04 00:00:00+03:00,out,False,944220,True,6,0,185,185
167977,2019-11-04 00:00:00+03:00,in,False,944216,False,3,142,218,76
167977,2019-11-04 00:00:00+03:00,out,False,944222,True,2,0,94,94
167977,2019-11-04 00:00:00+03:00,in,False,944220,False,3,289,387,98
167977,2019-11-04 00:00:00+03:00,in,False,944226,False,1,108,143,35
167977,2019-11-04 00:00:00+03:00,in,False,944216,False,3,142,218,76
167977,2019-11-05 00:00:00+03:00,out,False,944226,False,2,315,334,19
167977,2019-11-05 00:00:00+03:00,out,False,944220,True,5,0,13,13
167977,2019-11-05 00:00:00+03:00,in,False,944220,False,9,622,899,277
167977,2019-11-05 00:00:00+03:00,in,False,944226,False,5,515,697,182
167977,2019-11-05 00:00:00+03:00,out,False,944220,False,9,857,997,140
167977,2019-11-05 00:00:00+03:00,out,False,944216,False,4,345,378,33
167977,2019-11-05 00:00:00+03:00,in,False,944218,True,1,0,30,30
167977,2019-11-05 00:00:00+03:00,out,False,944218,False,3,117,156,39
167977,2019-11-05 00:00:00+03:00,in,False,944222,False,5,887,1064,177
167977,2019-11-05 00:00:00+03:00,in,False,944216,False,5,878,1072,194
167977,2019-11-05 00:00:00+03:00,in,False,944218,False,6,563,787,224
167977,2019-11-05 00:00:00+03:00,out,False,944222,False,11,946,1133,187
167977,2019-11-05 00:00:00+03:00,out,False,944222,True,4,0,68,68
167977,2019-11-05 00:00:00+03:00,in,False,-1,True,9,0,240,240
167977,2019-11-05 00:00:00+03:00,out,False,944226,False,2,315,334,19
167977,2019-11-05 00:00:00+03:00,out,False,944222,True,4,0,68,68
167977,2019-11-06 00:00:00+03:00,out,False,944226,True,1,0,39,39
167977,2019-11-06 00:00:00+03:00,in,False,944226,False,6,690,890,200
167977,2019-11-06 00:00:00+03:00,in,False,944222,False,4,212,333,121
167977,2019-11-06 00:00:00+03:00,in,False,944218,False,5,328,457,129
167977,2019-11-06 00:00:00+03:00,in,False,944216,False,7,1424,1636,212
167977,2019-11-06 00:00:00+03:00,in,False,944220,False,9,1045,1359,314
167977,2019-11-06 00:00:00+03:00,out,False,944226,False,3,126,136,10
167977,2019-11-06 00:00:00+03:00,out,False,944222,True,1,0,5,5
167977,2019-11-06 00:00:00+03:00,out,False,944222,False,8,1391,1502,111
167977,2019-11-06 00:00:00+03:00,in,False,-1,True,3,0,41,41
167977,2019-11-06 00:00:00+03:00,out,False,944218,False,7,962,1029,67
167977,2019-11-06 00:00:00+03:00,in,False,944222,True,1,0,16,16
167977,2019-11-06 00:00:00+03:00,out,False,944220,True,3,0,100,100
167977,2019-11-06 00:00:00+03:00,out,False,944220,False,4,312,360,48
167977,2019-11-06 00:00:00+03:00,in,False,944216,True,1,0,75,75
167977,2019-11-06 00:00:00+03:00,out,False,944216,False,6,504,574,70
167977,2019-11-06 00:00:00+03:00,out,False,944218,True,1,0,26,26
167977,2019-11-06 00:00:00+03:00,out,False,944218,False,7,962,1029,67
167977,2019-11-06 00:00:00+03:00,in,False,944226,False,6,690,890,200
167977,2019-11-07 00:00:00+03:00,out,False,944222,False,7,533,611,78
167977,2019-11-07 00:00:00+03:00,out,False,944220,False,2,130,154,24
167977,2019-11-07 00:00:00+03:00,in,False,944218,False,7,632,921,289
167977,2019-11-07 00:00:00+03:00,in,False,944216,False,6,657,909,252
167977,2019-11-07 00:00:00+03:00,out,False,944216,False,7,664,807,143
167977,2019-11-07 00:00:00+03:00,out,False,944216,True,2,0,26,26
167977,2019-11-07 00:00:00+03:00,in,False,-1,True,7,0,203,203
167977,2019-11-07 00:00:00+03:00,in,False,944220,False,6,384,585,201
167977,2019-11-07 00:00:00+03:00,in,False,944222,False,7,770,971,201
167977,2019-11-07 00:00:00+03:00,in,False,944226,False,3,236,328,92
167977,2019-11-07 00:00:00+03:00,out,False,944218,False,3,196,213,17
167977,2019-11-07 00:00:00+03:00,out,False,944218,True,2,0,50,50
167977,2019-11-08 00:00:00+03:00,in,False,944216,False,6,1111,1307,196
167977,2019-11-08 00:00:00+03:00,in,False,944226,False,8,1311,1605,294
167977,2019-11-08 00:00:00+03:00,out,False,944220,False,4,109,175,66
167977,2019-11-08 00:00:00+03:00,in,False,-1,True,13,0,392,392
167977,2019-11-08 00:00:00+03:00,out,False,944226,False,1,41,52,11
167977,2019-11-08 00:00:00+03:00,out,False,944218,False,7,589,666,77
167977,2019-11-08 00:00:00+03:00,in,False,944226,True,8,0,678,678
167977,2019-11-08 00:00:00+03:00,in,False,944218,False,10,1009,1369,360
167977,2019-11-08 00:00:00+03:00,in,False,944222,False,2,70,171,101
167977,2019-11-08 00:00:00+03:00,out,False,944216,False,2,174,197,23
167977,2019-11-08 00:00:00+03:00,in,False,944220,False,6,619,829,210
167977,2019-11-08 00:00:00+03:00,in,False,944226,True,8,0,678,678
167977,2019-11-08 00:00:00+03:00,in,False,-1,True,13,0,392,392
167977,2019-11-09 00:00:00+03:00,in,False,944216,False,8,741,1000,259
167977,2019-11-09 00:00:00+03:00,out,False,944220,False,1,204,211,7
167977,2019-11-09 00:00:00+03:00,in,False,944218,False,5,821,982,161
167977,2019-11-09 00:00:00+03:00,out,False,944216,True,1,0,33,33
167977,2019-11-09 00:00:00+03:00,in,False,944218,True,2,0,102,102
167977,2019-11-09 00:00:00+03:00,in,False,944226,True,1,0,80,80
167977,2019-11-09 00:00:00+03:00,in,False,944220,True,1,0,79,79
167977,2019-11-09 00:00:00+03:00,in,False,944216,True,2,0,95,95
167977,2019-11-09 00:00:00+03:00,in,False,-1,True,4,0,61,61
167977,2019-11-09 00:00:00+03:00,in,False,944220,False,4,1700,1833,133
167977,2019-11-09 00:00:00+03:00,out,False,944218,True,1,0,8,8
167977,2019-11-09 00:00:00+03:00,out,False,944218,False,1,151,160,9
167977,2019-11-09 00:00:00+03:00,in,False,944226,False,5,721,910,189
167977,2019-11-09 00:00:00+03:00,in,False,944216,True,2,0,95,95
167977,2019-11-09 00:00:00+03:00,in,False,944220,False,4,1700,1833,133
167977,2019-11-10 00:00:00+03:00,in,False,944222,False,4,1018,1137,119
167977,2019-11-10 00:00:00+03:00,out,False,944216,True,2,0,25,25
167977,2019-11-10 00:00:00+03:00,in,False,944220,False,2,568,650,82
167977,2019-11-10 00:00:00+03:00,out,False,944222,True,1,0,18,18
167977,2019-11-10 00:00:00+03:00,out,False,944222,False,3,30,59,29
167977,2019-11-10 00:00:00+03:00,out,False,944218,True,4,0,57,57
167977,2019-11-10 00:00:00+03:00,in,False,944216,False,2,304,368,64
167977,2019-11-10 00:00:00+03:00,in,False,944226,False,4,397,555,158
167977,2019-11-10 00:00:00+03:00,out,False,944220,True,1,0,24,24
167977,2019-11-10 00:00:00+03:00,in,False,-1,True,1,0,31,31
167977,2019-11-10 00:00:00+03:00,out,False,944226,False,4,208,258,50
167977,2019-11-10 00:00:00+03:00,out,False,944220,False,1,83,91,8
167977,2019-11-10 00:00:00+03:00,in,False,944218,False,1,97,126,29
167977,2019-11-11 00:00:00+03:00,in,False,944222,False,7,1037,1283,246
167977,2019-11-11 00:00:00+03:00,in,False,944218,False,12,2322,2695,373
167977,2019-11-11 00:00:00+03:00,out,False,944222,False,17,1421,1726,305
167977,2019-11-11 00:00:00+03:00,out,False,944218,False,10,1047,1162,115
167977,2019-11-11 00:00:00+03:00,out,False,944220,True,3,0,13,13
167977,2019-11-11 00:00:00+03:00,out,False,944216,False,2,80,91,11
167977,2019-11-11 00:00:00+03:00,out,False,944222,True,8,0,114,114
167977,2019-11-11 00:00:00+03:00,in,False,-1,False,1,74,136,62
167977,2019-11-11 00:00:00+03:00,in,False,944216,False,13,2173,2573,400
167977,2019-11-11 00:00:00+03:00,out,False,944218,True,6,0,96,96
167977,2019-11-11 00:00:00+03:00,in,False,944216,True,2,0,127,127
167977,2019-11-11 00:00:00+03:00,out,False,944226,True,2,0,83,83
167977,2019-11-11 00:00:00+03:00,in,False,944222,True,2,30,126,96
167977,2019-11-11 00:00:00+03:00,in,False,-1,True,11,0,474,474
167977,2019-11-11 00:00:00+03:00,out,False,944220,False,10,1790,1936,146
167977,2019-11-11 00:00:00+03:00,in,False,944220,False,7,1407,1641,234
167977,2019-11-11 00:00:00+03:00,out,False,944226,False,7,749,855,106
167977,2019-11-11 00:00:00+03:00,in,False,944226,False,8,1242,1528,286
167977,2019-11-11 00:00:00+03:00,out,False,944222,False,17,1421,1726,305
167977,2019-11-11 00:00:00+03:00,in,False,944216,False,13,2173,2573,400
167977,2019-11-11 00:00:00+03:00,in,False,944216,True,2,0,127,127
167977,2019-11-12 00:00:00+03:00,in,False,944218,True,2,0,91,91
167977,2019-11-12 00:00:00+03:00,in,False,-1,True,5,0,153,153
167977,2019-11-12 00:00:00+03:00,in,False,944220,True,2,0,96,96
167977,2019-11-12 00:00:00+03:00,out,False,944220,True,5,0,210,210
167977,2019-11-12 00:00:00+03:00,in,False,944216,True,5,147,412,265
167977,2019-11-12 00:00:00+03:00,out,False,944226,False,1,4,21,17
167977,2019-11-12 00:00:00+03:00,out,False,944220,False,9,1117,1232,115
167977,2019-11-12 00:00:00+03:00,out,False,944218,False,8,498,649,151
167977,2019-11-12 00:00:00+03:00,out,False,944222,True,1,0,8,8
167977,2019-11-12 00:00:00+03:00,out,False,944216,True,2,0,77,77
167977,2019-11-12 00:00:00+03:00,in,False,944220,False,8,1877,2149,272
167977,2019-11-12 00:00:00+03:00,out,False,944222,False,5,585,638,53
167977,2019-11-12 00:00:00+03:00,in,False,944222,False,11,1330,1704,374
167977,2019-11-12 00:00:00+03:00,in,False,944226,False,7,934,1192,258
167977,2019-11-12 00:00:00+03:00,in,False,944218,False,11,2656,2988,332
167977,2019-11-12 00:00:00+03:00,in,False,944226,True,1,0,51,51
167977,2019-11-12 00:00:00+03:00,in,False,944222,True,1,0,21,21
167977,2019-11-12 00:00:00+03:00,in,False,944216,False,4,859,974,115
167977,2019-11-12 00:00:00+03:00,in,False,944216,False,4,859,974,115
167977,2019-11-12 00:00:00+03:00,in,False,944226,False,7,934,1192,258
167977,2019-11-13 00:00:00+03:00,in,False,944222,True,2,0,93,93
167977,2019-11-13 00:00:00+03:00,out,False,944222,True,2,0,54,54
167977,2019-11-13 00:00:00+03:00,out,False,944226,False,4,335,374,39
167977,2019-11-13 00:00:00+03:00,out,False,944218,False,2,41,94,53
167977,2019-11-13 00:00:00+03:00,in,False,944218,False,5,562,736,174
167977,2019-11-13 00:00:00+03:00,out,False,944226,True,1,0,41,41
167977,2019-11-13 00:00:00+03:00,out,False,944220,False,6,774,848,74
167977,2019-11-13 00:00:00+03:00,out,False,944220,True,2,0,36,36
167977,2019-11-13 00:00:00+03:00,in,False,944222,False,6,919,1102,183
167977,2019-11-13 00:00:00+03:00,out,False,944222,False,5,243,317,74
167977,2019-11-13 00:00:00+03:00,out,False,944216,False,1,60,70,10
167977,2019-11-13 00:00:00+03:00,in,False,-1,True,4,0,156,156
167977,2019-11-13 00:00:00+03:00,in,False,944226,False,3,532,631,99
167977,2019-11-13 00:00:00+03:00,out,False,944218,True,3,0,17,17
167977,2019-11-13 00:00:00+03:00,in,False,944220,False,8,1231,1500,269
167977,2019-11-13 00:00:00+03:00,in,False,944216,False,4,593,720,127
167977,2019-11-13 00:00:00+03:00,out,False,944226,True,1,0,41,41
167977,2019-11-14 00:00:00+03:00,out,False,944226,True,1,0,32,32
167977,2019-11-14 00:00:00+03:00,out,False,944216,False,2,44,80,36
167977,2019-11-14 00:00:00+03:00,in,False,944226,True,1,0,16,16
167977,2019-11-14 00:00:00+03:00,in,False,944226,False,5,1320,1524,204
167977,2019-11-14 00:00:00+03:00,out,False,944218,False,10,782,903,121
167977,2019-11-14 00:00:00+03:00,out,False,944220,False,14,1020,1283,263
167977,2019-11-14 00:00:00+03:00,in,False,944222,False,6,719,913,194
167977,2019-11-14 00:00:00+03:00,in,False,-1,True,8,0,238,238
167977,2019-11-14 00:00:00+03:00,out,False,944222,False,1,78,84,6
167977,2019-11-14 00:00:00+03:00,in,False,944216,True,2,1,80,79
167977,2019-11-14 00:00:00+03:00,out,False,944218,True,1,0,5,5
167977,2019-11-14 00:00:00+03:00,out,False,944220,True,14,0,203,203
167977,2019-11-14 00:00:00+03:00,in,False,944220,True,1,0,40,40
167977,2019-11-14 00:00:00+03:00,in,False,944220,False,10,1566,1921,355
167977,2019-11-14 00:00:00+03:00,out,False,944226,False,3,755,780,25
167977,2019-11-14 00:00:00+03:00,in,False,944218,False,8,344,671,327
167977,2019-11-14 00:00:00+03:00,in,False,944216,False,13,2550,2953,403
167977,2019-11-14 00:00:00+03:00,in,False,944216,True,2,1,80,79
167977,2019-11-15 00:00:00+03:00,out,False,944222,False,10,1033,1149,116
167977,2019-11-15 00:00:00+03:00,in,False,944220,False,7,1033,1242,209
167977,2019-11-15 00:00:00+03:00,in,False,-1,True,5,0,244,244
167977,2019-11-15 00:00:00+03:00,in,False,944216,False,5,973,1178,205
167977,2019-11-15 00:00:00+03:00,in,False,944226,False,2,493,576,83
167977,2019-11-15 00:00:00+03:00,out,False,944220,False,2,70,84,14
167977,2019-11-15 00:00:00+03:00,out,False,944216,False,1,116,122,6
167977,2019-11-15 00:00:00+03:00,out,False,944222,True,3,0,82,82
167977,2019-11-15 00:00:00+03:00,out,False,944218,False,7,420,482,62
167977,2019-11-15 00:00:00+03:00,out,False,944218,True,1,0,7,7
167977,2019-11-15 00:00:00+03:00,in,False,944218,False,10,1282,1568,286
167977,2019-11-15 00:00:00+03:00,out,False,944218,True,1,0,7,7
167977,2019-11-16 00:00:00+03:00,out,False,944226,False,1,55,65,10
167977,2019-11-16 00:00:00+03:00,out,False,944222,False,4,444,479,35
167977,2019-11-16 00:00:00+03:00,in,False,944218,False,3,297,386,89
167977,2019-11-16 00:00:00+03:00,in,False,944226,False,3,71,145,74
167977,2019-11-16 00:00:00+03:00,in,False,944216,False,3,283,367,84
167977,2019-11-16 00:00:00+03:00,in,False,944222,False,2,428,482,54
167977,2019-11-16 00:00:00+03:00,out,False,944222,True,1,0,40,40
167977,2019-11-16 00:00:00+03:00,out,False,944220,False,4,281,361,80
167977,2019-11-16 00:00:00+03:00,in,False,-1,True,1,0,1,1
167977,2019-11-16 00:00:00+03:00,out,False,944218,False,1,40,54,14
167977,2019-11-16 00:00:00+03:00,in,False,944220,False,1,65,89,24
167977,2019-11-17 00:00:00+03:00,in,False,944226,True,2,0,57,57
167977,2019-11-17 00:00:00+03:00,in,False,944220,False,6,307,498,191
167977,2019-11-17 00:00:00+03:00,in,False,-1,True,5,0,78,78
167977,2019-11-17 00:00:00+03:00,out,False,944220,False,4,207,271,64
167977,2019-11-17 00:00:00+03:00,out,False,944220,True,1,0,46,46
167977,2019-11-17 00:00:00+03:00,in,False,944218,False,2,103,148,45
167977,2019-11-17 00:00:00+03:00,in,False,944220,True,1,0,48,48
167977,2019-11-17 00:00:00+03:00,in,False,944222,False,6,1326,1520,194
167977,2019-11-17 00:00:00+03:00,in,False,944216,False,6,613,781,168
167977,2019-11-17 00:00:00+03:00,out,False,944222,False,4,226,271,45
167977,2019-11-17 00:00:00+03:00,in,False,944222,True,2,0,56,56
167977,2019-11-17 00:00:00+03:00,in,False,944226,False,3,269,350,81
167977,2019-11-17 00:00:00+03:00,in,False,944216,True,1,0,50,50
167977,2019-11-17 00:00:00+03:00,in,False,944220,True,1,0,48,48
167977,2019-11-18 00:00:00+03:00,in,False,944222,False,10,1043,1393,350
167977,2019-11-18 00:00:00+03:00,in,False,944226,False,1,48,80,32
167977,2019-11-18 00:00:00+03:00,in,False,944216,False,6,918,1115,197
167977,2019-11-18 00:00:00+03:00,out,False,944222,False,18,1037,1289,252
167977,2019-11-18 00:00:00+03:00,out,False,944220,False,18,900,1164,264
167977,2019-11-18 00:00:00+03:00,in,False,944218,False,9,1862,2166,304
167977,2019-11-18 00:00:00+03:00,in,False,-1,True,3,0,92,92
167977,2019-11-18 00:00:00+03:00,out,False,944220,True,3,0,56,56
167977,2019-11-18 00:00:00+03:00,out,False,944222,True,5,0,90,90
167977,2019-11-18 00:00:00+03:00,out,False,944218,False,2,155,179,24
167977,2019-11-18 00:00:00+03:00,in,False,944220,False,8,1034,1309,275
167977,2019-11-18 00:00:00+03:00,out,False,944216,False,5,450,515,65
167977,2019-11-18 00:00:00+03:00,out,False,944218,False,2,155,179,24
167977,2019-11-18 00:00:00+03:00,in,False,944220,False,8,1034,1309,275
167977,2019-11-18 00:00:00+03:00,out,False,944216,False,5,450,515,65
167977,2019-11-19 00:00:00+03:00,in,False,944220,False,7,1095,1404,309
167977,2019-11-19 00:00:00+03:00,out,False,944222,False,9,578,718,140
167977,2019-11-19 00:00:00+03:00,in,False,944216,True,1,0,75,75
167977,2019-11-19 00:00:00+03:00,in,False,944218,False,6,1711,1960,249
167977,2019-11-19 00:00:00+03:00,out,False,944226,False,2,589,614,25
167977,2019-11-19 00:00:00+03:00,out,False,944220,True,1,0,40,40
167977,2019-11-19 00:00:00+03:00,out,False,944222,True,2,0,9,9
167977,2019-11-19 00:00:00+03:00,in,False,944222,False,10,2483,2814,331
167977,2019-11-19 00:00:00+03:00,out,False,944216,False,1,60,76,16
167977,2019-11-19 00:00:00+03:00,in,False,944226,True,2,66,170,104
167977,2019-11-19 00:00:00+03:00,in,False,-1,True,11,0,1039,1039
167977,2019-11-19 00:00:00+03:00,out,False,944218,True,1,0,7,7
167977,2019-11-19 00:00:00+03:00,out,False,944220,False,3,592,630,38
167977,2019-11-19 00:00:00+03:00,in,False,944226,False,7,2899,3772,873
167977,2019-11-19 00:00:00+03:00,out,False,944226,True,2,0,32,32
167977,2019-11-19 00:00:00+03:00,in,False,944216,False,9,750,1032,282
167977,2019-11-19 00:00:00+03:00,out,False,944216,True,1,0,18,18
167977,2019-11-19 00:00:00+03:00,out,False,944218,True,1,0,7,7
167977,2019-11-19 00:00:00+03:00,in,False,944216,True,1,0,75,75
167977,2019-11-20 00:00:00+03:00,in,False,944218,True,2,0,223,223
167977,2019-11-20 00:00:00+03:00,in,False,944216,False,10,1704,2073,369
167977,2019-11-20 00:00:00+03:00,in,False,944222,False,4,907,990,83
167977,2019-11-20 00:00:00+03:00,out,False,944222,False,4,273,333,60
167977,2019-11-20 00:00:00+03:00,in,False,944218,False,8,893,1322,429
167977,2019-11-20 00:00:00+03:00,in,False,944222,True,1,0,40,40
167977,2019-11-20 00:00:00+03:00,out,False,944218,False,9,1381,1484,103
167977,2019-11-20 00:00:00+03:00,out,False,944218,True,1,0,18,18
167977,2019-11-20 00:00:00+03:00,out,False,944226,True,1,0,28,28
167977,2019-11-20 00:00:00+03:00,out,False,944216,False,5,466,523,57
167977,2019-11-20 00:00:00+03:00,out,False,944222,True,4,0,28,28
167977,2019-11-20 00:00:00+03:00,in,False,944220,False,8,1049,1328,279
167977,2019-11-20 00:00:00+03:00,in,False,-1,True,5,0,139,139
167977,2019-11-20 00:00:00+03:00,out,False,944220,False,2,113,137,24
167977,2019-11-20 00:00:00+03:00,in,False,944226,False,4,674,788,114
167977,2019-11-21 00:00:00+03:00,out,False,944216,False,9,1095,1273,178
167977,2019-11-21 00:00:00+03:00,in,False,-1,True,7,0,156,156
167977,2019-11-21 00:00:00+03:00,in,False,944216,True,1,0,32,32
167977,2019-11-21 00:00:00+03:00,out,False,944216,True,9,0,220,220
167977,2019-11-21 00:00:00+03:00,in,False,944216,False,5,726,886,160
167977,2019-11-21 00:00:00+03:00,in,False,944220,False,12,1403,1821,418
167977,2019-11-21 00:00:00+03:00,in,False,944218,False,7,2158,2364,206
167977,2019-11-21 00:00:00+03:00,out,False,944222,True,4,0,44,44
167977,2019-11-21 00:00:00+03:00,out,False,944218,True,1,0,8,8
167977,2019-11-21 00:00:00+03:00,out,False,944226,False,2,91,119,28
167977,2019-11-21 00:00:00+03:00,in,False,944226,False,2,655,722,67
167977,2019-11-21 00:00:00+03:00,out,False,944218,False,2,83,95,12
167977,2019-11-21 00:00:00+03:00,out,False,944222,False,15,1311,1489,178
167977,2019-11-21 00:00:00+03:00,in,False,944226,True,1,0,31,31
167977,2019-11-21 00:00:00+03:00,out,False,944220,False,1,7,24,17
167977,2019-11-21 00:00:00+03:00,in,False,944222,False,3,293,374,81
167977,2019-11-21 00:00:00+03:00,in,False,944218,False,7,2158,2364,206
167977,2019-11-21 00:00:00+03:00,out,False,944222,True,4,0,44,44
167977,2019-11-22 00:00:00+03:00,in,False,944226,False,3,142,241,99
167977,2019-11-22 00:00:00+03:00,in,False,-1,True,8,0,499,499
167977,2019-11-22 00:00:00+03:00,in,False,944218,False,4,441,566,125
167977,2019-11-22 00:00:00+03:00,in,False,944220,False,9,1379,1701,322
167977,2019-11-22 00:00:00+03:00,in,False,944216,False,2,62,126,64
167977,2019-11-22 00:00:00+03:00,in,False,944222,True,1,0,62,62
167977,2019-11-22 00:00:00+03:00,in,False,944222,False,6,2390,2549,159
167977,2019-11-22 00:00:00+03:00,out,False,944222,True,5,0,84,84
167977,2019-11-22 00:00:00+03:00,out,False,944220,False,14,863,1069,206
167977,2019-11-22 00:00:00+03:00,in,False,944226,True,1,0,56,56
167977,2019-11-22 00:00:00+03:00,out,False,944220,True,6,0,179,179
167977,2019-11-22 00:00:00+03:00,out,False,944222,False,8,1183,1309,126
167977,2019-11-22 00:00:00+03:00,out,False,944218,False,7,1206,1269,63
167977,2019-11-22 00:00:00+03:00,in,False,944218,False,4,441,566,125
167977,2019-11-23 00:00:00+03:00,in,False,944218,True,1,0,45,45
167977,2019-11-23 00:00:00+03:00,in,False,944216,True,1,0,49,49
167977,2019-11-23 00:00:00+03:00,in,False,944222,False,2,363,424,61
167977,2019-11-23 00:00:00+03:00,in,False,944226,False,3,201,291,90
167977,2019-11-23 00:00:00+03:00,out,False,944216,False,9,582,766,184
167977,2019-11-23 00:00:00+03:00,in,False,944216,False,5,312,476,164
167977,2019-11-23 00:00:00+03:00,in,False,944218,False,2,524,589,65
167977,2019-11-23 00:00:00+03:00,out,False,944222,False,1,94,108,14
167977,2019-11-23 00:00:00+03:00,in,False,944220,False,6,1536,1735,199
167977,2019-11-23 00:00:00+03:00,out,False,944220,False,4,602,662,60
167977,2019-11-23 00:00:00+03:00,in,False,944226,True,1,0,15,15
167977,2019-11-23 00:00:00+03:00,in,False,-1,True,3,0,74,74
167977,2019-11-23 00:00:00+03:00,out,False,944218,False,1,24,33,9
167977,2019-11-23 00:00:00+03:00,out,False,944216,True,2,0,36,36
167977,2019-11-23 00:00:00+03:00,in,False,944220,True,2,0,113,113
167977,2019-11-23 00:00:00+03:00,in,False,944216,True,1,0,49,49
167977,2019-11-23 00:00:00+03:00,out,False,944218,False,1,24,33,9
167977,2019-11-23 00:00:00+03:00,out,False,944216,False,9,582,766,184
167977,2019-11-23 00:00:00+03:00,in,False,944220,True,2,0,113,113
167977,2019-11-24 00:00:00+03:00,out,False,944226,False,1,46,55,9
167977,2019-11-24 00:00:00+03:00,in,False,944226,False,2,232,302,70
167977,2019-11-24 00:00:00+03:00,in,False,944218,False,3,296,350,54
167977,2019-11-24 00:00:00+03:00,in,False,944220,False,4,517,639,122
167977,2019-11-24 00:00:00+03:00,in,False,944216,False,6,667,877,210
167977,2019-11-24 00:00:00+03:00,out,False,944222,False,2,524,546,22
167977,2019-11-24 00:00:00+03:00,out,False,944216,False,3,510,549,39
167977,2019-11-24 00:00:00+03:00,out,False,944220,True,1,0,60,60
167977,2019-11-24 00:00:00+03:00,in,False,-1,True,2,0,183,183
167977,2019-11-24 00:00:00+03:00,in,False,944222,False,2,337,410,73
167977,2019-11-24 00:00:00+03:00,in,False,-1,True,2,0,183,183
167977,2019-11-25 00:00:00+03:00,out,False,944220,True,2,0,101,101
167977,2019-11-25 00:00:00+03:00,in,False,944220,True,1,1,43,42
167977,2019-11-25 00:00:00+03:00,in,False,944218,False,9,2066,2398,332
167977,2019-11-25 00:00:00+03:00,in,False,944222,False,5,876,1049,173
167977,2019-11-25 00:00:00+03:00,out,False,944220,False,6,455,514,59
167977,2019-11-25 00:00:00+03:00,in,False,-1,True,1,0,2,2
167977,2019-11-25 00:00:00+03:00,in,False,944220,False,4,1709,1825,116
167977,2019-11-25 00:00:00+03:00,out,False,944222,False,8,1146,1238,92
167977,2019-11-25 00:00:00+03:00,out,False,944222,True,4,0,38,38
167977,2019-11-25 00:00:00+03:00,out,False,944218,False,10,1131,1230,99
167977,2019-11-25 00:00:00+03:00,in,False,944216,False,9,889,1221,332
167977,2019-11-25 00:00:00+03:00,in,False,944216,False,9,889,1221,332
167977,2019-11-26 00:00:00+03:00,in,False,944218,True,1,0,18,18
167977,2019-11-26 00:00:00+03:00,in,False,-1,True,3,0,129,129
167977,2019-11-26 00:00:00+03:00,out,False,944218,False,10,944,1071,127
167977,2019-11-26 00:00:00+03:00,out,False,944222,False,9,860,1023,163
167977,2019-11-26 00:00:00+03:00,out,False,944218,True,3,0,120,120
167977,2019-11-26 00:00:00+03:00,in,False,944226,False,4,1447,1575,128
167977,2019-11-26 00:00:00+03:00,out,False,944216,True,2,0,46,46
167977,2019-11-26 00:00:00+03:00,out,False,944222,True,4,0,134,134
167977,2019-11-26 00:00:00+03:00,in,False,944220,False,4,386,535,149
167977,2019-11-26 00:00:00+03:00,in,False,944216,False,8,2039,2300,261
167977,2019-11-26 00:00:00+03:00,out,False,944220,True,1,0,47,47
167977,2019-11-26 00:00:00+03:00,out,False,944220,False,4,919,974,55
167977,2019-11-26 00:00:00+03:00,in,False,944218,False,7,446,683,237
167977,2019-11-26 00:00:00+03:00,in,False,944222,False,5,652,803,151
167977,2019-11-26 00:00:00+03:00,out,False,944216,False,5,229,284,55
167977,2019-11-27 00:00:00+03:00,out,False,944220,False,5,1042,1114,72
167977,2019-11-27 00:00:00+03:00,in,False,944226,True,1,0,51,51
167977,2019-11-27 00:00:00+03:00,in,False,944222,False,10,979,1345,366
167977,2019-11-27 00:00:00+03:00,in,False,944216,True,1,0,37,37
167977,2019-11-27 00:00:00+03:00,in,False,-1,True,9,0,197,197
167977,2019-11-27 00:00:00+03:00,out,False,944226,False,1,11,14,3
167977,2019-11-27 00:00:00+03:00,out,False,944216,False,14,1937,2154,217
167977,2019-11-27 00:00:00+03:00,out,False,944218,False,3,466,505,39
167977,2019-11-27 00:00:00+03:00,in,False,944216,False,6,472,675,203
167977,2019-11-27 00:00:00+03:00,in,False,944226,False,6,798,995,197
167977,2019-11-27 00:00:00+03:00,in,False,944220,False,9,1032,1296,264
167977,2019-11-27 00:00:00+03:00,out,False,944222,True,11,0,203,203
167977,2019-11-27 00:00:00+03:00,out,False,944222,False,18,1751,1989,238
167977,2019-11-27 00:00:00+03:00,in,False,944218,False,7,671,874,203
167977,2019-11-27 00:00:00+03:00,in,False,944220,False,9,1032,1296,264
167977,2019-11-27 00:00:00+03:00,in,False,944216,False,6,472,675,203
167977,2019-11-28 00:00:00+03:00,in,False,944216,False,7,393,578,185
167977,2019-11-28 00:00:00+03:00,in,False,944222,True,2,0,151,151
167977,2019-11-28 00:00:00+03:00,in,False,944222,False,11,2472,2773,301
167977,2019-11-28 00:00:00+03:00,in,False,944220,False,10,1284,1595,311
167977,2019-11-28 00:00:00+03:00,out,False,944218,True,3,0,13,13
167977,2019-11-28 00:00:00+03:00,out,False,944216,False,3,259,306,47
167977,2019-11-28 00:00:00+03:00,out,False,944220,False,3,325,370,45
167977,2019-11-28 00:00:00+03:00,out,False,944222,False,13,1069,1271,202
167977,2019-11-28 00:00:00+03:00,in,False,944226,False,3,440,532,92
167977,2019-11-28 00:00:00+03:00,in,False,944218,False,9,1162,1439,277
167977,2019-11-28 00:00:00+03:00,out,False,944218,False,7,739,793,54
167977,2019-11-28 00:00:00+03:00,in,False,-1,True,5,0,146,146
167977,2019-11-28 00:00:00+03:00,out,False,944216,True,2,0,71,71
167977,2019-11-28 00:00:00+03:00,in,False,944220,False,10,1284,1595,311
167981,2019-11-03 00:00:00+03:00,in,False,-1,True,1,0,2,2
167989,2019-10-15 00:00:00+03:00,out,False,936324,False,19,1561,1955,394
167989,2019-10-15 00:00:00+03:00,out,False,936324,True,19,0,578,578
167989,2019-10-15 00:00:00+03:00,in,False,-1,True,1,0,7,7
167989,2019-10-15 00:00:00+03:00,out,True,936324,True,1,0,11,11
167989,2019-10-15 00:00:00+03:00,in,False,936324,False,2,243,262,19
167989,2019-10-15 00:00:00+03:00,out,False,936296,True,2,0,50,50
167989,2019-10-15 00:00:00+03:00,in,False,935394,False,1,130,137,7
167989,2019-10-15 00:00:00+03:00,out,True,936296,True,1,0,18,18
167989,2019-10-15 00:00:00+03:00,out,False,936324,True,19,0,578,578
167989,2019-10-16 00:00:00+03:00,out,False,936324,True,2,0,21,21
167989,2019-10-17 00:00:00+03:00,out,False,936324,False,3,291,347,56
167989,2019-10-17 00:00:00+03:00,in,False,-1,True,1,0,0,0
167989,2019-10-17 00:00:00+03:00,out,False,936324,True,5,0,112,112
167989,2019-10-18 00:00:00+03:00,out,False,936324,False,4,198,274,76
167989,2019-10-18 00:00:00+03:00,out,False,936324,True,3,0,112,112
167989,2019-10-18 00:00:00+03:00,out,False,936324,False,4,198,274,76
167989,2019-10-21 00:00:00+03:00,out,False,936324,False,1,97,121,24
167989,2019-10-22 00:00:00+03:00,out,False,936324,False,1,91,112,21
167989,2019-10-25 00:00:00+03:00,in,False,936324,False,2,160,188,28
167989,2019-10-29 00:00:00+03:00,out,True,936324,True,3,0,94,94
167989,2019-10-29 00:00:00+03:00,out,False,936324,True,3,0,99,99
167989,2019-10-29 00:00:00+03:00,out,False,936324,False,2,781,817,36
167989,2019-10-30 00:00:00+03:00,in,False,-1,True,1,0,3,3
167989,2019-10-30 00:00:00+03:00,in,False,936324,False,8,507,623,116
167989,2019-10-30 00:00:00+03:00,out,False,936324,False,6,681,802,121
167989,2019-10-30 00:00:00+03:00,out,False,936324,True,3,0,127,127
167989,2019-10-30 00:00:00+03:00,out,False,936324,True,3,0,127,127
167989,2019-10-31 00:00:00+03:00,in,False,936324,False,2,304,325,21
167989,2019-10-31 00:00:00+03:00,out,False,936324,False,6,275,386,111
167989,2019-10-31 00:00:00+03:00,out,False,936324,True,2,0,29,29
167989,2019-10-31 00:00:00+03:00,in,False,-1,True,2,0,7,7
167989,2019-10-31 00:00:00+03:00,out,False,936324,False,6,275,386,111
167989,2019-11-01 00:00:00+03:00,in,False,936324,False,1,28,36,8
167989,2019-11-01 00:00:00+03:00,out,False,936324,False,4,416,510,94
167989,2019-11-01 00:00:00+03:00,out,False,936324,False,4,416,510,94
167989,2019-11-04 00:00:00+03:00,out,False,936296,True,1,0,36,36
167989,2019-11-05 00:00:00+03:00,out,True,954376,True,1,0,15,15
167989,2019-11-05 00:00:00+03:00,out,True,954380,True,1,0,27,27
167989,2019-11-05 00:00:00+03:00,out,True,954378,False,2,114,155,41
167989,2019-11-05 00:00:00+03:00,out,True,954376,False,1,13,40,27
167989,2019-11-05 00:00:00+03:00,out,True,954378,True,2,0,40,40
167989,2019-11-06 00:00:00+03:00,out,True,954378,True,2,0,18,18
167989,2019-11-06 00:00:00+03:00,out,False,954378,True,1,0,28,28
167989,2019-11-06 00:00:00+03:00,out,True,954380,False,1,73,79,6
167989,2019-11-06 00:00:00+03:00,out,True,954376,False,1,19,27,8
167989,2019-11-06 00:00:00+03:00,out,False,954376,True,1,0,31,31
167989,2019-11-06 00:00:00+03:00,out,True,954378,False,1,54,59,5
167989,2019-11-06 00:00:00+03:00,out,True,954380,True,2,0,28,28
167989,2019-11-08 00:00:00+03:00,in,False,936324,False,1,326,339,13
167989,2019-11-08 00:00:00+03:00,in,False,-1,True,1,0,12,12
167989,2019-11-11 00:00:00+03:00,in,False,936324,False,1,273,292,19
167989,2019-11-11 00:00:00+03:00,in,False,-1,True,1,0,15,15
167989,2019-11-12 00:00:00+03:00,in,False,-1,True,4,0,174,174
167989,2019-11-12 00:00:00+03:00,out,False,936324,False,3,71,135,64
167989,2019-11-12 00:00:00+03:00,out,False,936324,True,2,0,41,41
167989,2019-11-13 00:00:00+03:00,in,False,936324,False,3,227,270,43
167989,2019-11-13 00:00:00+03:00,out,False,936324,False,1,229,256,27
167989,2019-11-13 00:00:00+03:00,in,False,-1,True,2,0,7,7
167989,2019-11-13 00:00:00+03:00,in,False,936324,False,3,227,270,43
167989,2019-11-14 00:00:00+03:00,in,False,-1,True,1,0,46,46
167989,2019-11-15 00:00:00+03:00,in,False,936324,False,3,250,286,36
167989,2019-11-20 00:00:00+03:00,in,False,-1,True,1,0,47,47
167989,2019-11-22 00:00:00+03:00,in,False,-1,True,1,0,19,19
167989,2019-11-25 00:00:00+03:00,in,False,936324,False,1,109,124,15
167989,2019-11-25 00:00:00+03:00,out,False,936324,True,2,0,120,120
167989,2019-11-26 00:00:00+03:00,in,False,936324,False,1,76,103,27
167989,2019-11-27 00:00:00+03:00,in,False,936324,False,3,154,201,47
167994,2019-10-11 00:00:00+03:00,in,False,933986,True,1,59,62,3
167994,2019-10-11 00:00:00+03:00,out,False,933986,False,1,32,33,1
167994,2019-10-11 00:00:00+03:00,out,False,933986,True,4,0,4,4
167994,2019-10-11 00:00:00+03:00,in,False,933996,False,1,11,46,35
167994,2019-10-11 00:00:00+03:00,in,False,934000,False,3,75,121,46
167994,2019-10-11 00:00:00+03:00,out,False,933996,True,1,0,14,14
167994,2019-10-11 00:00:00+03:00,out,True,933986,False,1,51,57,6
167994,2019-10-11 00:00:00+03:00,in,False,933986,False,5,347,392,45
167994,2019-10-11 00:00:00+03:00,out,True,934000,True,1,0,0,0
167994,2019-10-14 00:00:00+03:00,in,False,-1,True,16,0,0,0
167994,2019-10-18 00:00:00+03:00,out,False,933996,True,1,0,30,30
167994,2019-10-18 00:00:00+03:00,out,True,934000,False,1,61,66,5
167994,2019-10-18 00:00:00+03:00,in,False,934000,False,1,83,91,8
167994,2019-10-21 00:00:00+03:00,in,False,933996,False,1,10,22,12
167994,2019-10-21 00:00:00+03:00,in,False,933986,False,1,94,119,25
167994,2019-10-21 00:00:00+03:00,out,False,933996,False,1,8,10,2
167994,2019-10-21 00:00:00+03:00,out,False,933996,True,4,0,16,16
167994,2019-10-23 00:00:00+03:00,in,False,-1,True,3,0,33,33
167994,2019-10-24 00:00:00+03:00,in,False,933986,False,2,95,111,16
167994,2019-10-24 00:00:00+03:00,out,True,933996,True,1,0,3,3
167994,2019-10-25 00:00:00+03:00,out,True,933996,False,1,162,177,15
167994,2019-10-25 00:00:00+03:00,in,False,933996,False,1,85,90,5
167994,2019-10-25 00:00:00+03:00,out,True,933996,True,1,0,6,6
167994,2019-10-25 00:00:00+03:00,out,True,933986,True,1,0,6,6
167994,2019-10-25 00:00:00+03:00,in,False,933986,False,2,100,109,9
167994,2019-10-25 00:00:00+03:00,in,False,933986,False,2,100,109,9
167994,2019-10-28 00:00:00+03:00,in,False,934000,False,2,111,137,26
167994,2019-10-29 00:00:00+03:00,in,False,933986,False,1,491,505,14
167994,2019-10-30 00:00:00+03:00,in,False,-1,True,4,0,1,1
167994,2019-10-31 00:00:00+03:00,in,False,-1,True,1,0,25,25
167994,2019-10-31 00:00:00+03:00,out,False,933986,False,2,60,74,14
167994,2019-11-01 00:00:00+03:00,in,False,933986,False,1,24,61,37
167994,2019-11-01 00:00:00+03:00,in,False,934000,False,1,40,59,19
167994,2019-11-01 00:00:00+03:00,in,False,-1,True,1,0,37,37
167994,2019-11-02 00:00:00+03:00,in,False,-1,True,2,0,24,24
167994,2019-11-05 00:00:00+03:00,out,False,933986,False,1,97,97,0
167994,2019-11-05 00:00:00+03:00,in,False,-1,True,1,0,37,37
167994,2019-11-05 00:00:00+03:00,in,False,933986,False,1,120,155,35
167994,2019-11-06 00:00:00+03:00,in,False,934000,False,1,50,73,23
167994,2019-11-06 00:00:00+03:00,out,True,933996,True,1,0,0,0
167994,2019-11-11 00:00:00+03:00,in,False,933996,False,1,85,135,50
167994,2019-11-15 00:00:00+03:00,in,False,-1,True,4,0,122,122
167994,2019-11-18 00:00:00+03:00,in,False,-1,True,3,0,105,105
167994,2019-11-21 00:00:00+03:00,in,False,-1,True,1,0,42,42
167994,2019-11-22 00:00:00+03:00,in,False,-1,True,1,0,41,41
167994,2019-11-25 00:00:00+03:00,in,False,-1,True,2,0,4,4
167994,2019-11-26 00:00:00+03:00,in,False,-1,True,2,0,4,4
167994,2019-11-27 00:00:00+03:00,in,False,-1,True,3,0,6,6
167994,2019-11-28 00:00:00+03:00,in,False,-1,True,1,0,2,2
167995,2019-10-10 00:00:00+03:00,in,False,-1,True,2,0,4,4
167995,2019-10-11 00:00:00+03:00,in,False,934188,False,1,29,34,5
167995,2019-10-11 00:00:00+03:00,in,False,-1,True,9,0,42,42
167995,2019-10-12 00:00:00+03:00,in,False,-1,True,1,0,1,1
167995,2019-10-18 00:00:00+03:00,in,False,-1,True,1,0,8,8
167995,2019-10-21 00:00:00+03:00,in,False,934188,False,4,167,255,88
167995,2019-10-21 00:00:00+03:00,in,False,-1,True,11,0,112,112
167995,2019-10-29 00:00:00+03:00,out,False,934188,False,1,7,20,13
167995,2019-10-29 00:00:00+03:00,in,False,-1,True,4,0,33,33
167995,2019-10-29 00:00:00+03:00,out,False,934188,True,1,0,8,8
167995,2019-10-29 00:00:00+03:00,in,False,934188,False,1,11,22,11
167995,2019-10-29 00:00:00+03:00,in,False,-1,True,4,0,33,33
167995,2019-11-12 00:00:00+03:00,out,False,941838,True,2,0,20,20
167995,2019-11-12 00:00:00+03:00,out,False,941838,False,1,14,24,10
167995,2019-11-12 00:00:00+03:00,in,False,-1,True,1,0,8,8
167995,2019-11-14 00:00:00+03:00,in,False,-1,True,1,0,38,38
167995,2019-11-15 00:00:00+03:00,in,False,941844,False,2,17,45,28
167995,2019-11-15 00:00:00+03:00,in,False,-1,True,3,0,71,71
167995,2019-11-18 00:00:00+03:00,out,False,941844,True,1,0,24,24
167995,2019-11-18 00:00:00+03:00,in,False,-1,True,9,0,176,176
167995,2019-11-18 00:00:00+03:00,out,False,941842,True,1,0,12,12
167995,2019-11-18 00:00:00+03:00,in,False,941844,False,1,5,26,21
167995,2019-11-18 00:00:00+03:00,out,False,941838,False,5,74,114,40
167995,2019-11-18 00:00:00+03:00,in,False,941844,False,1,5,26,21
167995,2019-11-19 00:00:00+03:00,out,False,941838,False,1,9,17,8
167995,2019-11-19 00:00:00+03:00,in,False,-1,True,1,0,19,19
167995,2019-11-19 00:00:00+03:00,out,False,941844,True,3,0,28,28
167995,2019-11-19 00:00:00+03:00,out,False,941844,False,1,8,15,7
167995,2019-11-20 00:00:00+03:00,out,False,941844,False,1,47,58,11
167995,2019-11-20 00:00:00+03:00,out,False,941844,False,1,47,58,11
167995,2019-11-26 00:00:00+03:00,in,False,-1,True,2,0,31,31
167995,2019-11-26 00:00:00+03:00,in,False,941844,True,1,0,18,18
167995,2019-11-26 00:00:00+03:00,out,False,941842,True,1,0,10,10
167995,2019-11-26 00:00:00+03:00,out,False,941844,False,2,150,167,17
167995,2019-11-27 00:00:00+03:00,out,False,941844,False,3,112,137,25
167995,2019-11-27 00:00:00+03:00,in,False,941844,False,3,88,138,50
167995,2019-11-27 00:00:00+03:00,out,False,941842,False,1,103,116,13
167995,2019-11-27 00:00:00+03:00,in,False,-1,True,11,0,240,240
167998,2019-10-21 00:00:00+03:00,in,False,-1,True,1,0,6,6
167998,2019-10-23 00:00:00+03:00,in,False,-1,True,1,0,2,2
167998,2019-10-23 00:00:00+03:00,in,False,941786,False,3,309,348,39
167998,2019-10-25 00:00:00+03:00,in,False,-1,True,1,0,15,15
167998,2019-11-12 00:00:00+03:00,in,False,-1,True,1,0,3,3
167998,2019-11-12 00:00:00+03:00,in,False,944908,False,1,2,17,15
167998,2019-11-28 00:00:00+03:00,in,False,944908,False,1,1,13,12
167998,2019-11-28 00:00:00+03:00,in,False,-1,True,1,0,8,8
167999,2019-10-11 00:00:00+03:00,in,False,933804,False,3,33,66,33
167999,2019-10-11 00:00:00+03:00,in,False,-1,True,2,0,12,12
167999,2019-10-14 00:00:00+03:00,in,False,-1,True,1,0,35,35
167999,2019-10-14 00:00:00+03:00,out,False,933806,False,1,13,28,15
167999,2019-10-15 00:00:00+03:00,out,False,933806,False,4,674,722,48
167999,2019-10-15 00:00:00+03:00,out,False,933806,True,3,0,16,16
167999,2019-10-16 00:00:00+03:00,in,False,-1,True,2,0,50,50
167999,2019-10-16 00:00:00+03:00,in,False,933804,False,2,66,92,26
167999,2019-10-17 00:00:00+03:00,out,False,933806,True,1,0,30,30
167999,2019-10-17 00:00:00+03:00,out,False,933806,False,1,64,76,12
167999,2019-10-17 00:00:00+03:00,in,False,-1,True,1,0,33,33
167999,2019-10-17 00:00:00+03:00,in,False,933804,False,1,26,52,26
167999,2019-10-18 00:00:00+03:00,out,False,933806,True,4,0,75,75
167999,2019-10-18 00:00:00+03:00,out,False,933806,False,7,291,391,100
167999,2019-10-18 00:00:00+03:00,in,False,933804,False,1,4,13,9
167999,2019-10-19 00:00:00+03:00,out,False,933806,True,1,0,29,29
167999,2019-10-19 00:00:00+03:00,out,False,933806,False,3,278,314,36
167999,2019-10-20 00:00:00+03:00,out,False,933806,False,1,42,58,16
167999,2019-10-21 00:00:00+03:00,out,False,933806,True,13,0,346,346
167999,2019-10-21 00:00:00+03:00,in,False,933804,False,3,82,117,35
167999,2019-10-21 00:00:00+03:00,out,False,933810,True,1,0,11,11
167999,2019-10-21 00:00:00+03:00,out,False,933810,False,1,73,84,11
167999,2019-10-21 00:00:00+03:00,out,False,933806,False,18,1091,1345,254
167999,2019-10-21 00:00:00+03:00,in,False,-1,True,1,0,24,24
167999,2019-10-22 00:00:00+03:00,out,False,933810,True,1,0,7,7
167999,2019-10-22 00:00:00+03:00,out,False,933806,False,10,1074,1239,165
167999,2019-10-22 00:00:00+03:00,in,False,-1,True,1,0,46,46
167999,2019-10-22 00:00:00+03:00,out,False,933806,True,22,0,341,341
167999,2019-10-22 00:00:00+03:00,in,False,933804,False,2,32,66,34
167999,2019-10-23 00:00:00+03:00,out,False,933810,False,1,37,53,16
167999,2019-10-23 00:00:00+03:00,in,False,933804,False,1,25,35,10
167999,2019-10-23 00:00:00+03:00,out,False,933810,False,1,37,53,16
167999,2019-10-24 00:00:00+03:00,in,False,-1,True,1,0,26,26
167999,2019-10-24 00:00:00+03:00,out,False,933806,False,2,167,193,26
167999,2019-10-24 00:00:00+03:00,out,False,933806,True,4,0,55,55
167999,2019-10-25 00:00:00+03:00,out,False,933806,False,3,158,212,54
167999,2019-10-25 00:00:00+03:00,in,False,-1,True,1,0,11,11
167999,2019-10-25 00:00:00+03:00,out,False,933806,True,4,0,127,127
167999,2019-10-25 00:00:00+03:00,in,False,-1,True,1,0,11,11
167999,2019-10-26 00:00:00+03:00,out,False,933806,True,1,0,14,14
167999,2019-10-26 00:00:00+03:00,in,False,-1,True,1,0,17,17
167999,2019-10-26 00:00:00+03:00,out,False,933806,False,1,4,39,35
167999,2019-10-28 00:00:00+03:00,out,False,933806,False,1,157,188,31
167999,2019-10-28 00:00:00+03:00,out,False,933806,True,5,0,36,36
167999,2019-10-29 00:00:00+03:00,in,False,933804,False,1,168,180,12
167999,2019-10-29 00:00:00+03:00,out,False,933806,False,2,108,141,33
167999,2019-10-29 00:00:00+03:00,in,False,-1,True,1,0,0,0
167999,2019-10-29 00:00:00+03:00,out,False,933806,True,6,0,68,68
167999,2019-10-30 00:00:00+03:00,in,False,-1,True,1,0,46,46
167999,2019-10-30 00:00:00+03:00,out,False,933806,True,1,0,0,0
167999,2019-10-30 00:00:00+03:00,out,False,933806,False,1,8,24,16
167999,2019-11-01 00:00:00+03:00,out,False,933806,True,28,0,523,523
167999,2019-11-01 00:00:00+03:00,out,False,933806,False,26,1211,1521,310
167999,2019-11-04 00:00:00+03:00,out,True,933806,False,1,1,1,0
167999,2019-11-04 00:00:00+03:00,out,False,933806,False,15,1552,1710,158
167999,2019-11-04 00:00:00+03:00,in,False,-1,True,3,0,58,58
167999,2019-11-04 00:00:00+03:00,out,False,933806,True,10,0,307,307
167999,2019-11-06 00:00:00+03:00,out,False,933806,False,2,45,79,34
167999,2019-11-07 00:00:00+03:00,out,False,933806,True,6,0,162,162
167999,2019-11-07 00:00:00+03:00,in,False,-1,True,1,0,13,13
167999,2019-11-07 00:00:00+03:00,out,False,933806,False,5,1040,1107,67
167999,2019-11-08 00:00:00+03:00,out,False,933806,False,20,1882,2163,281
167999,2019-11-08 00:00:00+03:00,in,False,-1,True,4,0,65,65
167999,2019-11-08 00:00:00+03:00,out,False,933806,True,7,0,163,163
167999,2019-11-08 00:00:00+03:00,out,True,933806,True,1,0,0,0
167999,2019-11-08 00:00:00+03:00,in,False,933804,False,2,364,408,44
167999,2019-11-08 00:00:00+03:00,out,False,933806,True,7,0,163,163
167999,2019-11-09 00:00:00+03:00,out,False,933806,False,2,109,133,24
167999,2019-11-09 00:00:00+03:00,out,False,933806,True,3,0,78,78
167999,2019-11-09 00:00:00+03:00,in,False,-1,True,1,0,35,35
167999,2019-11-09 00:00:00+03:00,in,False,-1,True,1,0,35,35
167999,2019-11-10 00:00:00+03:00,in,False,-1,True,5,0,28,28
167999,2019-11-10 00:00:00+03:00,in,False,-1,True,5,0,28,28
167999,2019-11-11 00:00:00+03:00,out,True,933806,True,1,0,0,0
167999,2019-11-11 00:00:00+03:00,out,False,933810,False,12,1047,1198,151
167999,2019-11-11 00:00:00+03:00,out,False,933806,False,22,1805,2098,293
167999,2019-11-11 00:00:00+03:00,out,False,933806,True,17,0,512,512
167999,2019-11-11 00:00:00+03:00,out,False,933810,True,3,0,108,108
167999,2019-11-11 00:00:00+03:00,in,False,-1,True,1,0,7,7
167999,2019-11-11 00:00:00+03:00,in,False,933804,False,2,129,157,28
167999,2019-11-11 00:00:00+03:00,out,False,933806,False,22,1805,2098,293
167999,2019-11-12 00:00:00+03:00,in,False,933804,False,2,103,126,23
167999,2019-11-12 00:00:00+03:00,out,False,933810,False,24,1256,1591,335
167999,2019-11-12 00:00:00+03:00,out,False,933806,True,26,0,766,766
167999,2019-11-12 00:00:00+03:00,out,False,933810,True,16,0,466,466
167999,2019-11-12 00:00:00+03:00,in,False,-1,True,1,0,13,13
167999,2019-11-12 00:00:00+03:00,out,False,933806,False,20,1166,1486,320
167999,2019-11-12 00:00:00+03:00,out,False,933806,True,26,0,766,766
167999,2019-11-13 00:00:00+03:00,in,False,-1,True,1,0,46,46
167999,2019-11-15 00:00:00+03:00,in,False,-1,True,1,0,46,46
167999,2019-11-15 00:00:00+03:00,out,False,933810,False,14,1116,1305,189
167999,2019-11-15 00:00:00+03:00,out,False,933810,True,12,0,249,249
167999,2019-11-16 00:00:00+03:00,out,False,933810,False,1,117,128,11
167999,2019-11-17 00:00:00+03:00,out,False,933810,True,2,0,43,43
167999,2019-11-17 00:00:00+03:00,out,False,933806,True,3,0,42,42
167999,2019-11-17 00:00:00+03:00,in,False,-1,True,3,0,67,67
167999,2019-11-17 00:00:00+03:00,out,False,933806,False,1,24,35,11
167999,2019-11-17 00:00:00+03:00,out,False,933810,False,1,9,28,19
167999,2019-11-17 00:00:00+03:00,in,False,933804,False,2,15,49,34
167999,2019-11-18 00:00:00+03:00,out,False,933810,False,8,837,938,101
167999,2019-11-18 00:00:00+03:00,in,False,933804,False,1,110,124,14
167999,2019-11-18 00:00:00+03:00,out,False,933810,True,8,0,232,232
167999,2019-11-19 00:00:00+03:00,out,False,933810,False,1,18,26,8
167999,2019-11-19 00:00:00+03:00,out,False,933810,True,1,0,3,3
167999,2019-11-19 00:00:00+03:00,in,False,-1,True,1,0,39,39
167999,2019-11-19 00:00:00+03:00,in,False,933804,False,2,174,192,18
167999,2019-11-27 00:00:00+03:00,in,False,-1,True,2,0,50,50
168000,2019-11-15 00:00:00+03:00,out,False,933244,True,6,0,127,127
168000,2019-11-17 00:00:00+03:00,out,False,933244,True,2,0,83,83
168000,2019-11-17 00:00:00+03:00,in,False,-1,True,3,0,6,6
168000,2019-11-18 00:00:00+03:00,out,False,933244,True,1,0,12,12
168000,2019-11-18 00:00:00+03:00,in,False,-1,True,5,0,6,6
168000,2019-11-18 00:00:00+03:00,in,False,-1,True,5,0,6,6
168000,2019-11-19 00:00:00+03:00,out,False,933244,False,11,1000,1128,128
168000,2019-11-19 00:00:00+03:00,in,False,933244,False,1,26,31,5
168000,2019-11-19 00:00:00+03:00,in,False,-1,True,1,0,7,7
168000,2019-11-19 00:00:00+03:00,out,False,933244,True,6,0,102,102
168000,2019-11-19 00:00:00+03:00,in,False,-1,True,1,0,7,7
168000,2019-11-20 00:00:00+03:00,in,False,-1,True,2,0,8,8
168000,2019-11-20 00:00:00+03:00,out,False,933244,False,36,3848,4332,484
168000,2019-11-20 00:00:00+03:00,in,False,933244,False,1,17,30,13
168000,2019-11-20 00:00:00+03:00,out,False,933244,True,21,0,601,601
168000,2019-11-22 00:00:00+03:00,in,False,968338,False,3,193,224,31
168000,2019-11-22 00:00:00+03:00,out,False,968338,True,21,0,485,485
168000,2019-11-22 00:00:00+03:00,in,False,-1,True,2,0,17,17
168000,2019-11-22 00:00:00+03:00,out,False,968338,False,31,2721,3143,422
168000,2019-11-22 00:00:00+03:00,out,False,968338,False,31,2721,3143,422
168000,2019-11-23 00:00:00+03:00,in,False,968338,False,3,246,267,21
168000,2019-11-23 00:00:00+03:00,out,False,968338,False,30,2255,2735,480
168000,2019-11-23 00:00:00+03:00,out,False,968338,True,15,0,369,369
168000,2019-11-23 00:00:00+03:00,in,False,-1,True,4,0,77,77
168000,2019-11-23 00:00:00+03:00,in,False,968338,False,3,246,267,21
168000,2019-11-23 00:00:00+03:00,out,False,968338,True,15,0,369,369
168000,2019-11-24 00:00:00+03:00,in,False,968338,False,2,68,91,23
168000,2019-11-24 00:00:00+03:00,out,False,968338,False,17,1929,2150,221
168000,2019-11-24 00:00:00+03:00,out,False,968338,True,7,0,221,221
168000,2019-11-25 00:00:00+03:00,out,False,968338,True,10,0,289,289
168000,2019-11-25 00:00:00+03:00,in,False,968338,False,2,36,50,14
168000,2019-11-25 00:00:00+03:00,out,False,968338,False,17,1060,1419,359
168000,2019-11-25 00:00:00+03:00,out,False,933244,False,1,811,830,19
168000,2019-11-26 00:00:00+03:00,in,False,-1,True,3,0,0,0
168000,2019-11-26 00:00:00+03:00,in,False,968338,False,2,117,128,11
168000,2019-11-26 00:00:00+03:00,out,False,968338,True,3,0,55,55
168000,2019-11-26 00:00:00+03:00,out,False,968338,False,24,1435,1874,439
168000,2019-11-27 00:00:00+03:00,in,False,-1,True,4,0,71,71
168000,2019-11-27 00:00:00+03:00,out,False,968338,False,26,2014,2396,382
168000,2019-11-27 00:00:00+03:00,out,False,968338,True,11,0,331,331
168000,2019-11-27 00:00:00+03:00,in,False,968338,False,1,46,61,15
168000,2019-11-28 00:00:00+03:00,out,False,968338,False,1,14,22,8
168000,2019-11-28 00:00:00+03:00,in,False,-1,True,4,0,1,1
168004,2019-10-11 00:00:00+03:00,in,False,934098,False,1,24,38,14
168004,2019-10-11 00:00:00+03:00,in,False,-1,True,3,0,3,3
168004,2019-10-14 00:00:00+03:00,in,False,934098,True,1,0,46,46
168004,2019-10-18 00:00:00+03:00,in,False,-1,True,1,0,4,4
168004,2019-10-22 00:00:00+03:00,in,False,-1,True,1,0,2,2
168004,2019-10-24 00:00:00+03:00,in,False,-1,True,1,0,23,23
168004,2019-10-24 00:00:00+03:00,in,False,934098,False,2,14,61,47
168004,2019-10-29 00:00:00+03:00,in,False,-1,True,1,0,6,6
168004,2019-11-01 00:00:00+03:00,in,False,-1,True,2,0,47,47
168004,2019-11-05 00:00:00+03:00,in,False,-1,True,1,0,22,22
168004,2019-11-05 00:00:00+03:00,in,True,934098,True,1,0,30,30
168004,2019-11-05 00:00:00+03:00,in,True,934098,False,1,7,29,22
168004,2019-11-14 00:00:00+03:00,in,False,-1,True,1,0,2,2
168008,2019-10-23 00:00:00+03:00,in,False,-1,True,1,0,2,2
168008,2019-10-23 00:00:00+03:00,in,False,-1,True,1,0,2,2
168008,2019-10-24 00:00:00+03:00,in,False,-1,True,2,0,4,4
168008,2019-10-25 00:00:00+03:00,in,False,-1,True,1,0,2,2
168008,2019-10-25 00:00:00+03:00,in,False,946988,False,2,68,89,21
168008,2019-10-28 00:00:00+03:00,in,False,946988,False,1,51,60,9
168008,2019-10-28 00:00:00+03:00,out,False,946988,True,4,0,1,1
168008,2019-10-29 00:00:00+03:00,in,False,-1,True,3,0,62,62
168008,2019-10-29 00:00:00+03:00,in,False,948524,False,1,23,30,7
168008,2019-10-30 00:00:00+03:00,in,False,-1,True,2,0,5,5
168008,2019-10-31 00:00:00+03:00,in,False,-1,True,2,0,4,4
168008,2019-10-31 00:00:00+03:00,in,False,-1,True,2,0,4,4
168008,2019-11-01 00:00:00+03:00,in,False,948524,False,1,99,105,6
168008,2019-11-03 00:00:00+03:00,in,False,-1,True,4,0,1,1
168008,2019-11-05 00:00:00+03:00,in,False,948524,False,1,13,18,5
168008,2019-11-06 00:00:00+03:00,out,False,946988,True,1,0,12,12
168008,2019-11-07 00:00:00+03:00,in,False,-1,True,2,0,53,53
168008,2019-11-12 00:00:00+03:00,in,False,-1,True,1,0,26,26
168008,2019-11-19 00:00:00+03:00,in,False,948524,False,1,30,34,4
168010,2019-10-11 00:00:00+03:00,in,False,-1,True,2,0,0,0
168010,2019-10-28 00:00:00+03:00,in,False,932672,False,5,487,495,8
168010,2019-10-29 00:00:00+03:00,in,False,932672,False,1,194,195,1
168010,2019-11-05 00:00:00+03:00,in,False,932672,False,1,2,3,1
168010,2019-11-25 00:00:00+03:00,out,False,932676,False,1,28,43,15
168010,2019-11-25 00:00:00+03:00,out,False,932676,True,3,0,22,22
168013,2019-10-31 00:00:00+03:00,in,False,-1,True,2,0,5,5
168016,2019-10-14 00:00:00+03:00,in,False,935870,False,1,10,23,13
168016,2019-10-20 00:00:00+03:00,in,False,-1,True,3,0,6,6
168016,2019-10-20 00:00:00+03:00,in,False,-1,True,3,0,6,6
168016,2019-10-23 00:00:00+03:00,in,False,935870,False,1,1,10,9
168016,2019-10-25 00:00:00+03:00,in,False,935870,False,1,18,27,9
168016,2019-10-29 00:00:00+03:00,in,False,935870,False,1,7,17,10
168016,2019-10-29 00:00:00+03:00,in,False,-1,True,3,0,12,12
168016,2019-10-31 00:00:00+03:00,in,False,-1,True,1,0,1,1
168016,2019-11-07 00:00:00+03:00,in,False,-1,True,2,0,60,60
168016,2019-11-08 00:00:00+03:00,in,False,935870,False,1,120,136,16
168016,2019-11-09 00:00:00+03:00,in,False,-1,True,1,0,9,9
168016,2019-11-14 00:00:00+03:00,in,False,935870,False,2,80,112,32
168016,2019-11-14 00:00:00+03:00,in,False,-1,True,1,0,14,14
168016,2019-11-16 00:00:00+03:00,in,False,-1,True,1,0,2,2
168016,2019-11-19 00:00:00+03:00,in,False,-1,True,2,0,22,22
168016,2019-11-28 00:00:00+03:00,in,False,935870,False,1,29,43,14
168018,2019-10-24 00:00:00+03:00,in,False,-1,True,1,0,2,2
168018,2019-10-24 00:00:00+03:00,out,False,945902,False,3,65,95,30
168018,2019-10-24 00:00:00+03:00,out,False,945894,True,4,0,135,135
168018,2019-10-24 00:00:00+03:00,out,False,945900,False,6,78,143,65
168018,2019-10-24 00:00:00+03:00,out,False,945902,True,4,0,97,97
168018,2019-10-24 00:00:00+03:00,out,False,945894,False,5,89,163,74
168018,2019-10-24 00:00:00+03:00,out,False,945904,False,7,119,215,96
168018,2019-10-24 00:00:00+03:00,out,False,945900,True,6,0,112,112
168018,2019-10-24 00:00:00+03:00,out,False,945904,True,2,0,50,50
168018,2019-10-24 00:00:00+03:00,out,False,945898,True,3,0,1,1
168018,2019-10-24 00:00:00+03:00,out,False,945900,True,6,0,112,112
168018,2019-10-25 00:00:00+03:00,out,False,945900,True,152,0,2945,2945
168018,2019-10-25 00:00:00+03:00,out,False,945902,False,128,1803,3339,1536
168018,2019-10-25 00:00:00+03:00,out,False,945900,False,158,2239,4342,2103
168018,2019-10-25 00:00:00+03:00,out,False,945904,False,122,3454,5387,1933
168018,2019-10-25 00:00:00+03:00,out,False,945894,False,169,3438,6007,2569
168018,2019-10-25 00:00:00+03:00,out,False,945902,True,106,0,1961,1961
168018,2019-10-25 00:00:00+03:00,in,False,-1,True,67,0,149,149
168018,2019-10-25 00:00:00+03:00,out,False,945904,True,77,0,2195,2195
168018,2019-10-25 00:00:00+03:00,out,False,945894,True,124,0,2614,2614
168018,2019-10-25 00:00:00+03:00,out,False,945902,True,106,0,1961,1961
168018,2019-10-26 00:00:00+03:00,out,False,945902,True,25,0,530,530
168018,2019-10-26 00:00:00+03:00,out,False,945902,False,10,174,282,108
168018,2019-10-26 00:00:00+03:00,out,False,945904,False,56,1157,2004,847
168018,2019-10-26 00:00:00+03:00,in,False,-1,True,15,0,29,29
168018,2019-10-26 00:00:00+03:00,out,False,945904,True,56,0,1636,1636
168018,2019-10-26 00:00:00+03:00,out,False,945902,True,25,0,530,530
168018,2019-10-28 00:00:00+03:00,out,False,945900,False,157,2080,4428,2348
168018,2019-10-28 00:00:00+03:00,out,False,945900,True,152,0,3414,3414
168018,2019-10-28 00:00:00+03:00,in,False,-1,True,36,0,82,82
168018,2019-10-28 00:00:00+03:00,out,False,945902,True,32,0,576,576
168018,2019-10-28 00:00:00+03:00,out,False,945904,True,70,0,1887,1887
168018,2019-10-28 00:00:00+03:00,out,False,945904,False,100,1820,3551,1731
168018,2019-10-28 00:00:00+03:00,out,False,945902,False,26,492,852,360
168018,2019-10-29 00:00:00+03:00,out,False,945904,False,267,4348,8519,4171
168018,2019-10-29 00:00:00+03:00,out,True,945900,False,1,3,3,0
168018,2019-10-29 00:00:00+03:00,out,False,945904,True,122,0,3212,3212
168018,2019-10-29 00:00:00+03:00,out,False,945902,True,97,0,1707,1707
168018,2019-10-29 00:00:00+03:00,in,False,-1,True,49,0,107,107
168018,2019-10-29 00:00:00+03:00,out,False,945900,False,229,2930,6058,3128
168018,2019-10-29 00:00:00+03:00,out,False,945900,True,146,0,3111,3111
168018,2019-10-29 00:00:00+03:00,out,False,945902,False,133,2079,3863,1784
168018,2019-10-29 00:00:00+03:00,out,False,945900,True,146,0,3111,3111
168018,2019-10-29 00:00:00+03:00,out,False,945904,False,267,4348,8519,4171
168018,2019-10-30 00:00:00+03:00,out,False,945902,True,81,0,1442,1442
168018,2019-10-30 00:00:00+03:00,out,False,945904,True,122,0,2507,2507
168018,2019-10-30 00:00:00+03:00,out,False,945904,False,185,3312,6594,3282
168018,2019-10-30 00:00:00+03:00,out,False,945900,True,122,0,2698,2698
168018,2019-10-30 00:00:00+03:00,in,False,-1,True,27,0,53,53
168018,2019-10-30 00:00:00+03:00,out,False,945902,False,90,1170,2401,1231
168018,2019-10-30 00:00:00+03:00,out,False,945900,False,156,2145,4614,2469
168018,2019-10-30 00:00:00+03:00,out,False,945900,True,122,0,2698,2698
168018,2019-10-31 00:00:00+03:00,in,False,-1,True,63,0,130,130
168018,2019-10-31 00:00:00+03:00,out,False,945900,True,114,0,2748,2748
168018,2019-10-31 00:00:00+03:00,out,False,945900,False,158,2599,5305,2706
168018,2019-10-31 00:00:00+03:00,out,False,945904,True,109,0,2206,2206
168018,2019-10-31 00:00:00+03:00,out,False,945902,False,120,1856,3482,1626
168018,2019-10-31 00:00:00+03:00,out,False,945902,True,141,0,2386,2386
168018,2019-10-31 00:00:00+03:00,out,False,945904,False,114,2200,4213,2013
168018,2019-11-01 00:00:00+03:00,in,False,-1,True,37,0,80,80
168018,2019-11-01 00:00:00+03:00,out,False,945894,False,102,2475,4200,1725
168018,2019-11-01 00:00:00+03:00,out,False,945902,False,83,1830,2961,1131
168018,2019-11-01 00:00:00+03:00,out,False,945902,True,110,0,2074,2074
168018,2019-11-01 00:00:00+03:00,out,False,945894,True,86,0,2008,2008
168018,2019-11-01 00:00:00+03:00,out,False,945900,False,100,1389,3122,1733
168018,2019-11-01 00:00:00+03:00,out,False,945904,False,155,3188,5583,2395
168018,2019-11-01 00:00:00+03:00,out,False,945900,True,74,0,1838,1838
168018,2019-11-01 00:00:00+03:00,out,False,945904,True,89,0,2339,2339
168018,2019-11-01 00:00:00+03:00,out,False,945902,False,83,1830,2961,1131
168018,2019-11-02 00:00:00+03:00,in,False,-1,True,3,0,6,6
168018,2019-11-03 00:00:00+03:00,in,False,-1,True,2,0,4,4
168018,2019-11-05 00:00:00+03:00,out,False,945894,False,176,3360,5710,2350
168018,2019-11-05 00:00:00+03:00,out,False,945904,False,154,2723,5434,2711
168018,2019-11-05 00:00:00+03:00,in,False,-1,True,51,0,113,113
168018,2019-11-05 00:00:00+03:00,out,False,945900,False,168,1942,4664,2722
168018,2019-11-05 00:00:00+03:00,out,False,945904,True,87,0,2250,2250
168018,2019-11-05 00:00:00+03:00,out,False,945900,True,131,0,2917,2917
168018,2019-11-05 00:00:00+03:00,out,False,945894,True,122,0,2846,2846
168018,2019-11-05 00:00:00+03:00,out,False,-1,False,1,978,984,6
168018,2019-11-06 00:00:00+03:00,out,False,945894,False,42,665,1311,646
168018,2019-11-06 00:00:00+03:00,out,False,945902,False,35,935,1433,498
168018,2019-11-06 00:00:00+03:00,out,False,945902,True,21,0,361,361
168018,2019-11-06 00:00:00+03:00,out,False,945900,True,69,0,1787,1787
168018,2019-11-06 00:00:00+03:00,out,False,945900,False,73,1505,2787,1282
168018,2019-11-06 00:00:00+03:00,out,False,945894,True,44,0,1080,1080
168018,2019-11-06 00:00:00+03:00,out,False,945904,True,71,0,1706,1706
168018,2019-11-06 00:00:00+03:00,out,False,945904,False,115,2208,4204,1996
168018,2019-11-06 00:00:00+03:00,in,False,-1,True,25,0,54,54
168018,2019-11-06 00:00:00+03:00,out,False,945894,False,42,665,1311,646
168018,2019-11-06 00:00:00+03:00,out,False,945900,False,73,1505,2787,1282
168018,2019-11-07 00:00:00+03:00,out,False,945902,False,150,1847,3995,2148
168018,2019-11-07 00:00:00+03:00,out,False,945904,False,121,3612,5803,2191
168018,2019-11-07 00:00:00+03:00,out,False,945902,True,136,0,3046,3046
168018,2019-11-07 00:00:00+03:00,out,False,945904,True,101,0,2408,2408
168018,2019-11-07 00:00:00+03:00,out,False,945894,False,206,4417,7405,2988
168018,2019-11-07 00:00:00+03:00,in,False,-1,True,42,0,87,87
168018,2019-11-07 00:00:00+03:00,out,False,945894,True,188,0,3929,3929
168018,2019-11-07 00:00:00+03:00,out,False,945900,True,103,0,2498,2498
168018,2019-11-07 00:00:00+03:00,out,False,945900,False,164,2294,4865,2571
168018,2019-11-08 00:00:00+03:00,in,False,-1,True,28,0,58,58
168018,2019-11-08 00:00:00+03:00,out,False,945900,False,66,723,1768,1045
168018,2019-11-08 00:00:00+03:00,out,False,945894,False,66,1284,2280,996
168018,2019-11-08 00:00:00+03:00,out,False,945904,False,110,2275,4253,1978
168018,2019-11-08 00:00:00+03:00,out,False,945902,False,83,1304,2601,1297
168018,2019-11-08 00:00:00+03:00,out,False,945902,True,75,0,1658,1658
168018,2019-11-08 00:00:00+03:00,out,False,945900,True,45,0,940,940
168018,2019-11-08 00:00:00+03:00,out,False,945894,True,62,0,1268,1268
168018,2019-11-08 00:00:00+03:00,out,False,945904,True,108,0,2373,2373
168018,2019-11-09 00:00:00+03:00,in,False,-1,True,1,0,2,2
168018,2019-11-10 00:00:00+03:00,out,False,945904,True,1,0,50,50
168018,2019-11-10 00:00:00+03:00,out,False,945900,False,2,20,69,49
168018,2019-11-10 00:00:00+03:00,in,False,-1,True,5,0,11,11
168018,2019-11-10 00:00:00+03:00,out,False,945900,True,1,0,32,32
168018,2019-11-10 00:00:00+03:00,in,False,-1,True,5,0,11,11
168018,2019-11-11 00:00:00+03:00,out,False,945902,True,85,0,1758,1758
168018,2019-11-11 00:00:00+03:00,out,False,945902,False,122,1593,3466,1873
168018,2019-11-11 00:00:00+03:00,out,False,945904,True,132,0,3115,3115
168018,2019-11-11 00:00:00+03:00,out,False,945904,False,211,4013,7858,3845
168018,2019-11-11 00:00:00+03:00,in,False,-1,True,16,0,37,37
168018,2019-11-12 00:00:00+03:00,in,False,-1,True,11,0,22,22
168018,2019-11-12 00:00:00+03:00,out,False,945902,False,91,1337,2692,1355
168018,2019-11-12 00:00:00+03:00,out,False,945902,True,88,0,1910,1910
168018,2019-11-12 00:00:00+03:00,out,False,945902,False,91,1337,2692,1355
168018,2019-11-13 00:00:00+03:00,out,False,945900,False,53,559,1399,840
168018,2019-11-13 00:00:00+03:00,in,False,-1,True,30,0,65,65
168018,2019-11-13 00:00:00+03:00,out,False,945904,True,104,0,2626,2626
168018,2019-11-13 00:00:00+03:00,out,False,945902,False,117,2063,3949,1886
168018,2019-11-13 00:00:00+03:00,out,False,945900,True,42,0,1122,1122
168018,2019-11-13 00:00:00+03:00,out,False,-1,False,1,585,598,13
168018,2019-11-13 00:00:00+03:00,out,False,945904,False,142,3969,6400,2431
168018,2019-11-13 00:00:00+03:00,out,False,945902,True,94,0,2142,2142
168018,2019-11-13 00:00:00+03:00,out,False,945900,False,53,559,1399,840
168018,2019-11-14 00:00:00+03:00,out,False,945902,False,1,44,70,26
168018,2019-11-14 00:00:00+03:00,out,False,945904,True,112,0,2825,2825
168018,2019-11-14 00:00:00+03:00,out,False,945900,True,120,0,2609,2609
168018,2019-11-14 00:00:00+03:00,out,False,945904,False,135,3256,5555,2299
168018,2019-11-14 00:00:00+03:00,in,False,-1,True,30,0,61,61
168018,2019-11-14 00:00:00+03:00,out,False,945900,False,145,2046,4280,2234
168018,2019-11-15 00:00:00+03:00,out,False,945902,True,88,0,1559,1559
168018,2019-11-15 00:00:00+03:00,out,False,945904,True,140,0,3533,3533
168018,2019-11-15 00:00:00+03:00,out,False,945900,True,73,0,1648,1648
168018,2019-11-15 00:00:00+03:00,out,False,945900,False,40,471,1219,748
168018,2019-11-15 00:00:00+03:00,out,False,945902,False,82,1469,2614,1145
168018,2019-11-15 00:00:00+03:00,in,False,-1,True,43,0,92,92
168018,2019-11-15 00:00:00+03:00,out,False,945904,False,161,4799,7580,2781
168018,2019-11-15 00:00:00+03:00,out,False,945902,False,82,1469,2614,1145
168018,2019-11-15 00:00:00+03:00,out,False,945902,True,88,0,1559,1559
168018,2019-11-16 00:00:00+03:00,in,False,-1,True,1,0,2,2
168018,2019-11-16 00:00:00+03:00,out,False,945904,True,8,0,245,245
168018,2019-11-16 00:00:00+03:00,out,False,945904,False,9,547,719,172
168018,2019-11-17 00:00:00+03:00,in,False,-1,True,2,0,4,4
168018,2019-11-18 00:00:00+03:00,out,False,945900,True,86,0,2155,2155
168018,2019-11-18 00:00:00+03:00,out,False,945902,False,46,901,1503,602
168018,2019-11-18 00:00:00+03:00,out,False,945904,True,76,0,1686,1686
168018,2019-11-18 00:00:00+03:00,in,False,-1,True,15,0,32,32
168018,2019-11-18 00:00:00+03:00,out,False,945904,False,62,1414,2411,997
168018,2019-11-18 00:00:00+03:00,out,False,945902,True,42,0,769,769
168018,2019-11-18 00:00:00+03:00,out,False,945900,False,80,1107,2287,1180
168018,2019-11-19 00:00:00+03:00,in,False,-1,True,13,0,27,27
168018,2019-11-19 00:00:00+03:00,out,False,945902,False,50,830,1562,732
168018,2019-11-19 00:00:00+03:00,out,False,945902,True,73,0,1312,1312
168018,2019-11-19 00:00:00+03:00,out,False,945900,False,94,1563,3109,1546
168018,2019-11-19 00:00:00+03:00,out,False,945900,True,101,0,2163,2163
168018,2019-11-19 00:00:00+03:00,out,False,945900,True,101,0,2163,2163
168018,2019-11-20 00:00:00+03:00,out,False,945902,False,77,1689,2809,1120
168018,2019-11-20 00:00:00+03:00,in,False,-1,True,15,0,35,35
168018,2019-11-20 00:00:00+03:00,out,False,945900,True,102,0,2302,2302
168018,2019-11-20 00:00:00+03:00,out,False,945900,False,106,2098,3701,1603
168018,2019-11-20 00:00:00+03:00,out,False,945902,True,89,0,1755,1755
168018,2019-11-20 00:00:00+03:00,out,False,945900,False,106,2098,3701,1603
168018,2019-11-22 00:00:00+03:00,in,False,-1,True,2,0,4,4
168018,2019-11-26 00:00:00+03:00,out,False,945900,False,120,3137,4920,1783
168018,2019-11-26 00:00:00+03:00,out,False,-1,False,1,229,246,17
168018,2019-11-26 00:00:00+03:00,out,False,945900,True,78,0,1826,1826
168018,2019-11-26 00:00:00+03:00,out,False,945894,True,25,0,512,512
168018,2019-11-26 00:00:00+03:00,out,False,945894,False,42,1392,1966,574
168018,2019-11-26 00:00:00+03:00,out,False,945902,False,1,4,22,18
168018,2019-11-26 00:00:00+03:00,in,False,-1,True,23,0,51,51
168018,2019-11-27 00:00:00+03:00,out,False,945900,True,71,0,1828,1828
168018,2019-11-27 00:00:00+03:00,in,False,-1,True,18,0,37,37
168018,2019-11-27 00:00:00+03:00,out,False,945894,True,1,0,25,25
168018,2019-11-27 00:00:00+03:00,out,False,945900,False,116,3785,5454,1669
168018,2019-11-28 00:00:00+03:00,in,False,-1,True,1,0,2,2
168018,2019-11-28 00:00:00+03:00,out,False,945900,False,144,4261,6528,2267
168018,2019-11-28 00:00:00+03:00,in,False,-1,True,12,0,24,24
168018,2019-11-28 00:00:00+03:00,out,False,945900,True,86,0,1928,1928
168019,2019-10-09 00:00:00+03:00,in,False,-1,True,1,0,2,2
168019,2019-10-11 00:00:00+03:00,in,False,-1,True,2,0,75,75
168019,2019-10-14 00:00:00+03:00,in,False,935216,False,1,12,15,3
168019,2019-10-24 00:00:00+03:00,out,False,935216,False,2,118,148,30
168019,2019-10-24 00:00:00+03:00,out,False,935216,True,1,0,60,60
168019,2019-10-26 00:00:00+03:00,out,False,935216,False,1,173,175,2
168019,2019-10-28 00:00:00+03:00,out,False,935216,False,2,105,128,23
168019,2019-11-03 00:00:00+03:00,out,False,935216,False,2,232,243,11
168019,2019-11-03 00:00:00+03:00,out,False,935216,True,1,0,2,2
168019,2019-11-05 00:00:00+03:00,out,False,935216,False,2,600,610,10
168019,2019-11-07 00:00:00+03:00,out,False,935216,False,1,23,29,6
168019,2019-11-07 00:00:00+03:00,out,False,935216,True,4,0,8,8
168019,2019-11-11 00:00:00+03:00,out,False,935216,False,4,868,906,38
168019,2019-11-12 00:00:00+03:00,out,False,935216,False,1,126,130,4
168019,2019-11-13 00:00:00+03:00,out,False,935216,False,3,523,540,17
168019,2019-11-14 00:00:00+03:00,out,False,935216,False,2,437,445,8
168019,2019-11-19 00:00:00+03:00,out,False,935216,False,1,285,289,4
168019,2019-11-19 00:00:00+03:00,out,True,935216,True,4,0,0,0
168019,2019-11-19 00:00:00+03:00,in,False,935216,False,1,8,15,7
168019,2019-11-19 00:00:00+03:00,out,True,965232,False,1,23,31,8
168019,2019-11-19 00:00:00+03:00,out,False,965232,False,1,122,124,2
168019,2019-11-19 00:00:00+03:00,out,True,935216,False,1,23,35,12
168019,2019-11-19 00:00:00+03:00,out,True,935216,False,1,23,35,12
168019,2019-11-20 00:00:00+03:00,out,True,965232,False,1,18,24,6
168019,2019-11-20 00:00:00+03:00,out,True,935216,False,1,29,37,8
168019,2019-11-20 00:00:00+03:00,out,False,965232,True,8,0,201,201
168019,2019-11-20 00:00:00+03:00,in,False,-1,True,1,0,0,0
168019,2019-11-20 00:00:00+03:00,out,False,965232,False,12,1130,1189,59
168019,2019-11-20 00:00:00+03:00,out,True,965232,False,1,18,24,6
168019,2019-11-27 00:00:00+03:00,out,True,965232,False,1,13,21,8
168019,2019-11-27 00:00:00+03:00,out,False,965232,False,11,529,651,122
168019,2019-11-27 00:00:00+03:00,out,False,965232,True,2,0,1,1
168021,2019-10-17 00:00:00+03:00,out,False,939224,False,7,937,1024,87
168021,2019-10-17 00:00:00+03:00,out,False,939222,True,2,0,52,52
168021,2019-10-17 00:00:00+03:00,out,False,939224,True,7,0,73,73
168021,2019-10-17 00:00:00+03:00,in,False,-1,True,12,0,147,147
168021,2019-10-17 00:00:00+03:00,out,False,939222,False,13,2165,2333,168
168021,2019-10-18 00:00:00+03:00,in,False,-1,True,2,0,17,17
168021,2019-10-18 00:00:00+03:00,in,False,939222,False,1,18,31,13
168021,2019-10-18 00:00:00+03:00,in,False,939224,False,1,10,17,7
168021,2019-10-18 00:00:00+03:00,out,False,939224,True,3,0,58,58
168021,2019-10-18 00:00:00+03:00,out,False,939222,False,11,2051,2208,157
168021,2019-10-18 00:00:00+03:00,out,False,939222,True,2,0,35,35
168021,2019-10-18 00:00:00+03:00,out,False,939224,False,8,407,539,132
168021,2019-10-20 00:00:00+03:00,in,False,-1,True,2,0,0,0
168021,2019-10-20 00:00:00+03:00,in,False,-1,True,2,0,0,0
168021,2019-10-21 00:00:00+03:00,out,False,939222,True,6,0,120,120
168021,2019-10-21 00:00:00+03:00,out,False,939222,False,10,522,712,190
168021,2019-10-21 00:00:00+03:00,in,False,939222,False,1,165,179,14
168021,2019-10-21 00:00:00+03:00,out,False,939224,False,4,478,528,50
168021,2019-10-21 00:00:00+03:00,out,False,939224,True,4,0,42,42
168021,2019-10-22 00:00:00+03:00,out,False,939224,False,13,489,672,183
168021,2019-10-22 00:00:00+03:00,in,False,939222,False,2,90,101,11
168021,2019-10-22 00:00:00+03:00,in,False,-1,True,4,0,84,84
168021,2019-10-22 00:00:00+03:00,out,False,939224,True,3,0,30,30
168021,2019-10-22 00:00:00+03:00,out,False,939222,False,25,1332,1701,369
168021,2019-10-22 00:00:00+03:00,out,False,939218,False,4,80,125,45
168021,2019-10-22 00:00:00+03:00,out,False,939218,True,2,0,13,13
168021,2019-10-22 00:00:00+03:00,out,False,939222,True,15,0,307,307
168021,2019-10-22 00:00:00+03:00,out,False,939222,True,15,0,307,307
168021,2019-10-22 00:00:00+03:00,out,False,939224,False,13,489,672,183
168021,2019-10-23 00:00:00+03:00,out,False,939222,True,10,0,350,350
168021,2019-10-23 00:00:00+03:00,in,False,-1,True,7,0,88,88
168021,2019-10-23 00:00:00+03:00,out,False,939224,False,7,259,330,71
168021,2019-10-23 00:00:00+03:00,in,False,939222,False,1,17,29,12
168021,2019-10-23 00:00:00+03:00,out,False,939222,False,15,704,928,224
168021,2019-10-24 00:00:00+03:00,in,False,939222,False,2,47,81,34
168021,2019-10-24 00:00:00+03:00,in,False,-1,True,7,0,114,114
168021,2019-10-24 00:00:00+03:00,out,False,939222,False,15,2250,2468,218
168021,2019-10-24 00:00:00+03:00,out,False,939222,True,13,0,379,379
168021,2019-10-24 00:00:00+03:00,out,False,939218,False,2,100,148,48
168021,2019-10-24 00:00:00+03:00,out,False,939224,True,19,0,96,96
168021,2019-10-24 00:00:00+03:00,out,False,939224,False,14,269,408,139
168021,2019-10-24 00:00:00+03:00,out,False,939218,True,5,0,64,64
168021,2019-10-24 00:00:00+03:00,out,False,939218,False,2,100,148,48
168021,2019-10-25 00:00:00+03:00,in,False,939224,False,2,279,315,36
168021,2019-10-25 00:00:00+03:00,in,False,939222,False,2,153,177,24
168021,2019-10-25 00:00:00+03:00,out,False,939224,True,4,0,52,52
168021,2019-10-25 00:00:00+03:00,in,False,-1,True,5,0,83,83
168021,2019-10-25 00:00:00+03:00,out,False,939222,True,7,0,177,177
168021,2019-10-25 00:00:00+03:00,out,False,939218,True,3,0,6,6
168021,2019-10-25 00:00:00+03:00,out,False,939224,False,3,23,57,34
168021,2019-10-25 00:00:00+03:00,out,False,939222,False,6,569,678,109
168021,2019-10-25 00:00:00+03:00,out,False,939218,False,5,858,905,47
168021,2019-10-25 00:00:00+03:00,in,False,939224,False,2,279,315,36
168021,2019-10-26 00:00:00+03:00,in,False,-1,True,2,0,1,1
168021,2019-10-27 00:00:00+03:00,in,False,-1,True,2,0,0,0
168021,2019-10-28 00:00:00+03:00,out,False,939224,False,3,165,205,40
168021,2019-10-28 00:00:00+03:00,in,False,939218,False,2,42,65,23
168021,2019-10-28 00:00:00+03:00,out,False,939218,False,18,1073,1481,408
168021,2019-10-28 00:00:00+03:00,out,False,939218,True,2,0,32,32
168021,2019-10-28 00:00:00+03:00,out,False,939222,True,9,0,191,191
168021,2019-10-28 00:00:00+03:00,in,False,-1,True,4,0,6,6
168021,2019-10-28 00:00:00+03:00,out,False,939222,False,26,2860,3267,407
168021,2019-10-28 00:00:00+03:00,out,False,939218,True,2,0,32,32
168021,2019-10-29 00:00:00+03:00,out,False,939218,True,1,0,5,5
168021,2019-10-29 00:00:00+03:00,in,False,939222,False,2,186,210,24
168021,2019-10-29 00:00:00+03:00,out,False,939222,True,15,0,570,570
168021,2019-10-29 00:00:00+03:00,out,False,939218,False,6,385,494,109
168021,2019-10-29 00:00:00+03:00,in,False,-1,True,7,0,93,93
168021,2019-10-29 00:00:00+03:00,out,False,939222,False,19,1791,2171,380
168021,2019-10-30 00:00:00+03:00,out,False,939222,False,23,3083,3488,405
168021,2019-10-30 00:00:00+03:00,out,False,939224,False,2,124,149,25
168021,2019-10-30 00:00:00+03:00,in,False,-1,True,2,0,52,52
168021,2019-10-30 00:00:00+03:00,in,False,939222,False,2,230,259,29
168021,2019-10-30 00:00:00+03:00,out,False,939222,True,12,0,401,401
168021,2019-10-30 00:00:00+03:00,out,False,939224,True,2,0,26,26
168021,2019-10-31 00:00:00+03:00,out,False,939222,False,24,3068,3370,302
168021,2019-10-31 00:00:00+03:00,out,False,939222,True,10,0,291,291
168021,2019-10-31 00:00:00+03:00,out,False,939224,True,14,0,231,231
168021,2019-10-31 00:00:00+03:00,out,False,939224,False,8,206,299,93
168021,2019-10-31 00:00:00+03:00,in,False,939224,False,2,58,84,26
168021,2019-10-31 00:00:00+03:00,out,False,939218,False,10,327,589,262
168021,2019-10-31 00:00:00+03:00,out,False,939224,True,14,0,231,231
168021,2019-11-01 00:00:00+03:00,out,False,939222,False,20,1508,1816,308
168021,2019-11-01 00:00:00+03:00,in,False,939224,False,2,83,151,68
168021,2019-11-01 00:00:00+03:00,in,False,939222,False,1,57,68,11
168021,2019-11-01 00:00:00+03:00,out,False,939224,True,14,0,163,163
168021,2019-11-01 00:00:00+03:00,out,False,939218,False,3,196,298,102
168021,2019-11-01 00:00:00+03:00,out,False,939224,False,10,309,404,95
168021,2019-11-01 00:00:00+03:00,out,False,939222,True,19,0,520,520
168021,2019-11-01 00:00:00+03:00,out,False,939222,True,19,0,520,520
168021,2019-11-03 00:00:00+03:00,in,False,-1,True,1,0,0,0
168021,2019-11-04 00:00:00+03:00,in,False,939218,False,1,17,23,6
168021,2019-11-04 00:00:00+03:00,out,False,939218,False,7,1749,1899,150
168021,2019-11-04 00:00:00+03:00,out,False,939218,True,2,0,24,24
168021,2019-11-05 00:00:00+03:00,out,False,939218,False,13,489,789,300
168021,2019-11-05 00:00:00+03:00,out,False,939222,False,31,3762,4312,550
168021,2019-11-05 00:00:00+03:00,out,False,939224,True,37,0,547,547
168021,2019-11-05 00:00:00+03:00,out,False,939224,False,53,1183,1786,603
168021,2019-11-05 00:00:00+03:00,out,False,939218,True,2,0,30,30
168021,2019-11-05 00:00:00+03:00,in,False,939224,False,2,73,115,42
168021,2019-11-05 00:00:00+03:00,in,False,939222,False,2,178,203,25
168021,2019-11-05 00:00:00+03:00,in,False,-1,True,1,0,61,61
168021,2019-11-05 00:00:00+03:00,in,False,939218,False,1,9,22,13
168021,2019-11-05 00:00:00+03:00,out,False,939222,True,12,0,337,337
168021,2019-11-06 00:00:00+03:00,out,False,939224,True,38,0,581,581
168021,2019-11-06 00:00:00+03:00,in,False,-1,True,14,0,194,194
168021,2019-11-06 00:00:00+03:00,out,False,939218,True,3,0,96,96
168021,2019-11-06 00:00:00+03:00,in,False,939222,False,3,144,165,21
168021,2019-11-06 00:00:00+03:00,out,False,939218,False,12,2923,3173,250
168021,2019-11-06 00:00:00+03:00,in,False,939224,False,1,9,17,8
168021,2019-11-06 00:00:00+03:00,out,False,939224,False,34,724,1167,443
168021,2019-11-06 00:00:00+03:00,out,False,939222,True,17,0,540,540
168021,2019-11-06 00:00:00+03:00,out,False,939222,False,32,3214,3736,522
168021,2019-11-07 00:00:00+03:00,in,False,-1,True,1,0,14,14
168021,2019-11-07 00:00:00+03:00,out,False,939218,False,2,250,287,37
168021,2019-11-07 00:00:00+03:00,out,False,939222,True,22,0,562,562
168021,2019-11-07 00:00:00+03:00,out,False,939224,True,36,0,406,406
168021,2019-11-07 00:00:00+03:00,out,False,939218,True,2,0,82,82
168021,2019-11-07 00:00:00+03:00,in,False,939224,False,2,141,162,21
168021,2019-11-07 00:00:00+03:00,in,False,939222,False,1,4,16,12
168021,2019-11-07 00:00:00+03:00,out,False,939222,False,30,1867,2298,431
168021,2019-11-07 00:00:00+03:00,out,False,939224,False,47,1664,2251,587
168021,2019-11-07 00:00:00+03:00,in,False,939222,False,1,4,16,12
168021,2019-11-08 00:00:00+03:00,out,False,939222,True,12,0,283,283
168021,2019-11-08 00:00:00+03:00,in,False,-1,True,12,0,125,125
168021,2019-11-08 00:00:00+03:00,out,False,939224,True,35,0,419,419
168021,2019-11-08 00:00:00+03:00,in,False,939218,False,1,33,38,5
168021,2019-11-08 00:00:00+03:00,out,False,939218,False,19,1318,1662,344
168021,2019-11-08 00:00:00+03:00,out,False,939222,False,23,922,1374,452
168021,2019-11-08 00:00:00+03:00,in,False,939222,False,1,32,36,4
168021,2019-11-08 00:00:00+03:00,out,False,939224,False,31,520,834,314
168021,2019-11-08 00:00:00+03:00,out,False,939218,True,17,0,403,403
168021,2019-11-08 00:00:00+03:00,out,False,939224,False,31,520,834,314
168021,2019-11-09 00:00:00+03:00,in,False,-1,True,8,0,0,0
168021,2019-11-09 00:00:00+03:00,in,False,-1,True,8,0,0,0
168021,2019-11-11 00:00:00+03:00,out,False,939224,True,25,0,371,371
168021,2019-11-11 00:00:00+03:00,out,False,939222,True,14,0,522,522
168021,2019-11-11 00:00:00+03:00,in,False,-1,True,9,0,70,70
168021,2019-11-11 00:00:00+03:00,out,False,939218,False,2,1239,1269,30
168021,2019-11-11 00:00:00+03:00,out,False,939222,False,22,1475,1944,469
168021,2019-11-11 00:00:00+03:00,out,False,939224,False,23,453,720,267
168021,2019-11-11 00:00:00+03:00,out,False,939224,True,25,0,371,371
168021,2019-11-11 00:00:00+03:00,out,False,939224,False,23,453,720,267
168021,2019-11-12 00:00:00+03:00,out,False,939224,True,22,0,229,229
168021,2019-11-12 00:00:00+03:00,out,False,939218,True,6,0,95,95
168021,2019-11-12 00:00:00+03:00,out,False,939222,True,10,0,369,369
168021,2019-11-12 00:00:00+03:00,in,False,-1,True,3,0,71,71
168021,2019-11-12 00:00:00+03:00,out,False,939222,False,14,1090,1376,286
168021,2019-11-12 00:00:00+03:00,out,False,939218,False,6,45,200,155
168021,2019-11-12 00:00:00+03:00,in,False,939224,False,4,215,267,52
168021,2019-11-12 00:00:00+03:00,out,False,939224,False,16,240,419,179
168021,2019-11-12 00:00:00+03:00,out,False,939218,True,6,0,95,95
168021,2019-11-13 00:00:00+03:00,in,False,939224,False,3,134,186,52
168021,2019-11-13 00:00:00+03:00,out,False,939224,True,50,0,556,556
168021,2019-11-13 00:00:00+03:00,in,False,-1,True,7,0,64,64
168021,2019-11-13 00:00:00+03:00,out,False,939224,False,46,1089,1676,587
168021,2019-11-13 00:00:00+03:00,out,False,939218,True,1,0,1,1
168021,2019-11-13 00:00:00+03:00,out,False,939218,False,5,1929,2022,93
168021,2019-11-13 00:00:00+03:00,out,False,939222,True,10,0,451,451
168021,2019-11-13 00:00:00+03:00,out,False,939222,False,17,1694,2028,334
168021,2019-11-13 00:00:00+03:00,out,False,939218,False,5,1929,2022,93
168021,2019-11-13 00:00:00+03:00,out,False,939222,True,10,0,451,451
168021,2019-11-14 00:00:00+03:00,out,False,939222,False,20,2077,2434,357
168021,2019-11-14 00:00:00+03:00,out,False,939218,True,6,0,147,147
168021,2019-11-14 00:00:00+03:00,out,False,939222,True,11,0,322,322
168021,2019-11-14 00:00:00+03:00,in,False,939222,False,3,429,463,34
168021,2019-11-14 00:00:00+03:00,out,False,939224,True,53,0,429,429
168021,2019-11-14 00:00:00+03:00,out,False,939218,False,9,326,585,259
168021,2019-11-14 00:00:00+03:00,in,False,-1,True,13,0,225,225
168021,2019-11-14 00:00:00+03:00,out,False,939224,False,36,528,960,432
168021,2019-11-14 00:00:00+03:00,in,False,939218,False,1,19,24,5
168021,2019-11-14 00:00:00+03:00,out,False,939224,True,53,0,429,429
168021,2019-11-15 00:00:00+03:00,in,False,-1,True,21,0,171,171
168021,2019-11-15 00:00:00+03:00,out,False,939222,True,6,0,140,140
168021,2019-11-15 00:00:00+03:00,out,False,939224,False,43,756,1208,452
168021,2019-11-15 00:00:00+03:00,out,False,939224,True,50,0,472,472
168021,2019-11-15 00:00:00+03:00,out,False,939218,True,6,0,137,137
168021,2019-11-15 00:00:00+03:00,out,False,939222,False,19,1492,1780,288
168021,2019-11-15 00:00:00+03:00,out,False,939218,False,6,414,574,160
168021,2019-11-15 00:00:00+03:00,out,False,939222,True,6,0,140,140
168021,2019-11-16 00:00:00+03:00,in,False,-1,True,5,0,51,51
168021,2019-11-17 00:00:00+03:00,in,False,-1,True,4,0,0,0
168021,2019-11-18 00:00:00+03:00,in,False,939224,False,2,152,190,38
168021,2019-11-18 00:00:00+03:00,out,False,939222,False,17,1198,1506,308
168021,2019-11-18 00:00:00+03:00,out,False,939222,True,10,0,232,232
168021,2019-11-18 00:00:00+03:00,out,False,939224,True,16,0,273,273
168021,2019-11-18 00:00:00+03:00,out,False,939218,False,19,2956,3430,474
168021,2019-11-18 00:00:00+03:00,in,False,939218,False,2,355,371,16
168021,2019-11-18 00:00:00+03:00,in,False,-1,True,5,0,124,124
168021,2019-11-18 00:00:00+03:00,in,False,939222,False,1,60,80,20
168021,2019-11-18 00:00:00+03:00,out,False,939224,False,24,715,1024,309
168021,2019-11-18 00:00:00+03:00,out,False,939218,True,14,0,171,171
168021,2019-11-18 00:00:00+03:00,out,False,939224,True,16,0,273,273
168021,2019-11-19 00:00:00+03:00,in,False,939222,False,1,34,44,10
168021,2019-11-19 00:00:00+03:00,out,False,939224,True,31,0,336,336
168021,2019-11-19 00:00:00+03:00,in,False,-1,True,2,0,36,36
168021,2019-11-19 00:00:00+03:00,out,False,939218,False,10,338,636,298
168021,2019-11-19 00:00:00+03:00,out,False,939224,False,23,458,691,233
168021,2019-11-19 00:00:00+03:00,out,False,939218,True,10,0,297,297
168021,2019-11-19 00:00:00+03:00,out,False,939222,False,25,2344,2820,476
168021,2019-11-19 00:00:00+03:00,out,False,939222,True,10,0,361,361
168021,2019-11-19 00:00:00+03:00,in,False,939224,False,1,8,19,11
168021,2019-11-19 00:00:00+03:00,in,False,939224,False,1,8,19,11
168021,2019-11-20 00:00:00+03:00,out,False,939222,False,16,2545,2767,222
168021,2019-11-20 00:00:00+03:00,out,False,939224,True,54,0,678,678
168021,2019-11-20 00:00:00+03:00,in,False,939222,False,2,516,549,33
168021,2019-11-20 00:00:00+03:00,out,False,939218,False,6,964,1138,174
168021,2019-11-20 00:00:00+03:00,out,False,939224,False,47,904,1451,547
168021,2019-11-20 00:00:00+03:00,in,False,-1,True,2,0,70,70
168021,2019-11-20 00:00:00+03:00,out,False,939218,True,6,0,206,206
168021,2019-11-20 00:00:00+03:00,out,False,939222,True,14,0,446,446
168021,2019-11-20 00:00:00+03:00,in,False,939224,True,1,0,13,13
168021,2019-11-21 00:00:00+03:00,out,False,939218,True,2,0,100,100
168021,2019-11-21 00:00:00+03:00,out,False,939224,True,26,0,284,284
168021,2019-11-21 00:00:00+03:00,out,False,939222,False,12,1424,1641,217
168021,2019-11-21 00:00:00+03:00,in,False,-1,True,5,0,97,97
168021,2019-11-21 00:00:00+03:00,out,False,939218,False,9,4217,4422,205
168021,2019-11-21 00:00:00+03:00,in,False,939222,False,2,96,111,15
168021,2019-11-21 00:00:00+03:00,out,False,968150,True,7,0,109,109
168021,2019-11-21 00:00:00+03:00,out,False,939222,True,13,0,460,460
168021,2019-11-21 00:00:00+03:00,in,False,968150,False,3,103,106,3
168021,2019-11-21 00:00:00+03:00,out,False,939224,False,17,317,512,195
168021,2019-11-21 00:00:00+03:00,out,False,968150,False,9,988,1073,85
168021,2019-11-21 00:00:00+03:00,out,False,968150,False,9,988,1073,85
168021,2019-11-22 00:00:00+03:00,out,False,939222,True,5,0,211,211
168021,2019-11-22 00:00:00+03:00,out,False,968150,True,7,0,248,248
168021,2019-11-22 00:00:00+03:00,in,False,-1,True,3,0,78,78
168021,2019-11-22 00:00:00+03:00,in,False,939218,False,1,752,756,4
168021,2019-11-22 00:00:00+03:00,out,False,939218,False,18,1531,1952,421
168021,2019-11-22 00:00:00+03:00,out,False,939224,True,40,0,489,489
168021,2019-11-22 00:00:00+03:00,out,False,939224,False,42,666,1110,444
168021,2019-11-22 00:00:00+03:00,out,False,939218,True,25,0,564,564
168021,2019-11-22 00:00:00+03:00,out,False,939222,False,14,2100,2317,217
168021,2019-11-22 00:00:00+03:00,in,False,939224,False,3,59,100,41
168021,2019-11-22 00:00:00+03:00,out,False,968150,False,5,458,508,50
168021,2019-11-23 00:00:00+03:00,in,False,-1,True,8,0,0,0
168021,2019-11-25 00:00:00+03:00,in,False,-1,True,6,0,159,159
168021,2019-11-25 00:00:00+03:00,out,False,939224,True,3,0,36,36
168021,2019-11-25 00:00:00+03:00,out,False,939224,False,3,62,96,34
168021,2019-11-25 00:00:00+03:00,in,False,939222,False,1,36,42,6
168021,2019-11-25 00:00:00+03:00,out,False,939222,False,12,814,1069,255
168021,2019-11-25 00:00:00+03:00,out,False,939218,False,6,345,488,143
168021,2019-11-25 00:00:00+03:00,out,False,939222,True,7,0,197,197
168021,2019-11-25 00:00:00+03:00,in,False,968150,False,1,161,162,1
168021,2019-11-25 00:00:00+03:00,in,False,939218,False,1,43,50,7
168021,2019-11-25 00:00:00+03:00,out,False,939218,True,8,0,173,173
168021,2019-11-25 00:00:00+03:00,out,False,968150,True,7,0,255,255
168021,2019-11-25 00:00:00+03:00,out,False,968150,False,15,2794,2899,105
168021,2019-11-26 00:00:00+03:00,out,False,939224,False,22,379,591,212
168021,2019-11-26 00:00:00+03:00,in,False,-1,True,4,0,83,83
168021,2019-11-26 00:00:00+03:00,out,False,939222,True,9,0,245,245
168021,2019-11-26 00:00:00+03:00,out,False,939218,True,11,0,313,313
168021,2019-11-26 00:00:00+03:00,in,False,939218,False,1,158,166,8
168021,2019-11-26 00:00:00+03:00,out,False,939224,True,45,0,451,451
168021,2019-11-26 00:00:00+03:00,out,False,939218,False,8,297,535,238
168021,2019-11-26 00:00:00+03:00,out,False,968150,False,14,3900,4028,128
168021,2019-11-26 00:00:00+03:00,in,False,939222,False,2,639,657,18
168021,2019-11-26 00:00:00+03:00,out,False,939222,False,22,2232,2615,383
168021,2019-11-26 00:00:00+03:00,out,False,968150,True,4,0,191,191
168021,2019-11-26 00:00:00+03:00,in,False,939224,False,1,34,56,22
168021,2019-11-26 00:00:00+03:00,out,False,939222,False,22,2232,2615,383
168021,2019-11-27 00:00:00+03:00,out,False,939222,False,15,1552,1798,246
168021,2019-11-27 00:00:00+03:00,out,False,939218,False,6,325,477,152
168021,2019-11-27 00:00:00+03:00,out,False,939222,True,9,0,289,289
168021,2019-11-27 00:00:00+03:00,out,False,939224,True,29,0,370,370
168021,2019-11-27 00:00:00+03:00,out,False,968150,True,1,0,1,1
168021,2019-11-27 00:00:00+03:00,in,False,939224,False,5,147,225,78
168021,2019-11-27 00:00:00+03:00,out,False,939224,False,12,170,248,78
168021,2019-11-27 00:00:00+03:00,out,False,939218,True,5,0,211,211
168021,2019-11-27 00:00:00+03:00,in,False,-1,True,4,0,56,56
168021,2019-11-27 00:00:00+03:00,out,False,968150,False,8,1668,1789,121
168021,2019-11-28 00:00:00+03:00,out,False,939218,False,3,46,131,85
168021,2019-11-28 00:00:00+03:00,out,False,939224,True,46,0,617,617
168021,2019-11-28 00:00:00+03:00,out,False,939222,True,3,0,80,80
168021,2019-11-28 00:00:00+03:00,in,False,939222,False,1,54,96,42
168021,2019-11-28 00:00:00+03:00,out,False,939218,True,6,0,240,240
168021,2019-11-28 00:00:00+03:00,out,False,968150,False,10,2880,2967,87
168021,2019-11-28 00:00:00+03:00,out,False,939222,False,11,2078,2249,171
168021,2019-11-28 00:00:00+03:00,in,False,-1,True,3,0,37,37
168021,2019-11-28 00:00:00+03:00,out,False,968150,True,4,0,70,70
168021,2019-11-28 00:00:00+03:00,out,False,939224,False,37,712,1048,336
168021,2019-11-28 00:00:00+03:00,out,False,939218,False,3,46,131,85
168024,2019-10-12 00:00:00+03:00,in,False,-1,True,5,0,11,11
168024,2019-10-12 00:00:00+03:00,in,False,-1,True,5,0,11,11
168024,2019-10-13 00:00:00+03:00,in,False,-1,True,1,0,2,2
168024,2019-10-14 00:00:00+03:00,in,False,-1,True,3,0,6,6
168024,2019-10-15 00:00:00+03:00,in,False,-1,True,1,0,2,2
168024,2019-10-16 00:00:00+03:00,in,False,-1,True,1,0,3,3
168024,2019-10-18 00:00:00+03:00,in,False,-1,True,3,0,6,6
168024,2019-10-19 00:00:00+03:00,in,False,-1,True,1,0,2,2
168024,2019-10-22 00:00:00+03:00,in,False,-1,True,2,0,4,4
168024,2019-10-23 00:00:00+03:00,in,False,-1,True,2,0,4,4
168024,2019-10-28 00:00:00+03:00,in,False,-1,True,3,0,5,5
168024,2019-10-29 00:00:00+03:00,in,False,-1,True,5,0,11,11
168024,2019-10-30 00:00:00+03:00,in,False,-1,True,3,0,6,6
168024,2019-11-01 00:00:00+03:00,in,False,-1,True,2,0,4,4
168024,2019-11-02 00:00:00+03:00,in,False,-1,True,1,0,2,2
168024,2019-11-04 00:00:00+03:00,in,False,-1,True,2,0,4,4
168024,2019-11-05 00:00:00+03:00,in,False,-1,True,2,0,4,4
168024,2019-11-06 00:00:00+03:00,in,False,-1,True,1,0,2,2
168024,2019-11-07 00:00:00+03:00,in,False,-1,True,3,0,6,6
168024,2019-11-08 00:00:00+03:00,in,False,-1,True,3,0,6,6
168024,2019-11-09 00:00:00+03:00,in,False,-1,True,2,0,4,4
168024,2019-11-10 00:00:00+03:00,in,False,-1,True,3,0,6,6
168024,2019-11-12 00:00:00+03:00,in,False,-1,True,1,0,2,2
168024,2019-11-14 00:00:00+03:00,in,False,-1,True,2,0,5,5
168024,2019-11-15 00:00:00+03:00,in,False,-1,True,2,0,4,4
168024,2019-11-17 00:00:00+03:00,in,False,-1,True,3,0,7,7
168024,2019-11-19 00:00:00+03:00,in,False,-1,True,2,0,5,5
168024,2019-11-20 00:00:00+03:00,in,False,-1,True,1,0,2,2
168024,2019-11-21 00:00:00+03:00,in,False,-1,True,1,0,2,2
168024,2019-11-22 00:00:00+03:00,in,False,-1,True,2,0,4,4
168024,2019-11-23 00:00:00+03:00,in,False,-1,True,3,0,7,7
168024,2019-11-25 00:00:00+03:00,in,False,-1,True,1,0,2,2
168024,2019-11-28 00:00:00+03:00,in,False,-1,True,1,0,3,3
168025,2019-10-16 00:00:00+03:00,out,False,938078,True,80,0,1827,1827
168025,2019-10-16 00:00:00+03:00,out,False,938072,False,69,2777,4026,1249
168025,2019-10-16 00:00:00+03:00,in,False,933070,False,11,4425,4511,86
168025,2019-10-16 00:00:00+03:00,out,False,938074,False,53,4435,5368,933
168025,2019-10-16 00:00:00+03:00,out,False,938078,False,76,8439,9856,1417
168025,2019-10-16 00:00:00+03:00,out,False,938080,True,82,0,1913,1913
168025,2019-10-16 00:00:00+03:00,out,False,938070,False,79,7311,8529,1218
168025,2019-10-16 00:00:00+03:00,out,False,938080,False,102,7943,9711,1768
168025,2019-10-16 00:00:00+03:00,out,False,938074,True,51,0,1211,1211
168025,2019-10-16 00:00:00+03:00,out,False,938072,True,29,0,458,458
168025,2019-10-16 00:00:00+03:00,in,False,938022,False,4,218,267,49
168025,2019-10-16 00:00:00+03:00,out,False,933070,False,61,9632,10462,830
168025,2019-10-16 00:00:00+03:00,out,False,938022,True,19,0,250,250
168025,2019-10-16 00:00:00+03:00,out,False,933070,True,61,0,942,942
168025,2019-10-16 00:00:00+03:00,in,False,-1,True,77,0,352,352
168025,2019-10-16 00:00:00+03:00,out,False,938070,True,76,0,1652,1652
168025,2019-10-16 00:00:00+03:00,out,False,938022,False,16,1896,2107,211
168025,2019-10-16 00:00:00+03:00,out,False,938074,False,53,4435,5368,933
168025,2019-10-16 00:00:00+03:00,out,False,938078,False,76,8439,9856,1417
168025,2019-10-16 00:00:00+03:00,out,False,938080,True,82,0,1913,1913
168025,2019-10-17 00:00:00+03:00,in,False,933070,False,30,3191,3373,182
168025,2019-10-17 00:00:00+03:00,out,False,938080,False,102,10609,12388,1779
168025,2019-10-17 00:00:00+03:00,out,False,938070,False,114,10618,12301,1683
168025,2019-10-17 00:00:00+03:00,out,False,938080,True,65,0,1589,1589
168025,2019-10-17 00:00:00+03:00,out,False,938070,True,99,0,2421,2421
168025,2019-10-17 00:00:00+03:00,out,False,933070,False,122,11503,13077,1574
168025,2019-10-17 00:00:00+03:00,out,False,938022,True,21,0,460,460
168025,2019-10-17 00:00:00+03:00,out,False,938078,False,112,9631,11694,2063
168025,2019-10-17 00:00:00+03:00,out,False,933070,True,134,0,2133,2133
168025,2019-10-17 00:00:00+03:00,out,False,938078,True,116,0,3367,3367
168025,2019-10-17 00:00:00+03:00,out,False,938022,False,24,1945,2224,279
168025,2019-10-17 00:00:00+03:00,out,False,938074,True,70,0,1800,1800
168025,2019-10-17 00:00:00+03:00,in,False,938022,False,1,3,10,7
168025,2019-10-17 00:00:00+03:00,out,False,938072,True,77,0,1533,1533
168025,2019-10-17 00:00:00+03:00,out,False,938074,False,82,8476,9735,1259
168025,2019-10-17 00:00:00+03:00,out,False,938072,False,93,5916,7189,1273
168025,2019-10-17 00:00:00+03:00,in,False,-1,True,162,0,1079,1079
168025,2019-10-18 00:00:00+03:00,out,False,938072,False,91,6798,8432,1634
168025,2019-10-18 00:00:00+03:00,in,False,938022,False,5,78,129,51
168025,2019-10-18 00:00:00+03:00,out,False,933070,True,75,0,1525,1525
168025,2019-10-18 00:00:00+03:00,out,False,938078,False,102,11274,13243,1969
168025,2019-10-18 00:00:00+03:00,in,False,933070,False,13,202,292,90
168025,2019-10-18 00:00:00+03:00,out,False,938022,True,31,0,917,917
168025,2019-10-18 00:00:00+03:00,in,False,933070,True,1,0,6,6
168025,2019-10-18 00:00:00+03:00,out,False,938022,False,46,1488,2437,949
168025,2019-10-18 00:00:00+03:00,out,False,938070,False,121,10470,12496,2026
168025,2019-10-18 00:00:00+03:00,out,False,938080,True,92,0,3371,3371
168025,2019-10-18 00:00:00+03:00,out,True,938078,True,1,0,0,0
168025,2019-10-18 00:00:00+03:00,out,False,933070,False,84,6840,8038,1198
168025,2019-10-18 00:00:00+03:00,in,False,-1,True,147,0,861,861
168025,2019-10-18 00:00:00+03:00,out,False,938074,False,114,13056,15004,1948
168025,2019-10-18 00:00:00+03:00,out,False,938070,True,72,0,2173,2173
168025,2019-10-18 00:00:00+03:00,out,False,938072,True,69,0,1745,1745
168025,2019-10-18 00:00:00+03:00,out,False,938080,False,140,10950,13785,2835
168025,2019-10-18 00:00:00+03:00,out,False,938074,True,86,0,2343,2343
168025,2019-10-18 00:00:00+03:00,out,False,938078,True,74,0,2249,2249
168025,2019-10-19 00:00:00+03:00,in,False,-1,True,37,0,203,203
168025,2019-10-19 00:00:00+03:00,out,False,938078,False,77,7539,8984,1445
168025,2019-10-19 00:00:00+03:00,out,False,938070,True,51,0,1699,1699
168025,2019-10-19 00:00:00+03:00,out,False,938070,False,59,5486,6576,1090
168025,2019-10-19 00:00:00+03:00,out,True,938022,True,1,0,0,0
168025,2019-10-19 00:00:00+03:00,out,False,938022,True,37,0,797,797
168025,2019-10-19 00:00:00+03:00,out,False,933070,True,86,0,2044,2044
168025,2019-10-19 00:00:00+03:00,in,False,933070,False,9,872,925,53
168025,2019-10-19 00:00:00+03:00,out,False,938022,False,52,4733,5744,1011
168025,2019-10-19 00:00:00+03:00,out,False,938074,True,60,0,1822,1822
168025,2019-10-19 00:00:00+03:00,out,False,938074,False,64,5129,6200,1071
168025,2019-10-19 00:00:00+03:00,out,False,938078,True,56,0,1715,1715
168025,2019-10-19 00:00:00+03:00,in,False,938022,False,3,52,91,39
168025,2019-10-19 00:00:00+03:00,out,False,933070,False,97,7830,9528,1698
168025,2019-10-20 00:00:00+03:00,in,False,-1,True,4,0,2,2
168025,2019-10-21 00:00:00+03:00,out,False,938022,False,6,514,622,108
168025,2019-10-21 00:00:00+03:00,out,False,933070,True,29,0,660,660
168025,2019-10-21 00:00:00+03:00,in,False,933070,False,3,29,48,19
168025,2019-10-21 00:00:00+03:00,out,False,938074,True,15,0,462,462
168025,2019-10-21 00:00:00+03:00,out,False,938022,True,12,0,239,239
168025,2019-10-21 00:00:00+03:00,out,False,938080,True,33,0,739,739
168025,2019-10-21 00:00:00+03:00,in,False,-1,True,17,0,90,90
168025,2019-10-21 00:00:00+03:00,out,False,938078,False,26,3026,3501,475
168025,2019-10-21 00:00:00+03:00,out,False,933070,False,33,2232,2784,552
168025,2019-10-21 00:00:00+03:00,out,False,938078,True,30,0,1209,1209
168025,2019-10-21 00:00:00+03:00,in,False,938022,False,1,20,25,5
168025,2019-10-21 00:00:00+03:00,out,False,938074,False,16,3265,3525,260
168025,2019-10-21 00:00:00+03:00,out,False,938072,True,22,0,553,553
168025,2019-10-21 00:00:00+03:00,out,False,938072,False,22,2873,3231,358
168025,2019-10-21 00:00:00+03:00,out,False,938080,False,44,2216,3195,979
168025,2019-10-21 00:00:00+03:00,out,False,938078,True,30,0,1209,1209
168025,2019-10-21 00:00:00+03:00,out,False,938072,False,22,2873,3231,358
168025,2019-10-21 00:00:00+03:00,in,False,938022,False,1,20,25,5
168025,2019-10-21 00:00:00+03:00,in,False,-1,True,17,0,90,90
168025,2019-10-22 00:00:00+03:00,in,False,-1,True,2,0,4,4
168025,2019-10-23 00:00:00+03:00,in,False,-1,True,4,0,8,8
168025,2019-10-25 00:00:00+03:00,in,False,-1,True,1,0,2,2
168041,2019-10-11 00:00:00+03:00,in,False,-1,True,1,0,3,3
168041,2019-10-15 00:00:00+03:00,in,False,-1,True,3,0,11,11
168041,2019-10-15 00:00:00+03:00,in,False,934534,False,3,119,163,44
168041,2019-10-15 00:00:00+03:00,in,True,936514,False,1,12,27,15
168041,2019-10-16 00:00:00+03:00,in,False,-1,True,2,0,28,28
168041,2019-10-16 00:00:00+03:00,in,False,936514,False,1,181,193,12
168041,2019-10-16 00:00:00+03:00,in,False,-1,True,2,0,28,28
168041,2019-10-17 00:00:00+03:00,in,False,-1,True,2,0,39,39
168041,2019-10-17 00:00:00+03:00,in,False,934534,False,1,12,21,9
168041,2019-10-18 00:00:00+03:00,in,False,936514,False,1,103,113,10
168041,2019-10-18 00:00:00+03:00,in,False,934534,False,1,70,80,10
168041,2019-10-18 00:00:00+03:00,in,True,936514,False,3,192,231,39
168041,2019-10-18 00:00:00+03:00,in,False,-1,True,1,0,11,11
168041,2019-10-19 00:00:00+03:00,in,True,936514,False,1,101,110,9
168041,2019-10-19 00:00:00+03:00,in,False,936514,False,1,296,309,13
168041,2019-10-21 00:00:00+03:00,in,False,936514,False,3,297,343,46
168041,2019-10-21 00:00:00+03:00,in,False,934534,False,1,91,106,15
168041,2019-10-21 00:00:00+03:00,in,False,-1,True,11,0,317,317
168041,2019-10-22 00:00:00+03:00,in,False,936514,False,3,433,477,44
168041,2019-10-23 00:00:00+03:00,in,False,-1,True,1,0,16,16
168041,2019-10-25 00:00:00+03:00,in,False,-1,True,1,0,22,22
168041,2019-10-25 00:00:00+03:00,in,False,936514,False,1,177,194,17
168041,2019-10-26 00:00:00+03:00,in,False,934534,False,1,452,468,16
168041,2019-10-26 00:00:00+03:00,in,False,934534,False,1,452,468,16
168041,2019-10-28 00:00:00+03:00,in,False,934534,False,1,111,123,12
168041,2019-10-28 00:00:00+03:00,in,False,-1,True,1,0,19,19
168041,2019-10-28 00:00:00+03:00,in,False,-1,True,1,0,19,19
168041,2019-10-28 00:00:00+03:00,in,False,934534,False,1,111,123,12
168041,2019-10-29 00:00:00+03:00,in,False,934534,False,6,407,490,83
168041,2019-10-30 00:00:00+03:00,in,False,934534,False,4,196,267,71
168041,2019-10-30 00:00:00+03:00,in,False,936514,False,3,223,261,38
168041,2019-10-30 00:00:00+03:00,in,False,934534,False,4,196,267,71
168041,2019-10-31 00:00:00+03:00,in,False,-1,True,3,0,74,74
168041,2019-10-31 00:00:00+03:00,in,False,934534,False,7,610,832,222
168041,2019-10-31 00:00:00+03:00,in,False,936514,False,6,452,559,107
168041,2019-11-01 00:00:00+03:00,in,False,-1,True,1,0,34,34
168041,2019-11-01 00:00:00+03:00,in,False,934534,False,1,71,93,22
168041,2019-11-02 00:00:00+03:00,in,False,936514,False,1,215,232,17
168041,2019-11-02 00:00:00+03:00,in,False,-1,True,1,0,24,24
168041,2019-11-02 00:00:00+03:00,in,False,934534,False,1,100,110,10
168041,2019-11-02 00:00:00+03:00,in,False,-1,True,1,0,24,24
168041,2019-11-03 00:00:00+03:00,in,False,-1,True,1,0,61,61
168041,2019-11-03 00:00:00+03:00,in,False,934534,False,1,35,61,26
168041,2019-11-04 00:00:00+03:00,in,False,934534,False,2,15,36,21
168041,2019-11-05 00:00:00+03:00,in,False,934534,False,7,1157,1276,119
168041,2019-11-05 00:00:00+03:00,in,False,936514,False,1,89,103,14
168041,2019-11-06 00:00:00+03:00,in,False,934534,False,3,69,183,114
168041,2019-11-06 00:00:00+03:00,in,False,-1,True,1,0,45,45
168041,2019-11-06 00:00:00+03:00,in,False,-1,True,2,0,51,51
168041,2019-11-06 00:00:00+03:00,in,False,936514,False,1,48,63,15
168041,2019-11-06 00:00:00+03:00,in,False,936514,False,1,48,63,15
168041,2019-11-07 00:00:00+03:00,in,False,934534,False,1,66,82,16
168041,2019-11-07 00:00:00+03:00,in,False,-1,True,2,0,71,71
168041,2019-11-07 00:00:00+03:00,in,False,936514,False,1,15,28,13
168041,2019-11-08 00:00:00+03:00,in,False,936514,False,1,203,219,16
168041,2019-11-08 00:00:00+03:00,in,False,-1,True,1,0,52,52
168041,2019-11-08 00:00:00+03:00,in,False,934534,False,4,381,457,76
168041,2019-11-09 00:00:00+03:00,in,True,936514,True,1,1,21,20
168041,2019-11-09 00:00:00+03:00,in,False,-1,True,1,0,51,51
168041,2019-11-09 00:00:00+03:00,in,False,934534,False,3,55,113,58
168041,2019-11-09 00:00:00+03:00,in,False,936514,False,1,34,46,12
168041,2019-11-10 00:00:00+03:00,in,False,934534,False,2,123,179,56
168041,2019-11-10 00:00:00+03:00,in,False,936514,False,1,1,25,24
168041,2019-11-10 00:00:00+03:00,in,False,-1,True,1,0,4,4
168041,2019-11-11 00:00:00+03:00,in,False,934534,False,2,209,242,33
168041,2019-11-11 00:00:00+03:00,in,False,936514,False,5,452,588,136
168041,2019-11-11 00:00:00+03:00,in,False,-1,True,2,0,59,59
168041,2019-11-12 00:00:00+03:00,in,False,-1,True,4,0,199,199
168041,2019-11-12 00:00:00+03:00,in,False,934534,False,5,270,358,88
168041,2019-11-12 00:00:00+03:00,in,False,936514,False,6,671,759,88
168041,2019-11-13 00:00:00+03:00,in,False,934534,False,2,144,188,44
168041,2019-11-13 00:00:00+03:00,in,False,936514,False,3,282,325,43
168041,2019-11-13 00:00:00+03:00,in,False,-1,True,2,0,25,25
168041,2019-11-14 00:00:00+03:00,in,False,934534,False,3,252,337,85
168041,2019-11-14 00:00:00+03:00,in,False,936514,False,5,664,747,83
168041,2019-11-14 00:00:00+03:00,in,False,-1,True,7,0,140,140
168041,2019-11-15 00:00:00+03:00,in,False,936514,False,6,961,1175,214
168041,2019-11-15 00:00:00+03:00,in,False,934534,False,11,723,863,140
168041,2019-11-16 00:00:00+03:00,in,False,934534,False,4,233,296,63
168041,2019-11-16 00:00:00+03:00,in,False,936514,False,1,139,178,39
168041,2019-11-17 00:00:00+03:00,in,False,934534,False,3,62,172,110
168041,2019-11-17 00:00:00+03:00,in,False,-1,True,3,0,116,116
168041,2019-11-18 00:00:00+03:00,in,False,936514,False,1,134,150,16
168041,2019-11-18 00:00:00+03:00,in,False,934534,False,2,202,264,62
168041,2019-11-18 00:00:00+03:00,in,False,-1,True,1,0,12,12
168041,2019-11-18 00:00:00+03:00,in,False,936514,False,1,134,150,16
168041,2019-11-19 00:00:00+03:00,in,False,936514,False,2,174,205,31
168041,2019-11-19 00:00:00+03:00,in,False,934534,False,4,239,311,72
168041,2019-11-20 00:00:00+03:00,in,False,-1,True,1,0,12,12
168041,2019-11-20 00:00:00+03:00,in,False,934534,False,2,201,226,25
168041,2019-11-20 00:00:00+03:00,in,False,936514,False,2,711,736,25
168041,2019-11-21 00:00:00+03:00,in,False,936514,False,3,146,233,87
168041,2019-11-21 00:00:00+03:00,in,False,-1,True,2,0,36,36
168041,2019-11-22 00:00:00+03:00,in,False,934534,False,4,113,177,64
168041,2019-11-22 00:00:00+03:00,in,False,936514,False,1,26,41,15
168041,2019-11-22 00:00:00+03:00,in,False,-1,True,1,0,5,5
168041,2019-11-23 00:00:00+03:00,in,False,-1,True,3,0,90,90
168041,2019-11-23 00:00:00+03:00,in,False,936514,False,1,44,57,13
168041,2019-11-23 00:00:00+03:00,in,False,934534,False,3,200,283,83
168041,2019-11-24 00:00:00+03:00,in,True,934534,True,1,0,8,8
168041,2019-11-24 00:00:00+03:00,in,False,934534,False,3,196,216,20
168041,2019-11-25 00:00:00+03:00,in,True,934534,True,1,0,13,13
168041,2019-11-25 00:00:00+03:00,in,False,-1,True,1,0,35,35
168041,2019-11-25 00:00:00+03:00,in,False,936514,False,10,1181,1358,177
168041,2019-11-25 00:00:00+03:00,in,False,934534,False,13,550,756,206
168041,2019-11-25 00:00:00+03:00,in,False,-1,True,1,0,28,28
168041,2019-11-26 00:00:00+03:00,in,False,936514,False,2,238,297,59
168041,2019-11-26 00:00:00+03:00,in,False,-1,True,2,0,79,79
168041,2019-11-26 00:00:00+03:00,in,False,934534,False,10,393,532,139
168041,2019-11-27 00:00:00+03:00,in,False,934534,False,2,119,192,73
168041,2019-11-28 00:00:00+03:00,in,False,934534,False,2,235,257,22
168041,2019-11-28 00:00:00+03:00,in,False,-1,True,2,0,122,122
168042,2019-10-11 00:00:00+03:00,in,False,-1,True,1,0,1,1
168042,2019-10-11 00:00:00+03:00,in,False,934170,False,1,153,160,7
168042,2019-10-13 00:00:00+03:00,in,False,-1,True,1,0,30,30
168042,2019-10-16 00:00:00+03:00,in,False,934170,False,1,118,130,12
168042,2019-10-24 00:00:00+03:00,in,False,934170,False,1,51,61,10
168042,2019-10-29 00:00:00+03:00,in,False,934170,False,4,219,257,38
168042,2019-11-22 00:00:00+03:00,in,False,-1,True,2,0,60,60
168042,2019-11-25 00:00:00+03:00,in,False,934170,False,1,78,93,15
168047,2019-10-16 00:00:00+03:00,in,False,-1,True,1,0,16,16
168047,2019-10-16 00:00:00+03:00,out,False,937604,True,1,0,13,13
168047,2019-10-16 00:00:00+03:00,out,False,937604,False,4,982,991,9
168047,2019-10-17 00:00:00+03:00,out,False,937604,False,1,161,163,2
168047,2019-10-18 00:00:00+03:00,out,False,937604,False,3,358,364,6
168047,2019-10-18 00:00:00+03:00,out,True,937604,True,1,0,2,2
168047,2019-10-21 00:00:00+03:00,out,False,937604,False,1,76,81,5
168047,2019-10-21 00:00:00+03:00,in,False,937604,False,1,49,53,4
168047,2019-10-22 00:00:00+03:00,in,False,937604,False,1,42,60,18
168047,2019-10-22 00:00:00+03:00,out,False,937604,False,1,93,96,3
168047,2019-10-23 00:00:00+03:00,out,False,937604,True,2,0,94,94
168047,2019-10-24 00:00:00+03:00,in,False,937604,False,1,133,136,3
168047,2019-10-24 00:00:00+03:00,out,False,937604,False,2,234,237,3
168047,2019-10-25 00:00:00+03:00,out,False,937604,True,3,0,9,9
168047,2019-10-25 00:00:00+03:00,out,False,937604,False,1,240,242,2
168047,2019-10-29 00:00:00+03:00,out,False,937604,False,1,110,115,5
168047,2019-10-30 00:00:00+03:00,out,False,937604,False,1,4,4,0
168047,2019-10-30 00:00:00+03:00,out,False,937604,False,1,4,4,0
168047,2019-11-06 00:00:00+03:00,out,False,937604,False,1,297,300,3
168047,2019-11-08 00:00:00+03:00,out,False,937604,False,1,186,188,2
168047,2019-11-11 00:00:00+03:00,out,False,937604,False,1,291,293,2
168047,2019-11-12 00:00:00+03:00,out,True,937604,True,1,0,2,2
168047,2019-11-12 00:00:00+03:00,out,False,937604,True,2,0,32,32
168047,2019-11-14 00:00:00+03:00,out,False,937604,True,1,0,41,41
168047,2019-11-15 00:00:00+03:00,out,False,937604,False,2,453,458,5
168047,2019-11-18 00:00:00+03:00,out,True,937604,True,1,0,0,0
168047,2019-11-18 00:00:00+03:00,out,False,937604,True,1,0,8,8
168047,2019-11-18 00:00:00+03:00,out,False,937604,False,3,236,244,8
168047,2019-11-18 00:00:00+03:00,in,False,937604,False,1,119,123,4
168047,2019-11-19 00:00:00+03:00,out,True,937604,True,1,0,0,0
168047,2019-11-19 00:00:00+03:00,in,False,-1,True,6,0,347,347
168047,2019-11-19 00:00:00+03:00,out,False,937604,True,6,0,195,195
168047,2019-11-19 00:00:00+03:00,out,False,937604,False,3,775,799,24
168047,2019-11-19 00:00:00+03:00,in,False,937604,False,3,360,411,51
168047,2019-11-20 00:00:00+03:00,out,False,937604,True,1,0,37,37
168047,2019-11-20 00:00:00+03:00,out,True,937604,True,1,0,0,0
168047,2019-11-20 00:00:00+03:00,out,False,937604,True,1,0,37,37
168047,2019-11-21 00:00:00+03:00,out,True,937604,True,1,0,2,2
168047,2019-11-21 00:00:00+03:00,out,False,937604,False,1,105,121,16
168047,2019-11-28 00:00:00+03:00,out,False,937604,True,2,0,60,60
168047,2019-11-28 00:00:00+03:00,out,False,937604,True,2,0,60,60
168048,2019-10-22 00:00:00+03:00,in,False,-1,True,2,0,4,4
168048,2019-11-01 00:00:00+03:00,out,False,950806,False,2,158,198,40
168048,2019-11-01 00:00:00+03:00,out,False,950806,True,1,0,11,11
168048,2019-11-01 00:00:00+03:00,out,False,950806,True,1,0,11,11
168048,2019-11-07 00:00:00+03:00,in,False,950806,False,1,2,11,9
168048,2019-11-15 00:00:00+03:00,in,False,950806,False,1,10,36,26
168048,2019-11-26 00:00:00+03:00,in,False,950806,False,1,33,44,11
168048,2019-11-28 00:00:00+03:00,in,False,950806,False,3,61,82,21
168048,2019-11-28 00:00:00+03:00,in,False,950806,False,3,61,82,21
168054,2019-10-14 00:00:00+03:00,in,False,-1,True,1,0,2,2
168054,2019-10-15 00:00:00+03:00,in,False,-1,True,1,0,2,2
168054,2019-10-16 00:00:00+03:00,in,False,-1,True,1,0,2,2
168054,2019-10-21 00:00:00+03:00,in,False,-1,True,1,0,2,2
168054,2019-10-28 00:00:00+03:00,in,False,-1,True,1,0,2,2
168054,2019-10-31 00:00:00+03:00,in,False,-1,True,1,0,2,2
168054,2019-11-04 00:00:00+03:00,in,False,-1,True,1,0,2,2
168054,2019-11-12 00:00:00+03:00,in,False,-1,True,1,0,2,2
168054,2019-11-13 00:00:00+03:00,in,False,-1,True,5,0,10,10
168054,2019-11-20 00:00:00+03:00,in,False,-1,True,1,0,2,2
168054,2019-11-23 00:00:00+03:00,in,False,-1,True,1,0,2,2
168054,2019-11-25 00:00:00+03:00,in,False,971100,False,1,13,18,5
168054,2019-11-25 00:00:00+03:00,in,False,-1,True,2,0,36,36
168054,2019-11-25 00:00:00+03:00,in,False,971102,False,2,16,34,18
168054,2019-11-25 00:00:00+03:00,in,False,971102,False,2,16,34,18
168054,2019-11-26 00:00:00+03:00,in,False,971102,False,21,3017,3400,383
168054,2019-11-26 00:00:00+03:00,in,False,-1,True,12,0,337,337
168054,2019-11-26 00:00:00+03:00,in,False,-1,True,12,0,337,337
168054,2019-11-27 00:00:00+03:00,in,False,971102,False,26,4599,5093,494
168054,2019-11-27 00:00:00+03:00,in,False,971100,False,2,133,154,21
168054,2019-11-27 00:00:00+03:00,in,False,-1,True,24,0,586,586
168054,2019-11-28 00:00:00+03:00,in,False,971102,False,27,2980,3437,457
168054,2019-11-28 00:00:00+03:00,in,False,-1,True,23,0,587,587
168062,2019-10-28 00:00:00+03:00,in,False,-1,True,2,0,23,23
168062,2019-10-28 00:00:00+03:00,out,True,947610,True,1,0,0,0
168062,2019-10-28 00:00:00+03:00,in,False,947610,False,1,5,18,13
168062,2019-10-30 00:00:00+03:00,in,False,-1,True,1,0,29,29
168062,2019-10-31 00:00:00+03:00,out,True,947604,True,1,0,5,5
168062,2019-10-31 00:00:00+03:00,out,True,947604,False,1,26,37,11
168062,2019-10-31 00:00:00+03:00,in,False,947604,False,1,85,99,14
168062,2019-10-31 00:00:00+03:00,in,False,-1,True,1,0,25,25
168062,2019-10-31 00:00:00+03:00,out,True,947610,True,2,0,0,0
168062,2019-10-31 00:00:00+03:00,out,True,947616,True,1,0,14,14
168062,2019-10-31 00:00:00+03:00,in,False,-1,True,9,0,90,90
168062,2019-10-31 00:00:00+03:00,in,False,951506,False,1,21,56,35
168062,2019-10-31 00:00:00+03:00,out,True,951492,True,1,0,7,7
168062,2019-10-31 00:00:00+03:00,out,True,947610,False,2,31,41,10
168062,2019-10-31 00:00:00+03:00,out,True,947610,True,2,0,0,0
168062,2019-11-01 00:00:00+03:00,out,False,947652,False,16,843,1026,183
168062,2019-11-01 00:00:00+03:00,out,False,947598,False,11,734,878,144
168062,2019-11-01 00:00:00+03:00,out,False,947604,False,15,1200,1439,239
168062,2019-11-01 00:00:00+03:00,out,True,947610,True,1,0,26,26
168062,2019-11-01 00:00:00+03:00,out,True,947612,True,1,0,0,0
168062,2019-11-01 00:00:00+03:00,out,False,947658,True,94,0,1995,1995
168062,2019-11-01 00:00:00+03:00,in,False,951508,True,4,234,295,61
168062,2019-11-01 00:00:00+03:00,out,False,947592,False,25,2306,2589,283
168062,2019-11-01 00:00:00+03:00,out,False,947646,False,56,2515,3519,1004
168062,2019-11-01 00:00:00+03:00,out,False,947640,True,48,0,942,942
168062,2019-11-01 00:00:00+03:00,out,False,947598,True,15,0,440,440
168062,2019-11-01 00:00:00+03:00,out,False,947654,True,43,0,1582,1582
168062,2019-11-01 00:00:00+03:00,out,False,947620,False,15,963,1142,179
168062,2019-11-01 00:00:00+03:00,out,True,951492,True,5,0,0,0
168062,2019-11-01 00:00:00+03:00,out,True,951508,False,3,56,74,18
168062,2019-11-01 00:00:00+03:00,out,False,947604,True,53,0,878,878
168062,2019-11-01 00:00:00+03:00,out,False,947658,False,29,834,1434,600
168062,2019-11-01 00:00:00+03:00,out,False,947612,False,1,18,39,21
168062,2019-11-01 00:00:00+03:00,out,False,952392,False,10,411,614,203
168062,2019-11-01 00:00:00+03:00,out,False,947654,False,57,1956,2954,998
168062,2019-11-01 00:00:00+03:00,out,False,947644,False,6,251,285,34
168062,2019-11-01 00:00:00+03:00,out,False,947600,True,14,0,201,201
168062,2019-11-01 00:00:00+03:00,out,False,952392,True,3,0,108,108
168062,2019-11-01 00:00:00+03:00,out,False,947650,False,23,2250,2499,249
168062,2019-11-01 00:00:00+03:00,out,False,947616,False,42,1682,2173,491
168062,2019-11-01 00:00:00+03:00,in,False,951508,False,10,1420,1591,171
168062,2019-11-01 00:00:00+03:00,out,False,947612,True,1,0,8,8
168062,2019-11-01 00:00:00+03:00,out,False,947640,False,34,1893,2290,397
168062,2019-11-01 00:00:00+03:00,out,False,947600,False,13,625,783,158
168062,2019-11-01 00:00:00+03:00,out,True,947612,False,1,39,59,20
168062,2019-11-01 00:00:00+03:00,out,False,947652,True,9,0,392,392
168062,2019-11-01 00:00:00+03:00,out,True,951508,True,8,0,0,0
168062,2019-11-01 00:00:00+03:00,in,False,-1,True,6,0,65,65
168062,2019-11-01 00:00:00+03:00,out,False,947638,False,18,484,725,241
168062,2019-11-01 00:00:00+03:00,in,False,947610,False,1,56,62,6
168062,2019-11-01 00:00:00+03:00,out,False,947638,True,30,0,710,710
168062,2019-11-01 00:00:00+03:00,out,False,947620,True,31,0,517,517
168062,2019-11-01 00:00:00+03:00,out,False,947614,False,31,1301,1749,448
168062,2019-11-01 00:00:00+03:00,out,False,947614,True,55,0,747,747
168062,2019-11-01 00:00:00+03:00,out,True,951506,False,4,575,605,30
168062,2019-11-01 00:00:00+03:00,out,False,947650,True,40,0,1022,1022
168062,2019-11-01 00:00:00+03:00,out,False,947616,True,59,0,1029,1029
168062,2019-11-01 00:00:00+03:00,out,True,947654,True,1,0,0,0
168062,2019-11-01 00:00:00+03:00,out,False,947590,False,1,10,20,10
168062,2019-11-01 00:00:00+03:00,in,True,951508,False,4,100,146,46
168062,2019-11-01 00:00:00+03:00,out,True,947610,False,3,426,442,16
168062,2019-11-01 00:00:00+03:00,out,False,947646,True,79,0,2411,2411
168062,2019-11-01 00:00:00+03:00,out,False,947592,True,12,0,289,289
168062,2019-11-01 00:00:00+03:00,out,True,951506,True,4,0,6,6
168062,2019-11-01 00:00:00+03:00,out,False,947644,True,4,0,69,69
168062,2019-11-01 00:00:00+03:00,out,False,947620,False,15,963,1142,179
168062,2019-11-01 00:00:00+03:00,out,False,947640,True,48,0,942,942
168062,2019-11-01 00:00:00+03:00,out,False,947590,False,1,10,20,10
168062,2019-11-01 00:00:00+03:00,out,True,947654,True,1,0,0,0
168062,2019-11-04 00:00:00+03:00,in,False,-1,True,2,0,7,7
168062,2019-11-05 00:00:00+03:00,out,False,951492,False,2,2290,2315,25
168062,2019-11-05 00:00:00+03:00,out,False,947592,True,23,0,394,394
168062,2019-11-05 00:00:00+03:00,out,False,947658,True,103,0,2347,2347
168062,2019-11-05 00:00:00+03:00,in,False,951508,False,24,2432,2857,425
168062,2019-11-05 00:00:00+03:00,out,False,952392,False,21,1744,2055,311
168062,2019-11-05 00:00:00+03:00,out,False,947650,True,49,0,1142,1142
168062,2019-11-05 00:00:00+03:00,out,False,947612,True,1,0,16,16
168062,2019-11-05 00:00:00+03:00,out,True,951506,False,4,201,239,38
168062,2019-11-05 00:00:00+03:00,out,False,947644,False,25,1374,1516,142
168062,2019-11-05 00:00:00+03:00,out,False,947614,True,68,0,998,998
168062,2019-11-05 00:00:00+03:00,out,False,947644,True,7,0,76,76
168062,2019-11-05 00:00:00+03:00,out,False,947612,False,4,273,332,59
168062,2019-11-05 00:00:00+03:00,out,False,947620,False,24,915,1233,318
168062,2019-11-05 00:00:00+03:00,out,False,947646,False,61,3093,4005,912
168062,2019-11-05 00:00:00+03:00,out,False,947616,False,59,2863,3619,756
168062,2019-11-05 00:00:00+03:00,in,False,-1,True,16,0,150,150
168062,2019-11-05 00:00:00+03:00,out,True,951508,False,7,902,972,70
168062,2019-11-05 00:00:00+03:00,out,True,951508,True,2,0,44,44
168062,2019-11-05 00:00:00+03:00,out,False,947616,True,64,0,1266,1266
168062,2019-11-05 00:00:00+03:00,out,False,947638,False,34,1087,1542,455
168062,2019-11-05 00:00:00+03:00,out,False,947590,False,2,53,71,18
168062,2019-11-05 00:00:00+03:00,out,False,947614,False,37,1344,1856,512
168062,2019-11-05 00:00:00+03:00,out,False,947648,True,108,0,2201,2201
168062,2019-11-05 00:00:00+03:00,out,False,947658,False,59,2906,3745,839
168062,2019-11-05 00:00:00+03:00,out,True,947646,True,1,0,0,0
168062,2019-11-05 00:00:00+03:00,out,True,951506,True,3,0,51,51
168062,2019-11-05 00:00:00+03:00,out,False,952392,True,42,0,1079,1079
168062,2019-11-05 00:00:00+03:00,out,False,947604,False,28,3152,3620,468
168062,2019-11-05 00:00:00+03:00,in,True,951506,False,1,99,114,15
168062,2019-11-05 00:00:00+03:00,out,False,947600,False,22,361,570,209
168062,2019-11-05 00:00:00+03:00,out,False,947646,True,68,0,1657,1657
168062,2019-11-05 00:00:00+03:00,out,False,947592,False,27,2168,2429,261
168062,2019-11-05 00:00:00+03:00,out,False,947600,True,21,0,595,595
168062,2019-11-05 00:00:00+03:00,out,False,947654,False,42,3155,3895,740
168062,2019-11-05 00:00:00+03:00,out,False,947638,True,42,0,960,960
168062,2019-11-05 00:00:00+03:00,out,False,947650,False,45,3299,3827,528
168062,2019-11-05 00:00:00+03:00,out,True,947604,True,1,0,3,3
168062,2019-11-05 00:00:00+03:00,out,False,947648,False,65,3515,4451,936
168062,2019-11-05 00:00:00+03:00,out,False,951492,True,2,0,36,36
168062,2019-11-05 00:00:00+03:00,out,False,947654,True,59,0,1307,1307
168062,2019-11-05 00:00:00+03:00,out,False,947604,True,23,0,593,593
168062,2019-11-05 00:00:00+03:00,out,False,947620,True,31,0,581,581
168062,2019-11-05 00:00:00+03:00,out,False,947604,True,23,0,593,593
168062,2019-11-05 00:00:00+03:00,out,False,947654,False,42,3155,3895,740
168062,2019-11-05 00:00:00+03:00,out,True,947604,True,1,0,3,3
168062,2019-11-05 00:00:00+03:00,out,False,951492,False,2,2290,2315,25
168062,2019-11-06 00:00:00+03:00,out,False,947616,False,45,2187,2762,575
168062,2019-11-06 00:00:00+03:00,out,False,947598,False,17,386,660,274
168062,2019-11-06 00:00:00+03:00,out,False,947620,True,26,0,433,433
168062,2019-11-06 00:00:00+03:00,out,False,947638,True,38,0,842,842
168062,2019-11-06 00:00:00+03:00,out,False,951492,False,2,157,197,40
168062,2019-11-06 00:00:00+03:00,out,False,947646,False,73,2917,3923,1006
168062,2019-11-06 00:00:00+03:00,in,False,951508,True,1,74,113,39
168062,2019-11-06 00:00:00+03:00,out,False,947598,True,16,0,339,339
168062,2019-11-06 00:00:00+03:00,out,False,947650,False,28,2288,2608,320
168062,2019-11-06 00:00:00+03:00,out,True,951508,True,5,0,0,0
168062,2019-11-06 00:00:00+03:00,out,True,951492,True,1,0,0,0
168062,2019-11-06 00:00:00+03:00,in,False,-1,True,24,0,299,299
168062,2019-11-06 00:00:00+03:00,out,False,947590,False,2,28,65,37
168062,2019-11-06 00:00:00+03:00,out,False,947642,False,1,14,22,8
168062,2019-11-06 00:00:00+03:00,out,False,951492,True,3,0,38,38
168062,2019-11-06 00:00:00+03:00,out,False,947600,True,27,0,490,490
168062,2019-11-06 00:00:00+03:00,out,False,947658,False,103,4960,6533,1573
168062,2019-11-06 00:00:00+03:00,out,False,947648,False,85,4298,5576,1278
168062,2019-11-06 00:00:00+03:00,out,False,947638,False,24,1199,1465,266
168062,2019-11-06 00:00:00+03:00,out,True,947658,False,1,4,13,9
168062,2019-11-06 00:00:00+03:00,out,False,947652,False,15,534,697,163
168062,2019-11-06 00:00:00+03:00,out,False,947612,True,5,0,20,20
168062,2019-11-06 00:00:00+03:00,out,False,947620,False,11,500,630,130
168062,2019-11-06 00:00:00+03:00,out,False,947592,False,34,2425,2703,278
168062,2019-11-06 00:00:00+03:00,out,False,947646,True,82,0,1771,1771
168062,2019-11-06 00:00:00+03:00,out,False,947604,False,18,2394,2606,212
168062,2019-11-06 00:00:00+03:00,out,True,951506,False,4,584,621,37
168062,2019-11-06 00:00:00+03:00,out,False,947592,True,37,0,730,730
168062,2019-11-06 00:00:00+03:00,out,False,947600,False,12,566,749,183
168062,2019-11-06 00:00:00+03:00,out,True,951508,False,5,306,355,49
168062,2019-11-06 00:00:00+03:00,in,False,951506,False,5,325,554,229
168062,2019-11-06 00:00:00+03:00,out,True,947604,True,1,0,0,0
168062,2019-11-06 00:00:00+03:00,out,False,951508,True,2,0,51,51
168062,2019-11-06 00:00:00+03:00,out,False,947648,True,124,0,2745,2745
168062,2019-11-06 00:00:00+03:00,out,False,951506,False,3,289,296,7
168062,2019-11-06 00:00:00+03:00,out,False,951508,False,3,237,293,56
168062,2019-11-06 00:00:00+03:00,in,False,951508,False,23,2051,2514,463
168062,2019-11-06 00:00:00+03:00,out,False,947612,False,1,84,90,6
168062,2019-11-06 00:00:00+03:00,out,False,947654,True,97,0,2651,2651
168062,2019-11-06 00:00:00+03:00,out,False,947658,True,150,0,2749,2749
168062,2019-11-06 00:00:00+03:00,out,False,947614,False,2,322,327,5
168062,2019-11-06 00:00:00+03:00,out,False,947590,True,4,0,90,90
168062,2019-11-06 00:00:00+03:00,out,False,947640,True,1,0,1,1
168062,2019-11-06 00:00:00+03:00,out,False,947650,True,58,0,1375,1375
168062,2019-11-06 00:00:00+03:00,out,False,947616,True,58,0,1140,1140
168062,2019-11-06 00:00:00+03:00,out,True,951492,False,5,810,857,47
168062,2019-11-06 00:00:00+03:00,out,True,947642,False,1,2,11,9
168062,2019-11-06 00:00:00+03:00,out,False,947644,False,22,1360,1487,127
168062,2019-11-06 00:00:00+03:00,out,False,947644,True,4,0,171,171
168062,2019-11-06 00:00:00+03:00,out,False,947604,True,23,0,680,680
168062,2019-11-06 00:00:00+03:00,out,False,947652,True,33,0,773,773
168062,2019-11-06 00:00:00+03:00,out,False,947654,False,58,3716,4447,731
168062,2019-11-06 00:00:00+03:00,out,True,951506,True,3,0,0,0
168062,2019-11-06 00:00:00+03:00,out,False,951506,False,3,289,296,7
168062,2019-11-06 00:00:00+03:00,out,False,951492,False,2,157,197,40
168062,2019-11-06 00:00:00+03:00,out,False,947658,True,150,0,2749,2749
168062,2019-11-06 00:00:00+03:00,out,False,951492,True,3,0,38,38
168062,2019-11-06 00:00:00+03:00,out,False,947598,False,17,386,660,274
168062,2019-11-06 00:00:00+03:00,out,True,947642,False,1,2,11,9
168062,2019-11-06 00:00:00+03:00,out,True,951506,False,4,584,621,37
168062,2019-11-07 00:00:00+03:00,out,True,951508,False,5,309,347,38
168062,2019-11-07 00:00:00+03:00,out,False,947620,True,37,0,841,841
168062,2019-11-07 00:00:00+03:00,out,False,947646,True,86,0,2032,2032
168062,2019-11-07 00:00:00+03:00,in,False,951508,False,26,2334,2819,485
168062,2019-11-07 00:00:00+03:00,out,False,947590,True,3,0,68,68
168062,2019-11-07 00:00:00+03:00,out,False,947648,True,167,0,3091,3091
168062,2019-11-07 00:00:00+03:00,out,False,951492,False,6,1667,1722,55
168062,2019-11-07 00:00:00+03:00,out,False,947654,True,155,0,3411,3411
168062,2019-11-07 00:00:00+03:00,out,False,947612,False,2,557,581,24
168062,2019-11-07 00:00:00+03:00,out,True,947642,False,1,9,20,11
168062,2019-11-07 00:00:00+03:00,out,False,947642,True,12,0,201,201
168062,2019-11-07 00:00:00+03:00,out,False,947650,False,28,2520,2814,294
168062,2019-11-07 00:00:00+03:00,out,False,947644,True,2,0,15,15
168062,2019-11-07 00:00:00+03:00,out,False,947604,False,32,2187,2703,516
168062,2019-11-07 00:00:00+03:00,out,False,947592,True,33,0,710,710
168062,2019-11-07 00:00:00+03:00,out,False,947590,False,3,285,308,23
168062,2019-11-07 00:00:00+03:00,out,False,947620,False,24,843,1200,357
168062,2019-11-07 00:00:00+03:00,in,False,951506,False,1,93,108,15
168062,2019-11-07 00:00:00+03:00,out,True,951506,True,3,0,58,58
168062,2019-11-07 00:00:00+03:00,out,False,947616,True,65,0,1268,1268
168062,2019-11-07 00:00:00+03:00,out,False,947658,True,166,0,2895,2895
168062,2019-11-07 00:00:00+03:00,out,True,947614,False,1,147,152,5
168062,2019-11-07 00:00:00+03:00,out,True,951506,False,7,184,275,91
168062,2019-11-07 00:00:00+03:00,out,False,947658,False,87,3364,4748,1384
168062,2019-11-07 00:00:00+03:00,out,False,947652,True,27,0,876,876
168062,2019-11-07 00:00:00+03:00,out,False,947638,True,16,0,412,412
168062,2019-11-07 00:00:00+03:00,out,False,951506,False,3,137,169,32
168062,2019-11-07 00:00:00+03:00,out,False,947600,True,10,0,95,95
168062,2019-11-07 00:00:00+03:00,out,False,947592,False,36,2015,2361,346
168062,2019-11-07 00:00:00+03:00,out,True,951492,False,5,566,608,42
168062,2019-11-07 00:00:00+03:00,out,False,947598,True,5,0,40,40
168062,2019-11-07 00:00:00+03:00,out,False,947616,False,40,1372,1913,541
168062,2019-11-07 00:00:00+03:00,out,False,947652,False,30,1093,1503,410
168062,2019-11-07 00:00:00+03:00,out,False,947646,False,79,3200,4528,1328
168062,2019-11-07 00:00:00+03:00,out,False,947642,False,5,60,119,59
168062,2019-11-07 00:00:00+03:00,out,False,947600,False,10,335,419,84
168062,2019-11-07 00:00:00+03:00,out,False,947638,False,28,1109,1556,447
168062,2019-11-07 00:00:00+03:00,out,False,947648,False,98,3964,5438,1474
168062,2019-11-07 00:00:00+03:00,in,False,-1,True,21,0,268,268
168062,2019-11-07 00:00:00+03:00,out,False,952392,False,26,2027,2408,381
168062,2019-11-07 00:00:00+03:00,out,False,947604,True,32,0,838,838
168062,2019-11-07 00:00:00+03:00,out,True,951508,True,5,0,116,116
168062,2019-11-07 00:00:00+03:00,out,False,947654,False,68,3962,5027,1065
168062,2019-11-07 00:00:00+03:00,out,False,947644,False,12,579,656,77
168062,2019-11-07 00:00:00+03:00,out,False,947598,False,7,586,725,139
168062,2019-11-07 00:00:00+03:00,out,False,947650,True,45,0,1022,1022
168062,2019-11-07 00:00:00+03:00,out,False,952392,True,65,0,1305,1305
168062,2019-11-07 00:00:00+03:00,out,False,947590,True,3,0,68,68
168062,2019-11-08 00:00:00+03:00,out,False,947642,True,22,0,291,291
168062,2019-11-08 00:00:00+03:00,out,False,952392,False,49,3348,4094,746
168062,2019-11-08 00:00:00+03:00,out,True,951508,True,1,0,28,28
168062,2019-11-08 00:00:00+03:00,out,True,951492,False,2,52,65,13
168062,2019-11-08 00:00:00+03:00,out,False,947650,False,31,2325,2687,362
168062,2019-11-08 00:00:00+03:00,in,True,947638,False,2,124,151,27
168062,2019-11-08 00:00:00+03:00,out,False,947618,True,1,0,3,3
168062,2019-11-08 00:00:00+03:00,in,False,951508,True,1,88,103,15
168062,2019-11-08 00:00:00+03:00,in,False,951506,False,1,14,61,47
168062,2019-11-08 00:00:00+03:00,out,False,947646,True,81,0,1781,1781
168062,2019-11-08 00:00:00+03:00,out,False,947604,True,73,0,1267,1267
168062,2019-11-08 00:00:00+03:00,out,False,947592,True,24,0,501,501
168062,2019-11-08 00:00:00+03:00,out,True,947658,True,1,0,0,0
168062,2019-11-08 00:00:00+03:00,out,False,952392,True,131,0,2849,2849
168062,2019-11-08 00:00:00+03:00,out,False,947590,False,4,433,468,35
168062,2019-11-08 00:00:00+03:00,out,False,947620,False,16,770,946,176
168062,2019-11-08 00:00:00+03:00,out,False,951506,False,1,66,78,12
168062,2019-11-08 00:00:00+03:00,out,False,947598,True,8,0,162,162
168062,2019-11-08 00:00:00+03:00,out,False,947620,True,39,0,633,633
168062,2019-11-08 00:00:00+03:00,out,False,947598,False,9,380,471,91
168062,2019-11-08 00:00:00+03:00,out,False,947638,True,33,0,421,421
168062,2019-11-08 00:00:00+03:00,out,False,947648,False,83,3461,4500,1039
168062,2019-11-08 00:00:00+03:00,out,False,947604,False,26,2963,3299,336
168062,2019-11-08 00:00:00+03:00,out,False,947590,True,6,0,130,130
168062,2019-11-08 00:00:00+03:00,out,False,947612,True,3,0,2,2
168062,2019-11-08 00:00:00+03:00,out,False,947646,False,60,2460,3485,1025
168062,2019-11-08 00:00:00+03:00,out,False,947638,False,31,1036,1383,347
168062,2019-11-08 00:00:00+03:00,out,False,947644,True,1,0,3,3
168062,2019-11-08 00:00:00+03:00,in,True,947642,False,1,144,158,14
168062,2019-11-08 00:00:00+03:00,out,True,951508,False,6,454,503,49
168062,2019-11-08 00:00:00+03:00,out,False,947616,False,32,1643,2061,418
168062,2019-11-08 00:00:00+03:00,out,False,947600,True,11,0,192,192
168062,2019-11-08 00:00:00+03:00,out,False,947616,True,69,0,1538,1538
168062,2019-11-08 00:00:00+03:00,out,False,947600,False,4,454,499,45
168062,2019-11-08 00:00:00+03:00,out,False,947652,False,14,447,667,220
168062,2019-11-08 00:00:00+03:00,out,False,947650,True,52,0,1244,1244
168062,2019-11-08 00:00:00+03:00,out,True,951506,True,1,0,2,2
168062,2019-11-08 00:00:00+03:00,out,False,947658,False,63,1572,2471,899
168062,2019-11-08 00:00:00+03:00,out,False,947644,False,1,54,73,19
168062,2019-11-08 00:00:00+03:00,in,False,951508,False,9,774,947,173
168062,2019-11-08 00:00:00+03:00,out,False,947652,True,17,0,427,427
168062,2019-11-08 00:00:00+03:00,out,False,947642,False,7,272,322,50
168062,2019-11-08 00:00:00+03:00,out,False,947592,False,24,1076,1249,173
168062,2019-11-08 00:00:00+03:00,out,False,947658,True,172,0,3149,3149
168062,2019-11-08 00:00:00+03:00,out,False,947612,False,4,522,558,36
168062,2019-11-08 00:00:00+03:00,in,False,-1,True,5,0,35,35
168062,2019-11-08 00:00:00+03:00,in,False,951492,False,1,379,401,22
168062,2019-11-08 00:00:00+03:00,out,True,951506,False,3,129,150,21
168062,2019-11-08 00:00:00+03:00,out,False,947648,True,130,0,2497,2497
168062,2019-11-08 00:00:00+03:00,out,False,947616,False,32,1643,2061,418
168062,2019-11-08 00:00:00+03:00,out,False,951506,False,1,66,78,12
168062,2019-11-08 00:00:00+03:00,out,False,947616,True,69,0,1538,1538
168062,2019-11-11 00:00:00+03:00,out,False,947652,False,21,981,1221,240
168062,2019-11-11 00:00:00+03:00,out,False,947642,False,13,455,669,214
168062,2019-11-11 00:00:00+03:00,out,False,947638,True,28,0,310,310
168062,2019-11-11 00:00:00+03:00,out,False,947644,False,8,517,552,35
168062,2019-11-11 00:00:00+03:00,in,False,951508,False,19,2054,2459,405
168062,2019-11-11 00:00:00+03:00,out,False,947614,True,22,0,302,302
168062,2019-11-11 00:00:00+03:00,out,False,947650,True,59,0,1600,1600
168062,2019-11-11 00:00:00+03:00,out,False,947650,False,35,1800,2233,433
168062,2019-11-11 00:00:00+03:00,out,False,947604,True,27,0,578,578
168062,2019-11-11 00:00:00+03:00,out,False,952392,True,89,0,1751,1751
168062,2019-11-11 00:00:00+03:00,out,False,947616,False,55,2509,3220,711
168062,2019-11-11 00:00:00+03:00,out,False,947652,True,17,0,600,600
168062,2019-11-11 00:00:00+03:00,out,False,947592,True,33,0,609,609
168062,2019-11-11 00:00:00+03:00,in,False,951506,False,9,1046,1379,333
168062,2019-11-11 00:00:00+03:00,out,False,947654,False,38,3776,4281,505
168062,2019-11-11 00:00:00+03:00,out,False,947658,True,108,0,2196,2196
168062,2019-11-11 00:00:00+03:00,out,False,951508,False,2,104,131,27
168062,2019-11-11 00:00:00+03:00,out,False,947620,False,15,873,1059,186
168062,2019-11-11 00:00:00+03:00,out,True,951508,False,2,64,88,24
168062,2019-11-11 00:00:00+03:00,in,False,-1,True,15,0,180,180
168062,2019-11-11 00:00:00+03:00,in,False,-1,True,1,0,4,4
168062,2019-11-11 00:00:00+03:00,out,False,952392,False,36,2342,2790,448
168062,2019-11-11 00:00:00+03:00,out,False,947658,False,79,2617,4009,1392
168062,2019-11-11 00:00:00+03:00,out,False,947646,True,70,0,1788,1788
168062,2019-11-11 00:00:00+03:00,out,False,947620,True,25,0,578,578
168062,2019-11-11 00:00:00+03:00,out,False,947642,True,61,0,1287,1287
168062,2019-11-11 00:00:00+03:00,out,False,947648,True,130,0,2341,2341
168062,2019-11-11 00:00:00+03:00,in,False,951508,True,3,295,356,61
168062,2019-11-11 00:00:00+03:00,out,False,947592,False,31,1454,1725,271
168062,2019-11-11 00:00:00+03:00,out,False,947618,False,36,1754,2191,437
168062,2019-11-11 00:00:00+03:00,out,False,947590,False,4,99,122,23
168062,2019-11-11 00:00:00+03:00,out,False,947618,True,31,0,637,637
168062,2019-11-11 00:00:00+03:00,out,False,947644,True,1,0,5,5
168062,2019-11-11 00:00:00+03:00,out,False,947646,False,54,2226,3059,833
168062,2019-11-11 00:00:00+03:00,out,True,951508,True,4,0,39,39
168062,2019-11-11 00:00:00+03:00,out,False,947654,True,43,0,1023,1023
168062,2019-11-11 00:00:00+03:00,out,False,951506,False,1,85,91,6
168062,2019-11-11 00:00:00+03:00,out,False,947604,False,22,2582,2856,274
168062,2019-11-11 00:00:00+03:00,in,False,951492,False,3,545,604,59
168062,2019-11-11 00:00:00+03:00,out,False,947616,True,81,0,1443,1443
168062,2019-11-11 00:00:00+03:00,out,False,947612,True,5,0,139,139
168062,2019-11-11 00:00:00+03:00,out,False,947590,True,4,0,79,79
168062,2019-11-11 00:00:00+03:00,out,False,947648,False,86,4072,5113,1041
168062,2019-11-11 00:00:00+03:00,out,False,947638,False,23,714,891,177
168062,2019-11-11 00:00:00+03:00,out,False,947598,True,14,0,307,307
168062,2019-11-11 00:00:00+03:00,out,False,947614,False,19,669,930,261
168062,2019-11-11 00:00:00+03:00,out,False,947612,False,6,327,426,99
168062,2019-11-11 00:00:00+03:00,out,False,951492,True,2,0,92,92
168062,2019-11-11 00:00:00+03:00,out,False,947598,False,11,584,688,104
168062,2019-11-11 00:00:00+03:00,out,True,951506,False,6,655,741,86
168062,2019-11-11 00:00:00+03:00,out,False,951492,False,4,252,263,11
168062,2019-11-11 00:00:00+03:00,out,False,947646,False,54,2226,3059,833
168062,2019-11-11 00:00:00+03:00,out,False,947648,True,130,0,2341,2341
168062,2019-11-11 00:00:00+03:00,out,False,951508,False,2,104,131,27
168062,2019-11-11 00:00:00+03:00,out,True,951508,False,2,64,88,24
168062,2019-11-11 00:00:00+03:00,out,False,947598,False,11,584,688,104
168062,2019-11-11 00:00:00+03:00,out,False,947654,False,38,3776,4281,505
168062,2019-11-11 00:00:00+03:00,out,False,947598,True,14,0,307,307
168062,2019-11-11 00:00:00+03:00,out,False,947638,False,23,714,891,177
168062,2019-11-12 00:00:00+03:00,out,False,947590,False,6,237,295,58
168062,2019-11-12 00:00:00+03:00,out,False,947652,True,18,0,531,531
168062,2019-11-12 00:00:00+03:00,out,False,947620,True,42,0,806,806
168062,2019-11-12 00:00:00+03:00,out,False,947640,True,20,0,312,312
168062,2019-11-12 00:00:00+03:00,in,False,951508,False,25,2392,2846,454
168062,2019-11-12 00:00:00+03:00,out,False,947652,False,12,1015,1237,222
168062,2019-11-12 00:00:00+03:00,out,False,947616,True,94,0,1793,1793
168062,2019-11-12 00:00:00+03:00,out,False,947614,True,2,0,53,53
168062,2019-11-12 00:00:00+03:00,out,False,951506,False,1,28,52,24
168062,2019-11-12 00:00:00+03:00,out,False,947642,False,6,130,225,95
168062,2019-11-12 00:00:00+03:00,out,False,947638,True,47,0,482,482
168062,2019-11-12 00:00:00+03:00,out,False,952392,False,43,4729,5269,540
168062,2019-11-12 00:00:00+03:00,out,False,947648,True,148,0,3218,3218
168062,2019-11-12 00:00:00+03:00,out,False,947598,True,13,0,326,326
168062,2019-11-12 00:00:00+03:00,out,False,947598,False,12,408,583,175
168062,2019-11-12 00:00:00+03:00,in,False,-1,True,16,0,157,157
168062,2019-11-12 00:00:00+03:00,in,True,951508,False,1,118,133,15
168062,2019-11-12 00:00:00+03:00,out,False,951492,False,2,264,292,28
168062,2019-11-12 00:00:00+03:00,out,False,947618,False,39,1735,2362,627
168062,2019-11-12 00:00:00+03:00,out,False,947646,False,82,2492,3801,1309
168062,2019-11-12 00:00:00+03:00,out,False,947642,True,29,0,479,479
168062,2019-11-12 00:00:00+03:00,out,False,947644,True,3,0,122,122
168062,2019-11-12 00:00:00+03:00,out,False,947658,True,94,0,1756,1756
168062,2019-11-12 00:00:00+03:00,out,False,947590,True,6,0,122,122
168062,2019-11-12 00:00:00+03:00,out,False,951508,False,3,834,862,28
168062,2019-11-12 00:00:00+03:00,out,False,947646,True,119,0,3249,3249
168062,2019-11-12 00:00:00+03:00,out,True,951492,False,7,521,566,45
168062,2019-11-12 00:00:00+03:00,in,False,951506,False,1,52,107,55
168062,2019-11-12 00:00:00+03:00,out,True,947636,False,1,17,30,13
168062,2019-11-12 00:00:00+03:00,out,False,947650,True,46,0,1231,1231
168062,2019-11-12 00:00:00+03:00,out,False,952392,True,61,0,1423,1423
168062,2019-11-12 00:00:00+03:00,out,True,951508,True,7,0,92,92
168062,2019-11-12 00:00:00+03:00,out,False,947620,False,21,988,1298,310
168062,2019-11-12 00:00:00+03:00,out,False,947614,False,2,170,186,16
168062,2019-11-12 00:00:00+03:00,in,False,951508,True,5,332,423,91
168062,2019-11-12 00:00:00+03:00,out,False,947618,True,38,0,721,721
168062,2019-11-12 00:00:00+03:00,out,False,947592,True,40,0,768,768
168062,2019-11-12 00:00:00+03:00,out,False,947650,False,43,3925,4490,565
168062,2019-11-12 00:00:00+03:00,out,False,947648,False,70,3582,4534,952
168062,2019-11-12 00:00:00+03:00,out,False,947638,False,21,1553,1755,202
168062,2019-11-12 00:00:00+03:00,out,False,947604,False,23,1989,2322,333
168062,2019-11-12 00:00:00+03:00,out,True,951508,False,10,810,935,125
168062,2019-11-12 00:00:00+03:00,out,False,947592,False,31,1567,1923,356
168062,2019-11-12 00:00:00+03:00,out,False,947654,True,126,0,3158,3158
168062,2019-11-12 00:00:00+03:00,out,False,947636,False,18,1759,2031,272
168062,2019-11-12 00:00:00+03:00,out,False,947616,False,43,1640,2227,587
168062,2019-11-12 00:00:00+03:00,out,False,947658,False,89,3772,5011,1239
168062,2019-11-12 00:00:00+03:00,out,False,947644,False,18,981,1159,178
168062,2019-11-12 00:00:00+03:00,out,True,951492,True,2,0,0,0
168062,2019-11-12 00:00:00+03:00,out,False,951508,True,1,0,19,19
168062,2019-11-12 00:00:00+03:00,out,False,947640,False,16,708,936,228
168062,2019-11-12 00:00:00+03:00,out,True,951506,False,4,230,284,54
168062,2019-11-12 00:00:00+03:00,out,False,947636,True,30,0,734,734
168062,2019-11-12 00:00:00+03:00,out,False,947654,False,51,3837,4619,782
168062,2019-11-12 00:00:00+03:00,out,False,947604,True,48,0,1092,1092
168062,2019-11-12 00:00:00+03:00,out,False,947640,True,20,0,312,312
168062,2019-11-12 00:00:00+03:00,out,False,947654,False,51,3837,4619,782
168062,2019-11-12 00:00:00+03:00,out,False,947592,True,40,0,768,768
168062,2019-11-12 00:00:00+03:00,out,False,952392,True,61,0,1423,1423
168062,2019-11-12 00:00:00+03:00,out,True,951506,False,4,230,284,54
168062,2019-11-12 00:00:00+03:00,out,False,947590,True,6,0,122,122
168062,2019-11-12 00:00:00+03:00,out,False,947652,False,12,1015,1237,222
168062,2019-11-12 00:00:00+03:00,out,False,947654,True,126,0,3158,3158
168062,2019-11-13 00:00:00+03:00,out,False,947654,False,39,3103,3697,594
168062,2019-11-13 00:00:00+03:00,out,True,947612,False,2,21,37,16
168062,2019-11-13 00:00:00+03:00,out,False,947590,False,2,71,90,19
168062,2019-11-13 00:00:00+03:00,in,False,951492,False,2,247,279,32
168062,2019-11-13 00:00:00+03:00,out,True,947658,True,2,0,0,0
168062,2019-11-13 00:00:00+03:00,out,True,951508,False,7,225,276,51
168062,2019-11-13 00:00:00+03:00,out,False,947658,True,133,0,2510,2510
168062,2019-11-13 00:00:00+03:00,out,False,947618,True,47,0,973,973
168062,2019-11-13 00:00:00+03:00,out,False,947644,False,12,927,1115,188
168062,2019-11-13 00:00:00+03:00,out,False,947642,True,41,0,1010,1010
168062,2019-11-13 00:00:00+03:00,out,False,947616,False,48,3097,3737,640
168062,2019-11-13 00:00:00+03:00,out,False,947612,True,1,0,0,0
168062,2019-11-13 00:00:00+03:00,out,False,952392,False,26,1371,1782,411
168062,2019-11-13 00:00:00+03:00,out,False,947650,False,25,2387,2750,363
168062,2019-11-13 00:00:00+03:00,out,True,951492,False,2,67,84,17
168062,2019-11-13 00:00:00+03:00,out,False,947620,True,35,0,799,799
168062,2019-11-13 00:00:00+03:00,out,False,947650,True,25,0,557,557
168062,2019-11-13 00:00:00+03:00,out,False,947614,True,8,0,109,109
168062,2019-11-13 00:00:00+03:00,out,False,947612,False,8,1537,1685,148
168062,2019-11-13 00:00:00+03:00,out,False,952392,True,45,0,736,736
168062,2019-11-13 00:00:00+03:00,out,False,947592,False,29,1610,1858,248
168062,2019-11-13 00:00:00+03:00,out,False,947648,False,64,3024,3918,894
168062,2019-11-13 00:00:00+03:00,out,True,951508,True,1,0,27,27
168062,2019-11-13 00:00:00+03:00,out,False,947616,True,47,0,988,988
168062,2019-11-13 00:00:00+03:00,in,False,-1,True,14,0,138,138
168062,2019-11-13 00:00:00+03:00,in,False,951508,True,1,52,71,19
168062,2019-11-13 00:00:00+03:00,out,False,947620,False,15,1076,1273,197
168062,2019-11-13 00:00:00+03:00,out,False,951492,True,2,0,120,120
168062,2019-11-13 00:00:00+03:00,out,False,947644,True,13,0,383,383
168062,2019-11-13 00:00:00+03:00,out,False,947590,True,7,0,73,73
168062,2019-11-13 00:00:00+03:00,out,False,947618,False,29,1802,2146,344
168062,2019-11-13 00:00:00+03:00,out,False,951508,False,1,108,116,8
168062,2019-11-13 00:00:00+03:00,out,False,947614,False,2,52,74,22
168062,2019-11-13 00:00:00+03:00,out,False,947648,True,117,0,2383,2383
168062,2019-11-13 00:00:00+03:00,out,True,951506,False,14,640,761,121
168062,2019-11-13 00:00:00+03:00,out,True,951506,True,2,0,65,65
168062,2019-11-13 00:00:00+03:00,out,False,947638,False,17,589,785,196
168062,2019-11-13 00:00:00+03:00,out,False,947652,False,17,768,1149,381
168062,2019-11-13 00:00:00+03:00,out,True,951492,True,1,0,13,13
168062,2019-11-13 00:00:00+03:00,out,False,947638,True,26,0,352,352
168062,2019-11-13 00:00:00+03:00,out,False,947598,False,14,769,953,184
168062,2019-11-13 00:00:00+03:00,out,False,947604,True,29,0,682,682
168062,2019-11-13 00:00:00+03:00,out,False,947642,False,10,398,545,147
168062,2019-11-13 00:00:00+03:00,out,False,-1,True,1,0,0,0
168062,2019-11-13 00:00:00+03:00,in,False,951506,False,3,620,706,86
168062,2019-11-13 00:00:00+03:00,out,False,947654,True,87,0,1754,1754
168062,2019-11-13 00:00:00+03:00,out,False,947604,False,17,2022,2282,260
168062,2019-11-13 00:00:00+03:00,out,False,947652,True,18,0,398,398
168062,2019-11-13 00:00:00+03:00,out,False,951492,False,11,744,817,73
168062,2019-11-13 00:00:00+03:00,in,False,951508,False,14,1135,1400,265
168062,2019-11-13 00:00:00+03:00,out,False,947658,False,60,2064,3016,952
168062,2019-11-13 00:00:00+03:00,out,False,947592,True,30,0,602,602
168062,2019-11-13 00:00:00+03:00,out,False,947598,True,10,0,305,305
168062,2019-11-13 00:00:00+03:00,out,True,947612,False,2,21,37,16
168062,2019-11-13 00:00:00+03:00,out,False,947604,False,17,2022,2282,260
168062,2019-11-13 00:00:00+03:00,out,False,947650,True,25,0,557,557
168062,2019-11-14 00:00:00+03:00,out,False,947598,True,23,0,428,428
168062,2019-11-14 00:00:00+03:00,out,False,947644,True,22,0,472,472
168062,2019-11-14 00:00:00+03:00,out,False,947604,True,26,0,701,701
168062,2019-11-14 00:00:00+03:00,out,True,951508,False,4,186,218,32
168062,2019-11-14 00:00:00+03:00,out,False,947648,True,87,0,1899,1899
168062,2019-11-14 00:00:00+03:00,out,False,947620,True,53,0,1167,1167
168062,2019-11-14 00:00:00+03:00,out,False,947648,False,52,2778,3599,821
168062,2019-11-14 00:00:00+03:00,out,False,947616,True,44,0,883,883
168062,2019-11-14 00:00:00+03:00,out,False,947592,True,28,0,593,593
168062,2019-11-14 00:00:00+03:00,out,False,947614,True,10,0,71,71
168062,2019-11-14 00:00:00+03:00,out,False,947654,False,45,2915,3560,645
168062,2019-11-14 00:00:00+03:00,out,True,951506,False,2,134,151,17
168062,2019-11-14 00:00:00+03:00,out,False,951492,False,10,1289,1432,143
168062,2019-11-14 00:00:00+03:00,out,False,951492,True,2,0,0,0
168062,2019-11-14 00:00:00+03:00,out,False,952392,True,40,0,722,722
168062,2019-11-14 00:00:00+03:00,out,False,947638,True,35,0,524,524
168062,2019-11-14 00:00:00+03:00,in,False,951508,False,13,1431,1674,243
168062,2019-11-14 00:00:00+03:00,out,True,951492,False,1,54,60,6
168062,2019-11-14 00:00:00+03:00,out,False,947646,False,46,1920,2676,756
168062,2019-11-14 00:00:00+03:00,out,False,947618,False,32,2205,2573,368
168062,2019-11-14 00:00:00+03:00,out,False,947642,True,51,0,860,860
168062,2019-11-14 00:00:00+03:00,out,False,947592,False,19,1103,1310,207
168062,2019-11-14 00:00:00+03:00,in,False,951508,True,2,117,150,33
168062,2019-11-14 00:00:00+03:00,out,False,947658,True,109,0,1899,1899
168062,2019-11-14 00:00:00+03:00,out,False,947642,False,18,678,926,248
168062,2019-11-14 00:00:00+03:00,out,False,947604,False,20,1910,2171,261
168062,2019-11-14 00:00:00+03:00,out,False,947650,False,27,1536,1908,372
168062,2019-11-14 00:00:00+03:00,out,False,947614,False,3,199,240,41
168062,2019-11-14 00:00:00+03:00,out,False,947652,False,13,998,1193,195
168062,2019-11-14 00:00:00+03:00,out,False,947612,False,7,697,803,106
168062,2019-11-14 00:00:00+03:00,out,False,947652,True,23,0,644,644
168062,2019-11-14 00:00:00+03:00,out,False,947644,False,15,798,944,146
168062,2019-11-14 00:00:00+03:00,out,True,947654,True,1,0,0,0
168062,2019-11-14 00:00:00+03:00,out,False,947598,False,21,1022,1240,218
168062,2019-11-14 00:00:00+03:00,out,False,947616,False,17,667,854,187
168062,2019-11-14 00:00:00+03:00,out,False,947590,True,5,0,91,91
168062,2019-11-14 00:00:00+03:00,in,False,951492,False,2,205,239,34
168062,2019-11-14 00:00:00+03:00,out,False,947612,True,3,0,41,41
168062,2019-11-14 00:00:00+03:00,out,False,947646,True,76,0,2201,2201
168062,2019-11-14 00:00:00+03:00,out,False,947638,False,45,1392,1826,434
168062,2019-11-14 00:00:00+03:00,in,False,-1,True,9,0,113,113
168062,2019-11-14 00:00:00+03:00,out,False,952392,False,31,4572,4978,406
168062,2019-11-14 00:00:00+03:00,in,False,951506,False,1,46,102,56
168062,2019-11-14 00:00:00+03:00,out,False,947658,False,44,2476,3152,676
168062,2019-11-14 00:00:00+03:00,out,False,947620,False,15,1076,1274,198
168062,2019-11-14 00:00:00+03:00,out,False,947654,True,89,0,2758,2758
168062,2019-11-14 00:00:00+03:00,out,False,947650,True,50,0,1473,1473
168062,2019-11-14 00:00:00+03:00,out,False,947618,True,44,0,733,733
168062,2019-11-14 00:00:00+03:00,out,False,947590,False,12,750,859,109
168062,2019-11-14 00:00:00+03:00,out,False,947638,True,35,0,524,524
168062,2019-11-14 00:00:00+03:00,out,False,947592,False,19,1103,1310,207
168062,2019-11-14 00:00:00+03:00,out,False,947644,True,22,0,472,472
168062,2019-11-14 00:00:00+03:00,out,False,947642,False,18,678,926,248
168062,2019-11-14 00:00:00+03:00,out,False,947652,True,23,0,644,644
168062,2019-11-14 00:00:00+03:00,out,False,947612,False,7,697,803,106
168062,2019-11-15 00:00:00+03:00,out,False,947618,False,27,2238,2653,415
168062,2019-11-15 00:00:00+03:00,out,False,947612,False,3,606,656,50
168062,2019-11-15 00:00:00+03:00,in,True,951508,False,1,104,118,14
168062,2019-11-15 00:00:00+03:00,out,False,947658,False,21,1662,2016,354
168062,2019-11-15 00:00:00+03:00,out,False,947612,True,7,0,182,182
168062,2019-11-15 00:00:00+03:00,out,False,947650,False,38,2160,2690,530
168062,2019-11-15 00:00:00+03:00,out,False,947652,False,11,548,658,110
168062,2019-11-15 00:00:00+03:00,out,False,947642,True,47,0,1106,1106
168062,2019-11-15 00:00:00+03:00,out,False,947616,True,63,0,1140,1140
168062,2019-11-15 00:00:00+03:00,in,False,951506,False,3,100,257,157
168062,2019-11-15 00:00:00+03:00,out,True,951506,True,1,0,0,0
168062,2019-11-15 00:00:00+03:00,out,False,947598,True,18,0,389,389
168062,2019-11-15 00:00:00+03:00,out,False,947614,False,14,520,725,205
168062,2019-11-15 00:00:00+03:00,out,False,951492,False,2,61,144,83
168062,2019-11-15 00:00:00+03:00,out,False,947598,False,17,970,1251,281
168062,2019-11-15 00:00:00+03:00,out,False,947654,False,33,2807,3284,477
168062,2019-11-15 00:00:00+03:00,out,False,947652,True,12,0,487,487
168062,2019-11-15 00:00:00+03:00,in,False,951508,False,17,1789,2122,333
168062,2019-11-15 00:00:00+03:00,out,False,947644,False,10,731,822,91
168062,2019-11-15 00:00:00+03:00,out,True,951508,False,2,205,223,18
168062,2019-11-15 00:00:00+03:00,out,False,947658,True,38,0,687,687
168062,2019-11-15 00:00:00+03:00,out,False,951508,True,1,0,0,0
168062,2019-11-15 00:00:00+03:00,out,True,951506,False,4,545,579,34
168062,2019-11-15 00:00:00+03:00,out,False,947616,False,32,1671,2034,363
168062,2019-11-15 00:00:00+03:00,out,False,947654,True,63,0,1654,1654
168062,2019-11-15 00:00:00+03:00,out,False,947620,True,38,0,805,805
168062,2019-11-15 00:00:00+03:00,out,False,947650,True,45,0,1024,1024
168062,2019-11-15 00:00:00+03:00,in,False,951508,True,2,139,183,44
168062,2019-11-15 00:00:00+03:00,out,False,947618,True,48,0,966,966
168062,2019-11-15 00:00:00+03:00,out,False,947610,False,2,1394,1422,28
168062,2019-11-15 00:00:00+03:00,out,True,951492,False,1,14,21,7
168062,2019-11-15 00:00:00+03:00,out,False,947604,True,32,0,637,637
168062,2019-11-15 00:00:00+03:00,out,False,947614,True,32,0,544,544
168062,2019-11-15 00:00:00+03:00,out,False,947640,True,1,0,1,1
168062,2019-11-15 00:00:00+03:00,in,False,-1,True,8,0,114,114
168062,2019-11-15 00:00:00+03:00,out,False,947620,False,19,850,1069,219
168062,2019-11-15 00:00:00+03:00,out,False,947642,False,20,701,949,248
168062,2019-11-15 00:00:00+03:00,out,False,947590,True,2,0,65,65
168062,2019-11-15 00:00:00+03:00,out,False,947638,False,33,1360,1721,361
168062,2019-11-15 00:00:00+03:00,out,False,947646,True,43,0,1376,1376
168062,2019-11-15 00:00:00+03:00,out,False,947610,True,1,0,25,25
168062,2019-11-15 00:00:00+03:00,out,False,947604,False,17,2801,2998,197
168062,2019-11-15 00:00:00+03:00,out,False,947638,True,70,0,1155,1155
168062,2019-11-15 00:00:00+03:00,out,False,947648,False,37,1673,2171,498
168062,2019-11-15 00:00:00+03:00,out,False,947648,True,67,0,1470,1470
168062,2019-11-15 00:00:00+03:00,out,False,947644,True,10,0,307,307
168062,2019-11-15 00:00:00+03:00,in,False,951492,False,3,437,497,60
168062,2019-11-15 00:00:00+03:00,out,False,947590,False,5,80,120,40
168062,2019-11-15 00:00:00+03:00,out,False,952392,False,20,637,929,292
168062,2019-11-15 00:00:00+03:00,out,False,947646,False,37,1613,2168,555
168062,2019-11-15 00:00:00+03:00,out,False,952392,True,23,0,713,713
168062,2019-11-15 00:00:00+03:00,in,False,951506,False,3,100,257,157
168062,2019-11-15 00:00:00+03:00,out,False,947612,True,7,0,182,182
168062,2019-11-15 00:00:00+03:00,out,False,947642,True,47,0,1106,1106
168062,2019-11-15 00:00:00+03:00,out,False,951492,False,2,61,144,83
168062,2019-11-15 00:00:00+03:00,out,False,947646,False,37,1613,2168,555
168062,2019-11-15 00:00:00+03:00,out,False,947652,False,11,548,658,110
168062,2019-11-15 00:00:00+03:00,out,False,947610,True,1,0,25,25
168062,2019-11-15 00:00:00+03:00,in,False,-1,True,8,0,114,114
168062,2019-11-15 00:00:00+03:00,out,False,947640,True,1,0,1,1
168062,2019-11-15 00:00:00+03:00,in,False,951508,True,2,139,183,44
168062,2019-11-16 00:00:00+03:00,in,False,-1,True,1,0,7,7
168062,2019-11-17 00:00:00+03:00,in,False,-1,True,1,0,9,9
168062,2019-11-17 00:00:00+03:00,in,False,-1,True,1,0,9,9
168062,2019-11-18 00:00:00+03:00,out,False,947604,True,22,0,349,349
168062,2019-11-18 00:00:00+03:00,out,True,951506,False,22,1629,1841,212
168062,2019-11-18 00:00:00+03:00,out,False,947640,True,5,0,92,92
168062,2019-11-18 00:00:00+03:00,out,False,947598,True,6,0,170,170
168062,2019-11-18 00:00:00+03:00,out,True,947612,False,1,21,28,7
168062,2019-11-18 00:00:00+03:00,out,False,947590,False,3,46,87,41
168062,2019-11-18 00:00:00+03:00,out,False,947590,True,1,0,29,29
168062,2019-11-18 00:00:00+03:00,out,False,947618,True,52,0,862,862
168062,2019-11-18 00:00:00+03:00,out,False,947596,False,1,56,72,16
168062,2019-11-18 00:00:00+03:00,in,False,951508,False,9,756,943,187
168062,2019-11-18 00:00:00+03:00,in,False,951492,False,4,408,537,129
168062,2019-11-18 00:00:00+03:00,in,False,951506,False,2,184,274,90
168062,2019-11-18 00:00:00+03:00,out,False,947592,True,48,0,990,990
168062,2019-11-18 00:00:00+03:00,out,False,947650,True,55,0,1022,1022
168062,2019-11-18 00:00:00+03:00,in,False,-1,True,16,0,126,126
168062,2019-11-18 00:00:00+03:00,out,False,947638,True,46,0,1151,1151
168062,2019-11-18 00:00:00+03:00,out,False,947646,False,54,2150,2875,725
168062,2019-11-18 00:00:00+03:00,out,False,947642,True,34,0,700,700
168062,2019-11-18 00:00:00+03:00,out,False,947636,True,13,0,141,141
168062,2019-11-18 00:00:00+03:00,out,False,951492,False,1,131,132,1
168062,2019-11-18 00:00:00+03:00,out,False,947612,False,2,373,402,29
168062,2019-11-18 00:00:00+03:00,out,False,947612,True,1,0,0,0
168062,2019-11-18 00:00:00+03:00,out,False,947592,False,23,1027,1270,243
168062,2019-11-18 00:00:00+03:00,out,True,951506,True,7,0,6,6
168062,2019-11-18 00:00:00+03:00,out,False,947620,False,20,690,866,176
168062,2019-11-18 00:00:00+03:00,out,False,947654,True,148,0,3730,3730
168062,2019-11-18 00:00:00+03:00,out,True,947612,True,1,0,7,7
168062,2019-11-18 00:00:00+03:00,out,False,947618,False,34,1491,1915,424
168062,2019-11-18 00:00:00+03:00,out,True,951492,True,9,0,28,28
168062,2019-11-18 00:00:00+03:00,out,False,951508,False,1,165,167,2
168062,2019-11-18 00:00:00+03:00,out,False,947604,False,10,1357,1521,164
168062,2019-11-18 00:00:00+03:00,out,False,947614,False,28,977,1304,327
168062,2019-11-18 00:00:00+03:00,in,False,951508,True,1,53,70,17
168062,2019-11-18 00:00:00+03:00,out,False,947658,False,36,1065,1604,539
168062,2019-11-18 00:00:00+03:00,out,False,951492,True,1,0,11,11
168062,2019-11-18 00:00:00+03:00,out,False,947648,False,51,3144,3777,633
168062,2019-11-18 00:00:00+03:00,out,False,947600,False,8,192,266,74
168062,2019-11-18 00:00:00+03:00,out,False,947644,True,5,0,153,153
168062,2019-11-18 00:00:00+03:00,out,False,947644,False,12,455,682,227
168062,2019-11-18 00:00:00+03:00,out,False,947616,True,54,0,963,963
168062,2019-11-18 00:00:00+03:00,out,False,947640,False,4,209,314,105
168062,2019-11-18 00:00:00+03:00,out,True,951492,False,6,581,627,46
168062,2019-11-18 00:00:00+03:00,out,False,947648,True,77,0,1371,1371
168062,2019-11-18 00:00:00+03:00,out,False,947636,False,14,1065,1331,266
168062,2019-11-18 00:00:00+03:00,out,False,947658,True,59,0,1185,1185
168062,2019-11-18 00:00:00+03:00,out,False,947642,False,4,125,154,29
168062,2019-11-18 00:00:00+03:00,out,False,947654,False,41,3720,4382,662
168062,2019-11-18 00:00:00+03:00,out,False,947616,False,41,1155,1625,470
168062,2019-11-18 00:00:00+03:00,out,False,947638,False,39,1214,1596,382
168062,2019-11-18 00:00:00+03:00,out,False,947650,False,45,3755,4344,589
168062,2019-11-18 00:00:00+03:00,out,False,947600,True,13,0,284,284
168062,2019-11-18 00:00:00+03:00,out,False,947620,True,53,0,858,858
168062,2019-11-18 00:00:00+03:00,out,False,947646,True,96,0,2249,2249
168062,2019-11-18 00:00:00+03:00,out,False,952392,True,40,0,784,784
168062,2019-11-18 00:00:00+03:00,in,True,951508,False,1,33,54,21
168062,2019-11-18 00:00:00+03:00,out,False,947598,False,12,517,736,219
168062,2019-11-18 00:00:00+03:00,out,False,952392,False,21,2379,2703,324
168062,2019-11-18 00:00:00+03:00,out,False,947614,True,52,0,728,728
168062,2019-11-18 00:00:00+03:00,out,True,951508,False,4,255,293,38
168062,2019-11-18 00:00:00+03:00,out,True,951508,True,5,0,47,47
168062,2019-11-18 00:00:00+03:00,out,False,947618,False,34,1491,1915,424
168062,2019-11-18 00:00:00+03:00,out,False,947600,True,13,0,284,284
168062,2019-11-18 00:00:00+03:00,in,False,-1,True,16,0,126,126
168062,2019-11-18 00:00:00+03:00,out,False,947604,True,22,0,349,349
168062,2019-11-18 00:00:00+03:00,out,False,947592,True,48,0,990,990
168062,2019-11-18 00:00:00+03:00,out,False,947650,False,45,3755,4344,589
168062,2019-11-19 00:00:00+03:00,out,False,947646,False,44,1941,2712,771
168062,2019-11-19 00:00:00+03:00,out,False,947646,True,30,0,1054,1054
168062,2019-11-19 00:00:00+03:00,out,False,947644,False,29,1962,2279,317
168062,2019-11-19 00:00:00+03:00,out,False,947592,True,38,0,703,703
168062,2019-11-19 00:00:00+03:00,out,False,947648,False,22,701,943,242
168062,2019-11-19 00:00:00+03:00,out,False,947640,False,3,118,174,56
168062,2019-11-19 00:00:00+03:00,out,False,947650,True,68,0,1667,1667
168062,2019-11-19 00:00:00+03:00,in,False,-1,True,11,0,159,159
168062,2019-11-19 00:00:00+03:00,out,False,947636,False,1,63,78,15
168062,2019-11-19 00:00:00+03:00,out,False,947616,True,75,0,1211,1211
168062,2019-11-19 00:00:00+03:00,out,False,951506,True,2,0,52,52
168062,2019-11-19 00:00:00+03:00,out,False,947648,True,58,0,1186,1186
168062,2019-11-19 00:00:00+03:00,out,False,951506,False,3,37,71,34
168062,2019-11-19 00:00:00+03:00,out,False,947620,False,19,856,1075,219
168062,2019-11-19 00:00:00+03:00,out,True,951506,True,3,0,9,9
168062,2019-11-19 00:00:00+03:00,out,False,947592,False,35,1740,2157,417
168062,2019-11-19 00:00:00+03:00,out,False,947598,True,8,0,250,250
168062,2019-11-19 00:00:00+03:00,out,False,947658,False,44,1302,2002,700
168062,2019-11-19 00:00:00+03:00,out,False,952392,True,42,0,845,845
168062,2019-11-19 00:00:00+03:00,out,False,947642,True,2,0,22,22
168062,2019-11-19 00:00:00+03:00,out,False,947638,False,26,702,1047,345
168062,2019-11-19 00:00:00+03:00,out,False,947604,False,20,2664,2932,268
168062,2019-11-19 00:00:00+03:00,out,False,947650,False,35,3477,3963,486
168062,2019-11-19 00:00:00+03:00,out,False,947652,False,13,532,689,157
168062,2019-11-19 00:00:00+03:00,out,False,947616,False,43,1688,2280,592
168062,2019-11-19 00:00:00+03:00,out,False,947598,False,15,356,642,286
168062,2019-11-19 00:00:00+03:00,out,True,951506,False,9,476,580,104
168062,2019-11-19 00:00:00+03:00,out,False,947590,True,1,0,28,28
168062,2019-11-19 00:00:00+03:00,out,False,947614,False,36,918,1379,461
168062,2019-11-19 00:00:00+03:00,out,False,947620,True,40,0,879,879
168062,2019-11-19 00:00:00+03:00,out,False,947600,False,11,684,792,108
168062,2019-11-19 00:00:00+03:00,out,False,952392,False,24,1309,1719,410
168062,2019-11-19 00:00:00+03:00,in,False,951506,False,3,557,687,130
168062,2019-11-19 00:00:00+03:00,out,False,947658,True,52,0,992,992
168062,2019-11-19 00:00:00+03:00,out,False,947614,True,47,0,687,687
168062,2019-11-19 00:00:00+03:00,out,False,947612,False,7,673,768,95
168062,2019-11-19 00:00:00+03:00,out,False,947644,True,8,0,310,310
168062,2019-11-19 00:00:00+03:00,out,False,947640,True,2,0,66,66
168062,2019-11-19 00:00:00+03:00,out,False,947652,True,5,0,134,134
168062,2019-11-19 00:00:00+03:00,out,False,947638,True,50,0,1054,1054
168062,2019-11-19 00:00:00+03:00,out,False,947600,True,18,0,526,526
168062,2019-11-19 00:00:00+03:00,out,False,947618,True,46,0,774,774
168062,2019-11-19 00:00:00+03:00,out,False,947604,True,44,0,1160,1160
168062,2019-11-19 00:00:00+03:00,out,False,947590,False,12,606,705,99
168062,2019-11-19 00:00:00+03:00,out,True,951492,False,6,554,591,37
168062,2019-11-19 00:00:00+03:00,in,False,951508,False,13,1265,1511,246
168062,2019-11-19 00:00:00+03:00,out,True,951508,False,2,143,153,10
168062,2019-11-19 00:00:00+03:00,out,False,951492,False,3,299,357,58
168062,2019-11-19 00:00:00+03:00,out,False,947618,False,36,2394,2850,456
168062,2019-11-19 00:00:00+03:00,out,False,947640,False,3,118,174,56
168062,2019-11-19 00:00:00+03:00,out,True,951506,True,3,0,9,9
168062,2019-11-19 00:00:00+03:00,out,False,947638,True,50,0,1054,1054
168062,2019-11-20 00:00:00+03:00,out,False,947654,False,44,5453,6167,714
168062,2019-11-20 00:00:00+03:00,in,False,951506,False,4,296,458,162
168062,2019-11-20 00:00:00+03:00,out,False,951508,False,1,444,453,9
168062,2019-11-20 00:00:00+03:00,out,False,947618,False,30,1933,2406,473
168062,2019-11-20 00:00:00+03:00,out,False,947658,True,44,0,891,891
168062,2019-11-20 00:00:00+03:00,out,False,947600,False,6,176,231,55
168062,2019-11-20 00:00:00+03:00,out,False,947642,False,1,11,12,1
168062,2019-11-20 00:00:00+03:00,out,False,947590,False,6,1353,1407,54
168062,2019-11-20 00:00:00+03:00,out,False,947620,True,53,0,928,928
168062,2019-11-20 00:00:00+03:00,out,False,947604,False,11,774,950,176
168062,2019-11-20 00:00:00+03:00,out,False,951492,False,3,749,783,34
168062,2019-11-20 00:00:00+03:00,out,False,947616,True,45,0,709,709
168062,2019-11-20 00:00:00+03:00,out,False,947642,True,4,0,22,22
168062,2019-11-20 00:00:00+03:00,out,False,947590,True,3,0,67,67
168062,2019-11-20 00:00:00+03:00,out,False,947648,False,45,2351,2868,517
168062,2019-11-20 00:00:00+03:00,out,False,947652,False,16,928,1158,230
168062,2019-11-20 00:00:00+03:00,out,False,952392,True,67,0,1668,1668
168062,2019-11-20 00:00:00+03:00,out,False,952392,False,28,2571,3003,432
168062,2019-11-20 00:00:00+03:00,in,False,951492,False,3,280,400,120
168062,2019-11-20 00:00:00+03:00,out,False,947612,False,2,131,141,10
168062,2019-11-20 00:00:00+03:00,out,False,947592,True,21,0,425,425
168062,2019-11-20 00:00:00+03:00,out,False,947652,True,13,0,427,427
168062,2019-11-20 00:00:00+03:00,out,False,947604,True,20,0,494,494
168062,2019-11-20 00:00:00+03:00,in,False,951508,False,15,1419,1722,303
168062,2019-11-20 00:00:00+03:00,out,False,947654,True,119,0,2869,2869
168062,2019-11-20 00:00:00+03:00,out,False,947644,False,24,1207,1480,273
168062,2019-11-20 00:00:00+03:00,out,False,947616,False,55,1804,2454,650
168062,2019-11-20 00:00:00+03:00,out,True,951508,False,2,46,58,12
168062,2019-11-20 00:00:00+03:00,out,False,947592,False,34,2135,2436,301
168062,2019-11-20 00:00:00+03:00,out,False,947600,True,17,0,377,377
168062,2019-11-20 00:00:00+03:00,out,False,947614,False,35,1115,1646,531
168062,2019-11-20 00:00:00+03:00,out,False,947650,False,35,3445,3898,453
168062,2019-11-20 00:00:00+03:00,out,True,951506,False,10,1023,1097,74
168062,2019-11-20 00:00:00+03:00,out,False,947614,True,62,0,869,869
168062,2019-11-20 00:00:00+03:00,out,False,947618,True,51,0,1081,1081
168062,2019-11-20 00:00:00+03:00,out,False,947658,False,38,2546,3165,619
168062,2019-11-20 00:00:00+03:00,out,False,947598,False,9,424,537,113
168062,2019-11-20 00:00:00+03:00,out,True,951492,False,2,907,919,12
168062,2019-11-20 00:00:00+03:00,out,False,947648,True,78,0,1582,1582
168062,2019-11-20 00:00:00+03:00,in,False,-1,True,14,0,137,137
168062,2019-11-20 00:00:00+03:00,out,False,947650,True,42,0,1000,1000
168062,2019-11-20 00:00:00+03:00,out,True,951508,True,1,0,47,47
168062,2019-11-20 00:00:00+03:00,out,False,947598,True,24,0,413,413
168062,2019-11-20 00:00:00+03:00,out,False,947644,True,17,0,422,422
168062,2019-11-20 00:00:00+03:00,out,False,947620,False,28,2120,2442,322
168062,2019-11-20 00:00:00+03:00,out,False,947650,False,35,3445,3898,453
168062,2019-11-20 00:00:00+03:00,out,False,947598,False,9,424,537,113
168062,2019-11-20 00:00:00+03:00,out,False,947598,True,24,0,413,413
168062,2019-11-21 00:00:00+03:00,in,False,951508,False,11,714,912,198
168062,2019-11-21 00:00:00+03:00,out,False,947620,True,53,0,836,836
168062,2019-11-21 00:00:00+03:00,out,False,952392,False,30,3322,3704,382
168062,2019-11-21 00:00:00+03:00,out,True,947600,False,1,4,11,7
168062,2019-11-21 00:00:00+03:00,out,True,951506,True,2,0,19,19
168062,2019-11-21 00:00:00+03:00,out,False,947636,False,7,247,353,106
168062,2019-11-21 00:00:00+03:00,out,True,947618,False,3,30,40,10
168062,2019-11-21 00:00:00+03:00,out,False,947640,True,1,0,40,40
168062,2019-11-21 00:00:00+03:00,out,True,947620,False,2,14,20,6
168062,2019-11-21 00:00:00+03:00,out,False,947640,False,1,13,26,13
168062,2019-11-21 00:00:00+03:00,out,True,947592,False,1,4,9,5
168062,2019-11-21 00:00:00+03:00,out,False,951508,True,5,0,205,205
168062,2019-11-21 00:00:00+03:00,out,True,951508,False,1,142,150,8
168062,2019-11-21 00:00:00+03:00,out,True,947658,True,1,0,4,4
168062,2019-11-21 00:00:00+03:00,out,True,947636,True,1,0,3,3
168062,2019-11-21 00:00:00+03:00,out,True,947650,True,4,0,9,9
168062,2019-11-21 00:00:00+03:00,out,False,947644,False,17,1144,1346,202
168062,2019-11-21 00:00:00+03:00,out,True,947650,False,1,7,18,11
168062,2019-11-21 00:00:00+03:00,out,True,947652,True,3,0,20,20
168062,2019-11-21 00:00:00+03:00,out,False,947600,False,6,295,386,91
168062,2019-11-21 00:00:00+03:00,out,True,947618,True,3,0,35,35
168062,2019-11-21 00:00:00+03:00,out,False,947638,False,27,1379,1703,324
168062,2019-11-21 00:00:00+03:00,out,True,951492,False,3,346,366,20
168062,2019-11-21 00:00:00+03:00,out,False,947618,False,25,1317,1759,442
168062,2019-11-21 00:00:00+03:00,out,False,947652,False,27,1518,1869,351
168062,2019-11-21 00:00:00+03:00,out,False,951492,False,1,653,664,11
168062,2019-11-21 00:00:00+03:00,in,False,-1,True,17,0,172,172
168062,2019-11-21 00:00:00+03:00,out,True,947642,False,1,22,25,3
168062,2019-11-21 00:00:00+03:00,out,False,947658,False,25,1064,1435,371
168062,2019-11-21 00:00:00+03:00,out,False,947620,False,17,1208,1383,175
168062,2019-11-21 00:00:00+03:00,out,True,947614,False,1,8,12,4
168062,2019-11-21 00:00:00+03:00,out,True,947652,False,2,26,37,11
168062,2019-11-21 00:00:00+03:00,out,True,947654,False,1,21,28,7
168062,2019-11-21 00:00:00+03:00,out,False,952392,True,41,0,1010,1010
168062,2019-11-21 00:00:00+03:00,out,False,947644,True,11,0,390,390
168062,2019-11-21 00:00:00+03:00,in,False,951492,False,2,295,328,33
168062,2019-11-21 00:00:00+03:00,out,False,947600,True,9,0,273,273
168062,2019-11-21 00:00:00+03:00,out,False,947614,False,42,1357,1885,528
168062,2019-11-21 00:00:00+03:00,out,True,947620,True,1,0,0,0
168062,2019-11-21 00:00:00+03:00,out,False,947648,True,128,0,2821,2821
168062,2019-11-21 00:00:00+03:00,out,False,947604,False,13,1165,1298,133
168062,2019-11-21 00:00:00+03:00,out,False,947616,True,61,0,1234,1234
168062,2019-11-21 00:00:00+03:00,out,False,947618,True,55,0,979,979
168062,2019-11-21 00:00:00+03:00,out,False,947650,False,42,3757,4366,609
168062,2019-11-21 00:00:00+03:00,in,False,951506,False,1,35,83,48
168062,2019-11-21 00:00:00+03:00,out,False,947590,False,2,116,145,29
168062,2019-11-21 00:00:00+03:00,out,False,947658,True,56,0,1205,1205
168062,2019-11-21 00:00:00+03:00,out,False,947642,False,8,313,479,166
168062,2019-11-21 00:00:00+03:00,out,True,951506,False,12,1330,1449,119
168062,2019-11-21 00:00:00+03:00,out,False,947612,False,3,96,129,33
168062,2019-11-21 00:00:00+03:00,out,False,947642,True,11,0,227,227
168062,2019-11-21 00:00:00+03:00,out,False,947592,False,30,1380,1631,251
168062,2019-11-21 00:00:00+03:00,out,False,947652,True,31,0,1188,1188
168062,2019-11-21 00:00:00+03:00,out,True,947654,True,1,0,6,6
168062,2019-11-21 00:00:00+03:00,out,False,947654,False,40,3129,3888,759
168062,2019-11-21 00:00:00+03:00,out,False,947636,True,16,0,297,297
168062,2019-11-21 00:00:00+03:00,out,True,951508,True,1,0,6,6
168062,2019-11-21 00:00:00+03:00,out,True,947638,False,2,21,27,6
168062,2019-11-21 00:00:00+03:00,out,False,947616,False,48,1376,1921,545
168062,2019-11-21 00:00:00+03:00,out,False,947654,True,136,0,4030,4030
168062,2019-11-21 00:00:00+03:00,out,False,947604,True,9,0,285,285
168062,2019-11-21 00:00:00+03:00,out,False,947638,True,25,0,532,532
168062,2019-11-21 00:00:00+03:00,out,False,947648,False,63,3374,4153,779
168062,2019-11-21 00:00:00+03:00,out,False,947592,True,31,0,514,514
168062,2019-11-21 00:00:00+03:00,out,False,947614,True,46,0,592,592
168062,2019-11-21 00:00:00+03:00,out,True,947658,False,1,5,12,7
168062,2019-11-21 00:00:00+03:00,out,False,947650,True,30,0,623,623
168062,2019-11-21 00:00:00+03:00,out,True,947620,False,2,14,20,6
168062,2019-11-21 00:00:00+03:00,out,True,947600,False,1,4,11,7
168062,2019-11-21 00:00:00+03:00,out,False,947620,True,53,0,836,836
168062,2019-11-21 00:00:00+03:00,in,False,951492,False,2,295,328,33
168062,2019-11-21 00:00:00+03:00,out,False,947636,False,7,247,353,106
168062,2019-11-21 00:00:00+03:00,out,False,947648,True,128,0,2821,2821
168062,2019-11-22 00:00:00+03:00,out,False,947650,True,58,0,1412,1412
168062,2019-11-22 00:00:00+03:00,out,False,947644,False,13,585,694,109
168062,2019-11-22 00:00:00+03:00,out,False,947618,True,48,0,768,768
168062,2019-11-22 00:00:00+03:00,out,True,947614,True,1,0,26,26
168062,2019-11-22 00:00:00+03:00,out,False,947592,False,17,1199,1329,130
168062,2019-11-22 00:00:00+03:00,out,False,951492,True,8,0,119,119
168062,2019-11-22 00:00:00+03:00,out,False,947642,True,18,0,391,391
168062,2019-11-22 00:00:00+03:00,out,True,951506,True,1,0,39,39
168062,2019-11-22 00:00:00+03:00,out,False,951492,False,4,381,413,32
168062,2019-11-22 00:00:00+03:00,out,False,947592,True,7,0,157,157
168062,2019-11-22 00:00:00+03:00,in,False,-1,True,9,0,109,109
168062,2019-11-22 00:00:00+03:00,out,True,947618,False,2,12,16,4
168062,2019-11-22 00:00:00+03:00,out,True,952392,False,2,25,33,8
168062,2019-11-22 00:00:00+03:00,out,False,947620,True,49,0,943,943
168062,2019-11-22 00:00:00+03:00,out,False,947618,False,23,1932,2241,309
168062,2019-11-22 00:00:00+03:00,out,True,947648,False,2,23,34,11
168062,2019-11-22 00:00:00+03:00,out,False,947598,True,3,0,58,58
168062,2019-11-22 00:00:00+03:00,out,False,947658,False,34,1014,1522,508
168062,2019-11-22 00:00:00+03:00,out,True,951492,True,1,0,1,1
168062,2019-11-22 00:00:00+03:00,out,True,951492,False,4,151,186,35
168062,2019-11-22 00:00:00+03:00,in,False,951508,False,7,261,389,128
168062,2019-11-22 00:00:00+03:00,out,False,947654,False,35,2144,2828,684
168062,2019-11-22 00:00:00+03:00,out,True,947650,False,1,6,18,12
168062,2019-11-22 00:00:00+03:00,out,True,947598,False,1,3,8,5
168062,2019-11-22 00:00:00+03:00,out,False,947614,True,36,0,544,544
168062,2019-11-22 00:00:00+03:00,out,True,951508,False,6,305,356,51
168062,2019-11-22 00:00:00+03:00,out,False,947644,True,7,0,242,242
168062,2019-11-22 00:00:00+03:00,out,True,947604,False,3,12,34,22
168062,2019-11-22 00:00:00+03:00,out,False,947638,False,22,727,959,232
168062,2019-11-22 00:00:00+03:00,out,False,947616,False,24,994,1318,324
168062,2019-11-22 00:00:00+03:00,out,False,947604,True,23,0,597,597
168062,2019-11-22 00:00:00+03:00,out,True,947590,False,2,31,43,12
168062,2019-11-22 00:00:00+03:00,out,False,947598,False,4,117,181,64
168062,2019-11-22 00:00:00+03:00,out,False,947612,False,1,24,36,12
168062,2019-11-22 00:00:00+03:00,out,True,947644,False,2,12,25,13
168062,2019-11-22 00:00:00+03:00,out,True,947654,False,1,7,15,8
168062,2019-11-22 00:00:00+03:00,out,True,947642,False,1,8,14,6
168062,2019-11-22 00:00:00+03:00,out,False,947610,True,1,0,45,45
168062,2019-11-22 00:00:00+03:00,out,True,947600,False,2,9,18,9
168062,2019-11-22 00:00:00+03:00,out,False,947590,False,14,470,594,124
168062,2019-11-22 00:00:00+03:00,in,False,951492,False,1,90,115,25
168062,2019-11-22 00:00:00+03:00,out,False,947590,True,9,0,130,130
168062,2019-11-22 00:00:00+03:00,out,True,947592,False,2,6,14,8
168062,2019-11-22 00:00:00+03:00,out,False,947638,True,20,0,472,472
168062,2019-11-22 00:00:00+03:00,out,True,947610,False,2,196,225,29
168062,2019-11-22 00:00:00+03:00,out,False,947614,False,33,843,1278,435
168062,2019-11-22 00:00:00+03:00,out,False,947642,False,7,322,440,118
168062,2019-11-22 00:00:00+03:00,out,False,947616,True,27,0,582,582
168062,2019-11-22 00:00:00+03:00,out,True,947620,False,1,10,16,6
168062,2019-11-22 00:00:00+03:00,out,False,952392,True,48,0,1494,1494
168062,2019-11-22 00:00:00+03:00,out,True,951508,True,3,0,0,0
168062,2019-11-22 00:00:00+03:00,out,True,947644,True,1,0,16,16
168062,2019-11-22 00:00:00+03:00,out,False,947600,True,11,0,419,419
168062,2019-11-22 00:00:00+03:00,out,False,952392,False,32,1408,2041,633
168062,2019-11-22 00:00:00+03:00,out,False,947620,False,21,1553,1881,328
168062,2019-11-22 00:00:00+03:00,out,True,951506,False,10,1267,1364,97
168062,2019-11-22 00:00:00+03:00,out,True,947616,False,1,4,9,5
168062,2019-11-22 00:00:00+03:00,out,False,947658,True,58,0,1628,1628
168062,2019-11-22 00:00:00+03:00,out,False,947648,True,11,0,233,233
168062,2019-11-22 00:00:00+03:00,out,False,947600,False,8,342,467,125
168062,2019-11-22 00:00:00+03:00,out,False,947648,False,4,96,162,66
168062,2019-11-22 00:00:00+03:00,out,False,947650,False,25,2740,3053,313
168062,2019-11-22 00:00:00+03:00,out,True,947658,False,2,8,14,6
168062,2019-11-22 00:00:00+03:00,out,False,947604,False,10,546,663,117
168062,2019-11-22 00:00:00+03:00,out,True,947638,False,1,5,9,4
168062,2019-11-22 00:00:00+03:00,out,False,947654,True,113,0,3560,3560
168062,2019-11-22 00:00:00+03:00,out,False,947640,False,23,1268,1537,269
168062,2019-11-22 00:00:00+03:00,out,True,947614,False,2,13,23,10
168062,2019-11-22 00:00:00+03:00,out,False,947640,True,30,0,535,535
168062,2019-11-22 00:00:00+03:00,out,True,952392,True,1,0,10,10
168062,2019-11-22 00:00:00+03:00,out,True,947638,False,1,5,9,4
168062,2019-11-22 00:00:00+03:00,out,False,947650,True,58,0,1412,1412
168062,2019-11-22 00:00:00+03:00,out,True,951508,True,3,0,0,0
168062,2019-11-22 00:00:00+03:00,out,True,947616,False,1,4,9,5
168062,2019-11-22 00:00:00+03:00,out,False,947618,False,23,1932,2241,309
168062,2019-11-22 00:00:00+03:00,out,True,947600,False,2,9,18,9
168062,2019-11-22 00:00:00+03:00,out,False,947590,False,14,470,594,124
168062,2019-11-22 00:00:00+03:00,out,False,947650,False,25,2740,3053,313
168062,2019-11-22 00:00:00+03:00,out,False,947598,True,3,0,58,58
168062,2019-11-25 00:00:00+03:00,out,False,951492,False,2,272,287,15
168062,2019-11-25 00:00:00+03:00,out,False,947658,True,69,0,1452,1452
168062,2019-11-25 00:00:00+03:00,out,False,947646,True,49,0,1552,1552
168062,2019-11-25 00:00:00+03:00,out,False,947604,False,19,2033,2354,321
168062,2019-11-25 00:00:00+03:00,out,True,947650,True,1,0,0,0
168062,2019-11-25 00:00:00+03:00,out,True,951492,False,4,146,175,29
168062,2019-11-25 00:00:00+03:00,out,False,951508,False,2,35,67,32
168062,2019-11-25 00:00:00+03:00,out,False,947658,False,37,1775,2216,441
168062,2019-11-25 00:00:00+03:00,out,True,947600,False,2,6,15,9
168062,2019-11-25 00:00:00+03:00,out,False,947616,False,38,1397,1862,465
168062,2019-11-25 00:00:00+03:00,out,False,947650,False,54,3952,4668,716
168062,2019-11-25 00:00:00+03:00,out,True,947616,False,2,11,19,8
168062,2019-11-25 00:00:00+03:00,out,True,947642,False,1,7,13,6
168062,2019-11-25 00:00:00+03:00,out,True,952392,True,2,0,37,37
168062,2019-11-25 00:00:00+03:00,out,False,947598,True,12,0,79,79
168062,2019-11-25 00:00:00+03:00,out,True,947604,False,2,10,20,10
168062,2019-11-25 00:00:00+03:00,out,False,952392,False,28,2683,3030,347
168062,2019-11-25 00:00:00+03:00,out,True,947648,False,2,57,70,13
168062,2019-11-25 00:00:00+03:00,in,False,947612,False,1,784,802,18
168062,2019-11-25 00:00:00+03:00,out,False,947648,True,72,0,1869,1869
168062,2019-11-25 00:00:00+03:00,out,False,947642,True,67,0,1704,1704
168062,2019-11-25 00:00:00+03:00,out,True,947590,False,1,10,17,7
168062,2019-11-25 00:00:00+03:00,out,False,947638,True,51,0,1043,1043
168062,2019-11-25 00:00:00+03:00,out,False,947612,False,3,354,385,31
168062,2019-11-25 00:00:00+03:00,out,False,947654,False,39,3366,3992,626
168062,2019-11-25 00:00:00+03:00,out,False,947620,True,44,0,825,825
168062,2019-11-25 00:00:00+03:00,out,True,947646,False,1,5,7,2
168062,2019-11-25 00:00:00+03:00,out,True,947654,False,2,17,43,26
168062,2019-11-25 00:00:00+03:00,out,False,947620,False,15,667,865,198
168062,2019-11-25 00:00:00+03:00,out,False,947614,True,40,0,583,583
168062,2019-11-25 00:00:00+03:00,out,False,947646,False,52,1866,2607,741
168062,2019-11-25 00:00:00+03:00,out,False,947604,True,18,0,480,480
168062,2019-11-25 00:00:00+03:00,out,False,947598,False,19,751,888,137
168062,2019-11-25 00:00:00+03:00,out,False,947640,True,23,0,558,558
168062,2019-11-25 00:00:00+03:00,out,True,947638,False,3,51,63,12
168062,2019-11-25 00:00:00+03:00,out,True,947650,False,1,6,8,2
168062,2019-11-25 00:00:00+03:00,out,True,951506,True,1,0,6,6
168062,2019-11-25 00:00:00+03:00,out,False,947644,False,13,1089,1255,166
168062,2019-11-25 00:00:00+03:00,out,True,947658,False,2,9,16,7
168062,2019-11-25 00:00:00+03:00,out,False,947650,True,51,0,1194,1194
168062,2019-11-25 00:00:00+03:00,out,False,952392,True,37,0,892,892
168062,2019-11-25 00:00:00+03:00,out,True,947620,False,1,7,12,5
168062,2019-11-25 00:00:00+03:00,out,True,951508,False,3,87,124,37
168062,2019-11-25 00:00:00+03:00,out,False,947642,False,17,604,862,258
168062,2019-11-25 00:00:00+03:00,out,False,947618,False,37,1777,2284,507
168062,2019-11-25 00:00:00+03:00,in,False,951508,False,29,2045,2615,570
168062,2019-11-25 00:00:00+03:00,out,True,947618,False,2,11,18,7
168062,2019-11-25 00:00:00+03:00,out,False,947648,False,68,3799,4726,927
168062,2019-11-25 00:00:00+03:00,in,False,-1,True,9,0,196,196
168062,2019-11-25 00:00:00+03:00,out,True,951506,False,6,319,382,63
168062,2019-11-25 00:00:00+03:00,out,False,947600,True,6,0,189,189
168062,2019-11-25 00:00:00+03:00,out,False,947654,True,107,0,3194,3194
168062,2019-11-25 00:00:00+03:00,out,True,947658,True,4,0,18,18
168062,2019-11-25 00:00:00+03:00,in,False,951492,False,1,298,319,21
168062,2019-11-25 00:00:00+03:00,out,True,947640,False,2,10,16,6
168062,2019-11-25 00:00:00+03:00,out,False,947644,True,7,0,275,275
168062,2019-11-25 00:00:00+03:00,out,False,947590,True,2,0,55,55
168062,2019-11-25 00:00:00+03:00,out,False,947638,False,31,1082,1424,342
168062,2019-11-25 00:00:00+03:00,out,False,947612,True,1,0,0,0
168062,2019-11-25 00:00:00+03:00,out,True,947644,False,2,15,33,18
168062,2019-11-25 00:00:00+03:00,out,False,947590,False,10,665,775,110
168062,2019-11-25 00:00:00+03:00,out,False,947616,True,68,0,1351,1351
168062,2019-11-25 00:00:00+03:00,out,False,947600,False,17,712,982,270
168062,2019-11-25 00:00:00+03:00,out,False,947640,False,19,1146,1387,241
168062,2019-11-25 00:00:00+03:00,out,False,947636,True,1,0,40,40
168062,2019-11-25 00:00:00+03:00,out,True,947614,False,2,9,14,5
168062,2019-11-25 00:00:00+03:00,out,True,947598,False,2,7,17,10
168062,2019-11-25 00:00:00+03:00,out,True,947614,True,2,0,48,48
168062,2019-11-25 00:00:00+03:00,out,False,947618,True,41,0,872,872
168062,2019-11-25 00:00:00+03:00,out,True,952392,False,2,23,31,8
168062,2019-11-25 00:00:00+03:00,out,False,947614,False,31,809,1129,320
168062,2019-11-25 00:00:00+03:00,out,False,947640,False,19,1146,1387,241
168062,2019-11-25 00:00:00+03:00,out,True,947644,False,2,15,33,18
168062,2019-11-25 00:00:00+03:00,out,True,947654,False,2,17,43,26
168062,2019-11-25 00:00:00+03:00,out,True,951506,False,6,319,382,63
168062,2019-11-25 00:00:00+03:00,out,False,947616,False,38,1397,1862,465
168062,2019-11-25 00:00:00+03:00,out,True,947598,False,2,7,17,10
168062,2019-11-26 00:00:00+03:00,out,False,952392,False,51,3451,4167,716
168062,2019-11-26 00:00:00+03:00,out,False,947658,False,37,1621,2090,469
168062,2019-11-26 00:00:00+03:00,in,False,951506,False,1,15,61,46
168062,2019-11-26 00:00:00+03:00,out,True,947646,False,1,4,8,4
168062,2019-11-26 00:00:00+03:00,out,False,947590,False,7,351,422,71
168062,2019-11-26 00:00:00+03:00,out,True,947642,True,1,0,18,18
168062,2019-11-26 00:00:00+03:00,out,False,947640,True,22,0,456,456
168062,2019-11-26 00:00:00+03:00,out,True,947598,False,1,4,13,9
168062,2019-11-26 00:00:00+03:00,out,True,947590,False,1,7,14,7
168062,2019-11-26 00:00:00+03:00,out,False,947642,False,51,2750,3531,781
168062,2019-11-26 00:00:00+03:00,out,True,947640,False,2,7,14,7
168062,2019-11-26 00:00:00+03:00,out,False,947620,False,22,1560,1801,241
168062,2019-11-26 00:00:00+03:00,out,True,947618,True,1,0,16,16
168062,2019-11-26 00:00:00+03:00,out,False,947638,False,28,812,1156,344
168062,2019-11-26 00:00:00+03:00,out,True,947650,False,1,4,7,3
168062,2019-11-26 00:00:00+03:00,out,True,947616,False,2,17,24,7
168062,2019-11-26 00:00:00+03:00,out,False,947604,False,15,1034,1281,247
168062,2019-11-26 00:00:00+03:00,out,True,952392,False,2,15,22,7
168062,2019-11-26 00:00:00+03:00,in,False,951492,False,1,221,242,21
168062,2019-11-26 00:00:00+03:00,out,False,947638,True,35,0,460,460
168062,2019-11-26 00:00:00+03:00,out,True,947610,False,1,106,116,10
168062,2019-11-26 00:00:00+03:00,out,False,947646,False,51,1911,2613,702
168062,2019-11-26 00:00:00+03:00,out,False,947620,True,46,0,942,942
168062,2019-11-26 00:00:00+03:00,out,True,947654,False,1,8,11,3
168062,2019-11-26 00:00:00+03:00,out,False,947618,False,30,2355,2850,495
168062,2019-11-26 00:00:00+03:00,out,True,951506,False,2,386,406,20
168062,2019-11-26 00:00:00+03:00,out,False,947618,True,44,0,775,775
168062,2019-11-26 00:00:00+03:00,out,False,951492,False,2,365,390,25
168062,2019-11-26 00:00:00+03:00,in,True,951492,False,1,98,116,18
168062,2019-11-26 00:00:00+03:00,out,True,947648,False,2,12,18,6
168062,2019-11-26 00:00:00+03:00,out,True,951492,False,4,406,438,32
168062,2019-11-26 00:00:00+03:00,out,True,947644,False,2,13,25,12
168062,2019-11-26 00:00:00+03:00,out,False,947654,True,102,0,1803,1803
168062,2019-11-26 00:00:00+03:00,out,False,947654,False,39,3379,3964,585
168062,2019-11-26 00:00:00+03:00,out,False,947648,False,54,3129,3859,730
168062,2019-11-26 00:00:00+03:00,out,False,947600,True,3,0,8,8
168062,2019-11-26 00:00:00+03:00,out,False,947600,False,1,7,24,17
168062,2019-11-26 00:00:00+03:00,out,False,947590,True,2,0,46,46
168062,2019-11-26 00:00:00+03:00,out,False,947648,True,100,0,2159,2159
168062,2019-11-26 00:00:00+03:00,out,False,947640,False,26,2002,2365,363
168062,2019-11-26 00:00:00+03:00,out,False,947650,False,42,2741,3395,654
168062,2019-11-26 00:00:00+03:00,out,False,947598,True,7,0,121,121
168062,2019-11-26 00:00:00+03:00,out,False,947644,False,11,675,901,226
168062,2019-11-26 00:00:00+03:00,out,False,947616,True,66,0,1520,1520
168062,2019-11-26 00:00:00+03:00,out,False,947612,False,2,471,485,14
168062,2019-11-26 00:00:00+03:00,out,True,947642,False,1,16,20,4
168062,2019-11-26 00:00:00+03:00,out,False,947610,False,1,396,403,7
168062,2019-11-26 00:00:00+03:00,out,False,947612,True,1,0,9,9
168062,2019-11-26 00:00:00+03:00,out,True,947600,False,2,6,14,8
168062,2019-11-26 00:00:00+03:00,out,False,947642,True,132,0,2998,2998
168062,2019-11-26 00:00:00+03:00,out,True,947620,True,1,0,13,13
168062,2019-11-26 00:00:00+03:00,out,False,947598,False,9,239,367,128
168062,2019-11-26 00:00:00+03:00,out,False,952392,True,93,0,2278,2278
168062,2019-11-26 00:00:00+03:00,out,False,947646,True,50,0,1463,1463
168062,2019-11-26 00:00:00+03:00,out,False,947644,True,9,0,223,223
168062,2019-11-26 00:00:00+03:00,out,True,947620,False,1,5,7,2
168062,2019-11-26 00:00:00+03:00,out,False,947650,True,63,0,1558,1558
168062,2019-11-26 00:00:00+03:00,out,True,947658,False,2,4,11,7
168062,2019-11-26 00:00:00+03:00,in,False,951508,False,15,1710,1992,282
168062,2019-11-26 00:00:00+03:00,out,True,951508,False,4,361,395,34
168062,2019-11-26 00:00:00+03:00,out,True,947604,False,1,5,9,4
168062,2019-11-26 00:00:00+03:00,out,True,947618,False,2,10,14,4
168062,2019-11-26 00:00:00+03:00,out,False,947658,True,55,0,1290,1290
168062,2019-11-26 00:00:00+03:00,out,True,947638,False,1,7,12,5
168062,2019-11-26 00:00:00+03:00,out,False,947616,False,46,1356,1873,517
168062,2019-11-26 00:00:00+03:00,out,False,947604,True,19,0,424,424
168062,2019-11-26 00:00:00+03:00,in,False,-1,True,10,0,110,110
168062,2019-11-26 00:00:00+03:00,out,False,947638,True,35,0,460,460
168062,2019-11-26 00:00:00+03:00,out,False,947658,False,37,1621,2090,469
168062,2019-11-26 00:00:00+03:00,out,True,947642,True,1,0,18,18
168062,2019-11-26 00:00:00+03:00,out,False,947654,True,102,0,1803,1803
168062,2019-11-26 00:00:00+03:00,out,True,947618,True,1,0,16,16
168062,2019-11-27 00:00:00+03:00,out,False,947650,True,56,0,1288,1288
168062,2019-11-27 00:00:00+03:00,out,True,947614,True,1,0,3,3
168062,2019-11-27 00:00:00+03:00,out,False,952392,True,65,0,1877,1877
168062,2019-11-27 00:00:00+03:00,out,False,947614,False,29,982,1231,249
168062,2019-11-27 00:00:00+03:00,out,False,947600,False,5,260,284,24
168062,2019-11-27 00:00:00+03:00,out,False,947652,True,27,0,574,574
168062,2019-11-27 00:00:00+03:00,in,False,-1,True,7,0,70,70
168062,2019-11-27 00:00:00+03:00,out,False,947620,True,49,0,982,982
168062,2019-11-27 00:00:00+03:00,out,False,947614,True,46,0,459,459
168062,2019-11-27 00:00:00+03:00,out,True,951506,False,8,704,773,69
168062,2019-11-27 00:00:00+03:00,out,False,952392,False,30,2412,2796,384
168062,2019-11-27 00:00:00+03:00,out,True,947644,True,1,0,8,8
168062,2019-11-27 00:00:00+03:00,out,True,947652,False,2,120,145,25
168062,2019-11-27 00:00:00+03:00,out,True,947638,False,2,13,22,9
168062,2019-11-27 00:00:00+03:00,out,False,947600,True,8,0,71,71
168062,2019-11-27 00:00:00+03:00,out,False,947648,True,100,0,2426,2426
168062,2019-11-27 00:00:00+03:00,out,False,947620,False,14,722,954,232
168062,2019-11-27 00:00:00+03:00,out,True,947642,False,1,9,11,2
168062,2019-11-27 00:00:00+03:00,out,False,947618,False,35,1944,2485,541
168062,2019-11-27 00:00:00+03:00,out,True,947598,False,2,8,28,20
168062,2019-11-27 00:00:00+03:00,out,False,947598,True,12,0,183,183
168062,2019-11-27 00:00:00+03:00,out,True,947618,False,2,10,16,6
168062,2019-11-27 00:00:00+03:00,out,False,947658,True,58,0,1357,1357
168062,2019-11-27 00:00:00+03:00,out,False,947646,True,48,0,1162,1162
168062,2019-11-27 00:00:00+03:00,out,False,947644,True,10,0,136,136
168062,2019-11-27 00:00:00+03:00,out,False,947640,True,44,0,575,575
168062,2019-11-27 00:00:00+03:00,out,False,947618,True,34,0,717,717
168062,2019-11-27 00:00:00+03:00,out,False,947604,False,12,2980,3181,201
168062,2019-11-27 00:00:00+03:00,out,False,947616,True,40,0,1023,1023
168062,2019-11-27 00:00:00+03:00,out,True,947640,True,4,0,32,32
168062,2019-11-27 00:00:00+03:00,out,True,947616,True,2,0,0,0
168062,2019-11-27 00:00:00+03:00,out,True,947620,False,1,8,11,3
168062,2019-11-27 00:00:00+03:00,out,True,952392,True,1,0,8,8
168062,2019-11-27 00:00:00+03:00,out,True,947654,False,1,31,41,10
168062,2019-11-27 00:00:00+03:00,out,True,952392,False,1,7,10,3
168062,2019-11-27 00:00:00+03:00,out,True,947598,True,1,0,8,8
168062,2019-11-27 00:00:00+03:00,out,True,947620,True,2,0,17,17
168062,2019-11-27 00:00:00+03:00,out,True,951492,False,1,28,34,6
168062,2019-11-27 00:00:00+03:00,out,True,947644,False,2,14,42,28
168062,2019-11-27 00:00:00+03:00,out,False,947638,False,15,495,688,193
168062,2019-11-27 00:00:00+03:00,out,False,947646,False,51,1947,2772,825
168062,2019-11-27 00:00:00+03:00,out,False,947590,True,4,0,40,40
168062,2019-11-27 00:00:00+03:00,out,False,947590,False,3,352,427,75
168062,2019-11-27 00:00:00+03:00,out,True,947658,False,2,5,15,10
168062,2019-11-27 00:00:00+03:00,out,False,947642,False,37,2089,2599,510
168062,2019-11-27 00:00:00+03:00,in,False,951506,False,1,180,197,17
168062,2019-11-27 00:00:00+03:00,out,True,951508,False,3,412,435,23
168062,2019-11-27 00:00:00+03:00,out,False,947612,False,3,407,437,30
168062,2019-11-27 00:00:00+03:00,out,True,947648,False,2,13,19,6
168062,2019-11-27 00:00:00+03:00,out,False,947652,False,14,856,1049,193
168062,2019-11-27 00:00:00+03:00,out,False,947638,True,33,0,478,478
168062,2019-11-27 00:00:00+03:00,out,True,947616,False,2,11,16,5
168062,2019-11-27 00:00:00+03:00,out,True,947600,False,2,7,16,9
168062,2019-11-27 00:00:00+03:00,out,False,947644,False,20,1071,1399,328
168062,2019-11-27 00:00:00+03:00,out,False,947642,True,75,0,2115,2115
168062,2019-11-27 00:00:00+03:00,out,False,947604,True,11,0,326,326
168062,2019-11-27 00:00:00+03:00,out,False,947612,True,1,0,23,23
168062,2019-11-27 00:00:00+03:00,out,True,947646,False,1,4,6,2
168062,2019-11-27 00:00:00+03:00,in,False,951508,False,17,1688,1999,311
168062,2019-11-27 00:00:00+03:00,out,False,947654,True,55,0,1593,1593
168062,2019-11-27 00:00:00+03:00,out,False,947598,False,13,529,720,191
168062,2019-11-27 00:00:00+03:00,out,False,947650,False,32,3221,3665,444
168062,2019-11-27 00:00:00+03:00,out,True,947590,False,1,18,22,4
168062,2019-11-27 00:00:00+03:00,out,False,947658,False,43,2591,3210,619
168062,2019-11-27 00:00:00+03:00,out,False,947640,False,29,1405,1808,403
168062,2019-11-27 00:00:00+03:00,in,False,951492,False,2,595,628,33
168062,2019-11-27 00:00:00+03:00,out,False,947654,False,37,3122,3865,743
168062,2019-11-27 00:00:00+03:00,out,False,947648,False,61,3749,4536,787
168062,2019-11-27 00:00:00+03:00,out,True,947640,False,2,9,13,4
168062,2019-11-27 00:00:00+03:00,out,True,947614,False,2,11,15,4
168062,2019-11-27 00:00:00+03:00,out,False,947616,False,38,2294,2785,491
168062,2019-11-27 00:00:00+03:00,out,False,947640,False,29,1405,1808,403
168062,2019-11-27 00:00:00+03:00,out,False,947620,True,49,0,982,982
168062,2019-11-27 00:00:00+03:00,out,False,947652,False,14,856,1049,193
168062,2019-11-27 00:00:00+03:00,out,False,947638,True,33,0,478,478
168062,2019-11-28 00:00:00+03:00,out,True,951508,False,5,292,341,49
168062,2019-11-28 00:00:00+03:00,out,True,947620,False,1,13,16,3
168062,2019-11-28 00:00:00+03:00,out,False,947658,False,40,1737,2368,631
168062,2019-11-28 00:00:00+03:00,out,True,947618,False,2,12,24,12
168062,2019-11-28 00:00:00+03:00,out,False,947650,True,39,0,885,885
168062,2019-11-28 00:00:00+03:00,out,False,952392,False,17,1351,1637,286
168062,2019-11-28 00:00:00+03:00,out,False,947648,True,50,0,1321,1321
168062,2019-11-28 00:00:00+03:00,out,False,947638,True,48,0,664,664
168062,2019-11-28 00:00:00+03:00,out,True,947642,False,2,12,30,18
168062,2019-11-28 00:00:00+03:00,out,True,947590,False,2,39,52,13
168062,2019-11-28 00:00:00+03:00,out,False,947640,False,26,1446,1808,362
168062,2019-11-28 00:00:00+03:00,out,False,947638,False,19,745,956,211
168062,2019-11-28 00:00:00+03:00,out,True,947600,False,2,9,16,7
168062,2019-11-28 00:00:00+03:00,out,False,947598,False,3,70,96,26
168062,2019-11-28 00:00:00+03:00,out,False,947642,True,59,0,806,806
168062,2019-11-28 00:00:00+03:00,out,False,952392,True,29,0,576,576
168062,2019-11-28 00:00:00+03:00,out,True,952392,False,1,11,15,4
168062,2019-11-28 00:00:00+03:00,out,False,947640,True,28,0,562,562
168062,2019-11-28 00:00:00+03:00,out,False,947652,True,22,0,591,591
168062,2019-11-28 00:00:00+03:00,out,False,947620,True,46,0,927,927
168062,2019-11-28 00:00:00+03:00,out,False,947604,True,27,0,603,603
168062,2019-11-28 00:00:00+03:00,out,True,947658,False,2,6,15,9
168062,2019-11-28 00:00:00+03:00,out,True,947598,False,2,10,26,16
168062,2019-11-28 00:00:00+03:00,out,True,947616,False,1,5,7,2
168062,2019-11-28 00:00:00+03:00,out,True,947610,False,2,64,86,22
168062,2019-11-28 00:00:00+03:00,out,False,947642,False,21,986,1125,139
168062,2019-11-28 00:00:00+03:00,out,False,947658,True,62,0,1749,1749
168062,2019-11-28 00:00:00+03:00,out,False,947644,False,10,718,833,115
168062,2019-11-28 00:00:00+03:00,out,True,947646,False,2,10,25,15
168062,2019-11-28 00:00:00+03:00,in,False,951508,True,1,72,99,27
168062,2019-11-28 00:00:00+03:00,out,False,947590,False,1,67,68,1
168062,2019-11-28 00:00:00+03:00,in,False,951508,False,12,962,1183,221
168062,2019-11-28 00:00:00+03:00,out,False,947646,True,59,0,1452,1452
168062,2019-11-28 00:00:00+03:00,out,True,947640,False,2,9,15,6
168062,2019-11-28 00:00:00+03:00,out,True,947644,False,1,4,7,3
168062,2019-11-28 00:00:00+03:00,out,False,947598,True,6,0,49,49
168062,2019-11-28 00:00:00+03:00,out,True,947652,False,2,11,16,5
168062,2019-11-28 00:00:00+03:00,out,False,947644,True,16,0,431,431
168062,2019-11-28 00:00:00+03:00,out,True,947648,False,1,6,10,4
168062,2019-11-28 00:00:00+03:00,out,True,947614,False,2,19,24,5
168062,2019-11-28 00:00:00+03:00,out,False,947652,False,15,663,921,258
168062,2019-11-28 00:00:00+03:00,out,False,947612,True,3,0,108,108
168062,2019-11-28 00:00:00+03:00,out,False,947616,True,85,0,1657,1657
168062,2019-11-28 00:00:00+03:00,in,False,951492,False,2,204,243,39
168062,2019-11-28 00:00:00+03:00,out,False,947600,False,1,15,19,4
168062,2019-11-28 00:00:00+03:00,out,True,947638,False,2,14,27,13
168062,2019-11-28 00:00:00+03:00,out,False,947612,False,9,1226,1326,100
168062,2019-11-28 00:00:00+03:00,out,False,947614,False,63,2146,2839,693
168062,2019-11-28 00:00:00+03:00,out,False,947618,False,28,2186,2654,468
168062,2019-11-28 00:00:00+03:00,out,False,947648,False,44,3061,3552,491
168062,2019-11-28 00:00:00+03:00,out,True,951506,False,21,1813,2007,194
168062,2019-11-28 00:00:00+03:00,in,False,-1,True,4,0,37,37
168062,2019-11-28 00:00:00+03:00,out,False,947614,True,48,0,693,693
168062,2019-11-28 00:00:00+03:00,out,False,947618,True,38,0,778,778
168062,2019-11-28 00:00:00+03:00,out,False,947650,False,29,2968,3419,451
168062,2019-11-28 00:00:00+03:00,in,False,951506,False,2,180,271,91
168062,2019-11-28 00:00:00+03:00,out,False,947620,False,26,1042,1328,286
168062,2019-11-28 00:00:00+03:00,out,False,947616,False,44,1339,1915,576
168062,2019-11-28 00:00:00+03:00,out,True,947616,True,1,0,4,4
168062,2019-11-28 00:00:00+03:00,out,False,947646,False,51,1681,2452,771
168062,2019-11-28 00:00:00+03:00,out,True,947650,False,1,4,7,3
168062,2019-11-28 00:00:00+03:00,out,False,947604,False,15,1521,1715,194
168062,2019-11-28 00:00:00+03:00,out,False,947590,True,1,0,36,36
168062,2019-11-28 00:00:00+03:00,out,True,951492,False,9,752,831,79
168062,2019-11-28 00:00:00+03:00,in,False,951508,True,1,72,99,27
168062,2019-11-28 00:00:00+03:00,out,True,947600,False,2,9,16,7
168062,2019-11-28 00:00:00+03:00,out,False,947616,False,44,1339,1915,576
168064,2019-10-11 00:00:00+03:00,in,False,-1,True,7,0,1,1
168064,2019-10-18 00:00:00+03:00,out,True,934476,True,9,0,247,247
168064,2019-10-18 00:00:00+03:00,out,True,934476,False,1,17,30,13
168064,2019-10-18 00:00:00+03:00,in,True,934476,False,1,9,22,13
168064,2019-10-18 00:00:00+03:00,out,True,939762,False,1,8,21,13
168064,2019-10-18 00:00:00+03:00,in,False,-1,True,10,0,49,49
168064,2019-10-18 00:00:00+03:00,out,True,939762,True,7,0,118,118
168064,2019-10-18 00:00:00+03:00,out,False,939762,True,3,0,89,89
168064,2019-10-18 00:00:00+03:00,in,False,-1,True,10,0,49,49
168064,2019-10-19 00:00:00+03:00,out,False,939762,True,1,0,4,4
168064,2019-10-20 00:00:00+03:00,out,False,939762,True,2,0,34,34
168064,2019-10-21 00:00:00+03:00,out,False,939762,True,1,0,26,26
168064,2019-10-21 00:00:00+03:00,in,False,-1,True,1,0,5,5
168064,2019-10-21 00:00:00+03:00,out,True,939762,True,4,0,26,26
168064,2019-10-21 00:00:00+03:00,out,False,939762,False,6,139,233,94
168064,2019-10-21 00:00:00+03:00,out,False,939762,True,1,0,26,26
168064,2019-10-22 00:00:00+03:00,out,False,939762,False,22,454,1021,567
168064,2019-10-22 00:00:00+03:00,in,False,939762,False,10,872,982,110
168064,2019-10-22 00:00:00+03:00,out,True,939762,True,3,0,38,38
168064,2019-10-22 00:00:00+03:00,in,True,939762,False,2,68,77,9
168064,2019-10-22 00:00:00+03:00,out,False,939762,True,5,0,200,200
168064,2019-10-22 00:00:00+03:00,in,False,-1,True,1,0,31,31
168064,2019-10-22 00:00:00+03:00,in,False,-1,True,1,0,15,15
168064,2019-10-23 00:00:00+03:00,in,False,939762,False,16,873,999,126
168064,2019-10-23 00:00:00+03:00,out,False,939762,True,12,0,122,122
168064,2019-10-23 00:00:00+03:00,out,False,939762,False,22,934,1394,460
168064,2019-10-23 00:00:00+03:00,in,False,939762,False,16,873,999,126
168064,2019-10-24 00:00:00+03:00,out,False,939762,False,20,425,829,404
168064,2019-10-24 00:00:00+03:00,in,False,939762,False,16,1210,1312,102
168064,2019-10-24 00:00:00+03:00,in,False,-1,True,1,0,9,9
168064,2019-10-24 00:00:00+03:00,out,False,939762,True,6,0,120,120
168064,2019-10-24 00:00:00+03:00,in,False,-1,True,2,0,11,11
168064,2019-10-24 00:00:00+03:00,out,True,939762,False,1,8,23,15
168064,2019-10-25 00:00:00+03:00,out,False,939762,False,24,652,1082,430
168064,2019-10-25 00:00:00+03:00,in,False,939762,False,21,1455,1580,125
168064,2019-10-25 00:00:00+03:00,out,False,939762,True,7,0,133,133
168064,2019-10-25 00:00:00+03:00,in,False,-1,True,2,0,8,8
168064,2019-10-25 00:00:00+03:00,in,False,-1,True,1,0,15,15
168064,2019-10-26 00:00:00+03:00,in,False,-1,True,2,0,10,10
168064,2019-10-26 00:00:00+03:00,out,False,939762,False,25,780,1382,602
168064,2019-10-26 00:00:00+03:00,in,False,939762,False,22,1249,1389,140
168064,2019-10-26 00:00:00+03:00,out,False,939762,True,16,0,190,190
168064,2019-10-27 00:00:00+03:00,out,False,939762,True,9,0,214,214
168064,2019-10-27 00:00:00+03:00,in,False,939762,False,14,786,887,101
168064,2019-10-27 00:00:00+03:00,out,False,939762,False,25,728,1280,552
168064,2019-10-28 00:00:00+03:00,in,False,939762,False,26,1421,1880,459
168064,2019-10-28 00:00:00+03:00,out,False,939762,True,11,0,17,17
168064,2019-10-28 00:00:00+03:00,in,False,-1,True,6,0,53,53
168064,2019-10-28 00:00:00+03:00,out,False,939762,False,10,290,542,252
168064,2019-10-29 00:00:00+03:00,out,False,939762,False,20,514,1051,537
168064,2019-10-29 00:00:00+03:00,in,False,939762,False,20,1316,1672,356
168064,2019-10-29 00:00:00+03:00,out,False,939762,True,17,0,206,206
168064,2019-10-30 00:00:00+03:00,in,False,939762,False,12,1009,1251,242
168064,2019-10-30 00:00:00+03:00,out,False,939762,False,16,736,1086,350
168064,2019-10-30 00:00:00+03:00,out,False,939762,True,22,0,203,203
168064,2019-10-30 00:00:00+03:00,in,False,-1,True,2,0,21,21
168064,2019-10-30 00:00:00+03:00,in,False,-1,True,12,0,142,142
168064,2019-10-31 00:00:00+03:00,out,False,939762,False,28,988,1542,554
168064,2019-10-31 00:00:00+03:00,in,False,-1,True,3,0,87,87
168064,2019-10-31 00:00:00+03:00,in,False,939762,False,37,2261,2891,630
168064,2019-10-31 00:00:00+03:00,in,True,939762,False,1,4,21,17
168064,2019-10-31 00:00:00+03:00,out,False,939762,True,38,0,187,187
168064,2019-10-31 00:00:00+03:00,out,False,939762,True,38,0,187,187
168064,2019-11-01 00:00:00+03:00,out,False,939762,False,6,353,472,119
168064,2019-11-01 00:00:00+03:00,in,False,939762,False,33,2220,2835,615
168064,2019-11-01 00:00:00+03:00,out,False,939762,True,4,0,50,50
168064,2019-11-01 00:00:00+03:00,in,False,-1,True,4,0,46,46
168064,2019-11-01 00:00:00+03:00,in,False,939762,False,33,2220,2835,615
168064,2019-11-02 00:00:00+03:00,in,False,-1,True,5,0,84,84
168064,2019-11-02 00:00:00+03:00,out,False,939762,True,5,0,101,101
168064,2019-11-02 00:00:00+03:00,in,False,939762,False,29,1590,2134,544
168064,2019-11-02 00:00:00+03:00,out,False,939762,False,23,961,1463,502
168064,2019-11-03 00:00:00+03:00,out,False,939762,True,26,0,54,54
168064,2019-11-03 00:00:00+03:00,in,False,939762,False,26,1670,2180,510
168064,2019-11-03 00:00:00+03:00,out,False,939762,False,32,1383,1918,535
168064,2019-11-04 00:00:00+03:00,out,False,939762,False,20,780,1165,385
168064,2019-11-04 00:00:00+03:00,in,False,939762,False,16,1094,1388,294
168064,2019-11-04 00:00:00+03:00,out,False,939762,True,6,0,39,39
168064,2019-11-05 00:00:00+03:00,in,False,-1,True,2,0,29,29
168064,2019-11-05 00:00:00+03:00,out,False,939762,False,15,460,697,237
168064,2019-11-05 00:00:00+03:00,out,False,939762,True,2,0,10,10
168064,2019-11-05 00:00:00+03:00,in,False,939762,False,29,1752,2297,545
168064,2019-11-06 00:00:00+03:00,out,False,939762,True,9,0,120,120
168064,2019-11-06 00:00:00+03:00,out,False,939762,False,23,614,1117,503
168064,2019-11-06 00:00:00+03:00,in,False,939762,False,19,1172,1539,367
168064,2019-11-06 00:00:00+03:00,out,True,939762,True,1,0,0,0
168064,2019-11-06 00:00:00+03:00,in,False,-1,True,3,0,25,25
168064,2019-11-06 00:00:00+03:00,out,False,939762,True,9,0,120,120
168064,2019-11-07 00:00:00+03:00,out,False,939762,True,41,0,365,365
168064,2019-11-07 00:00:00+03:00,in,False,939762,False,30,2549,3113,564
168064,2019-11-07 00:00:00+03:00,out,False,939762,False,42,1562,2293,731
168064,2019-11-08 00:00:00+03:00,out,True,939762,True,3,0,4,4
168064,2019-11-08 00:00:00+03:00,in,False,939762,False,28,2220,2706,486
168064,2019-11-08 00:00:00+03:00,in,False,-1,True,2,0,13,13
168064,2019-11-08 00:00:00+03:00,in,True,939762,False,1,17,32,15
168064,2019-11-08 00:00:00+03:00,out,False,939762,True,88,0,1242,1242
168064,2019-11-08 00:00:00+03:00,out,False,939762,False,70,3222,4508,1286
168064,2019-11-08 00:00:00+03:00,in,False,-1,True,2,0,57,57
168064,2019-11-08 00:00:00+03:00,out,True,939762,True,3,0,4,4
168064,2019-11-09 00:00:00+03:00,in,False,-1,True,8,0,42,42
168064,2019-11-09 00:00:00+03:00,out,False,939762,False,43,2239,3126,887
168064,2019-11-09 00:00:00+03:00,in,False,939762,False,16,897,1194,297
168064,2019-11-09 00:00:00+03:00,out,False,939762,True,38,0,572,572
168064,2019-11-09 00:00:00+03:00,in,False,939762,False,16,897,1194,297
168064,2019-11-10 00:00:00+03:00,in,False,939762,False,14,828,1077,249
168064,2019-11-10 00:00:00+03:00,out,False,939762,True,16,0,351,351
168064,2019-11-10 00:00:00+03:00,out,False,939762,False,27,1049,1564,515
168064,2019-11-11 00:00:00+03:00,out,False,939762,True,26,0,549,549
168064,2019-11-11 00:00:00+03:00,out,False,939762,False,49,2877,3776,899
168064,2019-11-11 00:00:00+03:00,in,False,939762,False,19,1374,1709,335
168064,2019-11-11 00:00:00+03:00,in,False,-1,True,2,0,9,9
168064,2019-11-11 00:00:00+03:00,in,False,939762,False,19,1374,1709,335
168064,2019-11-12 00:00:00+03:00,out,False,939762,False,76,4310,5757,1447
168064,2019-11-12 00:00:00+03:00,out,False,939762,True,70,0,950,950
168064,2019-11-12 00:00:00+03:00,in,False,939762,False,29,2194,2710,516
168064,2019-11-12 00:00:00+03:00,in,False,-1,True,3,0,26,26
168064,2019-11-13 00:00:00+03:00,out,False,939762,True,3,0,64,64
168064,2019-11-13 00:00:00+03:00,in,False,-1,True,3,0,19,19
168064,2019-11-13 00:00:00+03:00,out,False,939762,False,14,507,795,288
168064,2019-11-13 00:00:00+03:00,in,False,939762,False,22,1330,1769,439
168064,2019-11-14 00:00:00+03:00,in,False,-1,True,3,0,69,69
168064,2019-11-14 00:00:00+03:00,out,False,939762,False,27,755,1346,591
168064,2019-11-14 00:00:00+03:00,in,False,939762,False,18,684,1031,347
168064,2019-11-14 00:00:00+03:00,out,False,939762,True,11,0,240,240
168064,2019-11-15 00:00:00+03:00,out,False,939762,False,31,1451,2042,591
168064,2019-11-15 00:00:00+03:00,in,False,939762,False,14,1161,1438,277
168064,2019-11-15 00:00:00+03:00,out,False,939762,True,14,0,137,137
168064,2019-11-16 00:00:00+03:00,in,False,-1,True,5,0,97,97
168064,2019-11-16 00:00:00+03:00,out,False,939762,True,32,0,583,583
168064,2019-11-16 00:00:00+03:00,in,False,939762,False,31,1999,2527,528
168064,2019-11-16 00:00:00+03:00,out,False,939762,False,43,2818,3663,845
168064,2019-11-16 00:00:00+03:00,out,False,939762,False,43,2818,3663,845
168064,2019-11-17 00:00:00+03:00,in,False,-1,True,2,0,67,67
168064,2019-11-17 00:00:00+03:00,in,False,939762,False,12,802,1015,213
168064,2019-11-17 00:00:00+03:00,out,False,939762,False,14,582,883,301
168064,2019-11-17 00:00:00+03:00,out,False,939762,True,14,0,179,179
168064,2019-11-18 00:00:00+03:00,in,False,-1,True,4,0,180,180
168064,2019-11-18 00:00:00+03:00,in,False,939762,False,14,907,1171,264
168064,2019-11-18 00:00:00+03:00,out,False,939762,True,13,0,91,91
168064,2019-11-18 00:00:00+03:00,out,False,939762,False,20,499,912,413
168064,2019-11-19 00:00:00+03:00,in,False,939762,False,31,2078,2679,601
168064,2019-11-19 00:00:00+03:00,out,False,939762,True,27,0,194,194
168064,2019-11-19 00:00:00+03:00,out,False,939762,False,46,2438,3408,970
168064,2019-11-19 00:00:00+03:00,in,False,-1,True,4,0,43,43
168064,2019-11-19 00:00:00+03:00,out,False,939762,True,27,0,194,194
168064,2019-11-19 00:00:00+03:00,out,False,939762,False,46,2438,3408,970
168064,2019-11-20 00:00:00+03:00,out,False,939762,False,47,2370,3162,792
168064,2019-11-20 00:00:00+03:00,in,False,-1,True,2,0,8,8
168064,2019-11-20 00:00:00+03:00,in,False,939762,False,23,1879,2287,408
168064,2019-11-20 00:00:00+03:00,out,False,939762,True,18,0,378,378
168064,2019-11-21 00:00:00+03:00,out,False,939762,True,37,0,282,282
168064,2019-11-21 00:00:00+03:00,in,False,939762,False,16,1336,1669,333
168064,2019-11-21 00:00:00+03:00,out,False,939762,False,29,1539,2087,548
168064,2019-11-22 00:00:00+03:00,in,False,939762,False,10,593,763,170
168064,2019-11-22 00:00:00+03:00,out,False,939762,True,8,0,144,144
168064,2019-11-22 00:00:00+03:00,in,False,-1,True,3,0,48,48
168064,2019-11-22 00:00:00+03:00,out,False,939762,False,15,341,649,308
168064,2019-11-23 00:00:00+03:00,in,False,-1,True,2,0,21,21
168064,2019-11-23 00:00:00+03:00,in,False,939762,False,19,1144,1501,357
168064,2019-11-23 00:00:00+03:00,out,False,939762,True,25,0,171,171
168064,2019-11-23 00:00:00+03:00,out,False,939762,False,33,1408,2037,629
168064,2019-11-23 00:00:00+03:00,in,False,939762,False,19,1144,1501,357
168064,2019-11-24 00:00:00+03:00,out,False,939762,False,20,1326,1708,382
168064,2019-11-24 00:00:00+03:00,out,False,939762,True,9,0,33,33
168064,2019-11-24 00:00:00+03:00,in,False,-1,True,5,0,60,60
168064,2019-11-24 00:00:00+03:00,in,False,939762,False,15,1047,1319,272
168064,2019-11-25 00:00:00+03:00,in,False,939762,False,24,1000,1458,458
168064,2019-11-25 00:00:00+03:00,out,False,939762,False,14,391,640,249
168064,2019-11-25 00:00:00+03:00,out,False,939762,True,15,0,305,305
168064,2019-11-25 00:00:00+03:00,in,False,-1,True,4,0,152,152
168064,2019-11-25 00:00:00+03:00,in,False,939762,False,24,1000,1458,458
168064,2019-11-26 00:00:00+03:00,out,False,939762,True,5,0,88,88
168064,2019-11-26 00:00:00+03:00,out,False,939762,False,26,631,1178,547
168064,2019-11-26 00:00:00+03:00,in,False,939762,False,23,1559,2013,454
168064,2019-11-27 00:00:00+03:00,in,False,939762,False,25,2147,2597,450
168064,2019-11-27 00:00:00+03:00,out,False,939762,False,29,2064,2697,633
168064,2019-11-27 00:00:00+03:00,in,False,-1,True,4,0,56,56
168064,2019-11-27 00:00:00+03:00,out,False,939762,True,35,0,334,334
168064,2019-11-28 00:00:00+03:00,out,False,939762,True,22,0,175,175
168064,2019-11-28 00:00:00+03:00,out,False,939762,False,37,2195,2980,785
168064,2019-11-28 00:00:00+03:00,in,False,-1,True,2,0,49,49
168064,2019-11-28 00:00:00+03:00,in,False,939762,False,25,1714,2114,400
168073,2019-10-16 00:00:00+03:00,out,True,937422,False,2,37,45,8
168073,2019-10-16 00:00:00+03:00,out,True,937428,False,1,28,31,3
168073,2019-10-16 00:00:00+03:00,out,True,937430,True,6,0,42,42
168073,2019-10-16 00:00:00+03:00,out,True,937422,True,3,0,0,0
168073,2019-10-16 00:00:00+03:00,in,False,-1,True,2,0,8,8
168073,2019-10-16 00:00:00+03:00,out,True,937430,False,3,39,61,22
168073,2019-10-16 00:00:00+03:00,out,True,937432,True,6,0,50,50
168073,2019-10-16 00:00:00+03:00,out,True,937432,True,6,0,50,50
168073,2019-10-17 00:00:00+03:00,out,True,937430,False,2,81,94,13
168073,2019-10-17 00:00:00+03:00,out,True,937430,True,2,0,8,8
168073,2019-10-17 00:00:00+03:00,out,True,937432,False,1,13,16,3
168073,2019-10-17 00:00:00+03:00,in,False,937432,True,1,0,13,13
168073,2019-10-21 00:00:00+03:00,out,True,937422,True,2,0,0,0
168073,2019-10-21 00:00:00+03:00,in,False,-1,True,1,0,10,10
168073,2019-10-21 00:00:00+03:00,in,False,-1,True,1,0,10,10
168073,2019-10-22 00:00:00+03:00,in,False,-1,True,1,0,20,20
168073,2019-10-23 00:00:00+03:00,out,True,937430,False,5,166,211,45
168073,2019-10-23 00:00:00+03:00,out,True,937432,True,9,0,48,48
168073,2019-10-23 00:00:00+03:00,out,True,937430,True,3,0,36,36
168073,2019-10-23 00:00:00+03:00,out,True,937422,False,4,470,500,30
168073,2019-10-23 00:00:00+03:00,out,True,941810,False,1,86,102,16
168073,2019-10-23 00:00:00+03:00,in,False,937432,False,1,40,51,11
168073,2019-10-23 00:00:00+03:00,out,True,941826,True,1,0,2,2
168073,2019-10-23 00:00:00+03:00,out,True,937428,False,1,21,37,16
168073,2019-10-23 00:00:00+03:00,out,True,937432,False,2,125,136,11
168073,2019-10-23 00:00:00+03:00,out,False,941810,True,1,0,29,29
168073,2019-10-23 00:00:00+03:00,out,True,937422,True,4,0,14,14
168073,2019-10-24 00:00:00+03:00,out,True,941816,False,1,19,29,10
168073,2019-10-24 00:00:00+03:00,out,True,937428,False,1,43,48,5
168073,2019-10-24 00:00:00+03:00,out,True,941740,False,2,179,198,19
168073,2019-10-24 00:00:00+03:00,out,True,937430,False,3,94,109,15
168073,2019-10-24 00:00:00+03:00,out,True,937432,False,1,7,14,7
168073,2019-10-24 00:00:00+03:00,out,True,941736,False,3,59,88,29
168073,2019-10-24 00:00:00+03:00,out,True,941810,False,2,34,44,10
168073,2019-10-24 00:00:00+03:00,out,True,941810,False,2,34,44,10
168073,2019-10-28 00:00:00+03:00,out,True,937422,True,2,0,15,15
168073,2019-10-28 00:00:00+03:00,out,False,941740,True,1,0,19,19
168073,2019-10-28 00:00:00+03:00,out,True,937422,False,4,95,123,28
168073,2019-10-28 00:00:00+03:00,out,True,937430,False,6,105,142,37
168073,2019-10-28 00:00:00+03:00,out,False,941740,False,1,119,128,9
168073,2019-10-28 00:00:00+03:00,out,True,937430,True,1,0,42,42
168073,2019-10-28 00:00:00+03:00,out,True,941740,False,2,29,34,5
168073,2019-10-28 00:00:00+03:00,out,True,937430,True,1,0,42,42
168073,2019-10-29 00:00:00+03:00,out,False,941740,True,1,0,2,2
168073,2019-10-29 00:00:00+03:00,out,False,941740,False,1,60,72,12
168073,2019-11-05 00:00:00+03:00,out,True,937428,False,5,121,145,24
168073,2019-11-05 00:00:00+03:00,out,True,954284,True,1,0,3,3
168073,2019-11-05 00:00:00+03:00,out,True,953362,False,1,16,28,12
168073,2019-11-05 00:00:00+03:00,out,True,937422,False,4,44,56,12
168073,2019-11-05 00:00:00+03:00,out,True,941736,False,1,47,56,9
168073,2019-11-05 00:00:00+03:00,out,False,953362,False,1,374,375,1
168073,2019-11-05 00:00:00+03:00,out,False,953362,True,2,0,0,0
168073,2019-11-05 00:00:00+03:00,out,True,953362,True,6,0,32,32
168073,2019-11-05 00:00:00+03:00,out,True,941736,True,5,0,14,14
168073,2019-11-05 00:00:00+03:00,out,True,937422,True,3,0,8,8
168073,2019-11-05 00:00:00+03:00,out,True,941736,False,1,47,56,9
168073,2019-11-07 00:00:00+03:00,in,False,-1,True,1,0,26,26
168073,2019-11-11 00:00:00+03:00,out,True,937430,False,2,24,35,11
168073,2019-11-11 00:00:00+03:00,out,True,937422,False,1,10,15,5
168073,2019-11-11 00:00:00+03:00,out,True,937422,True,1,0,0,0
168073,2019-11-11 00:00:00+03:00,out,False,937422,False,2,435,437,2
168073,2019-11-11 00:00:00+03:00,out,False,937422,True,4,0,6,6
168073,2019-11-11 00:00:00+03:00,out,True,937422,False,1,10,15,5
168073,2019-11-15 00:00:00+03:00,out,True,941736,False,1,38,44,6
168073,2019-11-18 00:00:00+03:00,in,False,937432,False,1,10,22,12
168090,2019-10-25 00:00:00+03:00,in,False,-1,True,1,0,2,2
168090,2019-10-31 00:00:00+03:00,in,False,-1,True,1,0,2,2
168090,2019-11-11 00:00:00+03:00,in,False,-1,True,2,0,4,4
168090,2019-11-14 00:00:00+03:00,in,False,-1,True,1,0,2,2
168090,2019-11-18 00:00:00+03:00,in,False,964518,False,2,13,55,42
168090,2019-11-21 00:00:00+03:00,in,False,-1,True,2,0,34,34
168090,2019-11-21 00:00:00+03:00,in,False,-1,True,2,0,34,34
168090,2019-11-22 00:00:00+03:00,in,False,-1,True,2,0,47,47
168091,2019-11-11 00:00:00+03:00,out,False,958460,True,3,0,6,6
168091,2019-11-11 00:00:00+03:00,out,False,958432,False,1,63,71,8
168091,2019-11-11 00:00:00+03:00,out,True,958672,False,1,17,25,8
168091,2019-11-11 00:00:00+03:00,out,True,958672,True,1,0,0,0
168091,2019-11-11 00:00:00+03:00,out,False,958456,False,13,1010,1148,138
168091,2019-11-11 00:00:00+03:00,out,False,958430,False,1,18,29,11
168091,2019-11-11 00:00:00+03:00,out,False,958456,True,13,0,392,392
168091,2019-11-11 00:00:00+03:00,out,True,958432,True,1,0,0,0
168091,2019-11-11 00:00:00+03:00,in,False,-1,True,1,0,2,2
168091,2019-11-11 00:00:00+03:00,out,True,958672,True,1,0,0,0
168091,2019-11-12 00:00:00+03:00,out,True,958454,True,2,0,4,4
168091,2019-11-12 00:00:00+03:00,in,False,-1,True,4,0,53,53
168091,2019-11-12 00:00:00+03:00,out,True,958432,False,2,64,79,15
168091,2019-11-12 00:00:00+03:00,out,True,958430,True,1,0,14,14
168091,2019-11-12 00:00:00+03:00,out,True,958460,False,9,173,203,30
168091,2019-11-12 00:00:00+03:00,out,True,958440,False,3,379,391,12
168091,2019-11-12 00:00:00+03:00,out,True,958430,False,2,156,165,9
168091,2019-11-12 00:00:00+03:00,out,True,958432,True,3,0,45,45
168091,2019-11-12 00:00:00+03:00,out,False,958472,False,1,199,200,1
168091,2019-11-12 00:00:00+03:00,out,True,958452,True,1,0,21,21
168091,2019-11-12 00:00:00+03:00,out,False,958452,False,17,2196,2404,208
168091,2019-11-12 00:00:00+03:00,out,False,958480,False,2,409,425,16
168091,2019-11-12 00:00:00+03:00,out,True,958454,False,3,82,95,13
168091,2019-11-12 00:00:00+03:00,out,False,958460,False,4,260,303,43
168091,2019-11-12 00:00:00+03:00,out,False,958456,True,28,0,851,851
168091,2019-11-12 00:00:00+03:00,out,False,958468,True,13,0,216,216
168091,2019-11-12 00:00:00+03:00,out,False,958460,True,3,0,6,6
168091,2019-11-12 00:00:00+03:00,out,True,958478,False,1,144,146,2
168091,2019-11-12 00:00:00+03:00,out,False,958430,False,12,1896,2085,189
168091,2019-11-12 00:00:00+03:00,out,False,958432,False,2,297,325,28
168091,2019-11-12 00:00:00+03:00,out,True,958452,False,2,67,75,8
168091,2019-11-12 00:00:00+03:00,in,False,958460,False,5,352,396,44
168091,2019-11-12 00:00:00+03:00,out,False,958456,False,51,3563,4059,496
168091,2019-11-12 00:00:00+03:00,in,False,958430,False,1,442,450,8
168091,2019-11-12 00:00:00+03:00,in,False,958434,False,1,35,49,14
168091,2019-11-12 00:00:00+03:00,out,True,958468,False,2,80,87,7
168091,2019-11-12 00:00:00+03:00,out,False,958452,True,9,0,241,241
168091,2019-11-12 00:00:00+03:00,out,False,958468,False,41,4155,4723,568
168091,2019-11-12 00:00:00+03:00,out,False,958478,True,15,0,385,385
168091,2019-11-12 00:00:00+03:00,out,False,958430,True,19,0,293,293
168091,2019-11-12 00:00:00+03:00,out,True,958456,False,1,82,90,8
168091,2019-11-12 00:00:00+03:00,out,True,958460,True,3,0,52,52
168091,2019-11-12 00:00:00+03:00,out,False,958472,True,1,0,2,2
168091,2019-11-12 00:00:00+03:00,out,False,958432,True,6,0,16,16
168091,2019-11-12 00:00:00+03:00,out,False,958478,False,13,2193,2367,174
168091,2019-11-12 00:00:00+03:00,out,True,958672,False,1,21,30,9
168091,2019-11-12 00:00:00+03:00,out,True,958444,False,3,185,197,12
168091,2019-11-12 00:00:00+03:00,out,False,958470,True,2,0,34,34
168091,2019-11-12 00:00:00+03:00,out,False,958456,True,28,0,851,851
168091,2019-11-13 00:00:00+03:00,in,False,958460,False,10,515,950,435
168091,2019-11-13 00:00:00+03:00,out,False,958456,False,56,4374,4993,619
168091,2019-11-13 00:00:00+03:00,out,False,958468,False,24,3222,3531,309
168091,2019-11-13 00:00:00+03:00,out,True,958440,False,2,154,163,9
168091,2019-11-13 00:00:00+03:00,out,True,958468,False,4,195,231,36
168091,2019-11-13 00:00:00+03:00,out,True,958452,False,3,44,65,21
168091,2019-11-13 00:00:00+03:00,in,False,958470,False,1,149,197,48
168091,2019-11-13 00:00:00+03:00,out,True,958434,True,1,0,17,17
168091,2019-11-13 00:00:00+03:00,out,False,958478,True,1,0,8,8
168091,2019-11-13 00:00:00+03:00,out,True,958460,True,4,0,42,42
168091,2019-11-13 00:00:00+03:00,out,True,958478,False,3,109,125,16
168091,2019-11-13 00:00:00+03:00,out,False,958434,True,1,0,5,5
168091,2019-11-13 00:00:00+03:00,out,False,958452,True,10,0,256,256
168091,2019-11-13 00:00:00+03:00,out,True,958444,False,4,163,187,24
168091,2019-11-13 00:00:00+03:00,out,False,958672,False,1,161,169,8
168091,2019-11-13 00:00:00+03:00,out,True,958454,True,2,0,28,28
168091,2019-11-13 00:00:00+03:00,in,False,-1,True,5,0,229,229
168091,2019-11-13 00:00:00+03:00,out,False,958478,False,23,5244,5493,249
168091,2019-11-13 00:00:00+03:00,in,False,958460,True,1,56,105,49
168091,2019-11-13 00:00:00+03:00,out,False,958452,False,28,2060,2302,242
168091,2019-11-13 00:00:00+03:00,out,False,958434,False,3,763,772,9
168091,2019-11-13 00:00:00+03:00,out,True,958434,False,5,847,870,23
168091,2019-11-13 00:00:00+03:00,out,False,958470,False,1,154,167,13
168091,2019-11-13 00:00:00+03:00,out,False,958460,False,6,707,739,32
168091,2019-11-13 00:00:00+03:00,out,False,958460,True,3,0,53,53
168091,2019-11-13 00:00:00+03:00,out,True,958454,False,4,245,270,25
168091,2019-11-13 00:00:00+03:00,out,True,958672,False,7,236,266,30
168091,2019-11-13 00:00:00+03:00,out,True,958430,False,1,44,47,3
168091,2019-11-13 00:00:00+03:00,out,True,958468,True,1,0,26,26
168091,2019-11-13 00:00:00+03:00,in,False,958456,False,1,68,117,49
168091,2019-11-13 00:00:00+03:00,out,True,958456,False,2,69,75,6
168091,2019-11-13 00:00:00+03:00,out,False,958470,True,3,0,12,12
168091,2019-11-13 00:00:00+03:00,out,False,958472,False,1,64,70,6
168091,2019-11-13 00:00:00+03:00,out,False,958430,False,1,89,93,4
168091,2019-11-13 00:00:00+03:00,out,False,958432,False,6,755,811,56
168091,2019-11-13 00:00:00+03:00,out,False,958432,True,2,0,11,11
168091,2019-11-13 00:00:00+03:00,in,False,958432,False,1,30,84,54
168091,2019-11-13 00:00:00+03:00,out,True,958444,True,1,0,19,19
168091,2019-11-13 00:00:00+03:00,out,True,958432,False,2,105,114,9
168091,2019-11-13 00:00:00+03:00,out,False,958468,True,10,0,199,199
168091,2019-11-13 00:00:00+03:00,in,False,958434,False,3,595,755,160
168091,2019-11-13 00:00:00+03:00,out,True,958460,False,1,16,21,5
168091,2019-11-13 00:00:00+03:00,out,False,958456,True,34,0,1066,1066
168091,2019-11-13 00:00:00+03:00,in,False,958452,False,2,384,466,82
168091,2019-11-13 00:00:00+03:00,out,True,958456,False,2,69,75,6
168091,2019-11-13 00:00:00+03:00,out,False,958452,True,10,0,256,256
168091,2019-11-13 00:00:00+03:00,out,True,958468,False,4,195,231,36
168091,2019-11-14 00:00:00+03:00,out,False,958432,False,7,448,513,65
168091,2019-11-14 00:00:00+03:00,out,False,958456,False,67,3663,4556,893
168091,2019-11-14 00:00:00+03:00,out,False,958478,False,18,2422,2588,166
168091,2019-11-14 00:00:00+03:00,out,True,958444,False,6,148,177,29
168091,2019-11-14 00:00:00+03:00,out,True,958460,False,7,166,204,38
168091,2019-11-14 00:00:00+03:00,out,True,958432,False,3,111,127,16
168091,2019-11-14 00:00:00+03:00,out,False,958468,False,23,5796,6107,311
168091,2019-11-14 00:00:00+03:00,out,False,958480,True,27,0,374,374
168091,2019-11-14 00:00:00+03:00,out,True,958456,False,1,18,25,7
168091,2019-11-14 00:00:00+03:00,in,False,958434,True,1,14,27,13
168091,2019-11-14 00:00:00+03:00,out,False,958478,True,20,0,540,540
168091,2019-11-14 00:00:00+03:00,out,False,958444,False,1,88,97,9
168091,2019-11-14 00:00:00+03:00,out,True,958672,False,4,143,161,18
168091,2019-11-14 00:00:00+03:00,out,True,958468,True,1,0,0,0
168091,2019-11-14 00:00:00+03:00,out,False,958456,True,37,0,1225,1225
168091,2019-11-14 00:00:00+03:00,out,False,958472,True,2,0,16,16
168091,2019-11-14 00:00:00+03:00,in,False,958432,False,1,82,90,8
168091,2019-11-14 00:00:00+03:00,out,False,958480,False,18,792,932,140
168091,2019-11-14 00:00:00+03:00,out,True,958440,False,8,3150,3203,53
168091,2019-11-14 00:00:00+03:00,out,True,958478,True,1,0,55,55
168091,2019-11-14 00:00:00+03:00,out,False,958472,False,4,424,435,11
168091,2019-11-14 00:00:00+03:00,out,False,958672,False,1,426,429,3
168091,2019-11-14 00:00:00+03:00,out,True,958472,True,1,0,3,3
168091,2019-11-14 00:00:00+03:00,out,True,958454,False,1,9,14,5
168091,2019-11-14 00:00:00+03:00,in,False,958460,False,3,275,423,148
168091,2019-11-14 00:00:00+03:00,out,True,958478,False,1,54,57,3
168091,2019-11-14 00:00:00+03:00,out,False,958470,True,1,0,31,31
168091,2019-11-14 00:00:00+03:00,in,False,-1,True,8,0,188,188
168091,2019-11-14 00:00:00+03:00,out,False,958470,False,1,573,582,9
168091,2019-11-14 00:00:00+03:00,out,True,958452,False,2,126,132,6
168091,2019-11-14 00:00:00+03:00,out,False,958452,False,20,2105,2394,289
168091,2019-11-14 00:00:00+03:00,out,True,958434,True,4,0,5,5
168091,2019-11-14 00:00:00+03:00,out,False,958432,True,3,0,52,52
168091,2019-11-14 00:00:00+03:00,out,True,958468,False,1,30,38,8
168091,2019-11-14 00:00:00+03:00,out,False,958468,True,16,0,341,341
168091,2019-11-14 00:00:00+03:00,out,False,958452,True,6,0,171,171
168091,2019-11-14 00:00:00+03:00,out,True,958460,True,1,0,15,15
168091,2019-11-14 00:00:00+03:00,in,False,958478,False,1,858,905,47
168091,2019-11-14 00:00:00+03:00,out,True,958434,False,7,170,210,40
168091,2019-11-14 00:00:00+03:00,in,False,958452,False,3,289,331,42
168091,2019-11-14 00:00:00+03:00,in,False,958456,False,1,85,135,50
168091,2019-11-14 00:00:00+03:00,out,False,958480,False,18,792,932,140
168091,2019-11-14 00:00:00+03:00,out,True,958444,False,6,148,177,29
168091,2019-11-14 00:00:00+03:00,out,False,958452,False,20,2105,2394,289
168091,2019-11-14 00:00:00+03:00,in,False,958452,False,3,289,331,42
168091,2019-11-15 00:00:00+03:00,out,False,958456,False,56,4201,4893,692
168091,2019-11-15 00:00:00+03:00,out,False,958456,True,30,0,793,793
168091,2019-11-15 00:00:00+03:00,out,False,958478,False,20,5033,5298,265
168091,2019-11-15 00:00:00+03:00,out,False,958460,True,1,0,19,19
168091,2019-11-15 00:00:00+03:00,out,True,958456,False,2,217,237,20
168091,2019-11-15 00:00:00+03:00,out,False,958470,False,2,109,130,21
168091,2019-11-15 00:00:00+03:00,out,True,958444,False,4,118,133,15
168091,2019-11-15 00:00:00+03:00,out,True,958468,True,3,0,29,29
168091,2019-11-15 00:00:00+03:00,out,True,958468,False,1,88,94,6
168091,2019-11-15 00:00:00+03:00,out,False,958452,True,12,0,290,290
168091,2019-11-15 00:00:00+03:00,out,False,958468,True,9,0,305,305
168091,2019-11-15 00:00:00+03:00,in,False,958468,False,1,639,784,145
168091,2019-11-15 00:00:00+03:00,out,True,958672,False,1,16,23,7
168091,2019-11-15 00:00:00+03:00,out,True,958454,False,1,31,36,5
168091,2019-11-15 00:00:00+03:00,in,False,958430,False,2,196,205,9
168091,2019-11-15 00:00:00+03:00,out,False,958472,True,6,0,99,99
168091,2019-11-15 00:00:00+03:00,out,True,958458,True,1,0,0,0
168091,2019-11-15 00:00:00+03:00,out,True,958434,True,1,0,16,16
168091,2019-11-15 00:00:00+03:00,out,True,958432,False,3,213,225,12
168091,2019-11-15 00:00:00+03:00,out,False,958480,False,20,271,469,198
168091,2019-11-15 00:00:00+03:00,out,False,958468,False,32,3051,3428,377
168091,2019-11-15 00:00:00+03:00,out,True,958460,False,4,128,162,34
168091,2019-11-15 00:00:00+03:00,in,False,958452,True,1,72,77,5
168091,2019-11-15 00:00:00+03:00,in,False,958478,False,1,837,885,48
168091,2019-11-15 00:00:00+03:00,out,False,958452,False,15,3429,3569,140
168091,2019-11-15 00:00:00+03:00,out,False,958430,True,7,0,224,224
168091,2019-11-15 00:00:00+03:00,out,True,958430,False,4,160,184,24
168091,2019-11-15 00:00:00+03:00,out,True,958452,False,2,488,495,7
168091,2019-11-15 00:00:00+03:00,out,True,958440,True,1,0,18,18
168091,2019-11-15 00:00:00+03:00,out,False,958460,False,3,337,370,33
168091,2019-11-15 00:00:00+03:00,out,False,958478,True,20,0,508,508
168091,2019-11-15 00:00:00+03:00,in,False,958470,False,1,261,312,51
168091,2019-11-15 00:00:00+03:00,out,True,958434,False,2,208,222,14
168091,2019-11-15 00:00:00+03:00,out,False,958432,False,5,408,467,59
168091,2019-11-15 00:00:00+03:00,in,False,958452,False,2,351,417,66
168091,2019-11-15 00:00:00+03:00,in,False,958460,False,4,407,609,202
168091,2019-11-15 00:00:00+03:00,in,False,-1,True,9,0,238,238
168091,2019-11-15 00:00:00+03:00,out,False,958432,True,4,0,60,60
168091,2019-11-15 00:00:00+03:00,out,False,958480,True,56,0,1038,1038
168091,2019-11-15 00:00:00+03:00,out,True,958430,True,3,0,50,50
168091,2019-11-15 00:00:00+03:00,out,True,958440,False,4,808,825,17
168091,2019-11-15 00:00:00+03:00,out,False,958430,False,15,1279,1482,203
168091,2019-11-15 00:00:00+03:00,out,False,958432,True,4,0,60,60
168091,2019-11-15 00:00:00+03:00,out,False,958478,True,20,0,508,508
168091,2019-11-15 00:00:00+03:00,out,True,958672,False,1,16,23,7
168091,2019-11-15 00:00:00+03:00,out,False,958480,False,20,271,469,198
168091,2019-11-15 00:00:00+03:00,in,False,958470,False,1,261,312,51
168091,2019-11-16 00:00:00+03:00,in,False,-1,True,1,0,5,5
168091,2019-11-17 00:00:00+03:00,in,False,-1,True,1,0,14,14
168091,2019-11-18 00:00:00+03:00,out,False,958456,False,47,2668,3324,656
168091,2019-11-18 00:00:00+03:00,out,True,958430,False,8,180,213,33
168091,2019-11-18 00:00:00+03:00,out,False,958480,False,5,186,245,59
168091,2019-11-18 00:00:00+03:00,out,True,958434,True,2,0,31,31
168091,2019-11-18 00:00:00+03:00,out,True,958444,True,1,0,1,1
168091,2019-11-18 00:00:00+03:00,out,True,958672,False,6,145,180,35
168091,2019-11-18 00:00:00+03:00,in,False,958460,False,8,1174,1584,410
168091,2019-11-18 00:00:00+03:00,out,False,958434,False,2,205,220,15
168091,2019-11-18 00:00:00+03:00,out,False,958452,False,24,3438,3703,265
168091,2019-11-18 00:00:00+03:00,out,False,958430,True,6,0,117,117
168091,2019-11-18 00:00:00+03:00,out,False,958478,True,14,0,459,459
168091,2019-11-18 00:00:00+03:00,in,False,958478,False,2,1049,1100,51
168091,2019-11-18 00:00:00+03:00,out,False,958480,True,10,0,179,179
168091,2019-11-18 00:00:00+03:00,out,False,958460,False,1,29,54,25
168091,2019-11-18 00:00:00+03:00,out,True,958468,False,1,46,50,4
168091,2019-11-18 00:00:00+03:00,out,False,958430,False,21,2175,2404,229
168091,2019-11-18 00:00:00+03:00,in,False,-1,True,13,0,399,399
168091,2019-11-18 00:00:00+03:00,out,False,958468,True,10,0,239,239
168091,2019-11-18 00:00:00+03:00,in,False,958434,False,1,78,110,32
168091,2019-11-18 00:00:00+03:00,out,True,958456,False,2,221,229,8
168091,2019-11-18 00:00:00+03:00,out,True,958460,False,5,110,145,35
168091,2019-11-18 00:00:00+03:00,out,True,958454,True,1,0,18,18
168091,2019-11-18 00:00:00+03:00,out,False,958456,True,30,0,986,986
168091,2019-11-18 00:00:00+03:00,out,False,958472,False,2,538,556,18
168091,2019-11-18 00:00:00+03:00,out,False,958432,False,5,303,366,63
168091,2019-11-18 00:00:00+03:00,out,False,958452,True,20,0,397,397
168091,2019-11-18 00:00:00+03:00,out,True,958454,False,2,28,36,8
168091,2019-11-18 00:00:00+03:00,out,True,958444,False,6,264,286,22
168091,2019-11-18 00:00:00+03:00,in,False,958432,False,1,128,137,9
168091,2019-11-18 00:00:00+03:00,out,False,958478,False,21,5964,6332,368
168091,2019-11-18 00:00:00+03:00,out,False,958468,False,38,3096,3613,517
168091,2019-11-18 00:00:00+03:00,in,False,958452,False,1,138,144,6
168091,2019-11-18 00:00:00+03:00,out,True,958430,True,4,0,61,61
168091,2019-11-18 00:00:00+03:00,out,True,958434,False,2,224,231,7
168091,2019-11-18 00:00:00+03:00,in,False,958456,False,1,154,204,50
168091,2019-11-18 00:00:00+03:00,out,True,958432,False,1,5,10,5
168091,2019-11-18 00:00:00+03:00,out,True,958460,True,1,0,14,14
168091,2019-11-18 00:00:00+03:00,out,False,958452,True,20,0,397,397
168091,2019-11-18 00:00:00+03:00,in,False,958434,False,1,78,110,32
168091,2019-11-18 00:00:00+03:00,out,False,958432,False,5,303,366,63
168091,2019-11-18 00:00:00+03:00,out,False,958472,False,2,538,556,18
168091,2019-11-19 00:00:00+03:00,out,True,958432,False,4,300,316,16
168091,2019-11-19 00:00:00+03:00,out,False,958452,False,22,2725,2989,264
168091,2019-11-19 00:00:00+03:00,out,False,958478,True,18,0,299,299
168091,2019-11-19 00:00:00+03:00,in,False,958478,False,1,85,131,46
168091,2019-11-19 00:00:00+03:00,out,True,958430,False,11,1190,1238,48
168091,2019-11-19 00:00:00+03:00,in,False,-1,True,6,0,146,146
168091,2019-11-19 00:00:00+03:00,out,False,958432,False,14,1188,1364,176
168091,2019-11-19 00:00:00+03:00,out,False,958472,False,3,140,184,44
168091,2019-11-19 00:00:00+03:00,out,False,958468,False,28,3929,4293,364
168091,2019-11-19 00:00:00+03:00,in,False,958432,False,1,57,63,6
168091,2019-11-19 00:00:00+03:00,out,False,958430,False,15,2704,2900,196
168091,2019-11-19 00:00:00+03:00,in,False,958430,False,2,541,593,52
168091,2019-11-19 00:00:00+03:00,out,False,958430,True,3,0,58,58
168091,2019-11-19 00:00:00+03:00,in,False,958456,False,1,303,313,10
168091,2019-11-19 00:00:00+03:00,out,True,958456,False,3,93,106,13
168091,2019-11-19 00:00:00+03:00,out,False,958432,True,4,0,56,56
168091,2019-11-19 00:00:00+03:00,out,False,958456,False,54,3773,4595,822
168091,2019-11-19 00:00:00+03:00,out,True,958434,False,7,404,449,45
168091,2019-11-19 00:00:00+03:00,in,False,958434,False,1,113,145,32
168091,2019-11-19 00:00:00+03:00,out,True,958440,False,10,441,490,49
168091,2019-11-19 00:00:00+03:00,out,False,958456,True,29,0,899,899
168091,2019-11-19 00:00:00+03:00,out,True,958444,False,5,218,263,45
168091,2019-11-19 00:00:00+03:00,out,True,958444,True,1,0,33,33
168091,2019-11-19 00:00:00+03:00,out,False,958468,True,4,0,78,78
168091,2019-11-19 00:00:00+03:00,out,True,958440,True,1,0,1,1
168091,2019-11-19 00:00:00+03:00,out,True,958430,True,1,0,12,12
168091,2019-11-19 00:00:00+03:00,out,False,958452,True,5,0,229,229
168091,2019-11-19 00:00:00+03:00,out,False,958478,False,39,7229,7775,546
168091,2019-11-19 00:00:00+03:00,in,False,958452,False,1,75,79,4
168091,2019-11-19 00:00:00+03:00,out,False,958434,False,2,621,644,23
168091,2019-11-19 00:00:00+03:00,out,True,958672,False,3,76,90,14
168091,2019-11-19 00:00:00+03:00,in,False,958460,False,8,1112,1520,408
168091,2019-11-19 00:00:00+03:00,out,False,958452,True,5,0,229,229
168091,2019-11-19 00:00:00+03:00,out,False,958432,False,14,1188,1364,176
168091,2019-11-19 00:00:00+03:00,out,False,958472,False,3,140,184,44
168091,2019-11-20 00:00:00+03:00,out,True,958672,False,3,74,89,15
168091,2019-11-20 00:00:00+03:00,out,False,958430,False,12,3857,4019,162
168091,2019-11-20 00:00:00+03:00,out,True,958460,False,5,90,113,23
168091,2019-11-20 00:00:00+03:00,in,False,958452,False,4,346,378,32
168091,2019-11-20 00:00:00+03:00,out,False,958468,False,27,4945,5226,281
168091,2019-11-20 00:00:00+03:00,out,True,958444,True,1,0,1,1
168091,2019-11-20 00:00:00+03:00,out,False,958430,True,1,0,42,42
168091,2019-11-20 00:00:00+03:00,in,False,958456,False,4,231,278,47
168091,2019-11-20 00:00:00+03:00,out,False,958478,True,5,0,68,68
168091,2019-11-20 00:00:00+03:00,in,False,958434,False,4,1077,1261,184
168091,2019-11-20 00:00:00+03:00,in,False,958460,False,13,1843,2503,660
168091,2019-11-20 00:00:00+03:00,out,True,958432,False,2,84,90,6
168091,2019-11-20 00:00:00+03:00,out,False,958460,False,1,47,51,4
168091,2019-11-20 00:00:00+03:00,out,True,958452,False,7,288,321,33
168091,2019-11-20 00:00:00+03:00,out,True,958444,False,8,193,230,37
168091,2019-11-20 00:00:00+03:00,out,True,958460,True,2,0,21,21
168091,2019-11-20 00:00:00+03:00,out,True,958452,True,1,0,6,6
168091,2019-11-20 00:00:00+03:00,out,False,958456,False,54,3223,3919,696
168091,2019-11-20 00:00:00+03:00,out,True,958478,False,1,145,148,3
168091,2019-11-20 00:00:00+03:00,out,True,958430,True,5,0,52,52
168091,2019-11-20 00:00:00+03:00,out,False,958452,True,12,0,370,370
168091,2019-11-20 00:00:00+03:00,out,True,958440,False,4,316,336,20
168091,2019-11-20 00:00:00+03:00,out,True,958456,False,8,316,347,31
168091,2019-11-20 00:00:00+03:00,out,True,958440,True,3,0,0,0
168091,2019-11-20 00:00:00+03:00,out,True,958672,True,1,0,1,1
168091,2019-11-20 00:00:00+03:00,out,False,958468,True,4,0,200,200
168091,2019-11-20 00:00:00+03:00,in,False,958468,False,4,369,393,24
168091,2019-11-20 00:00:00+03:00,out,False,958456,True,24,0,880,880
168091,2019-11-20 00:00:00+03:00,out,True,958434,False,9,458,500,42
168091,2019-11-20 00:00:00+03:00,out,True,958454,False,1,22,31,9
168091,2019-11-20 00:00:00+03:00,out,False,958460,True,3,0,121,121
168091,2019-11-20 00:00:00+03:00,in,False,-1,True,2,0,78,78
168091,2019-11-20 00:00:00+03:00,out,False,958434,False,2,487,488,1
168091,2019-11-20 00:00:00+03:00,out,False,958452,False,27,3837,4161,324
168091,2019-11-20 00:00:00+03:00,out,True,958430,False,8,929,968,39
168091,2019-11-20 00:00:00+03:00,out,False,958432,False,1,68,82,14
168091,2019-11-20 00:00:00+03:00,in,False,958430,False,2,247,295,48
168091,2019-11-20 00:00:00+03:00,in,False,958452,False,4,346,378,32
168091,2019-11-20 00:00:00+03:00,in,False,-1,True,2,0,78,78
168091,2019-11-20 00:00:00+03:00,out,True,958444,False,8,193,230,37
168091,2019-11-20 00:00:00+03:00,out,True,958452,True,1,0,6,6
168091,2019-11-20 00:00:00+03:00,out,True,958430,True,5,0,52,52
168091,2019-11-20 00:00:00+03:00,out,True,958460,True,2,0,21,21
168091,2019-11-21 00:00:00+03:00,out,False,958430,True,2,0,58,58
168091,2019-11-21 00:00:00+03:00,out,False,958468,True,21,0,701,701
168091,2019-11-21 00:00:00+03:00,out,True,958432,False,4,307,337,30
168091,2019-11-21 00:00:00+03:00,in,False,958460,False,7,923,1343,420
168091,2019-11-21 00:00:00+03:00,in,False,958432,False,1,497,547,50
168091,2019-11-21 00:00:00+03:00,out,False,958478,False,6,1940,2061,121
168091,2019-11-21 00:00:00+03:00,out,True,958440,True,2,0,1,1
168091,2019-11-21 00:00:00+03:00,out,False,958452,False,31,3287,3670,383
168091,2019-11-21 00:00:00+03:00,out,True,958440,False,9,874,939,65
168091,2019-11-21 00:00:00+03:00,out,True,958452,False,2,67,75,8
168091,2019-11-21 00:00:00+03:00,out,False,958470,False,1,421,430,9
168091,2019-11-21 00:00:00+03:00,out,True,958434,False,11,1026,1096,70
168091,2019-11-21 00:00:00+03:00,out,False,958430,False,7,915,1041,126
168091,2019-11-21 00:00:00+03:00,out,False,958478,True,7,0,24,24
168091,2019-11-21 00:00:00+03:00,out,False,958452,True,10,0,423,423
168091,2019-11-21 00:00:00+03:00,in,False,958452,False,1,56,69,13
168091,2019-11-21 00:00:00+03:00,out,False,958468,False,43,3179,3726,547
168091,2019-11-21 00:00:00+03:00,out,True,958434,True,2,0,21,21
168091,2019-11-21 00:00:00+03:00,in,False,958478,False,2,448,493,45
168091,2019-11-21 00:00:00+03:00,out,False,958460,True,2,0,78,78
168091,2019-11-21 00:00:00+03:00,in,False,-1,True,5,0,349,349
168091,2019-11-21 00:00:00+03:00,out,True,958472,True,1,0,0,0
168091,2019-11-21 00:00:00+03:00,out,False,958444,False,1,53,56,3
168091,2019-11-21 00:00:00+03:00,out,True,958430,True,1,0,13,13
168091,2019-11-21 00:00:00+03:00,out,True,958460,True,1,0,36,36
168091,2019-11-21 00:00:00+03:00,out,False,958432,False,6,1342,1439,97
168091,2019-11-21 00:00:00+03:00,out,False,958472,True,4,0,19,19
168091,2019-11-21 00:00:00+03:00,out,False,958434,False,2,241,263,22
168091,2019-11-21 00:00:00+03:00,out,True,958460,False,2,18,29,11
168091,2019-11-21 00:00:00+03:00,out,True,958672,False,3,515,537,22
168091,2019-11-21 00:00:00+03:00,in,False,958430,False,4,690,766,76
168091,2019-11-21 00:00:00+03:00,out,True,958444,False,7,473,513,40
168091,2019-11-21 00:00:00+03:00,out,True,958430,False,7,1281,1314,33
168091,2019-11-21 00:00:00+03:00,out,False,958460,False,6,843,902,59
168091,2019-11-21 00:00:00+03:00,out,True,958440,False,9,874,939,65
168091,2019-11-21 00:00:00+03:00,out,False,958430,True,2,0,58,58
168091,2019-11-22 00:00:00+03:00,out,False,958434,True,4,0,157,157
168091,2019-11-22 00:00:00+03:00,in,False,958452,False,1,24,31,7
168091,2019-11-22 00:00:00+03:00,out,True,958672,False,2,46,62,16
168091,2019-11-22 00:00:00+03:00,out,True,958672,True,2,0,9,9
168091,2019-11-22 00:00:00+03:00,out,True,958440,False,1,31,40,9
168091,2019-11-22 00:00:00+03:00,in,False,958430,False,3,1322,1366,44
168091,2019-11-22 00:00:00+03:00,out,True,958444,False,6,164,191,27
168091,2019-11-22 00:00:00+03:00,in,False,958470,False,1,292,345,53
168091,2019-11-22 00:00:00+03:00,out,True,958430,True,1,0,8,8
168091,2019-11-22 00:00:00+03:00,out,True,958454,False,2,15,36,21
168091,2019-11-22 00:00:00+03:00,out,True,958434,False,7,414,454,40
168091,2019-11-22 00:00:00+03:00,out,False,958460,False,3,320,340,20
168091,2019-11-22 00:00:00+03:00,out,True,958430,False,9,862,901,39
168091,2019-11-22 00:00:00+03:00,out,True,958460,True,1,0,0,0
168091,2019-11-22 00:00:00+03:00,out,False,958452,True,5,0,177,177
168091,2019-11-22 00:00:00+03:00,in,False,958434,False,3,984,1113,129
168091,2019-11-22 00:00:00+03:00,out,False,958434,False,6,199,255,56
168091,2019-11-22 00:00:00+03:00,in,False,958456,False,2,1193,1251,58
168091,2019-11-22 00:00:00+03:00,out,True,958468,False,1,27,33,6
168091,2019-11-22 00:00:00+03:00,out,False,958432,True,2,0,16,16
168091,2019-11-22 00:00:00+03:00,out,False,958468,True,8,0,70,70
168091,2019-11-22 00:00:00+03:00,in,False,958432,False,2,320,401,81
168091,2019-11-22 00:00:00+03:00,out,False,958452,False,16,2210,2422,212
168091,2019-11-22 00:00:00+03:00,out,True,958460,False,2,51,60,9
168091,2019-11-22 00:00:00+03:00,out,True,958432,False,1,41,53,12
168091,2019-11-22 00:00:00+03:00,out,True,958434,True,3,0,6,6
168091,2019-11-22 00:00:00+03:00,out,False,958430,False,14,1360,1549,189
168091,2019-11-22 00:00:00+03:00,in,False,958460,False,13,1773,2488,715
168091,2019-11-22 00:00:00+03:00,out,False,958432,False,6,571,653,82
168091,2019-11-22 00:00:00+03:00,out,False,958468,False,32,5757,6115,358
168091,2019-11-22 00:00:00+03:00,in,False,-1,True,8,0,285,285
168091,2019-11-22 00:00:00+03:00,out,True,958434,True,3,0,6,6
168091,2019-11-22 00:00:00+03:00,in,False,958432,False,2,320,401,81
168091,2019-11-22 00:00:00+03:00,out,True,958672,False,2,46,62,16
168091,2019-11-22 00:00:00+03:00,out,True,958672,True,2,0,9,9
168091,2019-11-22 00:00:00+03:00,out,False,958468,True,8,0,70,70
168091,2019-11-25 00:00:00+03:00,out,True,958460,False,3,57,67,10
168091,2019-11-25 00:00:00+03:00,out,False,958430,True,2,0,89,89
168091,2019-11-25 00:00:00+03:00,out,True,958460,True,1,0,0,0
168091,2019-11-25 00:00:00+03:00,in,False,958430,False,3,1184,1270,86
168091,2019-11-25 00:00:00+03:00,out,True,958434,False,1,93,97,4
168091,2019-11-25 00:00:00+03:00,in,False,958460,False,10,884,1426,542
168091,2019-11-25 00:00:00+03:00,in,False,958468,False,1,228,233,5
168091,2019-11-25 00:00:00+03:00,out,True,958430,True,2,0,4,4
168091,2019-11-25 00:00:00+03:00,out,True,958430,False,6,382,401,19
168091,2019-11-25 00:00:00+03:00,out,False,958432,True,1,0,30,30
168091,2019-11-25 00:00:00+03:00,out,False,958432,False,4,365,422,57
168091,2019-11-25 00:00:00+03:00,out,True,958440,True,1,0,0,0
168091,2019-11-25 00:00:00+03:00,out,False,958470,False,1,31,33,2
168091,2019-11-25 00:00:00+03:00,out,True,958432,False,6,137,162,25
168091,2019-11-25 00:00:00+03:00,out,False,958478,True,7,0,133,133
168091,2019-11-25 00:00:00+03:00,out,False,958452,False,15,2548,2702,154
168091,2019-11-25 00:00:00+03:00,in,False,958432,False,1,116,120,4
168091,2019-11-25 00:00:00+03:00,out,False,958434,False,8,1578,1635,57
168091,2019-11-25 00:00:00+03:00,out,True,958432,True,1,0,23,23
168091,2019-11-25 00:00:00+03:00,out,True,958672,True,2,0,12,12
168091,2019-11-25 00:00:00+03:00,in,False,958434,False,4,998,1153,155
168091,2019-11-25 00:00:00+03:00,out,False,958434,True,3,0,61,61
168091,2019-11-25 00:00:00+03:00,in,False,958454,False,2,352,382,30
168091,2019-11-25 00:00:00+03:00,in,False,958460,True,1,27,86,59
168091,2019-11-25 00:00:00+03:00,in,False,958452,False,3,636,664,28
168091,2019-11-25 00:00:00+03:00,out,True,958440,False,9,2718,2775,57
168091,2019-11-25 00:00:00+03:00,out,False,958430,False,10,1009,1157,148
168091,2019-11-25 00:00:00+03:00,out,False,958472,False,1,63,75,12
168091,2019-11-25 00:00:00+03:00,out,False,958478,False,12,3055,3246,191
168091,2019-11-25 00:00:00+03:00,out,True,958672,False,1,143,146,3
168091,2019-11-25 00:00:00+03:00,out,True,958444,False,1,18,24,6
168091,2019-11-25 00:00:00+03:00,in,False,-1,True,11,0,256,256
168091,2019-11-25 00:00:00+03:00,out,False,958460,False,4,468,495,27
168091,2019-11-25 00:00:00+03:00,out,True,958454,False,2,53,66,13
168091,2019-11-25 00:00:00+03:00,out,False,958468,True,6,0,60,60
168091,2019-11-25 00:00:00+03:00,out,False,958452,True,7,0,93,93
168091,2019-11-25 00:00:00+03:00,out,True,958452,False,2,204,214,10
168091,2019-11-25 00:00:00+03:00,out,False,958468,False,9,1021,1124,103
168091,2019-11-25 00:00:00+03:00,in,False,958468,False,1,228,233,5
168091,2019-11-25 00:00:00+03:00,in,False,-1,True,11,0,256,256
168091,2019-11-25 00:00:00+03:00,out,False,958434,True,3,0,61,61
168091,2019-11-25 00:00:00+03:00,in,False,958460,False,10,884,1426,542
168091,2019-11-26 00:00:00+03:00,out,True,958440,False,9,645,692,47
168091,2019-11-26 00:00:00+03:00,out,True,958672,True,2,0,8,8
168091,2019-11-26 00:00:00+03:00,in,False,958434,False,1,22,64,42
168091,2019-11-26 00:00:00+03:00,in,False,958452,False,4,385,427,42
168091,2019-11-26 00:00:00+03:00,out,False,958452,True,7,0,208,208
168091,2019-11-26 00:00:00+03:00,out,True,958452,False,3,109,120,11
168091,2019-11-26 00:00:00+03:00,out,False,958430,True,4,0,166,166
168091,2019-11-26 00:00:00+03:00,in,False,958432,False,2,282,383,101
168091,2019-11-26 00:00:00+03:00,out,False,958430,False,10,933,1070,137
168091,2019-11-26 00:00:00+03:00,out,False,958468,False,19,964,1133,169
168091,2019-11-26 00:00:00+03:00,in,False,958460,False,5,639,893,254
168091,2019-11-26 00:00:00+03:00,out,True,958672,False,1,23,30,7
168091,2019-11-26 00:00:00+03:00,out,False,958478,True,16,0,456,456
168091,2019-11-26 00:00:00+03:00,out,False,958460,False,5,1470,1513,43
168091,2019-11-26 00:00:00+03:00,out,False,958434,False,11,651,760,109
168091,2019-11-26 00:00:00+03:00,out,False,958452,False,24,3156,3483,327
168091,2019-11-26 00:00:00+03:00,out,True,958432,True,1,0,22,22
168091,2019-11-26 00:00:00+03:00,out,False,958432,False,10,950,1133,183
168091,2019-11-26 00:00:00+03:00,out,False,958432,True,1,0,38,38
168091,2019-11-26 00:00:00+03:00,out,True,958430,False,11,1716,1767,51
168091,2019-11-26 00:00:00+03:00,in,False,-1,True,9,0,411,411
168091,2019-11-26 00:00:00+03:00,out,True,958434,False,5,346,389,43
168091,2019-11-26 00:00:00+03:00,out,True,958430,True,1,0,2,2
168091,2019-11-26 00:00:00+03:00,out,False,958478,False,20,2496,2767,271
168091,2019-11-26 00:00:00+03:00,out,False,958434,True,12,0,121,121
168091,2019-11-26 00:00:00+03:00,out,True,958432,False,3,168,178,10
168091,2019-11-26 00:00:00+03:00,out,True,958434,True,4,0,47,47
168091,2019-11-26 00:00:00+03:00,out,True,958444,False,1,21,24,3
168091,2019-11-26 00:00:00+03:00,out,False,958468,True,5,0,83,83
168091,2019-11-26 00:00:00+03:00,in,False,958468,False,1,357,427,70
168091,2019-11-26 00:00:00+03:00,in,False,958468,False,1,357,427,70
168091,2019-11-26 00:00:00+03:00,out,False,958432,True,1,0,38,38
168091,2019-11-26 00:00:00+03:00,out,True,958430,True,1,0,2,2
168091,2019-11-27 00:00:00+03:00,in,False,958432,False,3,404,454,50
168091,2019-11-27 00:00:00+03:00,in,False,-1,True,16,0,476,476
168091,2019-11-27 00:00:00+03:00,out,True,958456,False,3,127,143,16
168091,2019-11-27 00:00:00+03:00,in,False,958460,False,8,803,1218,415
168091,2019-11-27 00:00:00+03:00,out,False,958430,False,8,1171,1274,103
168091,2019-11-27 00:00:00+03:00,out,False,958456,True,48,0,1356,1356
168091,2019-11-27 00:00:00+03:00,out,True,958434,True,3,0,37,37
168091,2019-11-27 00:00:00+03:00,out,False,958470,False,1,189,191,2
168091,2019-11-27 00:00:00+03:00,out,False,958430,True,4,0,151,151
168091,2019-11-27 00:00:00+03:00,in,False,958434,False,2,593,635,42
168091,2019-11-27 00:00:00+03:00,out,False,958452,False,22,2082,2367,285
168091,2019-11-27 00:00:00+03:00,out,True,958468,True,3,0,0,0
168091,2019-11-27 00:00:00+03:00,in,False,958430,False,3,1237,1276,39
168091,2019-11-27 00:00:00+03:00,out,False,958434,True,1,0,6,6
168091,2019-11-27 00:00:00+03:00,out,True,958440,True,1,0,1,1
168091,2019-11-27 00:00:00+03:00,out,False,958434,False,1,76,88,12
168091,2019-11-27 00:00:00+03:00,out,False,958456,False,65,4279,5315,1036
168091,2019-11-27 00:00:00+03:00,out,True,958434,False,4,589,609,20
168091,2019-11-27 00:00:00+03:00,out,True,958430,True,1,0,0,0
168091,2019-11-27 00:00:00+03:00,out,False,958460,False,4,241,299,58
168091,2019-11-27 00:00:00+03:00,out,False,958468,True,13,0,302,302
168091,2019-11-27 00:00:00+03:00,out,True,958432,False,3,370,388,18
168091,2019-11-27 00:00:00+03:00,out,False,958468,False,27,3300,3580,280
168091,2019-11-27 00:00:00+03:00,out,True,958672,False,2,41,51,10
168091,2019-11-27 00:00:00+03:00,out,True,958468,False,1,68,74,6
168091,2019-11-27 00:00:00+03:00,out,True,958452,False,3,458,468,10
168091,2019-11-27 00:00:00+03:00,in,False,958452,False,4,181,201,20
168091,2019-11-27 00:00:00+03:00,out,True,958460,False,2,37,50,13
168091,2019-11-27 00:00:00+03:00,out,True,958440,False,2,246,260,14
168091,2019-11-27 00:00:00+03:00,out,True,958444,False,1,34,49,15
168091,2019-11-27 00:00:00+03:00,out,False,958432,False,7,1506,1599,93
168091,2019-11-27 00:00:00+03:00,out,True,958430,False,4,707,729,22
168091,2019-11-27 00:00:00+03:00,out,False,958460,True,1,0,43,43
168091,2019-11-27 00:00:00+03:00,out,True,958454,False,1,15,22,7
168091,2019-11-27 00:00:00+03:00,out,False,958452,True,7,0,353,353
168091,2019-11-27 00:00:00+03:00,in,False,-1,True,16,0,476,476
168091,2019-11-27 00:00:00+03:00,in,False,958452,False,4,181,201,20
168091,2019-11-28 00:00:00+03:00,out,True,958452,True,2,0,17,17
168091,2019-11-28 00:00:00+03:00,out,True,958444,False,5,221,247,26
168091,2019-11-28 00:00:00+03:00,out,False,958468,False,24,2662,2927,265
168091,2019-11-28 00:00:00+03:00,out,True,958452,False,6,635,656,21
168091,2019-11-28 00:00:00+03:00,out,False,958430,False,8,1806,1904,98
168091,2019-11-28 00:00:00+03:00,out,False,958452,True,3,0,131,131
168091,2019-11-28 00:00:00+03:00,in,False,-1,True,14,0,542,542
168091,2019-11-28 00:00:00+03:00,out,False,958456,False,50,3504,4335,831
168091,2019-11-28 00:00:00+03:00,out,False,958430,True,3,0,16,16
168091,2019-11-28 00:00:00+03:00,in,False,958432,False,2,115,129,14
168091,2019-11-28 00:00:00+03:00,out,False,958440,False,1,36,45,9
168091,2019-11-28 00:00:00+03:00,out,True,958432,False,3,128,137,9
168091,2019-11-28 00:00:00+03:00,out,True,958672,True,1,0,9,9
168091,2019-11-28 00:00:00+03:00,out,False,958460,False,1,602,604,2
168091,2019-11-28 00:00:00+03:00,in,False,958460,False,6,246,548,302
168091,2019-11-28 00:00:00+03:00,in,False,958430,False,2,264,311,47
168091,2019-11-28 00:00:00+03:00,out,False,958432,True,2,0,64,64
168091,2019-11-28 00:00:00+03:00,out,True,958444,True,1,0,1,1
168091,2019-11-28 00:00:00+03:00,out,False,958456,True,30,0,871,871
168091,2019-11-28 00:00:00+03:00,in,False,958434,False,2,349,438,89
168091,2019-11-28 00:00:00+03:00,out,True,958440,True,2,0,0,0
168091,2019-11-28 00:00:00+03:00,out,True,958440,False,8,1177,1211,34
168091,2019-11-28 00:00:00+03:00,out,True,958430,False,8,676,752,76
168091,2019-11-28 00:00:00+03:00,out,True,958456,False,4,83,119,36
168091,2019-11-28 00:00:00+03:00,out,False,958452,False,13,1224,1352,128
168091,2019-11-28 00:00:00+03:00,out,False,958432,False,5,415,484,69
168091,2019-11-28 00:00:00+03:00,out,True,958672,False,3,80,91,11
168091,2019-11-28 00:00:00+03:00,out,True,958454,False,2,15,27,12
168091,2019-11-28 00:00:00+03:00,out,False,958468,True,11,0,405,405
168091,2019-11-28 00:00:00+03:00,out,False,958472,False,1,24,34,10
168091,2019-11-28 00:00:00+03:00,out,True,958460,False,4,103,136,33
168091,2019-11-28 00:00:00+03:00,out,False,958430,False,8,1806,1904,98
168091,2019-11-28 00:00:00+03:00,out,False,958430,True,3,0,16,16
168091,2019-11-28 00:00:00+03:00,out,True,958456,False,4,83,119,36
168093,2019-10-21 00:00:00+03:00,in,False,941390,False,1,65,70,5
168093,2019-10-21 00:00:00+03:00,out,False,941390,True,47,0,861,861
168093,2019-10-21 00:00:00+03:00,out,False,941390,False,58,1427,2547,1120
168093,2019-10-21 00:00:00+03:00,in,False,-1,True,5,0,14,14
168093,2019-10-22 00:00:00+03:00,out,False,941390,True,97,0,1497,1497
168093,2019-10-22 00:00:00+03:00,in,False,-1,True,8,0,17,17
168093,2019-10-22 00:00:00+03:00,out,False,941390,False,140,2772,4869,2097
168093,2019-10-24 00:00:00+03:00,in,False,-1,True,1,0,3,3
168093,2019-10-25 00:00:00+03:00,out,False,941390,False,20,1641,1754,113
168093,2019-10-25 00:00:00+03:00,out,False,941390,True,7,0,82,82
168093,2019-10-25 00:00:00+03:00,out,False,941390,True,7,0,82,82
168093,2019-10-26 00:00:00+03:00,in,False,-1,True,1,0,2,2
168093,2019-10-28 00:00:00+03:00,in,False,-1,True,1,0,2,2
168097,2019-10-14 00:00:00+03:00,in,False,-1,True,3,0,6,6
168097,2019-10-14 00:00:00+03:00,out,False,935246,True,1,0,2,2
168097,2019-10-15 00:00:00+03:00,out,False,935244,True,7,0,175,175
168097,2019-10-15 00:00:00+03:00,in,False,935244,False,2,57,95,38
168097,2019-10-15 00:00:00+03:00,out,False,935244,False,1,1956,1967,11
168097,2019-10-15 00:00:00+03:00,out,False,935246,True,2,0,11,11
168097,2019-10-15 00:00:00+03:00,in,False,-1,True,1,0,3,3
168097,2019-10-15 00:00:00+03:00,out,False,935246,True,2,0,11,11
168097,2019-10-16 00:00:00+03:00,out,False,935264,True,6,0,151,151
168097,2019-10-16 00:00:00+03:00,out,False,935244,False,4,225,314,89
168097,2019-10-16 00:00:00+03:00,out,False,935244,True,4,0,81,81
168097,2019-10-16 00:00:00+03:00,in,False,935264,False,3,69,90,21
168097,2019-10-16 00:00:00+03:00,in,False,935268,False,1,25,34,9
168097,2019-10-16 00:00:00+03:00,in,False,-1,True,1,0,5,5
168097,2019-10-16 00:00:00+03:00,out,False,935264,False,11,3116,3274,158
168097,2019-10-16 00:00:00+03:00,out,False,935264,False,11,3116,3274,158
168097,2019-10-17 00:00:00+03:00,out,False,935264,False,7,1254,1317,63
168097,2019-10-17 00:00:00+03:00,out,False,935244,False,9,1267,1381,114
168097,2019-10-17 00:00:00+03:00,out,False,935244,True,1,0,0,0
168097,2019-10-17 00:00:00+03:00,out,False,935264,True,3,0,0,0
168097,2019-10-17 00:00:00+03:00,in,False,935264,False,1,60,67,7
168097,2019-10-18 00:00:00+03:00,in,False,935268,False,2,59,80,21
168097,2019-10-18 00:00:00+03:00,out,False,935264,False,19,1489,1780,291
168097,2019-10-18 00:00:00+03:00,out,False,935264,True,9,0,220,220
168097,2019-10-18 00:00:00+03:00,out,False,935244,False,1,500,524,24
168097,2019-10-18 00:00:00+03:00,out,False,935244,False,1,500,524,24
168097,2019-10-19 00:00:00+03:00,in,False,-1,True,1,0,9,9
168097,2019-10-21 00:00:00+03:00,out,False,935246,False,1,77,90,13
168097,2019-10-21 00:00:00+03:00,in,False,935268,False,1,16,26,10
168097,2019-10-21 00:00:00+03:00,out,False,935246,False,1,77,90,13
168097,2019-10-23 00:00:00+03:00,in,False,-1,True,1,0,2,2
168097,2019-10-26 00:00:00+03:00,in,False,-1,True,1,0,2,2
168097,2019-10-27 00:00:00+03:00,in,False,-1,True,1,0,2,2
168097,2019-10-28 00:00:00+03:00,in,False,-1,True,2,0,4,4
168097,2019-10-29 00:00:00+03:00,in,False,-1,True,1,0,2,2
168097,2019-11-01 00:00:00+03:00,in,False,-1,True,2,0,4,4
168097,2019-11-05 00:00:00+03:00,in,False,-1,True,2,0,4,4
168097,2019-11-07 00:00:00+03:00,in,False,-1,True,3,0,6,6
168097,2019-11-08 00:00:00+03:00,in,False,-1,True,2,0,4,4
168097,2019-11-12 00:00:00+03:00,in,False,-1,True,4,0,173,173
168097,2019-11-13 00:00:00+03:00,in,False,935268,False,1,29,37,8
168101,2019-10-14 00:00:00+03:00,in,False,935548,False,1,17,26,9
168101,2019-10-14 00:00:00+03:00,in,False,-1,True,3,0,23,23
168101,2019-10-14 00:00:00+03:00,out,True,935548,True,1,0,8,8
168101,2019-10-14 00:00:00+03:00,out,True,935548,True,1,0,8,8
168101,2019-10-15 00:00:00+03:00,in,False,-1,True,1,0,6,6
168101,2019-10-16 00:00:00+03:00,in,False,-1,True,1,0,8,8
168101,2019-10-17 00:00:00+03:00,in,False,935548,False,3,278,302,24
168101,2019-10-23 00:00:00+03:00,out,False,935548,True,1,0,15,15
168101,2019-10-24 00:00:00+03:00,out,False,935548,False,1,10,22,12
168101,2019-10-24 00:00:00+03:00,in,False,-1,True,1,0,5,5
168101,2019-10-24 00:00:00+03:00,in,False,935548,False,3,164,193,29
168101,2019-10-24 00:00:00+03:00,in,False,-1,True,1,0,5,5
168101,2019-10-24 00:00:00+03:00,out,False,935548,False,1,10,22,12
168101,2019-10-25 00:00:00+03:00,in,False,935548,False,1,12,25,13
168101,2019-10-28 00:00:00+03:00,in,False,935548,False,1,283,296,13
168101,2019-11-01 00:00:00+03:00,in,False,935548,False,1,65,87,22
168101,2019-11-05 00:00:00+03:00,in,False,-1,True,1,0,32,32
168101,2019-11-10 00:00:00+03:00,in,False,-1,True,1,0,31,31
168101,2019-11-11 00:00:00+03:00,in,False,935548,False,2,133,153,20
168101,2019-11-13 00:00:00+03:00,in,False,-1,True,1,0,32,32
168101,2019-11-15 00:00:00+03:00,in,False,-1,True,1,0,14,14
168101,2019-11-19 00:00:00+03:00,in,False,935548,False,1,48,69,21
168101,2019-11-21 00:00:00+03:00,in,False,935548,False,1,83,91,8
168101,2019-11-25 00:00:00+03:00,in,False,935548,False,1,36,46,10
168101,2019-11-26 00:00:00+03:00,in,False,935548,False,3,251,278,27
168101,2019-11-28 00:00:00+03:00,in,False,935548,False,1,34,45,11
168105,2019-10-15 00:00:00+03:00,in,False,936984,False,2,193,239,46
168105,2019-10-15 00:00:00+03:00,in,False,-1,True,2,0,32,32
168105,2019-10-16 00:00:00+03:00,in,False,936984,False,1,35,44,9
168105,2019-10-17 00:00:00+03:00,in,False,936984,False,1,117,136,19
168105,2019-10-18 00:00:00+03:00,in,False,936984,False,1,93,128,35
168105,2019-10-23 00:00:00+03:00,in,False,-1,True,1,0,41,41
168105,2019-10-23 00:00:00+03:00,in,False,936984,False,1,149,177,28
168105,2019-10-23 00:00:00+03:00,in,False,936984,False,1,149,177,28
168105,2019-10-25 00:00:00+03:00,in,False,-1,True,1,0,13,13
168105,2019-10-25 00:00:00+03:00,in,False,-1,True,1,0,13,13
168105,2019-10-26 00:00:00+03:00,in,False,936984,False,1,110,133,23
168105,2019-10-27 00:00:00+03:00,in,False,-1,True,2,0,55,55
168105,2019-10-28 00:00:00+03:00,in,False,-1,True,4,0,121,121
168105,2019-10-28 00:00:00+03:00,in,False,936984,False,1,48,74,26
168105,2019-10-28 00:00:00+03:00,in,False,936984,False,1,48,74,26
168105,2019-10-29 00:00:00+03:00,in,False,-1,True,3,0,62,62
168105,2019-10-30 00:00:00+03:00,in,False,-1,True,4,0,56,56
168105,2019-10-30 00:00:00+03:00,in,False,951118,False,1,10,26,16
168105,2019-10-30 00:00:00+03:00,in,False,936984,False,5,132,198,66
168105,2019-10-30 00:00:00+03:00,in,False,-1,True,4,0,56,56
168105,2019-10-31 00:00:00+03:00,in,False,936984,False,2,248,271,23
168105,2019-11-01 00:00:00+03:00,in,False,-1,True,1,0,31,31
168105,2019-11-02 00:00:00+03:00,in,False,936984,False,5,664,730,66
168105,2019-11-03 00:00:00+03:00,in,False,936984,False,2,142,170,28
168105,2019-11-05 00:00:00+03:00,in,False,936984,False,3,324,359,35
168105,2019-11-06 00:00:00+03:00,in,False,936984,False,3,119,156,37
168105,2019-11-06 00:00:00+03:00,in,False,-1,True,1,0,11,11
168105,2019-11-06 00:00:00+03:00,in,False,936984,False,3,119,156,37
168105,2019-11-07 00:00:00+03:00,in,False,936984,False,4,229,286,57
168105,2019-11-07 00:00:00+03:00,in,False,-1,True,1,0,12,12
168105,2019-11-07 00:00:00+03:00,in,False,-1,True,1,0,12,12
168105,2019-11-08 00:00:00+03:00,in,False,-1,True,1,0,62,62
168105,2019-11-08 00:00:00+03:00,in,False,936984,False,1,134,144,10
168105,2019-11-09 00:00:00+03:00,in,False,936984,False,2,53,77,24
168105,2019-11-10 00:00:00+03:00,in,False,936984,False,1,68,85,17
168105,2019-11-12 00:00:00+03:00,in,False,936984,False,1,90,101,11
168105,2019-11-13 00:00:00+03:00,in,False,-1,True,1,0,14,14
168105,2019-11-13 00:00:00+03:00,in,False,936984,False,1,159,177,18
168105,2019-11-14 00:00:00+03:00,in,False,936984,False,1,492,505,13
168105,2019-11-14 00:00:00+03:00,in,False,-1,True,2,0,18,18
168105,2019-11-16 00:00:00+03:00,in,False,-1,True,2,0,18,18
168105,2019-11-16 00:00:00+03:00,in,False,936984,False,2,29,53,24
168105,2019-11-18 00:00:00+03:00,in,False,936984,False,1,21,31,10
168105,2019-11-18 00:00:00+03:00,in,False,951118,False,1,56,96,40
168105,2019-11-19 00:00:00+03:00,in,False,936984,False,1,125,139,14
168105,2019-11-20 00:00:00+03:00,in,False,936984,False,2,283,307,24
168105,2019-11-21 00:00:00+03:00,in,False,936984,False,5,402,480,78
168105,2019-11-22 00:00:00+03:00,in,False,-1,True,1,0,6,6
168105,2019-11-22 00:00:00+03:00,in,False,936984,False,1,65,80,15
168105,2019-11-23 00:00:00+03:00,in,False,-1,True,1,0,7,7
168105,2019-11-23 00:00:00+03:00,in,False,936984,False,3,311,341,30
168105,2019-11-24 00:00:00+03:00,in,False,951118,False,1,144,199,55
168105,2019-11-24 00:00:00+03:00,in,False,936984,False,3,461,494,33
168105,2019-11-24 00:00:00+03:00,in,False,-1,True,1,0,11,11
168105,2019-11-25 00:00:00+03:00,out,False,970484,True,4,0,25,25
168105,2019-11-25 00:00:00+03:00,in,False,936984,False,4,126,169,43
168105,2019-11-25 00:00:00+03:00,out,False,970484,False,2,75,91,16
168105,2019-11-25 00:00:00+03:00,in,False,-1,True,1,0,42,42
168105,2019-11-25 00:00:00+03:00,out,False,970486,True,1,0,2,2
168105,2019-11-25 00:00:00+03:00,out,False,970486,False,1,27,38,11
168105,2019-11-26 00:00:00+03:00,out,False,970486,True,1,0,9,9
168105,2019-11-26 00:00:00+03:00,in,False,936984,False,4,645,685,40
168105,2019-11-26 00:00:00+03:00,out,False,970486,False,3,273,307,34
168105,2019-11-26 00:00:00+03:00,out,False,970484,True,1,0,1,1
168105,2019-11-27 00:00:00+03:00,in,False,951118,False,1,48,67,19
168105,2019-11-27 00:00:00+03:00,in,False,936984,False,1,73,89,16
168105,2019-11-28 00:00:00+03:00,in,False,936984,False,4,683,733,50
168110,2019-10-16 00:00:00+03:00,in,False,-1,True,1,0,64,64
168110,2019-10-24 00:00:00+03:00,in,False,938432,False,1,9,22,13
168110,2019-10-29 00:00:00+03:00,in,False,938432,False,1,50,71,21
168110,2019-10-31 00:00:00+03:00,in,False,-1,True,1,0,10,10
168110,2019-11-07 00:00:00+03:00,in,False,938432,False,4,1137,1230,93
168110,2019-11-08 00:00:00+03:00,in,False,-1,True,1,0,60,60
168110,2019-11-08 00:00:00+03:00,in,False,938432,False,1,62,78,16
168110,2019-11-08 00:00:00+03:00,in,False,938432,False,1,62,78,16
168110,2019-11-11 00:00:00+03:00,in,False,-1,True,4,0,98,98
168110,2019-11-11 00:00:00+03:00,in,False,938432,False,1,32,49,17
168110,2019-11-12 00:00:00+03:00,in,False,938432,False,1,45,69,24
168121,2019-10-18 00:00:00+03:00,out,True,940486,False,5,118,140,22
168121,2019-10-18 00:00:00+03:00,out,False,940486,False,3,285,362,77
168121,2019-10-18 00:00:00+03:00,in,False,940458,False,1,13,62,49
168121,2019-10-18 00:00:00+03:00,out,False,940456,True,6,0,0,0
168121,2019-10-18 00:00:00+03:00,in,False,940456,False,2,47,69,22
168121,2019-10-18 00:00:00+03:00,out,True,940458,True,1,0,12,12
168121,2019-10-18 00:00:00+03:00,in,False,-1,True,2,0,3,3
168121,2019-10-18 00:00:00+03:00,out,True,940486,True,1,0,5,5
168121,2019-10-18 00:00:00+03:00,out,False,940486,True,12,0,127,127
168121,2019-10-18 00:00:00+03:00,out,False,940458,True,8,0,41,41
168121,2019-10-19 00:00:00+03:00,out,False,940460,True,2,0,21,21
168121,2019-10-19 00:00:00+03:00,out,False,940460,False,1,7,27,20
168121,2019-10-20 00:00:00+03:00,in,False,940456,False,2,215,230,15
168121,2019-10-20 00:00:00+03:00,out,False,940456,False,1,20,37,17
168121,2019-10-21 00:00:00+03:00,in,False,940458,False,1,4,11,7
168121,2019-10-21 00:00:00+03:00,out,True,940474,True,2,0,33,33
168121,2019-10-21 00:00:00+03:00,out,False,940458,False,1,219,221,2
168121,2019-10-21 00:00:00+03:00,out,False,940456,False,1,4,6,2
168121,2019-10-21 00:00:00+03:00,out,False,940456,True,3,0,40,40
168121,2019-10-21 00:00:00+03:00,out,True,940460,False,1,5,8,3
168121,2019-10-21 00:00:00+03:00,out,True,940460,True,1,0,4,4
168121,2019-10-21 00:00:00+03:00,out,False,940460,False,1,163,178,15
168121,2019-10-21 00:00:00+03:00,out,True,940474,False,1,15,18,3
168121,2019-10-22 00:00:00+03:00,out,False,940458,True,1,0,38,38
168121,2019-10-22 00:00:00+03:00,out,False,940460,False,3,336,343,7
168121,2019-10-22 00:00:00+03:00,out,False,940458,False,2,474,477,3
168121,2019-10-22 00:00:00+03:00,in,False,940458,False,1,8,57,49
168121,2019-10-22 00:00:00+03:00,out,False,940456,True,1,0,11,11
168121,2019-10-22 00:00:00+03:00,out,False,940460,True,1,0,0,0
168121,2019-10-23 00:00:00+03:00,out,False,940456,True,1,0,12,12
168121,2019-10-23 00:00:00+03:00,out,False,940460,False,2,506,514,8
168121,2019-10-23 00:00:00+03:00,out,False,940458,False,4,1123,1135,12
168121,2019-10-23 00:00:00+03:00,out,False,940458,False,4,1123,1135,12
168121,2019-10-24 00:00:00+03:00,out,False,940460,False,1,258,260,2
168121,2019-10-24 00:00:00+03:00,out,False,940458,False,1,307,310,3
168121,2019-10-24 00:00:00+03:00,out,True,940474,True,3,0,7,7
168121,2019-10-25 00:00:00+03:00,in,False,-1,True,2,0,12,12
168121,2019-10-26 00:00:00+03:00,out,True,940474,False,1,104,114,10
168121,2019-10-26 00:00:00+03:00,in,False,-1,True,1,0,6,6
168121,2019-10-26 00:00:00+03:00,out,True,940474,True,4,0,4,4
168121,2019-10-26 00:00:00+03:00,in,False,-1,True,1,0,14,14
168121,2019-10-28 00:00:00+03:00,in,False,940456,False,1,22,39,17
168121,2019-10-28 00:00:00+03:00,in,False,940458,False,1,25,39,14
168121,2019-10-28 00:00:00+03:00,out,True,940456,False,1,3,20,17
168121,2019-10-28 00:00:00+03:00,out,False,940474,False,1,68,89,21
168121,2019-10-28 00:00:00+03:00,out,False,940458,False,1,96,97,1
168121,2019-10-28 00:00:00+03:00,out,False,940486,False,1,448,458,10
168121,2019-10-29 00:00:00+03:00,out,False,940456,True,1,0,12,12
168121,2019-10-30 00:00:00+03:00,out,False,940460,False,7,3136,3164,28
168121,2019-10-30 00:00:00+03:00,in,False,940458,False,3,238,341,103
168121,2019-10-30 00:00:00+03:00,in,True,940458,False,1,28,62,34
168121,2019-10-30 00:00:00+03:00,out,True,940460,True,1,0,24,24
168121,2019-10-30 00:00:00+03:00,out,False,940486,False,1,103,105,2
168121,2019-10-30 00:00:00+03:00,in,False,-1,True,2,0,12,12
168121,2019-10-30 00:00:00+03:00,out,False,940456,True,1,0,1,1
168121,2019-10-30 00:00:00+03:00,out,True,940458,True,5,0,24,24
168121,2019-10-31 00:00:00+03:00,out,False,940458,False,1,9,27,18
168121,2019-10-31 00:00:00+03:00,out,False,940460,True,1,0,60,60
168121,2019-10-31 00:00:00+03:00,in,False,-1,True,1,0,7,7
168121,2019-10-31 00:00:00+03:00,out,False,940460,False,1,79,96,17
168121,2019-11-01 00:00:00+03:00,in,False,940458,False,1,2,8,6
168121,2019-11-01 00:00:00+03:00,in,False,-1,True,1,0,5,5
168121,2019-11-02 00:00:00+03:00,in,False,-1,True,1,0,4,4
168121,2019-11-03 00:00:00+03:00,in,False,940458,False,1,132,181,49
168121,2019-11-04 00:00:00+03:00,out,True,940474,True,2,0,0,0
168121,2019-11-05 00:00:00+03:00,out,False,940460,True,2,0,6,6
168121,2019-11-05 00:00:00+03:00,out,False,940460,False,4,684,714,30
168121,2019-11-05 00:00:00+03:00,out,False,940458,False,4,1637,1651,14
168121,2019-11-05 00:00:00+03:00,in,False,-1,True,3,0,81,81
168121,2019-11-05 00:00:00+03:00,in,False,940458,False,1,49,83,34
168121,2019-11-05 00:00:00+03:00,in,False,940512,False,1,1,20,19
168121,2019-11-05 00:00:00+03:00,out,False,940460,True,2,0,6,6
168121,2019-11-06 00:00:00+03:00,out,False,940460,True,18,0,357,357
168121,2019-11-06 00:00:00+03:00,in,True,940508,False,1,80,121,41
168121,2019-11-06 00:00:00+03:00,in,False,940508,False,1,68,110,42
168121,2019-11-06 00:00:00+03:00,in,False,-1,True,3,0,32,32
168121,2019-11-06 00:00:00+03:00,out,False,940460,False,3,227,248,21
168121,2019-11-07 00:00:00+03:00,out,False,940460,False,1,240,244,4
168121,2019-11-07 00:00:00+03:00,out,False,940474,False,1,227,233,6
168121,2019-11-07 00:00:00+03:00,in,False,-1,True,2,0,37,37
168121,2019-11-07 00:00:00+03:00,out,False,940458,False,4,98,156,58
168121,2019-11-07 00:00:00+03:00,out,False,940458,True,1,0,56,56
168121,2019-11-07 00:00:00+03:00,in,False,940458,False,1,536,570,34
168121,2019-11-07 00:00:00+03:00,in,False,-1,True,2,0,37,37
168121,2019-11-08 00:00:00+03:00,out,False,940474,False,1,144,145,1
168121,2019-11-08 00:00:00+03:00,out,False,940460,False,1,714,716,2
168121,2019-11-08 00:00:00+03:00,out,True,940456,False,2,273,294,21
168121,2019-11-08 00:00:00+03:00,out,False,940458,False,2,1176,1179,3
168121,2019-11-08 00:00:00+03:00,in,False,940456,False,3,387,412,25
168121,2019-11-08 00:00:00+03:00,out,False,940460,False,1,714,716,2
168121,2019-11-09 00:00:00+03:00,out,False,940456,True,1,0,1,1
168121,2019-11-09 00:00:00+03:00,in,False,-1,True,1,0,5,5
168121,2019-11-09 00:00:00+03:00,out,False,940456,True,1,0,1,1
168121,2019-11-10 00:00:00+03:00,in,False,-1,True,1,0,2,2
168121,2019-11-11 00:00:00+03:00,out,False,940474,False,1,32,47,15
168121,2019-11-12 00:00:00+03:00,out,False,940458,False,2,260,291,31
168121,2019-11-12 00:00:00+03:00,in,False,940458,False,1,27,78,51
168121,2019-11-12 00:00:00+03:00,in,False,-1,True,2,0,74,74
168121,2019-11-12 00:00:00+03:00,out,False,940474,False,2,59,84,25
168121,2019-11-12 00:00:00+03:00,out,False,940460,True,1,0,5,5
168121,2019-11-12 00:00:00+03:00,out,False,940460,False,9,4239,4284,45
168121,2019-11-12 00:00:00+03:00,in,False,-1,True,2,0,74,74
168121,2019-11-13 00:00:00+03:00,out,False,940458,False,4,22,61,39
168121,2019-11-13 00:00:00+03:00,in,False,940458,False,1,1,43,42
168121,2019-11-13 00:00:00+03:00,in,False,-1,True,2,0,49,49
168121,2019-11-13 00:00:00+03:00,in,True,940458,False,2,35,117,82
168121,2019-11-13 00:00:00+03:00,out,False,940460,False,12,5540,5628,88
168121,2019-11-13 00:00:00+03:00,in,False,940458,False,1,1,43,42
168121,2019-11-14 00:00:00+03:00,out,False,940460,False,2,538,547,9
168121,2019-11-14 00:00:00+03:00,out,True,940460,True,1,0,0,0
168121,2019-11-14 00:00:00+03:00,out,True,940460,True,1,0,0,0
168121,2019-11-15 00:00:00+03:00,in,False,940514,False,1,6,17,11
168121,2019-11-15 00:00:00+03:00,in,False,-1,True,1,0,5,5
168121,2019-11-15 00:00:00+03:00,out,False,940458,False,4,359,385,26
168121,2019-11-16 00:00:00+03:00,in,False,940458,False,1,16,35,19
168121,2019-11-17 00:00:00+03:00,in,False,940458,False,2,61,83,22
168121,2019-11-18 00:00:00+03:00,out,False,940458,False,2,87,108,21
168121,2019-11-18 00:00:00+03:00,in,False,-1,True,1,0,5,5
168121,2019-11-18 00:00:00+03:00,in,False,940456,False,2,12,42,30
168121,2019-11-18 00:00:00+03:00,out,True,940456,True,1,0,4,4
168121,2019-11-19 00:00:00+03:00,out,True,940456,False,3,152,160,8
168121,2019-11-19 00:00:00+03:00,out,False,940474,True,4,0,40,40
168121,2019-11-19 00:00:00+03:00,out,False,940460,False,1,435,437,2
168121,2019-11-19 00:00:00+03:00,in,False,940456,False,3,174,204,30
168121,2019-11-19 00:00:00+03:00,out,False,940474,True,4,0,40,40
168121,2019-11-20 00:00:00+03:00,out,False,940474,True,1,0,6,6
168121,2019-11-20 00:00:00+03:00,out,True,940456,False,1,3,6,3
168121,2019-11-20 00:00:00+03:00,out,False,940458,False,4,1228,1245,17
168121,2019-11-20 00:00:00+03:00,in,False,940458,False,1,123,158,35
168121,2019-11-20 00:00:00+03:00,in,False,940456,False,1,10,13,3
168121,2019-11-20 00:00:00+03:00,in,False,940458,False,1,123,158,35
168121,2019-11-21 00:00:00+03:00,out,False,940458,True,1,0,34,34
168121,2019-11-21 00:00:00+03:00,in,False,940458,False,1,48,85,37
168121,2019-11-21 00:00:00+03:00,out,False,940460,False,1,26,38,12
168121,2019-11-21 00:00:00+03:00,out,True,940456,False,1,6,12,6
168121,2019-11-21 00:00:00+03:00,in,False,940456,False,2,162,180,18
168121,2019-11-21 00:00:00+03:00,out,False,940458,False,7,343,437,94
168121,2019-11-22 00:00:00+03:00,out,False,940460,False,1,149,160,11
168121,2019-11-22 00:00:00+03:00,out,True,940456,False,2,9,15,6
168121,2019-11-22 00:00:00+03:00,in,False,940456,False,3,22,40,18
168121,2019-11-22 00:00:00+03:00,out,False,940456,True,1,0,22,22
168121,2019-11-22 00:00:00+03:00,out,False,940456,False,1,17,24,7
168121,2019-11-22 00:00:00+03:00,out,False,940458,False,3,760,787,27
168121,2019-11-22 00:00:00+03:00,out,False,940458,True,1,0,60,60
168121,2019-11-22 00:00:00+03:00,in,False,-1,True,1,0,1,1
168121,2019-11-23 00:00:00+03:00,in,False,940456,False,1,3,6,3
168121,2019-11-23 00:00:00+03:00,out,False,940460,False,1,89,105,16
168121,2019-11-25 00:00:00+03:00,in,False,940456,False,1,26,37,11
168121,2019-11-25 00:00:00+03:00,in,False,940458,False,1,122,133,11
168121,2019-11-25 00:00:00+03:00,out,True,940456,False,1,20,22,2
168121,2019-11-26 00:00:00+03:00,out,False,940458,False,2,836,844,8
168121,2019-11-26 00:00:00+03:00,in,True,940456,False,1,1,6,5
168121,2019-11-26 00:00:00+03:00,out,True,940456,True,1,0,0,0
168121,2019-11-26 00:00:00+03:00,out,False,940474,False,1,121,135,14
168121,2019-11-26 00:00:00+03:00,in,False,940456,False,1,1,4,3
168121,2019-11-26 00:00:00+03:00,out,False,940474,True,1,0,12,12
168121,2019-11-27 00:00:00+03:00,in,False,940456,False,1,3,8,5
168121,2019-11-27 00:00:00+03:00,in,False,940458,False,1,38,77,39
168121,2019-11-27 00:00:00+03:00,in,False,940458,False,1,38,77,39
168121,2019-11-28 00:00:00+03:00,in,False,940456,False,2,119,128,9
168121,2019-11-28 00:00:00+03:00,out,True,940456,False,1,115,116,1
168121,2019-11-28 00:00:00+03:00,in,False,-1,True,1,0,27,27
168121,2019-11-28 00:00:00+03:00,out,False,940460,False,1,197,199,2
168128,2019-10-16 00:00:00+03:00,in,False,-1,True,2,0,4,4
168128,2019-10-16 00:00:00+03:00,out,False,937650,True,4,0,54,54
168128,2019-10-17 00:00:00+03:00,out,False,937650,True,35,0,938,938
168128,2019-10-17 00:00:00+03:00,in,False,-1,True,23,0,46,46
168128,2019-10-17 00:00:00+03:00,out,False,937650,False,44,2047,2698,651
168128,2019-10-18 00:00:00+03:00,out,False,937650,True,1,0,6,6
168128,2019-10-18 00:00:00+03:00,in,False,-1,True,1,0,2,2
168128,2019-10-18 00:00:00+03:00,in,False,-1,True,1,0,2,2
168128,2019-10-26 00:00:00+03:00,in,False,-1,True,1,0,2,2
168128,2019-10-31 00:00:00+03:00,out,False,937650,True,6,0,6,6
168128,2019-10-31 00:00:00+03:00,in,False,-1,True,1,0,2,2
168128,2019-11-07 00:00:00+03:00,out,False,937650,True,1,0,8,8
168128,2019-11-08 00:00:00+03:00,in,False,-1,True,2,0,4,4
168128,2019-11-12 00:00:00+03:00,in,False,-1,True,1,0,2,2
168128,2019-11-13 00:00:00+03:00,in,False,-1,True,2,0,5,5
168128,2019-11-26 00:00:00+03:00,in,False,-1,True,1,0,2,2
168128,2019-11-26 00:00:00+03:00,in,False,-1,True,1,0,2,2
168154,2019-10-17 00:00:00+03:00,out,False,939370,True,3,0,48,48
168154,2019-10-17 00:00:00+03:00,out,False,939376,False,1,164,174,10
168154,2019-10-17 00:00:00+03:00,in,False,939376,False,1,85,100,15
168154,2019-10-17 00:00:00+03:00,out,False,939370,False,1,118,122,4
168154,2019-10-17 00:00:00+03:00,in,False,939370,False,2,31,57,26
168154,2019-10-17 00:00:00+03:00,out,False,939376,True,1,0,16,16
168154,2019-10-17 00:00:00+03:00,in,False,-1,True,2,0,42,42
168154,2019-10-17 00:00:00+03:00,in,False,-1,True,2,0,42,42
168154,2019-10-18 00:00:00+03:00,out,False,939376,True,12,0,321,321
168154,2019-10-18 00:00:00+03:00,out,False,939376,False,29,1755,2193,438
168154,2019-10-18 00:00:00+03:00,out,False,939370,True,3,0,37,37
168154,2019-10-18 00:00:00+03:00,out,False,939370,False,6,1432,1515,83
168154,2019-10-18 00:00:00+03:00,in,False,-1,True,34,0,1339,1339
168154,2019-10-18 00:00:00+03:00,in,False,939370,False,22,3098,3519,421
168154,2019-10-18 00:00:00+03:00,in,False,939376,False,17,3535,3784,249
168154,2019-10-18 00:00:00+03:00,out,False,939370,False,6,1432,1515,83
168154,2019-10-19 00:00:00+03:00,in,False,939370,False,5,53,261,208
168154,2019-10-19 00:00:00+03:00,out,False,939376,True,3,0,110,110
168154,2019-10-19 00:00:00+03:00,in,False,-1,True,20,0,689,689
168154,2019-10-19 00:00:00+03:00,in,False,939376,False,1,32,46,14
168154,2019-10-19 00:00:00+03:00,out,False,939376,False,5,92,241,149
168154,2019-10-20 00:00:00+03:00,in,False,939370,False,2,28,90,62
168154,2019-10-20 00:00:00+03:00,in,False,-1,True,13,0,437,437
168154,2019-10-21 00:00:00+03:00,out,False,939376,False,6,1043,1134,91
168154,2019-10-21 00:00:00+03:00,in,False,939376,False,10,4005,4229,224
168154,2019-10-21 00:00:00+03:00,in,False,939370,True,1,0,43,43
168154,2019-10-21 00:00:00+03:00,in,False,-1,True,43,0,1197,1197
168154,2019-10-21 00:00:00+03:00,out,False,939376,True,3,0,80,80
168154,2019-10-21 00:00:00+03:00,in,False,939370,False,30,4051,4834,783
168154,2019-10-22 00:00:00+03:00,out,False,939376,False,4,264,327,63
168154,2019-10-22 00:00:00+03:00,in,False,-1,True,13,0,284,284
168154,2019-10-22 00:00:00+03:00,in,False,939370,False,42,9860,10538,678
168154,2019-10-22 00:00:00+03:00,out,False,939370,False,4,323,384,61
168154,2019-10-22 00:00:00+03:00,out,False,939370,True,1,0,8,8
168154,2019-10-23 00:00:00+03:00,out,False,939376,True,1,0,60,60
168154,2019-10-23 00:00:00+03:00,in,False,939376,False,15,3875,4054,179
168154,2019-10-23 00:00:00+03:00,in,False,-1,True,8,0,119,119
168154,2019-10-23 00:00:00+03:00,in,False,939370,False,10,1077,1360,283
168154,2019-10-23 00:00:00+03:00,out,False,939376,False,3,807,834,27
168154,2019-10-24 00:00:00+03:00,in,False,939370,False,6,303,405,102
168154,2019-10-24 00:00:00+03:00,in,False,-1,True,6,0,173,173
168154,2019-10-24 00:00:00+03:00,in,False,939370,True,1,1,42,41
168154,2019-10-24 00:00:00+03:00,in,False,939376,False,17,5324,5507,183
168154,2019-10-24 00:00:00+03:00,out,False,939376,False,5,1498,1576,78
168154,2019-10-24 00:00:00+03:00,out,False,939376,False,5,1498,1576,78
168154,2019-10-25 00:00:00+03:00,in,False,-1,True,4,0,63,63
168154,2019-10-25 00:00:00+03:00,out,False,939376,True,20,0,569,569
168154,2019-10-25 00:00:00+03:00,in,False,939370,False,5,1117,1239,122
168154,2019-10-25 00:00:00+03:00,out,False,939376,False,33,4392,4937,545
168154,2019-10-25 00:00:00+03:00,in,False,939376,False,7,2134,2221,87
168154,2019-10-25 00:00:00+03:00,in,False,-1,True,4,0,63,63
168154,2019-10-26 00:00:00+03:00,out,False,939376,False,2,916,955,39
168154,2019-10-26 00:00:00+03:00,in,False,939370,False,2,49,72,23
168154,2019-10-26 00:00:00+03:00,in,False,-1,True,6,0,144,144
168154,2019-10-26 00:00:00+03:00,out,False,939376,True,4,0,174,174
168154,2019-10-27 00:00:00+03:00,in,False,-1,True,5,0,110,110
168154,2019-10-27 00:00:00+03:00,in,False,939370,False,1,27,40,13
168154,2019-10-28 00:00:00+03:00,in,False,-1,True,5,0,128,128
168154,2019-10-28 00:00:00+03:00,out,False,939376,True,2,0,55,55
168154,2019-10-28 00:00:00+03:00,out,False,939376,False,12,4021,4184,163
168154,2019-10-28 00:00:00+03:00,in,False,939376,False,9,2758,2871,113
168154,2019-10-28 00:00:00+03:00,in,False,939370,False,7,563,742,179
168154,2019-10-29 00:00:00+03:00,in,False,939370,False,13,1217,1434,217
168154,2019-10-29 00:00:00+03:00,out,False,939376,True,5,0,135,135
168154,2019-10-29 00:00:00+03:00,in,False,-1,True,7,0,179,179
168154,2019-10-29 00:00:00+03:00,in,False,939376,False,20,5096,5314,218
168154,2019-10-29 00:00:00+03:00,out,False,939376,False,11,2384,2592,208
168154,2019-10-30 00:00:00+03:00,out,False,939376,True,9,0,261,261
168154,2019-10-30 00:00:00+03:00,in,False,939370,False,7,899,1065,166
168154,2019-10-30 00:00:00+03:00,out,False,939376,False,11,2709,2863,154
168154,2019-10-30 00:00:00+03:00,in,False,-1,True,12,0,276,276
168154,2019-10-30 00:00:00+03:00,in,False,939376,False,14,3017,3229,212
168154,2019-10-31 00:00:00+03:00,in,False,939370,False,8,1862,2005,143
168154,2019-10-31 00:00:00+03:00,out,False,939376,False,10,3802,3938,136
168154,2019-10-31 00:00:00+03:00,in,False,-1,True,8,0,176,176
168154,2019-10-31 00:00:00+03:00,out,False,939376,True,3,0,43,43
168154,2019-10-31 00:00:00+03:00,in,False,939376,False,8,1997,2117,120
168154,2019-11-01 00:00:00+03:00,out,False,939376,False,24,2015,2428,413
168154,2019-11-01 00:00:00+03:00,in,False,-1,True,10,0,280,280
168154,2019-11-01 00:00:00+03:00,in,False,939370,False,10,768,929,161
168154,2019-11-01 00:00:00+03:00,in,False,939376,False,2,335,355,20
168154,2019-11-01 00:00:00+03:00,out,False,939376,True,9,0,324,324
168154,2019-11-01 00:00:00+03:00,in,False,-1,True,10,0,280,280
168154,2019-11-02 00:00:00+03:00,in,False,939370,False,2,25,39,14
168154,2019-11-02 00:00:00+03:00,in,False,-1,True,8,0,206,206
168154,2019-11-03 00:00:00+03:00,in,False,-1,True,3,0,84,84
168154,2019-11-03 00:00:00+03:00,in,False,939370,False,1,40,59,19
168154,2019-11-03 00:00:00+03:00,in,False,939370,False,1,40,59,19
168154,2019-11-04 00:00:00+03:00,in,False,939370,False,9,1354,1469,115
168154,2019-11-04 00:00:00+03:00,in,False,-1,True,3,0,61,61
168154,2019-11-05 00:00:00+03:00,in,False,939370,False,15,1558,1873,315
168154,2019-11-05 00:00:00+03:00,in,False,939376,False,15,4987,5164,177
168154,2019-11-05 00:00:00+03:00,in,False,-1,True,16,0,378,378
168154,2019-11-05 00:00:00+03:00,out,False,939376,True,11,0,284,284
168154,2019-11-05 00:00:00+03:00,out,False,939376,False,8,1623,1750,127
168154,2019-11-06 00:00:00+03:00,out,False,939376,False,12,2350,2591,241
168154,2019-11-06 00:00:00+03:00,in,False,939370,False,8,1656,1777,121
168154,2019-11-06 00:00:00+03:00,in,False,-1,True,15,0,273,273
168154,2019-11-06 00:00:00+03:00,in,False,939376,False,14,3642,3843,201
168154,2019-11-06 00:00:00+03:00,in,False,939370,True,1,1,31,30
168154,2019-11-06 00:00:00+03:00,out,False,939376,True,5,0,181,181
168154,2019-11-06 00:00:00+03:00,out,False,939376,True,5,0,181,181
168154,2019-11-07 00:00:00+03:00,in,False,939370,False,10,1135,1314,179
168154,2019-11-07 00:00:00+03:00,in,False,939376,False,12,3527,3686,159
168154,2019-11-07 00:00:00+03:00,in,False,-1,True,14,0,351,351
168154,2019-11-07 00:00:00+03:00,out,False,939376,False,5,644,703,59
168154,2019-11-08 00:00:00+03:00,in,False,939370,False,12,1565,1753,188
168154,2019-11-08 00:00:00+03:00,out,False,939376,False,3,318,357,39
168154,2019-11-08 00:00:00+03:00,out,False,939376,True,1,0,13,13
168154,2019-11-08 00:00:00+03:00,in,False,939376,False,1,116,125,9
168154,2019-11-08 00:00:00+03:00,in,False,-1,True,6,0,163,163
168154,2019-11-08 00:00:00+03:00,in,False,-1,True,6,0,163,163
168154,2019-11-09 00:00:00+03:00,in,False,-1,True,4,0,80,80
168154,2019-11-09 00:00:00+03:00,in,False,939370,False,5,96,170,74
168154,2019-11-10 00:00:00+03:00,in,False,939370,False,1,8,11,3
168154,2019-11-10 00:00:00+03:00,in,False,-1,True,5,0,75,75
168154,2019-11-10 00:00:00+03:00,in,False,-1,True,5,0,75,75
168154,2019-11-11 00:00:00+03:00,in,False,-1,True,27,0,654,654
168154,2019-11-11 00:00:00+03:00,out,False,939376,True,8,0,127,127
168154,2019-11-11 00:00:00+03:00,out,False,939376,False,18,5148,5463,315
168154,2019-11-11 00:00:00+03:00,in,False,939376,False,7,2212,2292,80
168154,2019-11-11 00:00:00+03:00,in,False,939370,False,15,1256,1569,313
168154,2019-11-11 00:00:00+03:00,out,False,939376,True,8,0,127,127
168154,2019-11-12 00:00:00+03:00,out,False,939376,True,19,0,354,354
168154,2019-11-12 00:00:00+03:00,in,False,-1,True,37,0,1467,1467
168154,2019-11-12 00:00:00+03:00,out,False,939370,True,28,0,668,668
168154,2019-11-12 00:00:00+03:00,out,False,939376,False,32,6931,7428,497
168154,2019-11-12 00:00:00+03:00,in,False,939370,False,18,5195,5433,238
168154,2019-11-12 00:00:00+03:00,in,False,939376,False,9,2185,2458,273
168154,2019-11-12 00:00:00+03:00,out,False,939370,False,46,9329,10095,766
168154,2019-11-13 00:00:00+03:00,in,False,939370,False,20,3321,3804,483
168154,2019-11-13 00:00:00+03:00,out,False,939376,True,21,0,459,459
168154,2019-11-13 00:00:00+03:00,in,False,-1,True,52,0,1692,1692
168154,2019-11-13 00:00:00+03:00,out,False,939370,True,4,0,128,128
168154,2019-11-13 00:00:00+03:00,in,False,939376,False,13,5867,6061,194
168154,2019-11-13 00:00:00+03:00,out,False,939370,False,23,6298,6700,402
168154,2019-11-13 00:00:00+03:00,out,False,939376,False,56,7560,8509,949
168154,2019-11-14 00:00:00+03:00,out,False,939370,True,4,0,130,130
168154,2019-11-14 00:00:00+03:00,out,False,939376,False,26,1663,2082,419
168154,2019-11-14 00:00:00+03:00,in,False,939376,False,4,273,306,33
168154,2019-11-14 00:00:00+03:00,in,False,-1,True,93,0,3265,3265
168154,2019-11-14 00:00:00+03:00,out,False,939370,False,16,3787,4007,220
168154,2019-11-14 00:00:00+03:00,out,False,939376,True,22,0,475,475
168154,2019-11-14 00:00:00+03:00,in,False,939370,False,28,2267,3142,875
168154,2019-11-14 00:00:00+03:00,out,False,939376,True,22,0,475,475
168154,2019-11-15 00:00:00+03:00,out,False,939370,False,22,4847,5209,362
168154,2019-11-15 00:00:00+03:00,out,False,939376,False,27,1688,2167,479
168154,2019-11-15 00:00:00+03:00,out,False,939376,True,24,0,692,692
168154,2019-11-15 00:00:00+03:00,in,False,-1,True,25,0,888,888
168154,2019-11-15 00:00:00+03:00,in,False,939370,False,8,1836,1944,108
168154,2019-11-15 00:00:00+03:00,out,False,939370,True,8,0,195,195
168154,2019-11-16 00:00:00+03:00,in,False,-1,True,1,0,31,31
168154,2019-11-16 00:00:00+03:00,in,False,-1,True,1,0,31,31
168154,2019-11-17 00:00:00+03:00,in,False,-1,True,2,0,59,59
168154,2019-11-18 00:00:00+03:00,in,False,939376,False,14,5775,5974,199
168154,2019-11-18 00:00:00+03:00,in,False,-1,True,62,0,1893,1893
168154,2019-11-18 00:00:00+03:00,in,False,939370,True,1,0,4,4
168154,2019-11-18 00:00:00+03:00,out,False,939376,False,39,5706,6267,561
168154,2019-11-18 00:00:00+03:00,out,False,939376,True,26,0,591,591
168154,2019-11-18 00:00:00+03:00,out,False,939370,False,29,5960,6469,509
168154,2019-11-18 00:00:00+03:00,out,False,939370,True,10,0,243,243
168154,2019-11-18 00:00:00+03:00,in,False,939370,False,22,4216,4663,447
168154,2019-11-18 00:00:00+03:00,out,False,939376,False,39,5706,6267,561
168154,2019-11-19 00:00:00+03:00,out,False,939376,False,55,6267,7113,846
168154,2019-11-19 00:00:00+03:00,in,False,-1,True,88,0,2965,2965
168154,2019-11-19 00:00:00+03:00,in,False,939370,False,21,4338,4667,329
168154,2019-11-19 00:00:00+03:00,in,False,939376,False,8,2285,2382,97
168154,2019-11-19 00:00:00+03:00,out,False,939370,True,15,0,330,330
168154,2019-11-19 00:00:00+03:00,out,False,939370,False,38,7518,8075,557
168154,2019-11-19 00:00:00+03:00,out,False,939376,True,37,0,679,679
168154,2019-11-19 00:00:00+03:00,in,False,939376,False,8,2285,2382,97
168154,2019-11-20 00:00:00+03:00,in,False,939376,False,6,1771,2001,230
168154,2019-11-20 00:00:00+03:00,out,False,939370,True,9,0,269,269
168154,2019-11-20 00:00:00+03:00,in,False,-1,True,83,0,2750,2750
168154,2019-11-20 00:00:00+03:00,in,False,939370,False,16,472,844,372
168154,2019-11-20 00:00:00+03:00,out,False,939376,True,11,0,230,230
168154,2019-11-20 00:00:00+03:00,out,False,939370,False,6,291,393,102
168154,2019-11-20 00:00:00+03:00,out,False,939376,False,30,5099,5519,420
168154,2019-11-20 00:00:00+03:00,in,False,939376,True,1,1,26,25
168154,2019-11-21 00:00:00+03:00,in,False,-1,True,106,0,3772,3772
168154,2019-11-21 00:00:00+03:00,in,False,939370,False,23,2946,3286,340
168154,2019-11-21 00:00:00+03:00,out,False,939370,False,66,10240,11294,1054
168154,2019-11-21 00:00:00+03:00,out,False,939376,True,16,0,410,410
168154,2019-11-21 00:00:00+03:00,in,False,939376,False,2,440,469,29
168154,2019-11-21 00:00:00+03:00,out,False,939370,True,14,0,305,305
168154,2019-11-21 00:00:00+03:00,out,False,939376,False,47,8693,9458,765
168154,2019-11-21 00:00:00+03:00,out,False,939376,True,16,0,410,410
168154,2019-11-22 00:00:00+03:00,out,False,939376,True,14,0,328,328
168154,2019-11-22 00:00:00+03:00,in,False,939376,False,3,266,299,33
168154,2019-11-22 00:00:00+03:00,in,False,939370,False,23,553,875,322
168154,2019-11-22 00:00:00+03:00,out,False,939376,False,17,748,1042,294
168154,2019-11-22 00:00:00+03:00,in,False,-1,True,58,0,1348,1348
168154,2019-11-23 00:00:00+03:00,out,False,939376,True,9,0,286,286
168154,2019-11-23 00:00:00+03:00,in,False,-1,True,31,0,708,708
168154,2019-11-23 00:00:00+03:00,out,False,-1,True,1,0,0,0
168154,2019-11-23 00:00:00+03:00,out,False,939376,False,17,2579,2809,230
168154,2019-11-23 00:00:00+03:00,in,False,-1,True,31,0,708,708
168154,2019-11-24 00:00:00+03:00,in,False,939370,False,1,10,22,12
168154,2019-11-24 00:00:00+03:00,in,False,-1,True,11,0,184,184
168154,2019-11-25 00:00:00+03:00,out,False,939376,False,35,5655,6168,513
168154,2019-11-25 00:00:00+03:00,in,False,939376,False,5,954,1038,84
168154,2019-11-25 00:00:00+03:00,out,False,939376,True,21,0,521,521
168154,2019-11-25 00:00:00+03:00,in,False,-1,True,150,0,4271,4271
168154,2019-11-25 00:00:00+03:00,in,False,939370,False,10,1879,1955,76
168154,2019-11-25 00:00:00+03:00,out,False,939370,False,56,9109,10015,906
168154,2019-11-25 00:00:00+03:00,out,False,939370,True,28,0,726,726
168154,2019-11-25 00:00:00+03:00,in,False,939370,False,10,1879,1955,76
168154,2019-11-26 00:00:00+03:00,out,False,939376,True,29,0,820,820
168154,2019-11-26 00:00:00+03:00,out,False,939376,False,29,3706,4244,538
168154,2019-11-26 00:00:00+03:00,in,False,939376,False,12,4251,4367,116
168154,2019-11-26 00:00:00+03:00,in,False,939370,False,20,3002,3213,211
168154,2019-11-26 00:00:00+03:00,in,False,-1,True,66,0,2003,2003
168154,2019-11-26 00:00:00+03:00,out,False,939370,False,21,3725,4030,305
168154,2019-11-26 00:00:00+03:00,out,False,939370,True,6,0,202,202
168154,2019-11-26 00:00:00+03:00,in,False,-1,True,66,0,2003,2003
168154,2019-11-26 00:00:00+03:00,out,False,939370,False,21,3725,4030,305
168154,2019-11-27 00:00:00+03:00,in,False,939376,False,9,1039,1127,88
168154,2019-11-27 00:00:00+03:00,in,False,-1,True,43,0,982,982
168154,2019-11-27 00:00:00+03:00,out,False,939376,True,17,0,424,424
168154,2019-11-27 00:00:00+03:00,in,False,939370,False,9,240,457,217
168154,2019-11-27 00:00:00+03:00,out,False,939376,False,41,9795,10377,582
168154,2019-11-27 00:00:00+03:00,in,False,939370,False,9,240,457,217
168154,2019-11-28 00:00:00+03:00,in,False,939370,False,9,2549,2606,57
168154,2019-11-28 00:00:00+03:00,out,False,939376,True,24,0,659,659
168154,2019-11-28 00:00:00+03:00,out,False,939370,True,7,0,185,185
168154,2019-11-28 00:00:00+03:00,in,False,939376,False,5,805,851,46
168154,2019-11-28 00:00:00+03:00,out,False,939370,False,17,2784,3081,297
168154,2019-11-28 00:00:00+03:00,out,False,939376,False,35,6599,7134,535
168154,2019-11-28 00:00:00+03:00,in,False,-1,True,81,0,1814,1814
168154,2019-11-28 00:00:00+03:00,out,False,939376,False,35,6599,7134,535
168154,2019-11-28 00:00:00+03:00,in,False,939376,False,5,805,851,46
168155,2019-10-16 00:00:00+03:00,out,False,938414,True,4,0,0,0
168155,2019-10-16 00:00:00+03:00,in,False,-1,True,3,0,7,7
168155,2019-10-16 00:00:00+03:00,in,False,-1,True,3,0,7,7
168155,2019-10-16 00:00:00+03:00,out,False,938414,True,4,0,0,0
168155,2019-10-18 00:00:00+03:00,out,False,938414,True,2,0,9,9
168155,2019-10-18 00:00:00+03:00,in,False,-1,True,2,0,20,20
168155,2019-10-22 00:00:00+03:00,in,False,-1,True,1,0,2,2
168155,2019-10-29 00:00:00+03:00,out,False,938414,False,1,145,147,2
168155,2019-10-29 00:00:00+03:00,out,False,938414,True,1,0,30,30
168155,2019-11-15 00:00:00+03:00,out,False,938414,False,1,64,69,5
168155,2019-11-15 00:00:00+03:00,out,False,938414,True,1,0,13,13
168155,2019-11-15 00:00:00+03:00,out,False,938414,True,1,0,13,13
168155,2019-11-18 00:00:00+03:00,out,False,938414,True,1,0,7,7
168155,2019-11-18 00:00:00+03:00,out,True,938414,True,1,0,0,0
168155,2019-11-18 00:00:00+03:00,out,False,938414,False,1,195,199,4
168155,2019-11-19 00:00:00+03:00,in,False,938414,False,9,1155,1407,252
168155,2019-11-19 00:00:00+03:00,out,False,938414,True,1,0,3,3
168155,2019-11-19 00:00:00+03:00,in,False,-1,True,23,0,601,601
168155,2019-11-20 00:00:00+03:00,in,False,938414,True,1,0,23,23
168155,2019-11-20 00:00:00+03:00,out,False,938414,True,2,0,31,31
168155,2019-11-20 00:00:00+03:00,in,False,-1,True,102,0,2988,2988
168155,2019-11-20 00:00:00+03:00,in,False,938414,False,7,744,914,170
168155,2019-11-20 00:00:00+03:00,out,False,938414,False,1,171,178,7
168155,2019-11-20 00:00:00+03:00,out,False,938414,True,2,0,31,31
168155,2019-11-21 00:00:00+03:00,out,False,938414,True,3,0,0,0
168155,2019-11-21 00:00:00+03:00,out,False,938414,False,3,868,914,46
168155,2019-11-21 00:00:00+03:00,in,False,-1,True,107,0,3009,3009
168155,2019-11-21 00:00:00+03:00,in,False,938414,False,7,1911,2078,167
168155,2019-11-22 00:00:00+03:00,in,False,-1,True,47,0,1303,1303
168155,2019-11-22 00:00:00+03:00,in,False,969288,False,1,162,179,17
168155,2019-11-23 00:00:00+03:00,in,False,-1,True,42,0,642,642
168155,2019-11-23 00:00:00+03:00,in,False,938414,False,17,3072,3396,324
168155,2019-11-23 00:00:00+03:00,in,False,969288,False,2,277,348,71
168155,2019-11-23 00:00:00+03:00,out,False,938414,False,2,669,680,11
168155,2019-11-23 00:00:00+03:00,in,False,938414,True,1,0,18,18
168155,2019-11-24 00:00:00+03:00,out,False,938414,False,8,2425,2491,66
168155,2019-11-24 00:00:00+03:00,in,False,938414,False,16,2105,2427,322
168155,2019-11-24 00:00:00+03:00,in,False,-1,True,57,0,1259,1259
168155,2019-11-24 00:00:00+03:00,out,False,938414,True,10,0,9,9
168155,2019-11-24 00:00:00+03:00,out,False,969288,True,2,0,21,21
168155,2019-11-25 00:00:00+03:00,in,False,938414,False,27,3968,4640,672
168155,2019-11-25 00:00:00+03:00,in,False,-1,True,216,0,3319,3319
168155,2019-11-26 00:00:00+03:00,in,False,938414,False,8,1047,1246,199
168155,2019-11-26 00:00:00+03:00,in,False,-1,True,93,0,1134,1134
168155,2019-11-26 00:00:00+03:00,out,False,938414,False,1,155,158,3
168155,2019-11-27 00:00:00+03:00,in,False,-1,True,50,0,804,804
168155,2019-11-28 00:00:00+03:00,in,False,-1,True,106,0,1985,1985
168155,2019-11-28 00:00:00+03:00,out,False,938414,True,2,0,28,28
168180,2019-11-12 00:00:00+03:00,in,False,958640,False,1,65,77,12
168180,2019-11-14 00:00:00+03:00,in,False,-1,True,1,0,15,15
168180,2019-11-15 00:00:00+03:00,in,False,958640,False,1,83,96,13
168180,2019-11-16 00:00:00+03:00,in,False,-1,True,1,0,34,34
168180,2019-11-17 00:00:00+03:00,in,False,958640,True,1,0,9,9
168180,2019-11-17 00:00:00+03:00,in,False,-1,True,1,0,34,34
168180,2019-11-20 00:00:00+03:00,in,False,958640,False,1,104,123,19
168180,2019-11-21 00:00:00+03:00,in,False,-1,True,4,0,61,61
168180,2019-11-21 00:00:00+03:00,in,False,958640,False,1,150,160,10
168180,2019-11-22 00:00:00+03:00,in,False,-1,True,1,0,13,13
168180,2019-11-22 00:00:00+03:00,in,False,958640,False,1,174,184,10
168180,2019-11-22 00:00:00+03:00,out,False,958640,True,3,0,9,9
168180,2019-11-25 00:00:00+03:00,in,False,958640,False,1,88,96,8
168180,2019-11-25 00:00:00+03:00,in,False,958640,False,1,88,96,8
168180,2019-11-26 00:00:00+03:00,in,False,958640,False,1,100,110,10
168180,2019-11-27 00:00:00+03:00,in,False,958640,False,1,75,84,9
168180,2019-11-27 00:00:00+03:00,out,False,958640,False,5,758,810,52
168180,2019-11-28 00:00:00+03:00,in,False,958640,False,1,175,180,5
168180,2019-11-28 00:00:00+03:00,out,False,958640,False,3,228,255,27
168185,2019-10-17 00:00:00+03:00,in,False,-1,True,8,0,7,7
168185,2019-10-23 00:00:00+03:00,in,False,939212,False,1,118,130,12
168185,2019-11-08 00:00:00+03:00,in,False,-1,True,1,0,43,43
168185,2019-11-11 00:00:00+03:00,in,False,939212,False,1,22,44,22
168185,2019-11-11 00:00:00+03:00,in,False,-1,True,2,0,135,135
168185,2019-11-12 00:00:00+03:00,in,False,939212,False,1,19,30,11
168185,2019-11-12 00:00:00+03:00,in,False,939212,False,1,19,30,11
168185,2019-11-15 00:00:00+03:00,out,False,939212,True,1,0,2,2
168185,2019-11-15 00:00:00+03:00,out,True,939212,True,1,0,2,2
168185,2019-11-15 00:00:00+03:00,out,False,939212,True,1,0,2,2
168185,2019-11-16 00:00:00+03:00,out,False,939212,True,2,0,21,21
168185,2019-11-16 00:00:00+03:00,in,False,-1,True,1,0,13,13
168185,2019-11-17 00:00:00+03:00,in,False,939212,False,1,347,369,22
168185,2019-11-18 00:00:00+03:00,in,False,-1,True,1,0,18,18
168185,2019-11-18 00:00:00+03:00,in,False,939212,False,2,114,153,39
168185,2019-11-18 00:00:00+03:00,out,False,939212,False,1,4,5,1
168185,2019-11-25 00:00:00+03:00,in,False,939212,False,1,40,67,27
168185,2019-11-27 00:00:00+03:00,out,False,939212,False,1,7,9,2
168185,2019-11-27 00:00:00+03:00,out,False,939212,True,2,0,15,15
168185,2019-11-27 00:00:00+03:00,in,False,-1,True,2,0,27,27
168185,2019-11-27 00:00:00+03:00,out,False,939212,False,1,7,9,2
168185,2019-11-28 00:00:00+03:00,out,False,939212,True,1,0,5,5
168185,2019-11-28 00:00:00+03:00,in,False,939212,False,1,2,18,16
168187,2019-10-16 00:00:00+03:00,in,False,937958,False,1,128,129,1
168187,2019-10-16 00:00:00+03:00,in,False,937958,True,1,0,1,1
168187,2019-10-16 00:00:00+03:00,out,False,937984,False,2,11,15,4
168187,2019-10-16 00:00:00+03:00,in,True,937960,False,1,14,15,1
168187,2019-10-16 00:00:00+03:00,in,True,937962,True,1,0,1,1
168187,2019-10-16 00:00:00+03:00,out,True,937984,True,2,0,54,54
168187,2019-10-16 00:00:00+03:00,in,False,937956,False,12,490,500,10
168187,2019-10-16 00:00:00+03:00,out,False,937902,True,3,0,77,77
168187,2019-10-16 00:00:00+03:00,in,True,937958,False,3,43,45,2
168187,2019-10-16 00:00:00+03:00,in,False,-1,True,6,0,45,45
168187,2019-10-16 00:00:00+03:00,in,False,937960,True,1,0,1,1
168187,2019-10-16 00:00:00+03:00,in,False,937962,False,1,62,63,1
168187,2019-10-16 00:00:00+03:00,out,False,937762,False,1,82,109,27
168187,2019-10-16 00:00:00+03:00,in,False,937960,False,1,75,76,1
168187,2019-10-16 00:00:00+03:00,in,True,937984,False,3,15,54,39
168187,2019-10-16 00:00:00+03:00,in,False,-1,True,3,0,56,56
168187,2019-10-16 00:00:00+03:00,out,False,937984,True,1,0,14,14
168187,2019-10-16 00:00:00+03:00,out,False,937888,True,1,0,64,64
168187,2019-10-16 00:00:00+03:00,in,True,937962,True,1,0,1,1
168187,2019-10-17 00:00:00+03:00,out,False,937708,True,4,0,136,136
168187,2019-10-17 00:00:00+03:00,out,False,937966,False,5,154,254,100
168187,2019-10-17 00:00:00+03:00,in,False,937956,False,13,691,708,17
168187,2019-10-17 00:00:00+03:00,in,False,937854,False,4,157,181,24
168187,2019-10-17 00:00:00+03:00,out,False,937984,True,1,0,25,25
168187,2019-10-17 00:00:00+03:00,out,False,937854,True,9,0,211,211
168187,2019-10-17 00:00:00+03:00,out,False,937888,True,8,0,106,106
168187,2019-10-17 00:00:00+03:00,out,False,937902,True,8,0,249,249
168187,2019-10-17 00:00:00+03:00,out,False,937902,False,8,349,507,158
168187,2019-10-17 00:00:00+03:00,out,False,937760,True,15,0,278,278
168187,2019-10-17 00:00:00+03:00,in,True,937956,False,2,23,24,1
168187,2019-10-17 00:00:00+03:00,in,False,937960,False,3,314,317,3
168187,2019-10-17 00:00:00+03:00,out,False,937708,False,1,25,41,16
168187,2019-10-17 00:00:00+03:00,in,False,937958,True,4,0,4,4
168187,2019-10-17 00:00:00+03:00,in,False,937984,False,2,96,127,31
168187,2019-10-17 00:00:00+03:00,out,False,937854,False,6,307,443,136
168187,2019-10-17 00:00:00+03:00,out,False,937760,False,8,273,474,201
168187,2019-10-17 00:00:00+03:00,in,False,-1,True,16,0,250,250
168187,2019-10-17 00:00:00+03:00,in,False,937760,False,5,286,321,35
168187,2019-10-17 00:00:00+03:00,in,False,937708,False,1,48,65,17
168187,2019-10-17 00:00:00+03:00,out,False,937762,False,5,121,280,159
168187,2019-10-17 00:00:00+03:00,out,False,937888,False,10,988,1193,205
168187,2019-10-17 00:00:00+03:00,in,False,937958,False,3,310,313,3
168187,2019-10-17 00:00:00+03:00,in,False,937956,True,11,0,11,11
168187,2019-10-17 00:00:00+03:00,out,False,937678,True,1,0,40,40
168187,2019-10-17 00:00:00+03:00,out,False,937966,True,6,0,51,51
168187,2019-10-17 00:00:00+03:00,in,True,937760,False,1,74,81,7
168187,2019-10-17 00:00:00+03:00,in,True,937854,False,1,10,16,6
168187,2019-10-17 00:00:00+03:00,in,False,937732,False,1,71,81,10
168187,2019-10-17 00:00:00+03:00,out,False,937732,False,1,13,22,9
168187,2019-10-17 00:00:00+03:00,in,False,-1,True,16,0,127,127
168187,2019-10-17 00:00:00+03:00,in,False,937860,False,5,628,672,44
168187,2019-10-17 00:00:00+03:00,in,False,937988,False,2,260,297,37
168187,2019-10-17 00:00:00+03:00,out,False,937732,True,1,0,8,8
168187,2019-10-17 00:00:00+03:00,out,False,937760,False,8,273,474,201
168187,2019-10-17 00:00:00+03:00,out,False,937854,False,6,307,443,136
168187,2019-10-18 00:00:00+03:00,out,True,937980,True,2,0,112,112
168187,2019-10-18 00:00:00+03:00,in,False,937732,False,3,225,256,31
168187,2019-10-18 00:00:00+03:00,out,False,937808,True,9,0,288,288
168187,2019-10-18 00:00:00+03:00,in,False,937988,False,3,441,484,43
168187,2019-10-18 00:00:00+03:00,out,False,937760,True,4,0,56,56
168187,2019-10-18 00:00:00+03:00,out,False,937708,False,7,803,968,165
168187,2019-10-18 00:00:00+03:00,out,False,937888,True,4,0,73,73
168187,2019-10-18 00:00:00+03:00,out,False,937708,True,5,0,81,81
168187,2019-10-18 00:00:00+03:00,in,False,-1,True,46,0,1200,1200
168187,2019-10-18 00:00:00+03:00,in,False,937958,False,2,21,69,48
168187,2019-10-18 00:00:00+03:00,out,False,937888,False,1,182,206,24
168187,2019-10-18 00:00:00+03:00,in,False,937960,False,2,29,127,98
168187,2019-10-18 00:00:00+03:00,out,False,937812,False,7,321,495,174
168187,2019-10-18 00:00:00+03:00,out,False,937788,True,7,0,78,78
168187,2019-10-18 00:00:00+03:00,in,False,937782,False,1,173,183,10
168187,2019-10-18 00:00:00+03:00,out,False,937750,True,10,0,275,275
168187,2019-10-18 00:00:00+03:00,out,False,937862,True,2,0,76,76
168187,2019-10-18 00:00:00+03:00,in,False,937868,True,1,0,11,11
168187,2019-10-18 00:00:00+03:00,in,False,937750,False,9,672,750,78
168187,2019-10-18 00:00:00+03:00,in,False,937752,False,2,103,116,13
168187,2019-10-18 00:00:00+03:00,out,False,937966,True,16,0,252,252
168187,2019-10-18 00:00:00+03:00,in,False,937860,False,9,1560,1630,70
168187,2019-10-18 00:00:00+03:00,in,False,937888,False,4,554,600,46
168187,2019-10-18 00:00:00+03:00,out,False,937750,False,1,5,7,2
168187,2019-10-18 00:00:00+03:00,out,False,937780,False,8,641,835,194
168187,2019-10-18 00:00:00+03:00,out,False,937732,False,3,203,251,48
168187,2019-10-18 00:00:00+03:00,out,False,937812,True,10,0,233,233
168187,2019-10-18 00:00:00+03:00,out,False,937752,True,2,0,39,39
168187,2019-10-18 00:00:00+03:00,in,False,937736,False,5,165,262,97
168187,2019-10-18 00:00:00+03:00,out,False,937966,False,9,578,789,211
168187,2019-10-18 00:00:00+03:00,out,False,937762,False,3,62,149,87
168187,2019-10-18 00:00:00+03:00,in,False,937788,False,1,64,71,7
168187,2019-10-18 00:00:00+03:00,out,False,937752,False,1,34,62,28
168187,2019-10-18 00:00:00+03:00,out,False,937854,True,12,0,310,310
168187,2019-10-18 00:00:00+03:00,out,False,937678,True,1,0,34,34
168187,2019-10-18 00:00:00+03:00,out,False,937788,False,1,14,34,20
168187,2019-10-18 00:00:00+03:00,in,False,937864,False,2,502,545,43
168187,2019-10-18 00:00:00+03:00,out,False,937780,True,7,0,262,262
168187,2019-10-18 00:00:00+03:00,in,False,937808,False,3,204,228,24
168187,2019-10-18 00:00:00+03:00,out,False,937988,True,1,0,9,9
168187,2019-10-18 00:00:00+03:00,out,False,937854,False,10,660,835,175
168187,2019-10-18 00:00:00+03:00,in,False,937780,False,1,64,84,20
168187,2019-10-18 00:00:00+03:00,out,False,937980,False,1,20,36,16
168187,2019-10-18 00:00:00+03:00,in,False,937956,False,9,1022,1031,9
168187,2019-10-18 00:00:00+03:00,in,False,937980,False,1,115,122,7
168187,2019-10-18 00:00:00+03:00,out,False,937732,True,10,0,116,116
168187,2019-10-18 00:00:00+03:00,out,False,937902,True,8,0,163,163
168187,2019-10-18 00:00:00+03:00,in,False,-1,True,1,0,6,6
168187,2019-10-18 00:00:00+03:00,out,False,937760,False,6,893,1000,107
168187,2019-10-18 00:00:00+03:00,out,False,937808,False,6,335,473,138
168187,2019-10-18 00:00:00+03:00,in,False,937862,False,3,167,194,27
168187,2019-10-18 00:00:00+03:00,in,False,937966,False,9,927,1002,75
168187,2019-10-18 00:00:00+03:00,out,False,937902,False,3,326,380,54
168187,2019-10-18 00:00:00+03:00,in,False,937854,False,17,1271,1403,132
168187,2019-10-18 00:00:00+03:00,in,False,937902,False,17,2847,3096,249
168187,2019-10-18 00:00:00+03:00,in,False,937678,False,2,508,522,14
168187,2019-10-18 00:00:00+03:00,out,False,937862,False,5,1350,1471,121
168187,2019-10-18 00:00:00+03:00,in,False,937760,False,7,366,450,84
168187,2019-10-18 00:00:00+03:00,in,False,937812,False,2,371,409,38
168187,2019-10-18 00:00:00+03:00,in,False,937868,False,3,221,246,25
168187,2019-10-18 00:00:00+03:00,in,False,937708,False,9,906,1013,107
168187,2019-10-18 00:00:00+03:00,in,False,937962,False,1,45,225,180
168187,2019-10-18 00:00:00+03:00,in,False,937956,False,9,1022,1031,9
168187,2019-10-18 00:00:00+03:00,in,False,-1,True,46,0,1200,1200
168187,2019-10-18 00:00:00+03:00,out,False,937854,True,12,0,310,310
168187,2019-10-18 00:00:00+03:00,out,False,937966,False,9,578,789,211
168187,2019-10-18 00:00:00+03:00,in,False,937732,False,3,225,256,31
168187,2019-10-18 00:00:00+03:00,in,False,937854,False,17,1271,1403,132
168187,2019-10-18 00:00:00+03:00,out,False,937808,True,9,0,288,288
168187,2019-10-18 00:00:00+03:00,out,False,937812,False,7,321,495,174
168187,2019-10-18 00:00:00+03:00,out,False,937988,True,1,0,9,9
168187,2019-10-19 00:00:00+03:00,in,False,937960,False,1,31,184,153
168187,2019-10-19 00:00:00+03:00,in,False,937956,True,1,0,1,1
168187,2019-10-19 00:00:00+03:00,in,False,937958,False,3,458,472,14
168187,2019-10-19 00:00:00+03:00,in,False,-1,True,8,0,181,181
168187,2019-10-19 00:00:00+03:00,in,False,937956,False,8,1254,1261,7
168187,2019-10-19 00:00:00+03:00,in,False,937956,True,1,0,1,1
168187,2019-10-20 00:00:00+03:00,in,False,937958,False,1,34,51,17
168187,2019-10-20 00:00:00+03:00,in,True,937956,False,2,14,16,2
168187,2019-10-20 00:00:00+03:00,in,False,-1,True,1,0,13,13
168187,2019-10-20 00:00:00+03:00,out,False,937984,False,1,8,32,24
168187,2019-10-20 00:00:00+03:00,in,False,937984,False,1,7,12,5
168187,2019-10-20 00:00:00+03:00,in,False,937960,False,2,189,231,42
168187,2019-10-20 00:00:00+03:00,in,True,937984,False,4,27,58,31
168187,2019-10-20 00:00:00+03:00,in,False,-1,True,5,0,120,120
168187,2019-10-20 00:00:00+03:00,in,True,937962,False,1,12,94,82
168187,2019-10-20 00:00:00+03:00,in,False,937956,False,5,372,377,5
168187,2019-10-20 00:00:00+03:00,in,False,937962,False,1,20,51,31
168187,2019-10-20 00:00:00+03:00,out,False,937984,False,1,8,32,24
168187,2019-10-21 00:00:00+03:00,in,False,937988,False,2,307,325,18
168187,2019-10-21 00:00:00+03:00,out,False,937966,True,27,0,513,513
168187,2019-10-21 00:00:00+03:00,out,False,937862,True,6,0,230,230
168187,2019-10-21 00:00:00+03:00,out,False,937808,False,10,1195,1486,291
168187,2019-10-21 00:00:00+03:00,out,False,937760,True,3,0,70,70
168187,2019-10-21 00:00:00+03:00,out,False,937868,False,6,1158,1307,149
168187,2019-10-21 00:00:00+03:00,out,True,937810,True,2,0,11,11
168187,2019-10-21 00:00:00+03:00,out,False,937678,False,1,49,68,19
168187,2019-10-21 00:00:00+03:00,out,False,937736,False,12,496,728,232
168187,2019-10-21 00:00:00+03:00,in,False,937966,False,6,477,528,51
168187,2019-10-21 00:00:00+03:00,out,False,937760,False,6,238,343,105
168187,2019-10-21 00:00:00+03:00,out,False,937902,False,15,3120,3405,285
168187,2019-10-21 00:00:00+03:00,in,False,937780,False,3,125,145,20
168187,2019-10-21 00:00:00+03:00,in,False,937956,False,7,555,604,49
168187,2019-10-21 00:00:00+03:00,in,False,937868,False,2,53,66,13
168187,2019-10-21 00:00:00+03:00,out,False,937854,False,13,1020,1265,245
168187,2019-10-21 00:00:00+03:00,in,False,937812,False,8,1659,1779,120
168187,2019-10-21 00:00:00+03:00,out,False,937854,True,11,0,249,249
168187,2019-10-21 00:00:00+03:00,in,False,937752,False,11,1572,1710,138
168187,2019-10-21 00:00:00+03:00,in,False,937960,False,2,171,268,97
168187,2019-10-21 00:00:00+03:00,in,False,937760,False,7,408,467,59
168187,2019-10-21 00:00:00+03:00,in,False,937750,False,5,346,396,50
168187,2019-10-21 00:00:00+03:00,out,False,937888,False,13,819,1060,241
168187,2019-10-21 00:00:00+03:00,out,False,937862,False,8,4334,4472,138
168187,2019-10-21 00:00:00+03:00,out,False,937732,False,4,799,851,52
168187,2019-10-21 00:00:00+03:00,out,False,937868,True,4,0,113,113
168187,2019-10-21 00:00:00+03:00,out,False,937988,True,1,0,7,7
168187,2019-10-21 00:00:00+03:00,out,True,937810,False,1,7,20,13
168187,2019-10-21 00:00:00+03:00,out,False,937762,False,3,11,113,102
168187,2019-10-21 00:00:00+03:00,in,False,937732,False,5,515,567,52
168187,2019-10-21 00:00:00+03:00,out,False,937708,True,9,0,398,398
168187,2019-10-21 00:00:00+03:00,out,False,937752,True,4,0,131,131
168187,2019-10-21 00:00:00+03:00,in,False,937962,False,2,49,111,62
168187,2019-10-21 00:00:00+03:00,in,True,937810,False,1,147,152,5
168187,2019-10-21 00:00:00+03:00,in,False,-1,True,70,0,2027,2027
168187,2019-10-21 00:00:00+03:00,out,False,937812,True,3,0,89,89
168187,2019-10-21 00:00:00+03:00,out,False,937732,True,1,0,42,42
168187,2019-10-21 00:00:00+03:00,in,False,937810,False,2,274,285,11
168187,2019-10-21 00:00:00+03:00,out,False,937856,False,1,13,39,26
168187,2019-10-21 00:00:00+03:00,out,False,937810,True,13,0,447,447
168187,2019-10-21 00:00:00+03:00,out,False,937708,False,12,1045,1254,209
168187,2019-10-21 00:00:00+03:00,out,False,937888,True,14,0,379,379
168187,2019-10-21 00:00:00+03:00,out,False,937762,True,1,0,71,71
168187,2019-10-21 00:00:00+03:00,in,False,937736,False,5,452,502,50
168187,2019-10-21 00:00:00+03:00,out,False,937750,False,5,171,293,122
168187,2019-10-21 00:00:00+03:00,in,False,937708,False,3,422,449,27
168187,2019-10-21 00:00:00+03:00,out,False,937788,True,11,0,205,205
168187,2019-10-21 00:00:00+03:00,out,False,937808,True,13,0,308,308
168187,2019-10-21 00:00:00+03:00,out,False,937812,False,3,250,303,53
168187,2019-10-21 00:00:00+03:00,in,False,937788,False,8,712,772,60
168187,2019-10-21 00:00:00+03:00,in,False,937782,False,4,139,192,53
168187,2019-10-21 00:00:00+03:00,in,False,937860,False,2,269,285,16
168187,2019-10-21 00:00:00+03:00,out,False,937782,False,1,8,15,7
168187,2019-10-21 00:00:00+03:00,in,False,937742,False,1,91,106,15
168187,2019-10-21 00:00:00+03:00,out,False,937678,True,2,0,50,50
168187,2019-10-21 00:00:00+03:00,out,False,937752,False,6,174,281,107
168187,2019-10-21 00:00:00+03:00,in,False,937854,False,5,359,418,59
168187,2019-10-21 00:00:00+03:00,in,False,937958,False,1,54,96,42
168187,2019-10-21 00:00:00+03:00,in,False,937902,False,12,2233,2362,129
168187,2019-10-21 00:00:00+03:00,out,False,937750,True,5,0,88,88
168187,2019-10-21 00:00:00+03:00,in,False,937678,False,1,186,195,9
168187,2019-10-21 00:00:00+03:00,out,False,937788,False,13,1512,1720,208
168187,2019-10-21 00:00:00+03:00,in,False,937888,False,5,751,782,31
168187,2019-10-21 00:00:00+03:00,out,False,937856,True,1,0,30,30
168187,2019-10-21 00:00:00+03:00,out,False,937736,True,22,0,449,449
168187,2019-10-21 00:00:00+03:00,in,False,937808,False,5,320,353,33
168187,2019-10-21 00:00:00+03:00,out,False,937810,False,5,820,903,83
168187,2019-10-21 00:00:00+03:00,out,False,937902,True,4,0,94,94
168187,2019-10-21 00:00:00+03:00,out,False,937966,False,12,442,642,200
168187,2019-10-21 00:00:00+03:00,out,False,937780,False,7,385,527,142
168187,2019-10-21 00:00:00+03:00,out,False,937780,True,5,0,83,83
168187,2019-10-21 00:00:00+03:00,in,False,937862,False,3,1077,1098,21
168187,2019-10-21 00:00:00+03:00,out,False,937708,False,12,1045,1254,209
168187,2019-10-21 00:00:00+03:00,out,False,937678,True,2,0,50,50
168187,2019-10-21 00:00:00+03:00,out,False,937678,False,1,49,68,19
168187,2019-10-21 00:00:00+03:00,out,False,937812,True,3,0,89,89
168187,2019-10-21 00:00:00+03:00,in,False,937960,False,2,171,268,97
168187,2019-10-21 00:00:00+03:00,out,True,937810,False,1,7,20,13
168187,2019-10-21 00:00:00+03:00,in,False,937966,False,6,477,528,51
168187,2019-10-21 00:00:00+03:00,out,False,937856,True,1,0,30,30
168187,2019-10-22 00:00:00+03:00,out,False,937988,False,1,114,126,12
168187,2019-10-22 00:00:00+03:00,out,False,937902,False,9,679,923,244
168187,2019-10-22 00:00:00+03:00,out,False,937708,False,7,580,700,120
168187,2019-10-22 00:00:00+03:00,out,False,937760,True,14,0,318,318
168187,2019-10-22 00:00:00+03:00,in,False,937810,False,4,550,579,29
168187,2019-10-22 00:00:00+03:00,in,False,937808,False,2,133,176,43
168187,2019-10-22 00:00:00+03:00,out,False,937856,False,1,33,49,16
168187,2019-10-22 00:00:00+03:00,in,False,937760,False,12,595,710,115
168187,2019-10-22 00:00:00+03:00,in,False,937788,False,1,106,110,4
168187,2019-10-22 00:00:00+03:00,out,False,937788,False,5,232,315,83
168187,2019-10-22 00:00:00+03:00,out,False,937736,False,14,595,903,308
168187,2019-10-22 00:00:00+03:00,in,False,937958,False,2,138,150,12
168187,2019-10-22 00:00:00+03:00,out,False,937988,True,2,0,18,18
168187,2019-10-22 00:00:00+03:00,out,True,937980,True,2,0,37,37
168187,2019-10-22 00:00:00+03:00,out,False,937902,True,14,0,347,347
168187,2019-10-22 00:00:00+03:00,out,False,937984,True,1,0,18,18
168187,2019-10-22 00:00:00+03:00,in,False,937902,False,9,506,598,92
168187,2019-10-22 00:00:00+03:00,out,False,937678,True,5,0,143,143
168187,2019-10-22 00:00:00+03:00,out,False,937750,False,4,283,367,84
168187,2019-10-22 00:00:00+03:00,out,False,937752,False,17,3132,3425,293
168187,2019-10-22 00:00:00+03:00,out,False,937762,False,7,718,882,164
168187,2019-10-22 00:00:00+03:00,out,False,937812,False,2,116,148,32
168187,2019-10-22 00:00:00+03:00,out,False,937812,True,2,0,35,35
168187,2019-10-22 00:00:00+03:00,out,False,937888,True,20,0,557,557
168187,2019-10-22 00:00:00+03:00,in,False,937678,False,1,238,244,6
168187,2019-10-22 00:00:00+03:00,in,False,937854,False,7,663,717,54
168187,2019-10-22 00:00:00+03:00,in,False,937708,False,9,1089,1159,70
168187,2019-10-22 00:00:00+03:00,out,False,937862,True,2,0,54,54
168187,2019-10-22 00:00:00+03:00,out,False,937808,True,18,0,507,507
168187,2019-10-22 00:00:00+03:00,out,False,937966,False,12,558,758,200
168187,2019-10-22 00:00:00+03:00,in,False,937860,False,2,143,156,13
168187,2019-10-22 00:00:00+03:00,out,False,937782,False,1,38,75,37
168187,2019-10-22 00:00:00+03:00,in,False,937762,False,1,15,31,16
168187,2019-10-22 00:00:00+03:00,out,False,937854,False,16,1146,1426,280
168187,2019-10-22 00:00:00+03:00,out,False,937760,False,12,398,624,226
168187,2019-10-22 00:00:00+03:00,out,False,937788,True,6,0,120,120
168187,2019-10-22 00:00:00+03:00,in,False,937780,False,5,566,642,76
168187,2019-10-22 00:00:00+03:00,in,False,937888,False,5,269,326,57
168187,2019-10-22 00:00:00+03:00,in,False,937864,False,3,760,798,38
168187,2019-10-22 00:00:00+03:00,out,False,937966,True,13,0,253,253
168187,2019-10-22 00:00:00+03:00,in,False,937956,False,9,1584,1593,9
168187,2019-10-22 00:00:00+03:00,out,False,937762,True,3,0,140,140
168187,2019-10-22 00:00:00+03:00,in,False,-1,True,58,0,1160,1160
168187,2019-10-22 00:00:00+03:00,in,False,937960,True,1,0,21,21
168187,2019-10-22 00:00:00+03:00,out,False,937752,True,18,0,379,379
168187,2019-10-22 00:00:00+03:00,in,False,937988,False,5,746,795,49
168187,2019-10-22 00:00:00+03:00,out,False,937810,True,8,0,221,221
168187,2019-10-22 00:00:00+03:00,in,False,937966,False,7,371,434,63
168187,2019-10-22 00:00:00+03:00,out,False,937862,False,6,189,300,111
168187,2019-10-22 00:00:00+03:00,out,False,937808,False,21,1128,1733,605
168187,2019-10-22 00:00:00+03:00,out,False,937810,False,2,44,88,44
168187,2019-10-22 00:00:00+03:00,out,False,937780,True,12,0,413,413
168187,2019-10-22 00:00:00+03:00,in,False,937732,False,5,611,731,120
168187,2019-10-22 00:00:00+03:00,out,False,937856,True,1,0,26,26
168187,2019-10-22 00:00:00+03:00,in,False,937736,False,4,555,605,50
168187,2019-10-22 00:00:00+03:00,in,False,937812,False,1,46,61,15
168187,2019-10-22 00:00:00+03:00,in,False,937960,False,5,607,692,85
168187,2019-10-22 00:00:00+03:00,in,False,937984,False,3,15,51,36
168187,2019-10-22 00:00:00+03:00,out,False,937854,True,8,0,173,173
168187,2019-10-22 00:00:00+03:00,in,False,937750,False,9,1186,1272,86
168187,2019-10-22 00:00:00+03:00,out,False,937678,False,2,163,218,55
168187,2019-10-22 00:00:00+03:00,out,False,937750,True,2,0,71,71
168187,2019-10-22 00:00:00+03:00,in,False,937868,False,3,184,209,25
168187,2019-10-22 00:00:00+03:00,in,False,937980,False,3,552,574,22
168187,2019-10-22 00:00:00+03:00,out,False,937980,False,3,551,571,20
168187,2019-10-22 00:00:00+03:00,out,False,937888,False,16,1764,2061,297
168187,2019-10-22 00:00:00+03:00,out,False,937708,True,11,0,251,251
168187,2019-10-22 00:00:00+03:00,out,False,937780,False,15,503,855,352
168187,2019-10-22 00:00:00+03:00,in,False,937752,False,7,1247,1330,83
168187,2019-10-22 00:00:00+03:00,in,False,-1,True,2,0,31,31
168187,2019-10-22 00:00:00+03:00,in,False,937862,False,3,873,902,29
168187,2019-10-22 00:00:00+03:00,out,False,937736,True,31,0,822,822
168187,2019-10-22 00:00:00+03:00,out,True,937980,False,3,984,1019,35
168187,2019-10-22 00:00:00+03:00,out,False,937980,True,2,0,74,74
168187,2019-10-22 00:00:00+03:00,out,False,937732,True,1,0,21,21
168187,2019-10-22 00:00:00+03:00,in,False,937708,False,9,1089,1159,70
168187,2019-10-22 00:00:00+03:00,out,False,937854,False,16,1146,1426,280
168187,2019-10-22 00:00:00+03:00,in,False,937760,False,12,595,710,115
168187,2019-10-22 00:00:00+03:00,out,False,937708,True,11,0,251,251
168187,2019-10-22 00:00:00+03:00,out,False,937762,True,3,0,140,140
168187,2019-10-22 00:00:00+03:00,out,False,937984,True,1,0,18,18
168187,2019-10-22 00:00:00+03:00,in,False,937868,False,3,184,209,25
168187,2019-10-22 00:00:00+03:00,out,False,937752,False,17,3132,3425,293
168187,2019-10-22 00:00:00+03:00,in,False,937808,False,2,133,176,43
168187,2019-10-22 00:00:00+03:00,in,False,937736,False,4,555,605,50
168187,2019-10-23 00:00:00+03:00,in,False,937902,False,10,970,1115,145
168187,2019-10-23 00:00:00+03:00,out,False,937868,False,8,1614,1771,157
168187,2019-10-23 00:00:00+03:00,in,False,937960,False,6,850,966,116
168187,2019-10-23 00:00:00+03:00,out,False,937988,True,1,0,10,10
168187,2019-10-23 00:00:00+03:00,in,False,937762,False,2,415,448,33
168187,2019-10-23 00:00:00+03:00,out,False,937854,False,7,301,437,136
168187,2019-10-23 00:00:00+03:00,out,False,937678,True,5,0,98,98
168187,2019-10-23 00:00:00+03:00,out,False,937966,False,16,621,981,360
168187,2019-10-23 00:00:00+03:00,out,False,937854,True,6,0,158,158
168187,2019-10-23 00:00:00+03:00,out,False,937752,False,19,1923,2325,402
168187,2019-10-23 00:00:00+03:00,in,False,937988,False,2,757,773,16
168187,2019-10-23 00:00:00+03:00,out,False,937782,False,1,7,12,5
168187,2019-10-23 00:00:00+03:00,out,False,937708,True,11,0,173,173
168187,2019-10-23 00:00:00+03:00,out,False,937762,False,4,360,474,114
168187,2019-10-23 00:00:00+03:00,out,False,937810,False,2,98,162,64
168187,2019-10-23 00:00:00+03:00,in,False,937808,False,1,144,152,8
168187,2019-10-23 00:00:00+03:00,in,True,937962,False,2,197,199,2
168187,2019-10-23 00:00:00+03:00,in,False,937788,False,5,406,468,62
168187,2019-10-23 00:00:00+03:00,in,False,937782,False,1,6,13,7
168187,2019-10-23 00:00:00+03:00,in,False,937980,False,2,709,723,14
168187,2019-10-23 00:00:00+03:00,in,False,937736,False,11,1085,1198,113
168187,2019-10-23 00:00:00+03:00,out,False,937750,False,3,206,283,77
168187,2019-10-23 00:00:00+03:00,out,False,937788,False,9,986,1145,159
168187,2019-10-23 00:00:00+03:00,out,False,937708,False,19,1508,1969,461
168187,2019-10-23 00:00:00+03:00,out,False,937678,False,3,65,100,35
168187,2019-10-23 00:00:00+03:00,out,False,937736,True,40,0,820,820
168187,2019-10-23 00:00:00+03:00,out,False,937888,True,12,0,353,353
168187,2019-10-23 00:00:00+03:00,in,False,937750,False,7,761,825,64
168187,2019-10-23 00:00:00+03:00,out,False,937808,False,17,1429,1818,389
168187,2019-10-23 00:00:00+03:00,in,False,937780,False,4,961,1004,43
168187,2019-10-23 00:00:00+03:00,out,False,937980,True,3,0,63,63
168187,2019-10-23 00:00:00+03:00,in,True,937958,False,1,10,11,1
168187,2019-10-23 00:00:00+03:00,in,False,937810,False,1,12,24,12
168187,2019-10-23 00:00:00+03:00,in,False,937966,False,10,830,901,71
168187,2019-10-23 00:00:00+03:00,out,False,937868,True,1,0,31,31
168187,2019-10-23 00:00:00+03:00,out,False,937980,False,2,581,615,34
168187,2019-10-23 00:00:00+03:00,out,False,937966,True,20,0,509,509
168187,2019-10-23 00:00:00+03:00,out,False,937760,False,20,2128,2508,380
168187,2019-10-23 00:00:00+03:00,in,False,937862,False,6,302,359,57
168187,2019-10-23 00:00:00+03:00,in,False,937752,False,7,278,333,55
168187,2019-10-23 00:00:00+03:00,in,False,937868,False,4,163,201,38
168187,2019-10-23 00:00:00+03:00,in,False,937854,False,4,1169,1191,22
168187,2019-10-23 00:00:00+03:00,in,True,937956,False,1,7,8,1
168187,2019-10-23 00:00:00+03:00,out,False,937732,True,5,0,65,65
168187,2019-10-23 00:00:00+03:00,out,False,937788,True,9,0,181,181
168187,2019-10-23 00:00:00+03:00,out,False,-1,True,1,0,0,0
168187,2019-10-23 00:00:00+03:00,in,False,-1,True,10,0,127,127
168187,2019-10-23 00:00:00+03:00,out,False,937862,True,5,0,131,131
168187,2019-10-23 00:00:00+03:00,out,False,937902,True,11,0,259,259
168187,2019-10-23 00:00:00+03:00,out,False,937810,True,3,0,75,75
168187,2019-10-23 00:00:00+03:00,in,False,937860,False,5,890,925,35
168187,2019-10-23 00:00:00+03:00,in,False,937760,False,7,645,712,67
168187,2019-10-23 00:00:00+03:00,out,False,937760,True,26,0,504,504
168187,2019-10-23 00:00:00+03:00,out,False,937888,False,11,811,1033,222
168187,2019-10-23 00:00:00+03:00,out,False,937808,True,10,0,269,269
168187,2019-10-23 00:00:00+03:00,out,False,937762,True,1,0,16,16
168187,2019-10-23 00:00:00+03:00,in,True,937960,False,1,91,92,1
168187,2019-10-23 00:00:00+03:00,in,False,937708,False,7,933,1062,129
168187,2019-10-23 00:00:00+03:00,out,False,937736,False,19,1357,1741,384
168187,2019-10-23 00:00:00+03:00,out,False,937750,True,1,0,32,32
168187,2019-10-23 00:00:00+03:00,out,False,937812,False,9,566,770,204
168187,2019-10-23 00:00:00+03:00,in,False,937732,False,2,436,468,32
168187,2019-10-23 00:00:00+03:00,out,False,937902,False,14,1135,1508,373
168187,2019-10-23 00:00:00+03:00,out,False,937782,True,1,0,43,43
168187,2019-10-23 00:00:00+03:00,out,False,937812,True,4,0,140,140
168187,2019-10-23 00:00:00+03:00,in,False,937956,False,11,662,705,43
168187,2019-10-23 00:00:00+03:00,in,False,937958,False,3,298,532,234
168187,2019-10-23 00:00:00+03:00,out,False,937752,True,13,0,322,322
168187,2019-10-23 00:00:00+03:00,out,False,937862,False,13,5312,5608,296
168187,2019-10-23 00:00:00+03:00,in,False,937888,False,1,159,173,14
168187,2019-10-23 00:00:00+03:00,in,False,-1,True,54,0,1893,1893
168187,2019-10-23 00:00:00+03:00,in,False,937812,False,5,755,812,57
168187,2019-10-23 00:00:00+03:00,in,False,937902,False,10,970,1115,145
168187,2019-10-23 00:00:00+03:00,in,True,937958,False,1,10,11,1
168187,2019-10-23 00:00:00+03:00,in,False,-1,True,54,0,1893,1893
168187,2019-10-23 00:00:00+03:00,in,False,937860,False,5,890,925,35
168187,2019-10-23 00:00:00+03:00,out,False,937888,False,11,811,1033,222
168187,2019-10-23 00:00:00+03:00,in,False,937788,False,5,406,468,62
168187,2019-10-23 00:00:00+03:00,out,False,937782,True,1,0,43,43
168187,2019-10-24 00:00:00+03:00,in,False,937788,False,5,188,231,43
168187,2019-10-24 00:00:00+03:00,out,False,937966,False,16,1082,1402,320
168187,2019-10-24 00:00:00+03:00,in,False,937902,False,12,1457,1633,176
168187,2019-10-24 00:00:00+03:00,in,False,937860,False,8,1094,1180,86
168187,2019-10-24 00:00:00+03:00,in,False,937782,False,3,197,226,29
168187,2019-10-24 00:00:00+03:00,in,False,937708,False,6,283,355,72
168187,2019-10-24 00:00:00+03:00,out,False,937708,False,7,519,705,186
168187,2019-10-24 00:00:00+03:00,in,False,937958,False,2,141,191,50
168187,2019-10-24 00:00:00+03:00,out,False,937860,False,1,359,367,8
168187,2019-10-24 00:00:00+03:00,out,False,937780,True,13,0,444,444
168187,2019-10-24 00:00:00+03:00,out,False,937854,False,1,43,68,25
168187,2019-10-24 00:00:00+03:00,out,False,937980,True,1,0,15,15
168187,2019-10-24 00:00:00+03:00,out,False,937782,True,1,0,47,47
168187,2019-10-24 00:00:00+03:00,in,False,937862,False,6,505,563,58
168187,2019-10-24 00:00:00+03:00,in,False,-1,True,61,0,1946,1946
168187,2019-10-24 00:00:00+03:00,in,False,937750,True,1,0,16,16
168187,2019-10-24 00:00:00+03:00,out,False,937750,False,1,38,55,17
168187,2019-10-24 00:00:00+03:00,out,False,937782,False,1,6,10,4
168187,2019-10-24 00:00:00+03:00,in,True,937864,False,3,26,37,11
168187,2019-10-24 00:00:00+03:00,out,False,937752,True,33,0,709,709
168187,2019-10-24 00:00:00+03:00,out,False,937750,True,3,0,41,41
168187,2019-10-24 00:00:00+03:00,out,False,937980,False,1,39,52,13
168187,2019-10-24 00:00:00+03:00,in,False,937988,False,1,164,179,15
168187,2019-10-24 00:00:00+03:00,in,False,937750,False,8,1590,1667,77
168187,2019-10-24 00:00:00+03:00,out,False,937862,False,7,649,815,166
168187,2019-10-24 00:00:00+03:00,in,False,937736,False,8,779,848,69
168187,2019-10-24 00:00:00+03:00,out,False,937868,False,16,670,924,254
168187,2019-10-24 00:00:00+03:00,in,True,937984,False,2,49,58,9
168187,2019-10-24 00:00:00+03:00,out,False,937760,False,5,464,518,54
168187,2019-10-24 00:00:00+03:00,out,False,937902,True,17,0,592,592
168187,2019-10-24 00:00:00+03:00,out,False,937888,True,13,0,489,489
168187,2019-10-24 00:00:00+03:00,out,False,937808,True,13,0,384,384
168187,2019-10-24 00:00:00+03:00,out,False,937780,False,29,2000,2753,753
168187,2019-10-24 00:00:00+03:00,in,True,937742,False,1,42,45,3
168187,2019-10-24 00:00:00+03:00,in,False,937864,True,1,44,50,6
168187,2019-10-24 00:00:00+03:00,in,False,937960,False,1,42,51,9
168187,2019-10-24 00:00:00+03:00,out,False,937762,True,2,0,27,27
168187,2019-10-24 00:00:00+03:00,in,False,937956,False,9,1491,1500,9
168187,2019-10-24 00:00:00+03:00,out,False,937888,False,8,918,1043,125
168187,2019-10-24 00:00:00+03:00,in,False,937762,False,2,65,77,12
168187,2019-10-24 00:00:00+03:00,out,False,937854,True,2,0,44,44
168187,2019-10-24 00:00:00+03:00,in,False,937864,False,14,772,904,132
168187,2019-10-24 00:00:00+03:00,out,False,937902,False,24,1557,2156,599
168187,2019-10-24 00:00:00+03:00,out,False,937762,False,3,184,270,86
168187,2019-10-24 00:00:00+03:00,in,True,937752,False,1,50,58,8
168187,2019-10-24 00:00:00+03:00,in,False,937780,False,2,239,275,36
168187,2019-10-24 00:00:00+03:00,out,False,937678,True,6,0,145,145
168187,2019-10-24 00:00:00+03:00,in,False,937868,False,6,357,418,61
168187,2019-10-24 00:00:00+03:00,in,False,937966,False,6,605,641,36
168187,2019-10-24 00:00:00+03:00,out,False,937812,True,3,0,74,74
168187,2019-10-24 00:00:00+03:00,in,False,937732,False,2,300,338,38
168187,2019-10-24 00:00:00+03:00,in,False,937980,False,3,282,310,28
168187,2019-10-24 00:00:00+03:00,out,False,937812,False,5,433,546,113
168187,2019-10-24 00:00:00+03:00,out,False,937810,False,9,631,815,184
168187,2019-10-24 00:00:00+03:00,out,False,937736,False,10,137,454,317
168187,2019-10-24 00:00:00+03:00,out,False,937788,False,18,1791,2094,303
168187,2019-10-24 00:00:00+03:00,in,False,937958,True,1,0,27,27
168187,2019-10-24 00:00:00+03:00,in,True,937762,False,1,27,30,3
168187,2019-10-24 00:00:00+03:00,out,False,937966,True,15,0,323,323
168187,2019-10-24 00:00:00+03:00,in,False,937736,True,1,0,27,27
168187,2019-10-24 00:00:00+03:00,out,False,937760,True,13,0,245,245
168187,2019-10-24 00:00:00+03:00,out,False,937708,True,8,0,329,329
168187,2019-10-24 00:00:00+03:00,out,False,937788,True,14,0,306,306
168187,2019-10-24 00:00:00+03:00,out,False,937868,True,11,0,298,298
168187,2019-10-24 00:00:00+03:00,in,False,-1,True,7,0,51,51
168187,2019-10-24 00:00:00+03:00,out,False,937736,True,22,0,652,652
168187,2019-10-24 00:00:00+03:00,in,False,937888,False,5,260,290,30
168187,2019-10-24 00:00:00+03:00,in,False,937760,False,6,329,369,40
168187,2019-10-24 00:00:00+03:00,out,False,937810,True,5,0,172,172
168187,2019-10-24 00:00:00+03:00,in,False,937962,False,1,255,256,1
168187,2019-10-24 00:00:00+03:00,in,False,937810,False,1,22,29,7
168187,2019-10-24 00:00:00+03:00,in,False,937752,False,12,2332,2417,85
168187,2019-10-24 00:00:00+03:00,out,False,937862,True,7,0,167,167
168187,2019-10-24 00:00:00+03:00,in,False,937812,False,4,346,403,57
168187,2019-10-24 00:00:00+03:00,out,False,937808,False,16,397,811,414
168187,2019-10-24 00:00:00+03:00,out,False,937752,False,23,1181,1528,347
168187,2019-10-24 00:00:00+03:00,out,False,937708,False,7,519,705,186
168187,2019-10-24 00:00:00+03:00,out,False,937868,True,11,0,298,298
168187,2019-10-24 00:00:00+03:00,out,False,937780,False,29,2000,2753,753
168187,2019-10-25 00:00:00+03:00,out,False,937984,False,2,2,27,25
168187,2019-10-25 00:00:00+03:00,out,False,937780,True,12,0,365,365
168187,2019-10-25 00:00:00+03:00,in,False,937762,False,3,197,237,40
168187,2019-10-25 00:00:00+03:00,out,False,937678,False,3,68,113,45
168187,2019-10-25 00:00:00+03:00,in,False,937788,False,4,554,578,24
168187,2019-10-25 00:00:00+03:00,out,False,-1,True,1,0,0,0
168187,2019-10-25 00:00:00+03:00,out,False,937980,True,5,0,126,126
168187,2019-10-25 00:00:00+03:00,in,False,937960,False,3,227,230,3
168187,2019-10-25 00:00:00+03:00,in,False,937812,False,3,572,615,43
168187,2019-10-25 00:00:00+03:00,in,False,937854,False,7,355,434,79
168187,2019-10-25 00:00:00+03:00,in,False,937752,False,14,1230,1495,265
168187,2019-10-25 00:00:00+03:00,out,False,937980,False,3,430,497,67
168187,2019-10-25 00:00:00+03:00,in,False,937868,False,3,523,549,26
168187,2019-10-25 00:00:00+03:00,out,False,937812,True,1,0,2,2
168187,2019-10-25 00:00:00+03:00,out,False,937762,True,6,0,242,242
168187,2019-10-25 00:00:00+03:00,out,False,937856,False,1,238,251,13
168187,2019-10-25 00:00:00+03:00,out,False,937902,False,24,1394,1903,509
168187,2019-10-25 00:00:00+03:00,in,False,937732,False,6,983,1151,168
168187,2019-10-25 00:00:00+03:00,out,False,937708,False,12,767,1014,247
168187,2019-10-25 00:00:00+03:00,out,False,937780,False,17,1111,1527,416
168187,2019-10-25 00:00:00+03:00,out,False,937868,False,1,27,52,25
168187,2019-10-25 00:00:00+03:00,in,False,937966,False,14,1617,1729,112
168187,2019-10-25 00:00:00+03:00,in,False,937708,False,9,1056,1181,125
168187,2019-10-25 00:00:00+03:00,out,False,937868,True,1,0,5,5
168187,2019-10-25 00:00:00+03:00,in,False,937864,False,1,4,12,8
168187,2019-10-25 00:00:00+03:00,out,False,937752,False,48,2075,2812,737
168187,2019-10-25 00:00:00+03:00,out,True,937762,False,1,15,24,9
168187,2019-10-25 00:00:00+03:00,out,False,937902,True,20,0,533,533
168187,2019-10-25 00:00:00+03:00,out,False,937862,True,4,0,139,139
168187,2019-10-25 00:00:00+03:00,in,False,937980,False,11,1385,1504,119
168187,2019-10-25 00:00:00+03:00,out,False,937788,True,18,0,221,221
168187,2019-10-25 00:00:00+03:00,out,False,937752,True,81,0,1684,1684
168187,2019-10-25 00:00:00+03:00,in,False,937888,False,7,341,386,45
168187,2019-10-25 00:00:00+03:00,in,False,937988,False,1,66,72,6
168187,2019-10-25 00:00:00+03:00,in,False,937860,False,9,540,612,72
168187,2019-10-25 00:00:00+03:00,in,False,-1,True,89,0,2661,2661
168187,2019-10-25 00:00:00+03:00,in,True,937762,False,5,147,228,81
168187,2019-10-25 00:00:00+03:00,out,False,937888,True,20,0,973,973
168187,2019-10-25 00:00:00+03:00,in,False,937956,False,11,1089,1106,17
168187,2019-10-25 00:00:00+03:00,out,False,937854,True,15,0,444,444
168187,2019-10-25 00:00:00+03:00,out,False,937788,False,5,105,205,100
168187,2019-10-25 00:00:00+03:00,out,False,937810,False,4,225,304,79
168187,2019-10-25 00:00:00+03:00,out,False,937812,False,1,20,35,15
168187,2019-10-25 00:00:00+03:00,out,False,937732,True,1,0,4,4
168187,2019-10-25 00:00:00+03:00,in,False,937736,False,9,639,803,164
168187,2019-10-25 00:00:00+03:00,in,False,937808,False,4,872,926,54
168187,2019-10-25 00:00:00+03:00,in,False,937780,False,7,396,474,78
168187,2019-10-25 00:00:00+03:00,in,False,937760,True,1,1,47,46
168187,2019-10-25 00:00:00+03:00,out,False,937810,True,7,0,268,268
168187,2019-10-25 00:00:00+03:00,out,False,937760,True,60,0,1520,1520
168187,2019-10-25 00:00:00+03:00,out,False,937854,False,15,1133,1344,211
168187,2019-10-25 00:00:00+03:00,in,False,937678,False,2,494,569,75
168187,2019-10-25 00:00:00+03:00,out,False,937762,False,6,99,292,193
168187,2019-10-25 00:00:00+03:00,in,False,937782,False,1,29,35,6
168187,2019-10-25 00:00:00+03:00,out,False,937736,False,10,328,554,226
168187,2019-10-25 00:00:00+03:00,out,False,937888,False,21,707,1250,543
168187,2019-10-25 00:00:00+03:00,out,False,937966,False,12,770,997,227
168187,2019-10-25 00:00:00+03:00,in,False,937760,False,14,1010,1187,177
168187,2019-10-25 00:00:00+03:00,out,False,937736,True,25,0,600,600
168187,2019-10-25 00:00:00+03:00,out,False,937750,True,1,0,11,11
168187,2019-10-25 00:00:00+03:00,in,False,937750,False,4,641,747,106
168187,2019-10-25 00:00:00+03:00,in,False,937958,False,9,497,534,37
168187,2019-10-25 00:00:00+03:00,in,False,937984,False,4,140,182,42
168187,2019-10-25 00:00:00+03:00,out,False,937708,True,17,0,326,326
168187,2019-10-25 00:00:00+03:00,in,False,-1,True,12,0,72,72
168187,2019-10-25 00:00:00+03:00,out,False,937966,True,27,0,497,497
168187,2019-10-25 00:00:00+03:00,in,False,937862,False,6,2024,2089,65
168187,2019-10-25 00:00:00+03:00,in,False,937902,False,7,1205,1257,52
168187,2019-10-25 00:00:00+03:00,out,False,937678,True,4,0,90,90
168187,2019-10-25 00:00:00+03:00,out,False,937988,True,5,0,56,56
168187,2019-10-25 00:00:00+03:00,out,False,937760,False,6,338,471,133
168187,2019-10-25 00:00:00+03:00,out,False,937742,False,1,409,424,15
168187,2019-10-25 00:00:00+03:00,out,False,937984,True,7,0,47,47
168187,2019-10-25 00:00:00+03:00,in,True,937988,False,1,266,272,6
168187,2019-10-25 00:00:00+03:00,in,False,937956,True,1,69,72,3
168187,2019-10-25 00:00:00+03:00,out,False,937862,False,10,2633,2816,183
168187,2019-10-25 00:00:00+03:00,out,True,937762,False,1,15,24,9
168187,2019-10-25 00:00:00+03:00,out,False,937708,False,12,767,1014,247
168187,2019-10-25 00:00:00+03:00,in,False,937760,False,14,1010,1187,177
168187,2019-10-25 00:00:00+03:00,out,False,937788,False,5,105,205,100
168187,2019-10-25 00:00:00+03:00,in,False,937958,False,9,497,534,37
168187,2019-10-25 00:00:00+03:00,out,False,937736,False,10,328,554,226
168187,2019-10-26 00:00:00+03:00,out,False,937872,True,1,0,18,18
168187,2019-10-26 00:00:00+03:00,in,False,937956,False,9,1402,1415,13
168187,2019-10-26 00:00:00+03:00,in,False,-1,True,17,0,802,802
168187,2019-10-26 00:00:00+03:00,in,False,-1,True,1,0,30,30
168187,2019-10-26 00:00:00+03:00,in,False,937958,False,1,20,39,19
168187,2019-10-26 00:00:00+03:00,in,False,937962,False,1,343,516,173
168187,2019-10-26 00:00:00+03:00,in,False,-1,True,17,0,802,802
168187,2019-10-26 00:00:00+03:00,in,False,-1,True,1,0,30,30
168187,2019-10-27 00:00:00+03:00,in,False,937960,False,2,49,91,42
168187,2019-10-27 00:00:00+03:00,in,False,937956,False,9,850,858,8
168187,2019-10-27 00:00:00+03:00,in,False,-1,True,8,0,422,422
168187,2019-10-27 00:00:00+03:00,out,False,937854,False,1,45,69,24
168187,2019-10-28 00:00:00+03:00,in,False,937854,False,5,234,283,49
168187,2019-10-28 00:00:00+03:00,in,True,937980,False,1,30,42,12
168187,2019-10-28 00:00:00+03:00,in,False,937888,False,9,512,587,75
168187,2019-10-28 00:00:00+03:00,out,False,937760,False,9,2063,2249,186
168187,2019-10-28 00:00:00+03:00,in,False,937960,False,1,15,21,6
168187,2019-10-28 00:00:00+03:00,in,False,937902,False,17,1633,1880,247
168187,2019-10-28 00:00:00+03:00,in,False,937788,False,1,138,153,15
168187,2019-10-28 00:00:00+03:00,in,True,937880,False,1,26,40,14
168187,2019-10-28 00:00:00+03:00,in,False,937958,False,9,743,762,19
168187,2019-10-28 00:00:00+03:00,in,False,937984,False,2,7,18,11
168187,2019-10-28 00:00:00+03:00,out,False,937732,True,14,0,238,238
168187,2019-10-28 00:00:00+03:00,out,False,937736,True,28,0,843,843
168187,2019-10-28 00:00:00+03:00,in,False,937856,False,1,88,95,7
168187,2019-10-28 00:00:00+03:00,out,False,937788,True,6,0,135,135
168187,2019-10-28 00:00:00+03:00,out,False,937750,True,3,0,53,53
168187,2019-10-28 00:00:00+03:00,in,False,937862,False,4,676,715,39
168187,2019-10-28 00:00:00+03:00,out,False,937902,False,30,1650,2305,655
168187,2019-10-28 00:00:00+03:00,out,False,937988,True,8,0,377,377
168187,2019-10-28 00:00:00+03:00,in,False,937780,False,6,552,633,81
168187,2019-10-28 00:00:00+03:00,out,False,937678,True,4,0,149,149
168187,2019-10-28 00:00:00+03:00,out,False,937888,True,23,0,761,761
168187,2019-10-28 00:00:00+03:00,out,False,937888,False,32,1267,2038,771
168187,2019-10-28 00:00:00+03:00,out,False,937862,False,9,982,1190,208
168187,2019-10-28 00:00:00+03:00,out,False,937966,False,20,1050,1358,308
168187,2019-10-28 00:00:00+03:00,in,False,937808,False,1,66,80,14
168187,2019-10-28 00:00:00+03:00,in,False,-1,True,64,0,1690,1690
168187,2019-10-28 00:00:00+03:00,in,False,937678,False,1,77,84,7
168187,2019-10-28 00:00:00+03:00,out,False,937708,True,5,0,162,162
168187,2019-10-28 00:00:00+03:00,out,False,937966,True,23,0,473,473
168187,2019-10-28 00:00:00+03:00,out,False,937732,False,12,278,544,266
168187,2019-10-28 00:00:00+03:00,out,False,937750,False,2,84,114,30
168187,2019-10-28 00:00:00+03:00,in,False,937966,False,10,738,823,85
168187,2019-10-28 00:00:00+03:00,in,False,937962,False,1,12,13,1
168187,2019-10-28 00:00:00+03:00,out,False,937862,True,8,0,270,270
168187,2019-10-28 00:00:00+03:00,in,False,937980,False,7,385,487,102
168187,2019-10-28 00:00:00+03:00,in,False,937868,False,3,120,145,25
168187,2019-10-28 00:00:00+03:00,out,False,937812,False,2,104,143,39
168187,2019-10-28 00:00:00+03:00,out,False,937788,False,9,1109,1236,127
168187,2019-10-28 00:00:00+03:00,out,False,937762,True,4,0,84,84
168187,2019-10-28 00:00:00+03:00,in,False,937860,False,4,1022,1057,35
168187,2019-10-28 00:00:00+03:00,out,False,937780,False,17,1053,1454,401
168187,2019-10-28 00:00:00+03:00,out,False,937760,True,11,0,248,248
168187,2019-10-28 00:00:00+03:00,out,False,937736,False,26,1350,1932,582
168187,2019-10-28 00:00:00+03:00,out,False,937810,False,8,196,339,143
168187,2019-10-28 00:00:00+03:00,in,False,937760,False,21,1559,1758,199
168187,2019-10-28 00:00:00+03:00,out,False,937868,False,1,166,179,13
168187,2019-10-28 00:00:00+03:00,out,False,937902,True,18,0,468,468
168187,2019-10-28 00:00:00+03:00,out,False,937856,False,3,249,314,65
168187,2019-10-28 00:00:00+03:00,in,False,937736,False,12,836,966,130
168187,2019-10-28 00:00:00+03:00,in,False,937810,False,3,450,483,33
168187,2019-10-28 00:00:00+03:00,out,False,937810,True,8,0,330,330
168187,2019-10-28 00:00:00+03:00,out,False,937808,True,26,0,685,685
168187,2019-10-28 00:00:00+03:00,in,False,937812,False,6,402,479,77
168187,2019-10-28 00:00:00+03:00,in,False,937956,False,12,1578,1602,24
168187,2019-10-28 00:00:00+03:00,in,False,937880,False,1,82,93,11
168187,2019-10-28 00:00:00+03:00,out,False,937678,False,1,8,25,17
168187,2019-10-28 00:00:00+03:00,in,False,937956,True,1,0,1,1
168187,2019-10-28 00:00:00+03:00,out,False,937808,False,20,292,766,474
168187,2019-10-28 00:00:00+03:00,out,False,937780,True,12,0,224,224
168187,2019-10-28 00:00:00+03:00,out,False,937812,True,2,0,14,14
168187,2019-10-28 00:00:00+03:00,in,False,937762,False,6,535,646,111
168187,2019-10-28 00:00:00+03:00,in,False,937708,False,8,725,815,90
168187,2019-10-28 00:00:00+03:00,in,False,937752,False,13,1215,1449,234
168187,2019-10-28 00:00:00+03:00,out,False,937854,True,6,0,141,141
168187,2019-10-28 00:00:00+03:00,out,False,937988,False,8,418,628,210
168187,2019-10-28 00:00:00+03:00,in,False,937750,False,5,592,639,47
168187,2019-10-28 00:00:00+03:00,out,False,937752,False,25,1994,2494,500
168187,2019-10-28 00:00:00+03:00,in,False,937988,False,10,618,698,80
168187,2019-10-28 00:00:00+03:00,in,False,937732,False,2,113,132,19
168187,2019-10-28 00:00:00+03:00,out,False,937752,True,50,0,1243,1243
168187,2019-10-28 00:00:00+03:00,out,False,937708,False,14,531,876,345
168187,2019-10-28 00:00:00+03:00,in,False,937864,False,1,67,72,5
168187,2019-10-28 00:00:00+03:00,out,False,937762,False,4,79,162,83
168187,2019-10-28 00:00:00+03:00,out,False,937810,True,8,0,330,330
168187,2019-10-28 00:00:00+03:00,in,False,937864,False,1,67,72,5
168187,2019-10-28 00:00:00+03:00,out,False,937708,False,14,531,876,345
168187,2019-10-28 00:00:00+03:00,out,False,937760,False,9,2063,2249,186
168187,2019-10-28 00:00:00+03:00,in,False,937888,False,9,512,587,75
168187,2019-10-28 00:00:00+03:00,out,False,937808,True,26,0,685,685
168187,2019-10-28 00:00:00+03:00,out,False,937762,False,4,79,162,83
168187,2019-10-29 00:00:00+03:00,in,False,937958,False,7,1356,1435,79
168187,2019-10-29 00:00:00+03:00,in,False,937862,False,6,1820,1879,59
168187,2019-10-29 00:00:00+03:00,in,False,937962,False,3,219,252,33
168187,2019-10-29 00:00:00+03:00,out,False,937860,True,5,0,53,53
168187,2019-10-29 00:00:00+03:00,in,False,937760,False,14,1375,1502,127
168187,2019-10-29 00:00:00+03:00,out,False,937966,False,23,1753,2220,467
168187,2019-10-29 00:00:00+03:00,in,False,937732,False,3,211,254,43
168187,2019-10-29 00:00:00+03:00,out,False,937868,True,5,0,158,158
168187,2019-10-29 00:00:00+03:00,out,False,937862,True,7,0,153,153
168187,2019-10-29 00:00:00+03:00,in,False,937788,False,4,406,470,64
168187,2019-10-29 00:00:00+03:00,in,False,937902,False,3,962,992,30
168187,2019-10-29 00:00:00+03:00,out,False,937678,False,3,306,351,45
168187,2019-10-29 00:00:00+03:00,out,False,937902,True,18,0,676,676
168187,2019-10-29 00:00:00+03:00,out,False,937902,False,25,5490,6076,586
168187,2019-10-29 00:00:00+03:00,in,False,937780,False,5,318,364,46
168187,2019-10-29 00:00:00+03:00,out,True,937854,True,5,0,59,59
168187,2019-10-29 00:00:00+03:00,in,True,937956,False,3,214,217,3
168187,2019-10-29 00:00:00+03:00,out,False,937780,True,17,0,513,513
168187,2019-10-29 00:00:00+03:00,out,True,937780,True,1,0,8,8
168187,2019-10-29 00:00:00+03:00,in,True,937958,False,1,24,30,6
168187,2019-10-29 00:00:00+03:00,out,False,937782,True,1,0,27,27
168187,2019-10-29 00:00:00+03:00,out,False,937810,True,4,0,101,101
168187,2019-10-29 00:00:00+03:00,out,False,937760,False,8,540,691,151
168187,2019-10-29 00:00:00+03:00,in,False,937810,False,3,916,933,17
168187,2019-10-29 00:00:00+03:00,out,False,937854,True,9,0,224,224
168187,2019-10-29 00:00:00+03:00,out,False,937988,False,8,265,475,210
168187,2019-10-29 00:00:00+03:00,out,False,937736,False,13,1296,1571,275
168187,2019-10-29 00:00:00+03:00,in,False,937854,False,4,150,177,27
168187,2019-10-29 00:00:00+03:00,in,False,937988,False,2,178,193,15
168187,2019-10-29 00:00:00+03:00,in,False,937960,False,1,134,145,11
168187,2019-10-29 00:00:00+03:00,in,False,937880,False,3,187,212,25
168187,2019-10-29 00:00:00+03:00,out,False,937752,True,19,0,317,317
168187,2019-10-29 00:00:00+03:00,in,True,937760,False,2,15,37,22
168187,2019-10-29 00:00:00+03:00,out,False,937760,True,16,0,322,322
168187,2019-10-29 00:00:00+03:00,in,False,937752,False,6,755,812,57
168187,2019-10-29 00:00:00+03:00,out,False,937780,False,13,575,876,301
168187,2019-10-29 00:00:00+03:00,in,False,937708,False,9,925,1148,223
168187,2019-10-29 00:00:00+03:00,in,False,937966,False,4,308,329,21
168187,2019-10-29 00:00:00+03:00,out,False,937750,False,1,57,69,12
168187,2019-10-29 00:00:00+03:00,out,False,937860,False,6,317,385,68
168187,2019-10-29 00:00:00+03:00,out,False,937788,True,12,0,269,269
168187,2019-10-29 00:00:00+03:00,in,False,937860,False,5,909,993,84
168187,2019-10-29 00:00:00+03:00,in,False,937812,False,5,708,787,79
168187,2019-10-29 00:00:00+03:00,out,True,937752,True,1,0,25,25
168187,2019-10-29 00:00:00+03:00,in,False,937762,False,2,63,94,31
168187,2019-10-29 00:00:00+03:00,out,False,937966,True,36,0,766,766
168187,2019-10-29 00:00:00+03:00,out,False,937988,True,7,0,174,174
168187,2019-10-29 00:00:00+03:00,out,False,937812,False,7,666,815,149
168187,2019-10-29 00:00:00+03:00,out,False,937708,True,13,0,410,410
168187,2019-10-29 00:00:00+03:00,out,False,937980,True,30,0,911,911
168187,2019-10-29 00:00:00+03:00,in,False,-1,True,43,0,1346,1346
168187,2019-10-29 00:00:00+03:00,in,False,937736,False,6,897,953,56
168187,2019-10-29 00:00:00+03:00,out,False,937782,False,1,3,43,40
168187,2019-10-29 00:00:00+03:00,out,False,937810,False,10,298,480,182
168187,2019-10-29 00:00:00+03:00,out,False,937752,False,11,685,844,159
168187,2019-10-29 00:00:00+03:00,out,False,937750,True,1,0,3,3
168187,2019-10-29 00:00:00+03:00,in,False,937868,False,2,146,189,43
168187,2019-10-29 00:00:00+03:00,out,False,937762,False,4,149,232,83
168187,2019-10-29 00:00:00+03:00,in,False,937956,False,10,1532,1551,19
168187,2019-10-29 00:00:00+03:00,out,False,937812,True,7,0,301,301
168187,2019-10-29 00:00:00+03:00,out,False,937678,True,10,0,276,276
168187,2019-10-29 00:00:00+03:00,out,False,937732,True,3,0,62,62
168187,2019-10-29 00:00:00+03:00,in,False,937750,False,4,588,621,33
168187,2019-10-29 00:00:00+03:00,out,False,937808,True,26,0,785,785
168187,2019-10-29 00:00:00+03:00,out,False,937980,False,22,1408,1901,493
168187,2019-10-29 00:00:00+03:00,out,False,937736,True,13,0,403,403
168187,2019-10-29 00:00:00+03:00,out,False,937854,False,17,810,1116,306
168187,2019-10-29 00:00:00+03:00,in,False,937888,False,7,607,666,59
168187,2019-10-29 00:00:00+03:00,out,False,937708,False,20,957,1404,447
168187,2019-10-29 00:00:00+03:00,out,True,937808,True,9,0,44,44
168187,2019-10-29 00:00:00+03:00,out,False,937868,False,14,3587,3843,256
168187,2019-10-29 00:00:00+03:00,out,False,937762,True,2,0,108,108
168187,2019-10-29 00:00:00+03:00,out,False,937862,False,7,1095,1212,117
168187,2019-10-29 00:00:00+03:00,out,False,937888,True,26,0,735,735
168187,2019-10-29 00:00:00+03:00,out,True,937736,True,5,0,29,29
168187,2019-10-29 00:00:00+03:00,out,False,937808,False,12,600,901,301
168187,2019-10-29 00:00:00+03:00,out,True,937678,True,4,0,0,0
168187,2019-10-29 00:00:00+03:00,in,False,937980,False,6,203,245,42
168187,2019-10-29 00:00:00+03:00,in,False,-1,True,1,0,1,1
168187,2019-10-29 00:00:00+03:00,in,False,937808,False,3,306,326,20
168187,2019-10-29 00:00:00+03:00,out,False,937888,False,21,704,1180,476
168187,2019-10-29 00:00:00+03:00,out,False,937788,False,5,545,635,90
168187,2019-10-29 00:00:00+03:00,out,False,937868,False,14,3587,3843,256
168187,2019-10-29 00:00:00+03:00,in,False,937788,False,4,406,470,64
168187,2019-10-29 00:00:00+03:00,in,False,937750,False,4,588,621,33
168187,2019-10-29 00:00:00+03:00,out,False,937808,False,12,600,901,301
168187,2019-10-29 00:00:00+03:00,out,False,937760,False,8,540,691,151
168187,2019-10-29 00:00:00+03:00,in,False,-1,True,1,0,1,1
168187,2019-10-30 00:00:00+03:00,out,False,937980,False,9,2447,2531,84
168187,2019-10-30 00:00:00+03:00,out,True,937720,False,1,9,45,36
168187,2019-10-30 00:00:00+03:00,out,False,937782,True,2,0,49,49
168187,2019-10-30 00:00:00+03:00,in,False,-1,True,61,0,2180,2180
168187,2019-10-30 00:00:00+03:00,out,False,937808,False,25,1931,2472,541
168187,2019-10-30 00:00:00+03:00,out,False,937868,False,10,1060,1282,222
168187,2019-10-30 00:00:00+03:00,out,False,937902,True,7,0,194,194
168187,2019-10-30 00:00:00+03:00,out,True,937984,True,1,0,0,0
168187,2019-10-30 00:00:00+03:00,in,False,937854,False,6,241,289,48
168187,2019-10-30 00:00:00+03:00,in,False,937960,False,8,1031,1108,77
168187,2019-10-30 00:00:00+03:00,in,False,937736,True,1,0,20,20
168187,2019-10-30 00:00:00+03:00,out,False,937902,False,18,3570,3926,356
168187,2019-10-30 00:00:00+03:00,out,False,937860,False,20,1589,1971,382
168187,2019-10-30 00:00:00+03:00,out,False,937862,True,5,0,52,52
168187,2019-10-30 00:00:00+03:00,out,False,937732,False,1,158,177,19
168187,2019-10-30 00:00:00+03:00,out,False,937788,True,14,0,297,297
168187,2019-10-30 00:00:00+03:00,in,False,937980,False,3,239,288,49
168187,2019-10-30 00:00:00+03:00,in,False,937752,False,13,929,1030,101
168187,2019-10-30 00:00:00+03:00,out,False,937788,False,14,802,1130,328
168187,2019-10-30 00:00:00+03:00,out,False,937708,True,7,0,246,246
168187,2019-10-30 00:00:00+03:00,in,False,937762,False,1,15,25,10
168187,2019-10-30 00:00:00+03:00,out,False,937860,True,18,0,389,389
168187,2019-10-30 00:00:00+03:00,out,False,937854,True,11,0,284,284
168187,2019-10-30 00:00:00+03:00,in,False,937788,False,7,192,258,66
168187,2019-10-30 00:00:00+03:00,out,False,937780,False,11,591,836,245
168187,2019-10-30 00:00:00+03:00,out,False,937988,False,8,405,596,191
168187,2019-10-30 00:00:00+03:00,in,False,937862,False,5,903,959,56
168187,2019-10-30 00:00:00+03:00,out,False,937888,False,26,1928,2386,458
168187,2019-10-30 00:00:00+03:00,in,False,937860,False,10,1638,1729,91
168187,2019-10-30 00:00:00+03:00,out,False,937782,False,1,56,74,18
168187,2019-10-30 00:00:00+03:00,in,False,937956,False,16,2044,2080,36
168187,2019-10-30 00:00:00+03:00,in,False,937988,False,6,777,823,46
168187,2019-10-30 00:00:00+03:00,out,False,937752,False,41,1993,2675,682
168187,2019-10-30 00:00:00+03:00,out,False,937988,True,6,0,232,232
168187,2019-10-30 00:00:00+03:00,out,True,937710,True,1,0,15,15
168187,2019-10-30 00:00:00+03:00,in,False,948286,False,9,1174,1348,174
168187,2019-10-30 00:00:00+03:00,out,False,937980,True,1,0,27,27
168187,2019-10-30 00:00:00+03:00,in,False,937736,False,7,834,944,110
168187,2019-10-30 00:00:00+03:00,in,False,937780,False,1,25,31,6
168187,2019-10-30 00:00:00+03:00,in,False,937760,False,7,814,884,70
168187,2019-10-30 00:00:00+03:00,in,False,937810,False,2,193,218,25
168187,2019-10-30 00:00:00+03:00,out,False,937966,False,9,2070,2241,171
168187,2019-10-30 00:00:00+03:00,out,False,937856,False,1,2,41,39
168187,2019-10-30 00:00:00+03:00,out,False,937736,False,8,1043,1225,182
168187,2019-10-30 00:00:00+03:00,out,False,937732,True,1,0,5,5
168187,2019-10-30 00:00:00+03:00,out,False,937966,True,28,0,566,566
168187,2019-10-30 00:00:00+03:00,out,False,937752,True,49,0,1037,1037
168187,2019-10-30 00:00:00+03:00,in,False,937888,False,3,296,327,31
168187,2019-10-30 00:00:00+03:00,out,False,937760,True,8,0,132,132
168187,2019-10-30 00:00:00+03:00,out,False,937780,True,18,0,521,521
168187,2019-10-30 00:00:00+03:00,out,False,937762,True,2,0,105,105
168187,2019-10-30 00:00:00+03:00,in,False,937812,False,4,552,601,49
168187,2019-10-30 00:00:00+03:00,out,False,937678,False,1,35,52,17
168187,2019-10-30 00:00:00+03:00,in,False,937868,False,1,39,49,10
168187,2019-10-30 00:00:00+03:00,out,False,937708,False,10,647,909,262
168187,2019-10-30 00:00:00+03:00,out,False,937854,False,15,661,863,202
168187,2019-10-30 00:00:00+03:00,out,False,937678,True,2,0,59,59
168187,2019-10-30 00:00:00+03:00,in,False,937732,False,3,595,630,35
168187,2019-10-30 00:00:00+03:00,out,False,937888,True,16,0,649,649
168187,2019-10-30 00:00:00+03:00,out,False,937808,True,20,0,527,527
168187,2019-10-30 00:00:00+03:00,in,False,937962,False,8,705,822,117
168187,2019-10-30 00:00:00+03:00,out,False,937810,False,6,513,635,122
168187,2019-10-30 00:00:00+03:00,out,False,937810,True,6,0,124,124
168187,2019-10-30 00:00:00+03:00,in,False,937678,False,1,42,50,8
168187,2019-10-30 00:00:00+03:00,in,False,937708,False,3,1210,1229,19
168187,2019-10-30 00:00:00+03:00,out,False,937762,False,2,59,101,42
168187,2019-10-30 00:00:00+03:00,out,False,937760,False,9,487,634,147
168187,2019-10-30 00:00:00+03:00,out,False,937862,False,9,685,841,156
168187,2019-10-30 00:00:00+03:00,out,False,937736,True,14,0,465,465
168187,2019-10-30 00:00:00+03:00,in,False,937808,False,6,898,946,48
168187,2019-10-30 00:00:00+03:00,out,False,937812,False,3,702,775,73
168187,2019-10-30 00:00:00+03:00,in,False,937880,False,1,15,21,6
168187,2019-10-30 00:00:00+03:00,in,False,937958,False,14,1548,1646,98
168187,2019-10-30 00:00:00+03:00,out,False,937868,True,3,0,119,119
168187,2019-10-30 00:00:00+03:00,in,True,937956,False,1,4,5,1
168187,2019-10-30 00:00:00+03:00,in,False,937678,False,1,42,50,8
168187,2019-10-30 00:00:00+03:00,out,False,937732,False,1,158,177,19
168187,2019-10-30 00:00:00+03:00,in,False,937868,False,1,39,49,10
168187,2019-10-30 00:00:00+03:00,out,False,937678,True,2,0,59,59
168187,2019-10-30 00:00:00+03:00,in,False,937760,False,7,814,884,70
168187,2019-10-30 00:00:00+03:00,out,False,937810,False,6,513,635,122
168187,2019-10-30 00:00:00+03:00,out,False,937856,False,1,2,41,39
168187,2019-10-31 00:00:00+03:00,out,False,937888,False,19,989,1353,364
168187,2019-10-31 00:00:00+03:00,in,False,937902,False,4,293,319,26
168187,2019-10-31 00:00:00+03:00,in,False,937736,False,16,1034,1175,141
168187,2019-10-31 00:00:00+03:00,out,False,937810,False,3,97,183,86
168187,2019-10-31 00:00:00+03:00,out,False,937902,False,16,2491,2879,388
168187,2019-10-31 00:00:00+03:00,in,False,937808,False,6,822,864,42
168187,2019-10-31 00:00:00+03:00,in,False,937888,False,3,189,216,27
168187,2019-10-31 00:00:00+03:00,out,False,937782,True,1,0,16,16
168187,2019-10-31 00:00:00+03:00,out,False,937762,True,2,0,130,130
168187,2019-10-31 00:00:00+03:00,in,False,-1,True,72,0,4139,4139
168187,2019-10-31 00:00:00+03:00,in,False,937788,False,4,158,208,50
168187,2019-10-31 00:00:00+03:00,out,False,937862,True,1,0,39,39
168187,2019-10-31 00:00:00+03:00,in,False,937860,False,5,379,412,33
168187,2019-10-31 00:00:00+03:00,out,True,937980,False,1,225,246,21
168187,2019-10-31 00:00:00+03:00,in,False,937868,False,2,102,134,32
168187,2019-10-31 00:00:00+03:00,out,False,937966,True,23,0,459,459
168187,2019-10-31 00:00:00+03:00,out,False,937966,False,17,828,1168,340
168187,2019-10-31 00:00:00+03:00,out,False,937752,True,38,0,758,758
168187,2019-10-31 00:00:00+03:00,out,False,937736,False,11,494,733,239
168187,2019-10-31 00:00:00+03:00,out,False,937780,True,6,0,218,218
168187,2019-10-31 00:00:00+03:00,in,False,937958,False,7,642,687,45
168187,2019-10-31 00:00:00+03:00,out,False,937788,True,5,0,118,118
168187,2019-10-31 00:00:00+03:00,in,False,937760,False,15,992,1232,240
168187,2019-10-31 00:00:00+03:00,out,False,937808,True,17,0,525,525
168187,2019-10-31 00:00:00+03:00,out,False,937736,True,22,0,689,689
168187,2019-10-31 00:00:00+03:00,in,False,937862,False,5,1214,1256,42
168187,2019-10-31 00:00:00+03:00,in,False,937732,False,3,376,446,70
168187,2019-10-31 00:00:00+03:00,in,False,937988,False,3,254,290,36
168187,2019-10-31 00:00:00+03:00,out,False,937812,False,1,5,6,1
168187,2019-10-31 00:00:00+03:00,in,False,937708,False,5,1878,2049,171
168187,2019-10-31 00:00:00+03:00,out,False,937988,True,7,0,235,235
168187,2019-10-31 00:00:00+03:00,in,False,-1,True,1,0,70,70
168187,2019-10-31 00:00:00+03:00,in,False,937780,False,4,424,469,45
168187,2019-10-31 00:00:00+03:00,out,False,937760,False,13,723,938,215
168187,2019-10-31 00:00:00+03:00,out,False,937780,False,8,233,430,197
168187,2019-10-31 00:00:00+03:00,out,False,937760,True,14,0,255,255
168187,2019-10-31 00:00:00+03:00,in,False,937966,False,10,966,1026,60
168187,2019-10-31 00:00:00+03:00,out,False,937860,False,15,547,843,296
168187,2019-10-31 00:00:00+03:00,in,False,937980,False,7,558,632,74
168187,2019-10-31 00:00:00+03:00,out,False,937708,False,6,222,396,174
168187,2019-10-31 00:00:00+03:00,out,False,937854,True,5,0,163,163
168187,2019-10-31 00:00:00+03:00,in,False,937856,False,4,105,135,30
168187,2019-10-31 00:00:00+03:00,in,False,937956,False,29,1800,1824,24
168187,2019-10-31 00:00:00+03:00,out,False,937856,False,1,24,50,26
168187,2019-10-31 00:00:00+03:00,out,False,937772,True,1,0,18,18
168187,2019-10-31 00:00:00+03:00,out,False,937988,False,8,304,473,169
168187,2019-10-31 00:00:00+03:00,in,False,937762,False,1,218,227,9
168187,2019-10-31 00:00:00+03:00,out,False,937708,True,7,0,246,246
168187,2019-10-31 00:00:00+03:00,out,False,937854,False,12,469,650,181
168187,2019-10-31 00:00:00+03:00,out,False,937868,True,4,0,109,109
168187,2019-10-31 00:00:00+03:00,out,False,937762,False,3,430,514,84
168187,2019-10-31 00:00:00+03:00,out,False,937808,False,19,738,1168,430
168187,2019-10-31 00:00:00+03:00,in,False,937752,False,14,4430,4563,133
168187,2019-10-31 00:00:00+03:00,out,False,937868,False,7,385,533,148
168187,2019-10-31 00:00:00+03:00,out,False,937862,False,5,929,1073,144
168187,2019-10-31 00:00:00+03:00,in,False,948286,False,3,153,210,57
168187,2019-10-31 00:00:00+03:00,out,False,937980,False,5,674,719,45
168187,2019-10-31 00:00:00+03:00,in,False,937960,False,3,604,637,33
168187,2019-10-31 00:00:00+03:00,out,False,937752,False,37,3409,4011,602
168187,2019-10-31 00:00:00+03:00,in,False,937810,False,4,1486,1530,44
168187,2019-10-31 00:00:00+03:00,out,False,937810,True,4,0,173,173
168187,2019-10-31 00:00:00+03:00,in,False,937854,False,4,304,351,47
168187,2019-10-31 00:00:00+03:00,in,False,937812,False,1,15,23,8
168187,2019-10-31 00:00:00+03:00,out,False,937812,True,3,0,72,72
168187,2019-10-31 00:00:00+03:00,out,False,937902,True,22,0,823,823
168187,2019-10-31 00:00:00+03:00,out,False,937860,True,23,0,547,547
168187,2019-10-31 00:00:00+03:00,in,False,937750,False,1,14,24,10
168187,2019-10-31 00:00:00+03:00,out,False,937788,False,5,119,238,119
168187,2019-10-31 00:00:00+03:00,out,False,937888,True,11,0,314,314
168187,2019-10-31 00:00:00+03:00,in,False,937736,False,16,1034,1175,141
168187,2019-10-31 00:00:00+03:00,in,False,937862,False,5,1214,1256,42
168187,2019-10-31 00:00:00+03:00,out,False,937782,True,1,0,16,16
168187,2019-10-31 00:00:00+03:00,out,False,937854,True,5,0,163,163
168187,2019-10-31 00:00:00+03:00,out,False,937752,False,37,3409,4011,602
168187,2019-10-31 00:00:00+03:00,out,False,937810,True,4,0,173,173
168187,2019-11-01 00:00:00+03:00,in,False,937902,False,5,446,490,44
168187,2019-11-01 00:00:00+03:00,out,False,937782,True,1,0,49,49
168187,2019-11-01 00:00:00+03:00,in,False,937732,False,2,533,561,28
168187,2019-11-01 00:00:00+03:00,out,False,937966,False,5,573,668,95
168187,2019-11-01 00:00:00+03:00,out,False,937854,True,8,0,139,139
168187,2019-11-01 00:00:00+03:00,in,False,937782,False,2,153,171,18
168187,2019-11-01 00:00:00+03:00,out,False,937988,True,5,0,167,167
168187,2019-11-01 00:00:00+03:00,in,False,937960,False,3,637,640,3
168187,2019-11-01 00:00:00+03:00,out,False,937856,False,1,46,65,19
168187,2019-11-01 00:00:00+03:00,out,False,937860,False,11,1548,1770,222
168187,2019-11-01 00:00:00+03:00,in,False,937862,False,5,521,582,61
168187,2019-11-01 00:00:00+03:00,in,False,937956,False,19,1205,1222,17
168187,2019-11-01 00:00:00+03:00,out,False,937780,False,9,903,1132,229
168187,2019-11-01 00:00:00+03:00,out,False,937888,False,18,655,1111,456
168187,2019-11-01 00:00:00+03:00,in,False,937808,False,3,184,206,22
168187,2019-11-01 00:00:00+03:00,in,False,937966,False,5,897,968,71
168187,2019-11-01 00:00:00+03:00,out,False,937862,False,3,185,229,44
168187,2019-11-01 00:00:00+03:00,in,False,937984,False,3,54,78,24
168187,2019-11-01 00:00:00+03:00,out,False,937752,False,19,739,1080,341
168187,2019-11-01 00:00:00+03:00,out,False,937902,True,18,0,351,351
168187,2019-11-01 00:00:00+03:00,out,False,937868,False,1,34,55,21
168187,2019-11-01 00:00:00+03:00,out,False,937808,True,7,0,250,250
168187,2019-11-01 00:00:00+03:00,out,False,937708,True,6,0,168,168
168187,2019-11-01 00:00:00+03:00,out,False,937860,True,7,0,165,165
168187,2019-11-01 00:00:00+03:00,in,False,937888,False,3,675,703,28
168187,2019-11-01 00:00:00+03:00,in,False,937868,False,7,767,824,57
168187,2019-11-01 00:00:00+03:00,out,False,937966,True,11,0,265,265
168187,2019-11-01 00:00:00+03:00,in,False,937958,False,7,873,905,32
168187,2019-11-01 00:00:00+03:00,in,False,937708,False,5,833,868,35
168187,2019-11-01 00:00:00+03:00,out,False,937678,False,1,3,11,8
168187,2019-11-01 00:00:00+03:00,out,False,937980,False,3,18,155,137
168187,2019-11-01 00:00:00+03:00,out,False,937760,False,3,24,84,60
168187,2019-11-01 00:00:00+03:00,out,False,937782,False,1,2,43,41
168187,2019-11-01 00:00:00+03:00,in,False,948286,False,4,240,324,84
168187,2019-11-01 00:00:00+03:00,out,False,937752,True,34,0,468,468
168187,2019-11-01 00:00:00+03:00,in,False,937752,False,22,1327,1482,155
168187,2019-11-01 00:00:00+03:00,out,False,937762,False,1,3,42,39
168187,2019-11-01 00:00:00+03:00,out,False,937732,True,5,0,130,130
168187,2019-11-01 00:00:00+03:00,out,False,937808,False,12,192,484,292
168187,2019-11-01 00:00:00+03:00,out,False,937708,False,12,240,465,225
168187,2019-11-01 00:00:00+03:00,out,False,937854,False,12,839,1050,211
168187,2019-11-01 00:00:00+03:00,in,False,937736,False,10,628,718,90
168187,2019-11-01 00:00:00+03:00,out,False,937760,True,12,0,192,192
168187,2019-11-01 00:00:00+03:00,out,True,937780,True,1,0,0,0
168187,2019-11-01 00:00:00+03:00,out,False,937736,True,14,0,318,318
168187,2019-11-01 00:00:00+03:00,out,False,937862,True,6,0,145,145
168187,2019-11-01 00:00:00+03:00,out,False,937810,False,5,119,192,73
168187,2019-11-01 00:00:00+03:00,in,False,937760,False,6,260,330,70
168187,2019-11-01 00:00:00+03:00,out,False,937988,False,1,193,207,14
168187,2019-11-01 00:00:00+03:00,out,False,937888,True,33,0,804,804
168187,2019-11-01 00:00:00+03:00,out,False,937812,False,1,6,40,34
168187,2019-11-01 00:00:00+03:00,in,False,937880,False,1,17,26,9
168187,2019-11-01 00:00:00+03:00,in,False,937812,False,3,575,624,49
168187,2019-11-01 00:00:00+03:00,in,False,937988,False,4,219,245,26
168187,2019-11-01 00:00:00+03:00,out,False,937780,True,13,0,339,339
168187,2019-11-01 00:00:00+03:00,in,False,937810,False,2,126,141,15
168187,2019-11-01 00:00:00+03:00,in,False,937854,False,3,147,190,43
168187,2019-11-01 00:00:00+03:00,in,False,937780,False,5,631,678,47
168187,2019-11-01 00:00:00+03:00,in,False,937980,False,4,1071,1117,46
168187,2019-11-01 00:00:00+03:00,out,False,937810,True,3,0,133,133
168187,2019-11-01 00:00:00+03:00,out,False,937736,False,11,950,1158,208
168187,2019-11-01 00:00:00+03:00,in,False,937860,False,4,627,659,32
168187,2019-11-01 00:00:00+03:00,out,False,937678,True,2,0,36,36
168187,2019-11-01 00:00:00+03:00,out,False,937902,False,18,655,1077,422
168187,2019-11-01 00:00:00+03:00,out,False,937980,True,4,0,63,63
168187,2019-11-01 00:00:00+03:00,in,False,-1,True,95,0,2654,2654
168187,2019-11-01 00:00:00+03:00,out,False,937732,False,2,161,210,49
168187,2019-11-01 00:00:00+03:00,in,False,937966,True,1,0,13,13
168187,2019-11-01 00:00:00+03:00,out,False,937752,False,19,739,1080,341
168187,2019-11-01 00:00:00+03:00,in,False,937984,False,3,54,78,24
168187,2019-11-01 00:00:00+03:00,in,False,937966,True,1,0,13,13
168187,2019-11-01 00:00:00+03:00,in,False,937860,False,4,627,659,32
168187,2019-11-01 00:00:00+03:00,in,False,937980,False,4,1071,1117,46
168187,2019-11-02 00:00:00+03:00,in,False,937810,False,1,222,236,14
168187,2019-11-02 00:00:00+03:00,in,False,937708,False,1,134,144,10
168187,2019-11-02 00:00:00+03:00,in,False,-1,True,7,0,196,196
168187,2019-11-02 00:00:00+03:00,in,False,937956,False,15,796,808,12
168187,2019-11-02 00:00:00+03:00,in,False,937958,False,2,112,131,19
168187,2019-11-02 00:00:00+03:00,in,False,937962,False,7,940,1052,112
168187,2019-11-02 00:00:00+03:00,in,False,948286,False,9,805,993,188
168187,2019-11-02 00:00:00+03:00,in,False,937960,False,3,1089,1121,32
168187,2019-11-03 00:00:00+03:00,in,False,937958,False,4,540,563,23
168187,2019-11-03 00:00:00+03:00,in,False,-1,True,3,0,21,21
168187,2019-11-03 00:00:00+03:00,in,False,937956,False,8,275,289,14
168187,2019-11-03 00:00:00+03:00,in,False,948286,False,4,560,643,83
168187,2019-11-03 00:00:00+03:00,in,False,937960,False,3,695,727,32
168187,2019-11-03 00:00:00+03:00,in,False,937762,False,1,411,432,21
168187,2019-11-04 00:00:00+03:00,in,False,937956,False,7,115,121,6
168187,2019-11-04 00:00:00+03:00,in,False,-1,True,11,0,119,119
168187,2019-11-04 00:00:00+03:00,in,False,937958,False,1,28,34,6
168187,2019-11-05 00:00:00+03:00,in,False,937736,False,9,402,513,111
168187,2019-11-05 00:00:00+03:00,out,False,937988,False,5,523,614,91
168187,2019-11-05 00:00:00+03:00,in,False,937864,False,4,680,787,107
168187,2019-11-05 00:00:00+03:00,out,False,937888,False,16,1439,1744,305
168187,2019-11-05 00:00:00+03:00,out,False,937862,True,3,0,116,116
168187,2019-11-05 00:00:00+03:00,in,False,937762,False,3,173,209,36
168187,2019-11-05 00:00:00+03:00,out,False,937860,True,54,0,1573,1573
168187,2019-11-05 00:00:00+03:00,out,False,937760,True,16,0,279,279
168187,2019-11-05 00:00:00+03:00,in,False,937868,False,1,5,13,8
168187,2019-11-05 00:00:00+03:00,in,False,-1,True,87,0,2341,2341
168187,2019-11-05 00:00:00+03:00,out,False,937854,True,5,0,34,34
168187,2019-11-05 00:00:00+03:00,out,False,937888,True,14,0,490,490
168187,2019-11-05 00:00:00+03:00,out,False,937812,False,1,1,39,38
168187,2019-11-05 00:00:00+03:00,out,False,937902,False,11,1120,1371,251
168187,2019-11-05 00:00:00+03:00,in,False,937708,False,4,1185,1209,24
168187,2019-11-05 00:00:00+03:00,in,False,937888,False,6,297,338,41
168187,2019-11-05 00:00:00+03:00,out,False,937980,False,5,832,890,58
168187,2019-11-05 00:00:00+03:00,in,False,937760,False,9,677,909,232
168187,2019-11-05 00:00:00+03:00,out,False,937762,False,1,40,53,13
168187,2019-11-05 00:00:00+03:00,in,False,937788,False,7,480,592,112
168187,2019-11-05 00:00:00+03:00,out,False,937810,True,13,0,421,421
168187,2019-11-05 00:00:00+03:00,out,False,937736,True,32,0,872,872
168187,2019-11-05 00:00:00+03:00,out,True,937810,False,1,33,43,10
168187,2019-11-05 00:00:00+03:00,out,False,-1,True,1,0,0,0
168187,2019-11-05 00:00:00+03:00,out,False,937966,True,1,0,5,5
168187,2019-11-05 00:00:00+03:00,out,False,937980,True,7,0,187,187
168187,2019-11-05 00:00:00+03:00,in,False,937732,False,5,456,559,103
168187,2019-11-05 00:00:00+03:00,in,False,937810,False,5,196,227,31
168187,2019-11-05 00:00:00+03:00,out,True,937810,True,1,0,32,32
168187,2019-11-05 00:00:00+03:00,in,False,948286,False,4,344,407,63
168187,2019-11-05 00:00:00+03:00,out,False,937860,False,37,2854,3572,718
168187,2019-11-05 00:00:00+03:00,out,False,937808,True,20,0,457,457
168187,2019-11-05 00:00:00+03:00,in,False,937960,False,1,86,87,1
168187,2019-11-05 00:00:00+03:00,in,False,937862,False,6,1536,1600,64
168187,2019-11-05 00:00:00+03:00,out,False,937862,False,2,376,415,39
168187,2019-11-05 00:00:00+03:00,in,True,948286,False,1,6,27,21
168187,2019-11-05 00:00:00+03:00,in,False,937958,False,2,355,362,7
168187,2019-11-05 00:00:00+03:00,in,False,937966,False,13,1564,1683,119
168187,2019-11-05 00:00:00+03:00,in,False,937812,False,3,534,570,36
168187,2019-11-05 00:00:00+03:00,in,False,937962,False,7,969,1081,112
168187,2019-11-05 00:00:00+03:00,in,False,-1,True,5,0,148,148
168187,2019-11-05 00:00:00+03:00,out,False,937752,True,53,0,856,856
168187,2019-11-05 00:00:00+03:00,out,False,937678,False,3,394,449,55
168187,2019-11-05 00:00:00+03:00,in,False,937902,False,5,354,466,112
168187,2019-11-05 00:00:00+03:00,out,False,937868,False,7,1380,1551,171
168187,2019-11-05 00:00:00+03:00,out,False,937808,False,16,1128,1466,338
168187,2019-11-05 00:00:00+03:00,out,False,937732,True,5,0,11,11
168187,2019-11-05 00:00:00+03:00,out,False,937788,True,8,0,225,225
168187,2019-11-05 00:00:00+03:00,out,False,937760,False,9,274,399,125
168187,2019-11-05 00:00:00+03:00,out,False,937752,False,44,10369,11096,727
168187,2019-11-05 00:00:00+03:00,in,False,937988,False,1,95,104,9
168187,2019-11-05 00:00:00+03:00,in,False,937980,False,5,330,376,46
168187,2019-11-05 00:00:00+03:00,in,False,937752,False,7,571,632,61
168187,2019-11-05 00:00:00+03:00,out,False,937856,True,1,0,6,6
168187,2019-11-05 00:00:00+03:00,out,False,937854,False,6,1041,1136,95
168187,2019-11-05 00:00:00+03:00,out,False,937868,True,5,0,188,188
168187,2019-11-05 00:00:00+03:00,out,False,937736,False,26,976,1468,492
168187,2019-11-05 00:00:00+03:00,out,False,937902,True,8,0,197,197
168187,2019-11-05 00:00:00+03:00,out,False,937708,True,12,0,240,240
168187,2019-11-05 00:00:00+03:00,in,False,937782,False,1,7,15,8
168187,2019-11-05 00:00:00+03:00,out,False,937966,False,8,1116,1248,132
168187,2019-11-05 00:00:00+03:00,out,False,937988,True,5,0,260,260
168187,2019-11-05 00:00:00+03:00,out,False,937788,False,7,691,847,156
168187,2019-11-05 00:00:00+03:00,out,False,937732,False,4,454,504,50
168187,2019-11-05 00:00:00+03:00,in,False,937854,False,5,330,371,41
168187,2019-11-05 00:00:00+03:00,out,False,937812,True,1,0,36,36
168187,2019-11-05 00:00:00+03:00,out,False,937782,False,2,38,68,30
168187,2019-11-05 00:00:00+03:00,out,False,937708,False,14,491,815,324
168187,2019-11-05 00:00:00+03:00,out,False,937870,True,2,0,20,20
168187,2019-11-05 00:00:00+03:00,in,False,937860,False,15,1301,1411,110
168187,2019-11-05 00:00:00+03:00,out,True,937980,True,2,0,21,21
168187,2019-11-05 00:00:00+03:00,out,False,937678,True,6,0,161,161
168187,2019-11-05 00:00:00+03:00,in,False,937956,False,14,1500,1516,16
168187,2019-11-05 00:00:00+03:00,in,False,937808,False,10,1008,1102,94
168187,2019-11-05 00:00:00+03:00,in,True,937980,False,1,27,34,7
168187,2019-11-05 00:00:00+03:00,out,False,937810,False,4,386,461,75
168187,2019-11-05 00:00:00+03:00,in,False,937742,False,1,23,44,21
168187,2019-11-05 00:00:00+03:00,in,False,937780,False,1,65,81,16
168187,2019-11-05 00:00:00+03:00,out,False,937888,False,16,1439,1744,305
168187,2019-11-05 00:00:00+03:00,out,False,937678,False,3,394,449,55
168187,2019-11-05 00:00:00+03:00,in,False,937808,False,10,1008,1102,94
168187,2019-11-05 00:00:00+03:00,out,False,937854,True,5,0,34,34
168187,2019-11-05 00:00:00+03:00,out,False,937966,True,1,0,5,5
168187,2019-11-05 00:00:00+03:00,in,False,937780,False,1,65,81,16
168187,2019-11-05 00:00:00+03:00,in,False,937810,False,5,196,227,31
168187,2019-11-05 00:00:00+03:00,in,False,937988,False,1,95,104,9
168187,2019-11-05 00:00:00+03:00,out,False,937902,True,8,0,197,197
168187,2019-11-05 00:00:00+03:00,out,False,937810,True,13,0,421,421
168187,2019-11-06 00:00:00+03:00,in,False,937708,False,7,677,723,46
168187,2019-11-06 00:00:00+03:00,in,False,937854,False,5,919,955,36
168187,2019-11-06 00:00:00+03:00,in,False,937864,False,5,434,476,42
168187,2019-11-06 00:00:00+03:00,in,False,937780,False,3,199,222,23
168187,2019-11-06 00:00:00+03:00,in,False,937860,True,1,1,8,7
168187,2019-11-06 00:00:00+03:00,out,False,937854,True,7,0,183,183
168187,2019-11-06 00:00:00+03:00,in,False,937752,False,10,973,1052,79
168187,2019-11-06 00:00:00+03:00,in,False,937988,False,2,383,397,14
168187,2019-11-06 00:00:00+03:00,out,False,937902,False,14,1816,2079,263
168187,2019-11-06 00:00:00+03:00,in,True,937960,False,1,9,20,11
168187,2019-11-06 00:00:00+03:00,in,False,937960,False,2,949,961,12
168187,2019-11-06 00:00:00+03:00,out,False,937810,False,5,96,187,91
168187,2019-11-06 00:00:00+03:00,in,False,937812,False,5,494,572,78
168187,2019-11-06 00:00:00+03:00,out,False,937708,False,10,518,765,247
168187,2019-11-06 00:00:00+03:00,out,False,937810,True,10,0,297,297
168187,2019-11-06 00:00:00+03:00,out,False,937966,True,21,0,484,484
168187,2019-11-06 00:00:00+03:00,out,False,937732,False,3,301,372,71
168187,2019-11-06 00:00:00+03:00,out,False,937782,True,1,0,42,42
168187,2019-11-06 00:00:00+03:00,out,False,937860,False,35,2034,2626,592
168187,2019-11-06 00:00:00+03:00,in,False,937760,False,10,837,952,115
168187,2019-11-06 00:00:00+03:00,out,False,937988,True,2,0,71,71
168187,2019-11-06 00:00:00+03:00,out,False,937902,True,16,0,506,506
168187,2019-11-06 00:00:00+03:00,in,False,937788,False,3,907,934,27
168187,2019-11-06 00:00:00+03:00,out,False,937966,False,21,1383,1770,387
168187,2019-11-06 00:00:00+03:00,out,False,937678,False,1,28,43,15
168187,2019-11-06 00:00:00+03:00,out,False,937788,True,7,0,109,109
168187,2019-11-06 00:00:00+03:00,out,False,937762,True,5,0,214,214
168187,2019-11-06 00:00:00+03:00,out,False,937854,False,6,248,365,117
168187,2019-11-06 00:00:00+03:00,in,False,937958,False,8,1125,1158,33
168187,2019-11-06 00:00:00+03:00,in,False,937862,False,1,156,170,14
168187,2019-11-06 00:00:00+03:00,in,False,-1,True,2,0,168,168
168187,2019-11-06 00:00:00+03:00,out,False,937752,False,20,1012,1297,285
168187,2019-11-06 00:00:00+03:00,in,False,937980,False,7,494,591,97
168187,2019-11-06 00:00:00+03:00,in,False,937810,False,5,184,225,41
168187,2019-11-06 00:00:00+03:00,in,False,937860,False,2,123,135,12
168187,2019-11-06 00:00:00+03:00,out,True,937780,True,2,0,22,22
168187,2019-11-06 00:00:00+03:00,in,False,937808,False,6,511,587,76
168187,2019-11-06 00:00:00+03:00,out,False,937760,True,11,0,210,210
168187,2019-11-06 00:00:00+03:00,out,False,937732,True,5,0,108,108
168187,2019-11-06 00:00:00+03:00,out,False,937752,True,64,0,1221,1221
168187,2019-11-06 00:00:00+03:00,in,False,937732,False,3,305,341,36
168187,2019-11-06 00:00:00+03:00,in,False,937762,False,4,192,266,74
168187,2019-11-06 00:00:00+03:00,in,False,937736,False,8,672,778,106
168187,2019-11-06 00:00:00+03:00,out,False,937736,False,15,968,1295,327
168187,2019-11-06 00:00:00+03:00,out,False,937812,True,4,0,56,56
168187,2019-11-06 00:00:00+03:00,out,False,-1,True,1,0,0,0
168187,2019-11-06 00:00:00+03:00,in,False,-1,True,40,0,1388,1388
168187,2019-11-06 00:00:00+03:00,out,False,937888,True,26,0,739,739
168187,2019-11-06 00:00:00+03:00,out,True,937980,False,1,176,186,10
168187,2019-11-06 00:00:00+03:00,in,False,937966,False,13,922,1018,96
168187,2019-11-06 00:00:00+03:00,out,False,937888,False,25,2603,3159,556
168187,2019-11-06 00:00:00+03:00,in,False,937956,False,18,2025,2039,14
168187,2019-11-06 00:00:00+03:00,out,False,937868,True,2,0,67,67
168187,2019-11-06 00:00:00+03:00,out,False,937780,False,5,1036,1144,108
168187,2019-11-06 00:00:00+03:00,in,False,937868,False,5,937,985,48
168187,2019-11-06 00:00:00+03:00,out,False,937860,True,43,0,990,990
168187,2019-11-06 00:00:00+03:00,out,False,937780,True,2,0,46,46
168187,2019-11-06 00:00:00+03:00,out,False,937708,True,10,0,297,297
168187,2019-11-06 00:00:00+03:00,out,False,937788,False,7,1677,1812,135
168187,2019-11-06 00:00:00+03:00,in,False,937888,False,7,399,475,76
168187,2019-11-06 00:00:00+03:00,in,False,948286,False,2,64,105,41
168187,2019-11-06 00:00:00+03:00,out,False,937736,True,19,0,365,365
168187,2019-11-06 00:00:00+03:00,out,False,937762,False,6,449,647,198
168187,2019-11-06 00:00:00+03:00,out,False,937808,False,16,646,1042,396
168187,2019-11-06 00:00:00+03:00,out,False,937808,True,18,0,543,543
168187,2019-11-06 00:00:00+03:00,in,False,937902,False,14,1970,2077,107
168187,2019-11-06 00:00:00+03:00,out,False,937862,False,6,1031,1180,149
168187,2019-11-06 00:00:00+03:00,out,False,937988,False,3,239,307,68
168187,2019-11-06 00:00:00+03:00,out,False,937760,False,3,352,413,61
168187,2019-11-06 00:00:00+03:00,out,False,937862,True,4,0,25,25
168187,2019-11-06 00:00:00+03:00,out,False,937678,True,3,0,79,79
168187,2019-11-06 00:00:00+03:00,out,False,937812,False,1,179,213,34
168187,2019-11-06 00:00:00+03:00,out,False,937868,False,2,46,130,84
168187,2019-11-06 00:00:00+03:00,out,False,937762,True,5,0,214,214
168187,2019-11-06 00:00:00+03:00,out,False,937780,True,2,0,46,46
168187,2019-11-06 00:00:00+03:00,out,False,937812,False,1,179,213,34
168187,2019-11-06 00:00:00+03:00,in,False,937752,False,10,973,1052,79
168187,2019-11-06 00:00:00+03:00,in,False,937732,False,3,305,341,36
168187,2019-11-06 00:00:00+03:00,in,False,937854,False,5,919,955,36
168187,2019-11-06 00:00:00+03:00,in,False,937810,False,5,184,225,41
168187,2019-11-06 00:00:00+03:00,out,False,937780,False,5,1036,1144,108
168187,2019-11-06 00:00:00+03:00,out,False,937782,True,1,0,42,42
168187,2019-11-06 00:00:00+03:00,in,False,-1,True,2,0,168,168
168187,2019-11-07 00:00:00+03:00,out,False,937860,True,27,0,660,660
168187,2019-11-07 00:00:00+03:00,out,False,937732,True,5,0,30,30
168187,2019-11-07 00:00:00+03:00,out,False,937708,True,10,0,258,258
168187,2019-11-07 00:00:00+03:00,out,False,937810,True,3,0,70,70
168187,2019-11-07 00:00:00+03:00,out,False,937736,True,14,0,311,311
168187,2019-11-07 00:00:00+03:00,in,False,-1,True,38,0,660,660
168187,2019-11-07 00:00:00+03:00,in,False,937708,False,3,150,254,104
168187,2019-11-07 00:00:00+03:00,out,False,937788,False,8,398,541,143
168187,2019-11-07 00:00:00+03:00,out,False,937854,True,10,0,301,301
168187,2019-11-07 00:00:00+03:00,out,False,937854,False,5,397,459,62
168187,2019-11-07 00:00:00+03:00,out,False,937678,False,1,75,93,18
168187,2019-11-07 00:00:00+03:00,in,False,937736,False,10,1162,1313,151
168187,2019-11-07 00:00:00+03:00,in,False,937810,False,1,42,50,8
168187,2019-11-07 00:00:00+03:00,out,False,937868,True,3,0,86,86
168187,2019-11-07 00:00:00+03:00,out,False,937888,False,9,884,1102,218
168187,2019-11-07 00:00:00+03:00,in,True,937762,False,2,32,53,21
168187,2019-11-07 00:00:00+03:00,out,False,937966,True,20,0,503,503
168187,2019-11-07 00:00:00+03:00,in,False,948286,False,7,111,208,97
168187,2019-11-07 00:00:00+03:00,in,False,937956,False,14,2222,2240,18
168187,2019-11-07 00:00:00+03:00,out,False,937732,False,1,196,215,19
168187,2019-11-07 00:00:00+03:00,out,False,937752,False,16,2205,2453,248
168187,2019-11-07 00:00:00+03:00,out,False,937762,True,5,0,444,444
168187,2019-11-07 00:00:00+03:00,in,False,937868,False,3,179,210,31
168187,2019-11-07 00:00:00+03:00,out,False,937752,True,50,0,907,907
168187,2019-11-07 00:00:00+03:00,out,False,937708,False,8,842,1003,161
168187,2019-11-07 00:00:00+03:00,in,True,937810,False,3,177,204,27
168187,2019-11-07 00:00:00+03:00,out,False,937862,False,4,396,461,65
168187,2019-11-07 00:00:00+03:00,out,False,937810,False,5,192,309,117
168187,2019-11-07 00:00:00+03:00,in,False,937960,False,5,554,618,64
168187,2019-11-07 00:00:00+03:00,in,False,937966,False,11,863,964,101
168187,2019-11-07 00:00:00+03:00,out,False,937966,False,8,1269,1409,140
168187,2019-11-07 00:00:00+03:00,in,False,937854,False,10,1166,1265,99
168187,2019-11-07 00:00:00+03:00,out,False,937868,False,1,47,82,35
168187,2019-11-07 00:00:00+03:00,in,False,937808,False,1,141,150,9
168187,2019-11-07 00:00:00+03:00,in,True,937752,False,2,47,71,24
168187,2019-11-07 00:00:00+03:00,out,False,937988,False,3,350,428,78
168187,2019-11-07 00:00:00+03:00,in,False,-1,True,1,0,67,67
168187,2019-11-07 00:00:00+03:00,out,False,-1,True,1,0,0,0
168187,2019-11-07 00:00:00+03:00,out,False,937788,True,18,0,382,382
168187,2019-11-07 00:00:00+03:00,in,False,937860,False,9,1151,1257,106
168187,2019-11-07 00:00:00+03:00,in,False,937780,False,4,464,506,42
168187,2019-11-07 00:00:00+03:00,out,False,937862,True,2,0,53,53
168187,2019-11-07 00:00:00+03:00,out,True,937980,False,1,40,58,18
168187,2019-11-07 00:00:00+03:00,out,False,937760,False,15,754,1040,286
168187,2019-11-07 00:00:00+03:00,in,False,937980,False,2,126,157,31
168187,2019-11-07 00:00:00+03:00,in,False,937902,False,17,2194,2372,178
168187,2019-11-07 00:00:00+03:00,in,False,937732,False,1,19,31,12
168187,2019-11-07 00:00:00+03:00,out,False,937762,False,9,415,735,320
168187,2019-11-07 00:00:00+03:00,out,False,937736,False,20,532,918,386
168187,2019-11-07 00:00:00+03:00,in,False,937864,False,1,11,18,7
168187,2019-11-07 00:00:00+03:00,in,False,937742,False,1,18,30,12
168187,2019-11-07 00:00:00+03:00,out,False,937988,True,5,0,126,126
168187,2019-11-07 00:00:00+03:00,in,False,937862,False,6,1516,1582,66
168187,2019-11-07 00:00:00+03:00,out,False,937774,True,1,0,30,30
168187,2019-11-07 00:00:00+03:00,out,False,937902,False,14,755,1008,253
168187,2019-11-07 00:00:00+03:00,out,False,937808,True,28,0,594,594
168187,2019-11-07 00:00:00+03:00,in,False,937760,False,8,460,610,150
168187,2019-11-07 00:00:00+03:00,out,False,937760,True,15,0,280,280
168187,2019-11-07 00:00:00+03:00,in,False,937752,False,7,1300,1391,91
168187,2019-11-07 00:00:00+03:00,out,False,937808,False,23,719,1301,582
168187,2019-11-07 00:00:00+03:00,in,False,937958,False,3,949,962,13
168187,2019-11-07 00:00:00+03:00,in,False,937762,False,1,23,35,12
168187,2019-11-07 00:00:00+03:00,out,False,937902,True,13,0,369,369
168187,2019-11-07 00:00:00+03:00,in,False,937788,False,7,614,708,94
168187,2019-11-07 00:00:00+03:00,out,True,937854,False,1,226,242,16
168187,2019-11-07 00:00:00+03:00,in,False,937888,False,3,739,765,26
168187,2019-11-07 00:00:00+03:00,out,False,937780,False,1,108,122,14
168187,2019-11-07 00:00:00+03:00,out,False,937888,True,14,0,333,333
168187,2019-11-07 00:00:00+03:00,out,False,937860,False,16,3557,3809,252
168187,2019-11-07 00:00:00+03:00,in,False,937966,False,11,863,964,101
168187,2019-11-07 00:00:00+03:00,in,False,937762,False,1,23,35,12
168187,2019-11-07 00:00:00+03:00,out,False,937762,False,9,415,735,320
168187,2019-11-07 00:00:00+03:00,out,False,937752,False,16,2205,2453,248
168187,2019-11-08 00:00:00+03:00,in,False,937956,False,6,660,666,6
168187,2019-11-08 00:00:00+03:00,in,False,937902,False,6,1047,1134,87
168187,2019-11-08 00:00:00+03:00,in,True,937958,False,1,20,26,6
168187,2019-11-08 00:00:00+03:00,out,False,937762,True,2,0,78,78
168187,2019-11-08 00:00:00+03:00,in,False,937956,True,1,0,1,1
168187,2019-11-08 00:00:00+03:00,out,False,937966,False,1,29,46,17
168187,2019-11-08 00:00:00+03:00,out,True,937854,True,5,0,0,0
168187,2019-11-08 00:00:00+03:00,out,False,937736,False,9,195,414,219
168187,2019-11-08 00:00:00+03:00,in,False,937732,False,5,471,561,90
168187,2019-11-08 00:00:00+03:00,in,False,937888,False,13,970,1057,87
168187,2019-11-08 00:00:00+03:00,out,False,937888,True,17,0,451,451
168187,2019-11-08 00:00:00+03:00,out,False,937812,False,2,257,296,39
168187,2019-11-08 00:00:00+03:00,in,False,-1,True,63,0,1363,1363
168187,2019-11-08 00:00:00+03:00,out,False,937868,True,2,0,87,87
168187,2019-11-08 00:00:00+03:00,out,False,937966,True,11,0,267,267
168187,2019-11-08 00:00:00+03:00,out,False,937760,True,9,0,134,134
168187,2019-11-08 00:00:00+03:00,in,False,937736,False,10,753,988,235
168187,2019-11-08 00:00:00+03:00,out,False,937708,True,7,0,200,200
168187,2019-11-08 00:00:00+03:00,out,False,937788,True,11,0,263,263
168187,2019-11-08 00:00:00+03:00,out,False,937808,True,7,0,140,140
168187,2019-11-08 00:00:00+03:00,out,False,937780,False,13,594,858,264
168187,2019-11-08 00:00:00+03:00,out,False,937678,False,4,1260,1347,87
168187,2019-11-08 00:00:00+03:00,out,False,937760,False,3,178,243,65
168187,2019-11-08 00:00:00+03:00,out,False,937736,True,21,0,514,514
168187,2019-11-08 00:00:00+03:00,in,False,948286,False,8,583,689,106
168187,2019-11-08 00:00:00+03:00,in,False,937780,False,4,176,223,47
168187,2019-11-08 00:00:00+03:00,in,False,937678,False,1,129,138,9
168187,2019-11-08 00:00:00+03:00,in,False,937808,False,2,103,117,14
168187,2019-11-08 00:00:00+03:00,in,False,937980,False,4,341,386,45
168187,2019-11-08 00:00:00+03:00,in,False,937854,False,4,1074,1107,33
168187,2019-11-08 00:00:00+03:00,out,False,937752,True,33,0,662,662
168187,2019-11-08 00:00:00+03:00,out,False,937750,False,2,273,327,54
168187,2019-11-08 00:00:00+03:00,out,False,937868,False,2,904,939,35
168187,2019-11-08 00:00:00+03:00,out,False,937762,False,10,315,508,193
168187,2019-11-08 00:00:00+03:00,in,False,937762,False,4,254,301,47
168187,2019-11-08 00:00:00+03:00,in,False,937962,False,1,194,210,16
168187,2019-11-08 00:00:00+03:00,out,False,937780,True,15,0,442,442
168187,2019-11-08 00:00:00+03:00,in,False,937960,False,3,335,363,28
168187,2019-11-08 00:00:00+03:00,out,False,937860,False,10,955,1112,157
168187,2019-11-08 00:00:00+03:00,in,False,937752,False,10,1309,1448,139
168187,2019-11-08 00:00:00+03:00,in,False,937812,False,2,353,386,33
168187,2019-11-08 00:00:00+03:00,out,False,937812,True,1,0,13,13
168187,2019-11-08 00:00:00+03:00,out,False,937862,True,3,0,65,65
168187,2019-11-08 00:00:00+03:00,out,False,937810,True,6,0,249,249
168187,2019-11-08 00:00:00+03:00,in,False,937750,False,1,237,309,72
168187,2019-11-08 00:00:00+03:00,in,False,937708,False,6,526,643,117
168187,2019-11-08 00:00:00+03:00,out,False,937980,True,3,0,124,124
168187,2019-11-08 00:00:00+03:00,out,False,937860,True,15,0,284,284
168187,2019-11-08 00:00:00+03:00,in,False,937782,False,1,28,36,8
168187,2019-11-08 00:00:00+03:00,out,False,937750,True,1,0,16,16
168187,2019-11-08 00:00:00+03:00,out,False,937788,False,2,307,336,29
168187,2019-11-08 00:00:00+03:00,in,False,937810,False,1,107,114,7
168187,2019-11-08 00:00:00+03:00,out,False,937988,False,7,1601,1774,173
168187,2019-11-08 00:00:00+03:00,out,False,937854,False,6,241,395,154
168187,2019-11-08 00:00:00+03:00,out,False,937808,False,13,1500,1795,295
168187,2019-11-08 00:00:00+03:00,out,False,937980,False,6,798,929,131
168187,2019-11-08 00:00:00+03:00,in,False,937988,False,3,769,801,32
168187,2019-11-08 00:00:00+03:00,out,False,937810,False,2,142,163,21
168187,2019-11-08 00:00:00+03:00,out,False,937708,False,8,391,566,175
168187,2019-11-08 00:00:00+03:00,out,False,937678,True,1,0,15,15
168187,2019-11-08 00:00:00+03:00,out,False,937854,True,12,0,228,228
168187,2019-11-08 00:00:00+03:00,in,False,937862,False,1,24,39,15
168187,2019-11-08 00:00:00+03:00,out,False,937988,True,8,0,277,277
168187,2019-11-08 00:00:00+03:00,out,False,937902,False,7,319,521,202
168187,2019-11-08 00:00:00+03:00,out,False,937732,True,5,0,46,46
168187,2019-11-08 00:00:00+03:00,in,False,937958,False,5,159,179,20
168187,2019-11-08 00:00:00+03:00,out,False,937902,True,9,0,214,214
168187,2019-11-08 00:00:00+03:00,out,False,937888,False,14,984,1247,263
168187,2019-11-08 00:00:00+03:00,in,False,937860,False,3,619,652,33
168187,2019-11-08 00:00:00+03:00,in,False,937788,False,4,451,486,35
168187,2019-11-08 00:00:00+03:00,out,False,937752,False,31,2097,2522,425
168187,2019-11-08 00:00:00+03:00,in,False,937966,False,14,1289,1401,112
168187,2019-11-08 00:00:00+03:00,in,False,937760,False,7,644,701,57
168187,2019-11-08 00:00:00+03:00,out,False,937862,False,3,249,317,68
168187,2019-11-08 00:00:00+03:00,out,False,937732,False,1,197,206,9
168187,2019-11-08 00:00:00+03:00,out,False,937780,True,15,0,442,442
168187,2019-11-08 00:00:00+03:00,in,False,937860,False,3,619,652,33
168187,2019-11-08 00:00:00+03:00,in,False,937752,False,10,1309,1448,139
168187,2019-11-08 00:00:00+03:00,out,False,937808,True,7,0,140,140
168187,2019-11-08 00:00:00+03:00,in,False,937780,False,4,176,223,47
168187,2019-11-08 00:00:00+03:00,in,False,937760,False,7,644,701,57
168187,2019-11-08 00:00:00+03:00,out,False,937862,True,3,0,65,65
168187,2019-11-08 00:00:00+03:00,in,False,937962,False,1,194,210,16
168187,2019-11-09 00:00:00+03:00,in,False,937888,False,1,16,30,14
168187,2019-11-09 00:00:00+03:00,in,True,937762,False,1,56,75,19
168187,2019-11-09 00:00:00+03:00,in,False,937762,False,1,136,152,16
168187,2019-11-09 00:00:00+03:00,in,False,937956,False,11,810,826,16
168187,2019-11-09 00:00:00+03:00,in,False,937960,False,5,339,391,52
168187,2019-11-09 00:00:00+03:00,in,False,948286,True,1,11,17,6
168187,2019-11-09 00:00:00+03:00,in,False,937958,False,12,2511,2583,72
168187,2019-11-09 00:00:00+03:00,in,False,937962,False,3,599,647,48
168187,2019-11-09 00:00:00+03:00,out,False,937956,True,1,0,0,0
168187,2019-11-09 00:00:00+03:00,in,False,-1,True,16,0,329,329
168187,2019-11-09 00:00:00+03:00,in,False,937956,False,11,810,826,16
168187,2019-11-09 00:00:00+03:00,in,False,937960,False,5,339,391,52
168187,2019-11-10 00:00:00+03:00,in,False,948286,False,4,116,192,76
168187,2019-11-10 00:00:00+03:00,in,False,937752,False,1,227,258,31
168187,2019-11-10 00:00:00+03:00,in,False,937958,False,3,40,67,27
168187,2019-11-10 00:00:00+03:00,out,False,937762,False,1,38,131,93
168187,2019-11-10 00:00:00+03:00,in,False,937960,False,2,674,696,22
168187,2019-11-10 00:00:00+03:00,in,False,937956,False,12,1815,1826,11
168187,2019-11-10 00:00:00+03:00,out,False,937762,True,2,0,261,261
168187,2019-11-10 00:00:00+03:00,in,False,-1,True,8,0,133,133
168187,2019-11-10 00:00:00+03:00,in,False,948286,False,4,116,192,76
168187,2019-11-11 00:00:00+03:00,out,False,937812,True,4,0,67,67
168187,2019-11-11 00:00:00+03:00,in,True,937774,False,2,179,207,28
168187,2019-11-11 00:00:00+03:00,out,False,937780,False,25,1434,1977,543
168187,2019-11-11 00:00:00+03:00,out,True,937966,False,1,102,109,7
168187,2019-11-11 00:00:00+03:00,out,False,937760,True,14,0,305,305
168187,2019-11-11 00:00:00+03:00,out,False,937782,False,1,160,175,15
168187,2019-11-11 00:00:00+03:00,in,False,937810,False,3,78,103,25
168187,2019-11-11 00:00:00+03:00,in,True,937980,False,4,912,947,35
168187,2019-11-11 00:00:00+03:00,in,False,937960,False,6,862,922,60
168187,2019-11-11 00:00:00+03:00,in,False,937788,False,9,274,364,90
168187,2019-11-11 00:00:00+03:00,out,False,937678,True,3,0,49,49
168187,2019-11-11 00:00:00+03:00,out,False,937752,True,17,0,398,398
168187,2019-11-11 00:00:00+03:00,out,False,937810,True,6,0,252,252
168187,2019-11-11 00:00:00+03:00,out,False,937780,True,19,0,714,714
168187,2019-11-11 00:00:00+03:00,out,False,937782,True,1,0,41,41
168187,2019-11-11 00:00:00+03:00,out,False,937762,True,4,0,83,83
168187,2019-11-11 00:00:00+03:00,in,False,937780,False,10,1001,1087,86
168187,2019-11-11 00:00:00+03:00,in,False,937966,False,8,738,784,46
168187,2019-11-11 00:00:00+03:00,out,True,937980,False,4,225,297,72
168187,2019-11-11 00:00:00+03:00,out,False,937856,False,2,44,101,57
168187,2019-11-11 00:00:00+03:00,out,False,937888,True,33,0,1124,1124
168187,2019-11-11 00:00:00+03:00,in,False,937808,False,5,320,417,97
168187,2019-11-11 00:00:00+03:00,out,False,937854,False,9,686,928,242
168187,2019-11-11 00:00:00+03:00,out,False,937788,True,15,0,268,268
168187,2019-11-11 00:00:00+03:00,out,True,937774,False,1,33,43,10
168187,2019-11-11 00:00:00+03:00,out,False,937752,False,26,4235,4616,381
168187,2019-11-11 00:00:00+03:00,in,False,948286,False,14,822,1089,267
168187,2019-11-11 00:00:00+03:00,out,True,937854,True,4,0,2,2
168187,2019-11-11 00:00:00+03:00,out,False,937808,True,21,0,549,549
168187,2019-11-11 00:00:00+03:00,out,False,937678,False,3,232,305,73
168187,2019-11-11 00:00:00+03:00,out,False,937856,True,3,0,70,70
168187,2019-11-11 00:00:00+03:00,out,False,937708,False,7,1403,1538,135
168187,2019-11-11 00:00:00+03:00,out,False,937966,True,13,0,233,233
168187,2019-11-11 00:00:00+03:00,in,False,937958,False,2,5,78,73
168187,2019-11-11 00:00:00+03:00,out,False,937966,False,10,616,837,221
168187,2019-11-11 00:00:00+03:00,in,True,937856,False,1,444,480,36
168187,2019-11-11 00:00:00+03:00,in,False,937812,False,7,933,993,60
168187,2019-11-11 00:00:00+03:00,in,False,937732,False,11,1053,1347,294
168187,2019-11-11 00:00:00+03:00,in,False,937864,False,2,105,123,18
168187,2019-11-11 00:00:00+03:00,out,False,937788,False,17,2921,3225,304
168187,2019-11-11 00:00:00+03:00,in,False,937862,False,6,678,752,74
168187,2019-11-11 00:00:00+03:00,out,False,937868,False,2,17,43,26
168187,2019-11-11 00:00:00+03:00,in,False,937750,False,1,243,266,23
168187,2019-11-11 00:00:00+03:00,out,False,937762,False,5,402,502,100
168187,2019-11-11 00:00:00+03:00,in,True,937736,False,1,862,869,7
168187,2019-11-11 00:00:00+03:00,in,False,937736,False,16,2463,2666,203
168187,2019-11-11 00:00:00+03:00,out,False,937774,False,1,57,70,13
168187,2019-11-11 00:00:00+03:00,out,False,937860,True,46,0,1004,1004
168187,2019-11-11 00:00:00+03:00,out,False,937810,False,6,120,255,135
168187,2019-11-11 00:00:00+03:00,in,False,937860,False,7,926,976,50
168187,2019-11-11 00:00:00+03:00,in,False,937752,False,14,933,1030,97
168187,2019-11-11 00:00:00+03:00,in,False,937854,False,6,760,818,58
168187,2019-11-11 00:00:00+03:00,in,False,937708,False,9,1050,1231,181
168187,2019-11-11 00:00:00+03:00,out,False,937736,True,22,0,732,732
168187,2019-11-11 00:00:00+03:00,out,False,937888,False,34,2484,3272,788
168187,2019-11-11 00:00:00+03:00,out,False,937854,True,7,0,153,153
168187,2019-11-11 00:00:00+03:00,in,False,937760,False,7,587,650,63
168187,2019-11-11 00:00:00+03:00,in,False,-1,True,98,0,2475,2475
168187,2019-11-11 00:00:00+03:00,in,False,937762,False,1,63,74,11
168187,2019-11-11 00:00:00+03:00,out,False,937902,False,15,1787,2114,327
168187,2019-11-11 00:00:00+03:00,out,False,937902,True,9,0,366,366
168187,2019-11-11 00:00:00+03:00,out,False,937736,False,30,1620,2222,602
168187,2019-11-11 00:00:00+03:00,in,False,937956,False,23,2576,2619,43
168187,2019-11-11 00:00:00+03:00,out,False,937860,False,34,2217,2773,556
168187,2019-11-11 00:00:00+03:00,out,False,937760,False,5,381,484,103
168187,2019-11-11 00:00:00+03:00,out,False,937988,False,13,3066,3383,317
168187,2019-11-11 00:00:00+03:00,out,False,937732,False,1,9,33,24
168187,2019-11-11 00:00:00+03:00,in,False,937980,False,3,182,199,17
168187,2019-11-11 00:00:00+03:00,out,False,937988,True,7,0,361,361
168187,2019-11-11 00:00:00+03:00,out,False,937862,False,7,641,820,179
168187,2019-11-11 00:00:00+03:00,in,False,937988,False,6,716,778,62
168187,2019-11-11 00:00:00+03:00,out,True,937854,False,1,139,152,13
168187,2019-11-11 00:00:00+03:00,out,False,937862,True,6,0,137,137
168187,2019-11-11 00:00:00+03:00,in,False,937902,False,11,1062,1163,101
168187,2019-11-11 00:00:00+03:00,out,False,937708,True,6,0,167,167
168187,2019-11-11 00:00:00+03:00,out,False,937868,True,3,0,21,21
168187,2019-11-11 00:00:00+03:00,in,False,937782,False,1,24,37,13
168187,2019-11-11 00:00:00+03:00,in,False,948284,False,1,5,6,1
168187,2019-11-11 00:00:00+03:00,out,False,937808,False,27,1643,2325,682
168187,2019-11-11 00:00:00+03:00,in,False,937888,False,14,854,981,127
168187,2019-11-11 00:00:00+03:00,out,False,937812,False,8,781,924,143
168187,2019-11-11 00:00:00+03:00,out,False,937780,False,25,1434,1977,543
168187,2019-11-11 00:00:00+03:00,out,False,937788,False,17,2921,3225,304
168187,2019-11-11 00:00:00+03:00,in,False,937752,False,14,933,1030,97
168187,2019-11-11 00:00:00+03:00,out,False,937812,False,8,781,924,143
168187,2019-11-11 00:00:00+03:00,out,False,937782,False,1,160,175,15
168187,2019-11-11 00:00:00+03:00,in,False,937956,False,23,2576,2619,43
168187,2019-11-12 00:00:00+03:00,out,False,937752,False,47,2868,3667,799
168187,2019-11-12 00:00:00+03:00,out,False,937782,True,1,0,49,49
168187,2019-11-12 00:00:00+03:00,out,False,937788,False,10,237,457,220
168187,2019-11-12 00:00:00+03:00,out,False,937774,True,13,0,441,441
168187,2019-11-12 00:00:00+03:00,out,False,937862,False,2,75,129,54
168187,2019-11-12 00:00:00+03:00,out,False,937854,False,9,883,1084,201
168187,2019-11-12 00:00:00+03:00,in,False,937960,False,5,638,683,45
168187,2019-11-12 00:00:00+03:00,in,False,937962,False,5,643,717,74
168187,2019-11-12 00:00:00+03:00,in,False,-1,True,1,0,6,6
168187,2019-11-12 00:00:00+03:00,out,False,937812,True,10,0,301,301
168187,2019-11-12 00:00:00+03:00,out,False,937854,True,7,0,97,97
168187,2019-11-12 00:00:00+03:00,in,False,937736,False,14,1334,1582,248
168187,2019-11-12 00:00:00+03:00,out,False,937810,True,4,0,127,127
168187,2019-11-12 00:00:00+03:00,in,False,937808,False,5,836,879,43
168187,2019-11-12 00:00:00+03:00,out,False,937732,True,1,0,27,27
168187,2019-11-12 00:00:00+03:00,out,False,937868,False,3,79,119,40
168187,2019-11-12 00:00:00+03:00,out,False,937860,False,30,3173,3758,585
168187,2019-11-12 00:00:00+03:00,out,False,937780,True,12,0,424,424
168187,2019-11-12 00:00:00+03:00,out,False,937868,True,1,0,22,22
168187,2019-11-12 00:00:00+03:00,in,False,937854,False,5,467,518,51
168187,2019-11-12 00:00:00+03:00,out,False,937812,False,4,382,451,69
168187,2019-11-12 00:00:00+03:00,out,False,937862,True,6,0,192,192
168187,2019-11-12 00:00:00+03:00,in,False,937956,False,20,1498,1517,19
168187,2019-11-12 00:00:00+03:00,out,False,937732,False,2,172,195,23
168187,2019-11-12 00:00:00+03:00,in,False,937958,False,10,2101,2170,69
168187,2019-11-12 00:00:00+03:00,out,False,937860,True,36,0,955,955
168187,2019-11-12 00:00:00+03:00,out,False,937708,True,15,0,538,538
168187,2019-11-12 00:00:00+03:00,out,False,937902,True,11,0,413,413
168187,2019-11-12 00:00:00+03:00,in,False,937788,False,3,111,133,22
168187,2019-11-12 00:00:00+03:00,in,False,937762,False,6,488,559,71
168187,2019-11-12 00:00:00+03:00,in,False,937782,False,1,45,54,9
168187,2019-11-12 00:00:00+03:00,out,False,937736,False,13,528,797,269
168187,2019-11-12 00:00:00+03:00,out,False,937988,True,7,0,105,105
168187,2019-11-12 00:00:00+03:00,in,False,948286,False,13,331,532,201
168187,2019-11-12 00:00:00+03:00,out,False,937752,True,58,0,1081,1081
168187,2019-11-12 00:00:00+03:00,in,False,937888,False,1,334,341,7
168187,2019-11-12 00:00:00+03:00,in,False,-1,True,76,0,4022,4022
168187,2019-11-12 00:00:00+03:00,out,False,937762,False,4,239,303,64
168187,2019-11-12 00:00:00+03:00,out,False,937774,False,5,873,1008,135
168187,2019-11-12 00:00:00+03:00,in,False,937752,False,16,2635,2797,162
168187,2019-11-12 00:00:00+03:00,out,False,937810,False,5,467,540,73
168187,2019-11-12 00:00:00+03:00,out,False,937678,False,5,623,743,120
168187,2019-11-12 00:00:00+03:00,out,False,937708,False,12,1303,1606,303
168187,2019-11-12 00:00:00+03:00,out,False,937678,True,4,0,111,111
168187,2019-11-12 00:00:00+03:00,out,False,937736,True,19,0,576,576
168187,2019-11-12 00:00:00+03:00,out,False,937966,False,8,1477,1624,147
168187,2019-11-12 00:00:00+03:00,out,False,937762,True,2,0,62,62
168187,2019-11-12 00:00:00+03:00,out,False,937902,False,15,1084,1429,345
168187,2019-11-12 00:00:00+03:00,in,False,937774,False,15,1647,1754,107
168187,2019-11-12 00:00:00+03:00,out,False,937788,True,12,0,324,324
168187,2019-11-12 00:00:00+03:00,in,False,937780,False,2,176,235,59
168187,2019-11-12 00:00:00+03:00,out,False,937760,False,5,809,901,92
168187,2019-11-12 00:00:00+03:00,in,False,937732,True,1,1,23,22
168187,2019-11-12 00:00:00+03:00,out,False,937780,False,14,1207,1479,272
168187,2019-11-12 00:00:00+03:00,out,False,937760,True,7,0,173,173
168187,2019-11-12 00:00:00+03:00,out,False,937888,True,13,0,398,398
168187,2019-11-12 00:00:00+03:00,out,False,937966,True,13,0,266,266
168187,2019-11-12 00:00:00+03:00,in,False,937760,False,2,156,170,14
168187,2019-11-12 00:00:00+03:00,in,False,937980,False,5,267,310,43
168187,2019-11-12 00:00:00+03:00,in,False,937988,False,2,77,108,31
168187,2019-11-12 00:00:00+03:00,in,False,937812,False,5,855,916,61
168187,2019-11-12 00:00:00+03:00,in,False,937732,False,4,721,796,75
168187,2019-11-12 00:00:00+03:00,out,False,937988,False,7,559,725,166
168187,2019-11-12 00:00:00+03:00,in,False,937966,False,9,699,779,80
168187,2019-11-12 00:00:00+03:00,in,False,937902,False,10,785,943,158
168187,2019-11-12 00:00:00+03:00,in,False,937862,False,5,615,674,59
168187,2019-11-12 00:00:00+03:00,out,False,937808,True,4,0,59,59
168187,2019-11-12 00:00:00+03:00,in,False,937708,False,8,1078,1153,75
168187,2019-11-12 00:00:00+03:00,in,False,937856,False,1,43,52,9
168187,2019-11-12 00:00:00+03:00,out,False,937808,False,13,1268,1518,250
168187,2019-11-12 00:00:00+03:00,out,False,937888,False,7,600,749,149
168187,2019-11-12 00:00:00+03:00,in,False,937860,False,9,1358,1430,72
168187,2019-11-12 00:00:00+03:00,out,False,-1,True,1,0,0,0
168187,2019-11-12 00:00:00+03:00,in,False,937742,False,2,170,223,53
168187,2019-11-12 00:00:00+03:00,out,False,937788,False,10,237,457,220
168187,2019-11-12 00:00:00+03:00,out,False,937780,True,12,0,424,424
168187,2019-11-12 00:00:00+03:00,in,False,937980,False,5,267,310,43
168187,2019-11-12 00:00:00+03:00,out,False,937708,False,12,1303,1606,303
168187,2019-11-12 00:00:00+03:00,out,False,937762,False,4,239,303,64
168187,2019-11-13 00:00:00+03:00,in,False,948286,False,15,699,809,110
168187,2019-11-13 00:00:00+03:00,out,False,937774,False,4,286,387,101
168187,2019-11-13 00:00:00+03:00,out,False,937778,True,1,0,19,19
168187,2019-11-13 00:00:00+03:00,in,False,937762,False,3,697,729,32
168187,2019-11-13 00:00:00+03:00,out,False,937902,False,17,1003,1366,363
168187,2019-11-13 00:00:00+03:00,in,False,937868,False,5,141,268,127
168187,2019-11-13 00:00:00+03:00,out,False,937888,False,17,1018,1298,280
168187,2019-11-13 00:00:00+03:00,in,False,937810,False,3,279,306,27
168187,2019-11-13 00:00:00+03:00,out,False,937752,False,33,2484,3079,595
168187,2019-11-13 00:00:00+03:00,in,False,937736,False,13,842,1039,197
168187,2019-11-13 00:00:00+03:00,out,False,937988,False,14,1262,1585,323
168187,2019-11-13 00:00:00+03:00,out,False,937732,True,2,0,0,0
168187,2019-11-13 00:00:00+03:00,out,False,937760,True,10,0,209,209
168187,2019-11-13 00:00:00+03:00,in,False,937752,False,19,2099,2270,171
168187,2019-11-13 00:00:00+03:00,out,False,937810,True,4,0,153,153
168187,2019-11-13 00:00:00+03:00,out,False,937762,False,3,185,229,44
168187,2019-11-13 00:00:00+03:00,out,False,937862,False,3,105,176,71
168187,2019-11-13 00:00:00+03:00,out,False,937868,False,2,462,510,48
168187,2019-11-13 00:00:00+03:00,in,False,937962,False,3,518,567,49
168187,2019-11-13 00:00:00+03:00,in,False,937708,False,3,338,371,33
168187,2019-11-13 00:00:00+03:00,in,False,937956,False,21,2661,2688,27
168187,2019-11-13 00:00:00+03:00,in,False,-1,True,2,0,38,38
168187,2019-11-13 00:00:00+03:00,in,False,937732,False,2,137,166,29
168187,2019-11-13 00:00:00+03:00,in,False,937854,False,2,65,80,15
168187,2019-11-13 00:00:00+03:00,out,False,937966,False,8,302,465,163
168187,2019-11-13 00:00:00+03:00,in,False,937888,False,9,1322,1388,66
168187,2019-11-13 00:00:00+03:00,out,False,937736,True,32,0,859,859
168187,2019-11-13 00:00:00+03:00,out,False,937988,True,4,0,194,194
168187,2019-11-13 00:00:00+03:00,out,False,937860,False,32,3091,3768,677
168187,2019-11-13 00:00:00+03:00,out,False,937812,False,3,202,299,97
168187,2019-11-13 00:00:00+03:00,out,False,937862,True,3,0,86,86
168187,2019-11-13 00:00:00+03:00,out,False,-1,True,1,0,0,0
168187,2019-11-13 00:00:00+03:00,in,False,937980,False,3,205,225,20
168187,2019-11-13 00:00:00+03:00,in,False,937774,False,9,971,1036,65
168187,2019-11-13 00:00:00+03:00,in,False,937812,False,4,412,461,49
168187,2019-11-13 00:00:00+03:00,out,False,937808,True,14,0,425,425
168187,2019-11-13 00:00:00+03:00,out,False,937762,True,1,0,50,50
168187,2019-11-13 00:00:00+03:00,out,False,937678,True,1,0,5,5
168187,2019-11-13 00:00:00+03:00,in,False,937860,False,7,1213,1263,50
168187,2019-11-13 00:00:00+03:00,out,False,937678,False,1,46,62,16
168187,2019-11-13 00:00:00+03:00,out,False,937854,True,2,0,12,12
168187,2019-11-13 00:00:00+03:00,in,False,937902,False,7,709,767,58
168187,2019-11-13 00:00:00+03:00,out,False,937902,True,8,0,249,249
168187,2019-11-13 00:00:00+03:00,out,False,937732,False,3,292,342,50
168187,2019-11-13 00:00:00+03:00,in,False,937808,False,2,83,95,12
168187,2019-11-13 00:00:00+03:00,in,False,937988,False,1,138,146,8
168187,2019-11-13 00:00:00+03:00,out,False,937774,True,1,0,49,49
168187,2019-11-13 00:00:00+03:00,in,False,937966,False,4,303,334,31
168187,2019-11-13 00:00:00+03:00,out,False,937788,False,13,908,1180,272
168187,2019-11-13 00:00:00+03:00,out,False,937780,False,23,1422,1884,462
168187,2019-11-13 00:00:00+03:00,out,False,937808,False,10,511,774,263
168187,2019-11-13 00:00:00+03:00,in,False,937958,False,6,1089,1154,65
168187,2019-11-13 00:00:00+03:00,out,False,937752,True,16,0,396,396
168187,2019-11-13 00:00:00+03:00,out,False,937810,False,1,7,9,2
168187,2019-11-13 00:00:00+03:00,out,False,937736,False,16,1215,1541,326
168187,2019-11-13 00:00:00+03:00,out,False,937708,True,13,0,393,393
168187,2019-11-13 00:00:00+03:00,out,False,937782,True,2,0,80,80
168187,2019-11-13 00:00:00+03:00,out,False,937788,True,12,0,286,286
168187,2019-11-13 00:00:00+03:00,out,False,937980,False,5,565,670,105
168187,2019-11-13 00:00:00+03:00,in,False,937742,False,2,120,151,31
168187,2019-11-13 00:00:00+03:00,out,False,937888,True,15,0,435,435
168187,2019-11-13 00:00:00+03:00,out,False,937860,True,44,0,960,960
168187,2019-11-13 00:00:00+03:00,in,False,937760,False,13,1014,1126,112
168187,2019-11-13 00:00:00+03:00,in,False,937960,False,9,1128,1179,51
168187,2019-11-13 00:00:00+03:00,out,False,937708,False,17,1360,1753,393
168187,2019-11-13 00:00:00+03:00,out,False,937854,False,8,488,626,138
168187,2019-11-13 00:00:00+03:00,in,False,937788,False,4,365,404,39
168187,2019-11-13 00:00:00+03:00,in,False,937782,False,1,57,64,7
168187,2019-11-13 00:00:00+03:00,out,False,937980,True,8,0,206,206
168187,2019-11-13 00:00:00+03:00,in,False,-1,True,62,0,2040,2040
168187,2019-11-13 00:00:00+03:00,in,False,937956,True,3,0,3,3
168187,2019-11-13 00:00:00+03:00,out,False,937780,True,19,0,610,610
168187,2019-11-13 00:00:00+03:00,out,False,937760,False,5,476,573,97
168187,2019-11-13 00:00:00+03:00,in,False,937780,False,8,2588,2677,89
168187,2019-11-13 00:00:00+03:00,in,False,937862,False,2,424,445,21
168187,2019-11-13 00:00:00+03:00,out,False,937966,True,7,0,163,163
168187,2019-11-13 00:00:00+03:00,out,False,937780,False,23,1422,1884,462
168187,2019-11-13 00:00:00+03:00,out,False,937808,False,10,511,774,263
168187,2019-11-13 00:00:00+03:00,out,False,937862,True,3,0,86,86
168187,2019-11-13 00:00:00+03:00,in,False,937956,False,21,2661,2688,27
168187,2019-11-13 00:00:00+03:00,in,False,937760,False,13,1014,1126,112
168187,2019-11-13 00:00:00+03:00,out,False,937860,False,32,3091,3768,677
168187,2019-11-13 00:00:00+03:00,out,False,937678,False,1,46,62,16
168187,2019-11-13 00:00:00+03:00,in,False,937742,False,2,120,151,31
168187,2019-11-13 00:00:00+03:00,out,False,937762,True,1,0,50,50
168187,2019-11-13 00:00:00+03:00,out,False,937736,True,32,0,859,859
168187,2019-11-13 00:00:00+03:00,out,False,937854,True,2,0,12,12
168187,2019-11-13 00:00:00+03:00,out,False,937760,True,10,0,209,209
168187,2019-11-14 00:00:00+03:00,in,False,937864,False,2,164,180,16
168187,2019-11-14 00:00:00+03:00,out,False,937788,False,7,354,481,127
168187,2019-11-14 00:00:00+03:00,out,False,937988,True,5,0,177,177
168187,2019-11-14 00:00:00+03:00,in,False,937902,False,13,1420,1628,208
168187,2019-11-14 00:00:00+03:00,out,False,937854,False,4,130,211,81
168187,2019-11-14 00:00:00+03:00,in,False,937860,False,12,1909,2022,113
168187,2019-11-14 00:00:00+03:00,out,False,937760,False,5,339,417,78
168187,2019-11-14 00:00:00+03:00,out,False,937868,False,13,2289,2526,237
168187,2019-11-14 00:00:00+03:00,in,False,937812,False,8,971,1093,122
168187,2019-11-14 00:00:00+03:00,out,False,937810,False,2,130,210,80
168187,2019-11-14 00:00:00+03:00,in,False,937780,False,6,313,416,103
168187,2019-11-14 00:00:00+03:00,in,False,937956,False,21,2917,2940,23
168187,2019-11-14 00:00:00+03:00,out,False,937810,True,1,0,40,40
168187,2019-11-14 00:00:00+03:00,in,False,937762,False,6,1209,1278,69
168187,2019-11-14 00:00:00+03:00,out,False,937732,False,2,525,566,41
168187,2019-11-14 00:00:00+03:00,in,False,948286,False,5,551,650,99
168187,2019-11-14 00:00:00+03:00,out,False,937736,False,9,252,555,303
168187,2019-11-14 00:00:00+03:00,out,False,937732,True,6,0,27,27
168187,2019-11-14 00:00:00+03:00,in,False,-1,True,84,0,2501,2501
168187,2019-11-14 00:00:00+03:00,in,False,937988,False,3,1073,1126,53
168187,2019-11-14 00:00:00+03:00,out,False,937774,True,17,0,499,499
168187,2019-11-14 00:00:00+03:00,in,False,937808,False,6,461,510,49
168187,2019-11-14 00:00:00+03:00,out,False,937862,True,4,0,121,121
168187,2019-11-14 00:00:00+03:00,out,False,937988,False,7,534,744,210
168187,2019-11-14 00:00:00+03:00,out,False,937708,True,10,0,314,314
168187,2019-11-14 00:00:00+03:00,out,False,937966,True,42,0,1072,1072
168187,2019-11-14 00:00:00+03:00,in,False,937862,False,10,1025,1224,199
168187,2019-11-14 00:00:00+03:00,out,False,937854,True,4,0,113,113
168187,2019-11-14 00:00:00+03:00,in,False,937774,False,31,1294,1497,203
168187,2019-11-14 00:00:00+03:00,out,False,937788,True,4,0,55,55
168187,2019-11-14 00:00:00+03:00,out,False,937678,True,2,0,61,61
168187,2019-11-14 00:00:00+03:00,in,False,937810,False,3,210,245,35
168187,2019-11-14 00:00:00+03:00,out,False,937888,False,18,701,1096,395
168187,2019-11-14 00:00:00+03:00,out,False,937860,True,57,0,1546,1546
168187,2019-11-14 00:00:00+03:00,out,False,937808,False,10,1354,1535,181
168187,2019-11-14 00:00:00+03:00,in,False,937960,False,5,693,742,49
168187,2019-11-14 00:00:00+03:00,out,False,937762,False,3,372,430,58
168187,2019-11-14 00:00:00+03:00,out,False,937902,True,11,0,304,304
168187,2019-11-14 00:00:00+03:00,out,False,937812,True,4,0,92,92
168187,2019-11-14 00:00:00+03:00,in,False,937732,False,4,431,492,61
168187,2019-11-14 00:00:00+03:00,out,False,937808,True,5,0,263,263
168187,2019-11-14 00:00:00+03:00,out,False,937752,True,44,0,942,942
168187,2019-11-14 00:00:00+03:00,out,False,937736,True,21,0,638,638
168187,2019-11-14 00:00:00+03:00,in,False,937760,False,11,697,864,167
168187,2019-11-14 00:00:00+03:00,in,False,937708,False,5,1041,1110,69
168187,2019-11-14 00:00:00+03:00,out,False,937678,False,1,3,24,21
168187,2019-11-14 00:00:00+03:00,out,False,937780,False,15,584,885,301
168187,2019-11-14 00:00:00+03:00,in,False,937736,False,12,1531,1742,211
168187,2019-11-14 00:00:00+03:00,in,False,937966,False,15,1111,1240,129
168187,2019-11-14 00:00:00+03:00,out,False,937708,False,16,1333,1669,336
168187,2019-11-14 00:00:00+03:00,out,False,937760,True,18,0,292,292
168187,2019-11-14 00:00:00+03:00,in,False,937788,False,3,691,727,36
168187,2019-11-14 00:00:00+03:00,in,False,937962,False,4,601,645,44
168187,2019-11-14 00:00:00+03:00,out,False,937868,True,4,0,73,73
168187,2019-11-14 00:00:00+03:00,out,False,937966,False,18,1348,1753,405
168187,2019-11-14 00:00:00+03:00,out,False,937762,True,4,0,160,160
168187,2019-11-14 00:00:00+03:00,out,False,937780,True,25,0,878,878
168187,2019-11-14 00:00:00+03:00,out,False,937862,False,8,976,1116,140
168187,2019-11-14 00:00:00+03:00,in,False,937958,False,3,883,902,19
168187,2019-11-14 00:00:00+03:00,out,False,937752,False,23,2519,2851,332
168187,2019-11-14 00:00:00+03:00,in,False,937782,False,1,20,27,7
168187,2019-11-14 00:00:00+03:00,in,False,937854,False,4,278,301,23
168187,2019-11-14 00:00:00+03:00,out,False,937860,False,52,4028,5121,1093
168187,2019-11-14 00:00:00+03:00,out,False,937902,False,7,576,770,194
168187,2019-11-14 00:00:00+03:00,out,False,937774,False,14,570,882,312
168187,2019-11-14 00:00:00+03:00,in,False,937752,False,16,2694,2854,160
168187,2019-11-14 00:00:00+03:00,out,False,937888,True,19,0,511,511
168187,2019-11-14 00:00:00+03:00,in,False,937888,False,9,1360,1422,62
168187,2019-11-14 00:00:00+03:00,in,False,937854,False,4,278,301,23
168187,2019-11-14 00:00:00+03:00,in,False,937752,False,16,2694,2854,160
168187,2019-11-14 00:00:00+03:00,out,False,937902,True,11,0,304,304
168187,2019-11-14 00:00:00+03:00,out,False,937788,True,4,0,55,55
168187,2019-11-14 00:00:00+03:00,out,False,937732,False,2,525,566,41
168187,2019-11-14 00:00:00+03:00,out,False,937678,False,1,3,24,21
168187,2019-11-14 00:00:00+03:00,out,False,937774,True,17,0,499,499
168187,2019-11-14 00:00:00+03:00,out,False,937774,False,14,570,882,312
168187,2019-11-15 00:00:00+03:00,in,False,937958,False,10,1589,1643,54
168187,2019-11-15 00:00:00+03:00,in,False,937988,False,2,59,94,35
168187,2019-11-15 00:00:00+03:00,in,False,937780,False,6,1112,1163,51
168187,2019-11-15 00:00:00+03:00,in,False,937812,False,5,598,650,52
168187,2019-11-15 00:00:00+03:00,out,False,937760,False,3,141,183,42
168187,2019-11-15 00:00:00+03:00,in,False,937752,False,17,2073,2247,174
168187,2019-11-15 00:00:00+03:00,in,False,937736,False,11,549,699,150
168187,2019-11-15 00:00:00+03:00,out,False,937760,True,7,0,93,93
168187,2019-11-15 00:00:00+03:00,out,False,937752,True,41,0,1060,1060
168187,2019-11-15 00:00:00+03:00,in,False,937760,False,4,142,195,53
168187,2019-11-15 00:00:00+03:00,out,False,937762,False,5,109,226,117
168187,2019-11-15 00:00:00+03:00,out,False,937774,True,6,0,270,270
168187,2019-11-15 00:00:00+03:00,out,False,937788,True,5,0,74,74
168187,2019-11-15 00:00:00+03:00,out,False,937860,True,43,0,1002,1002
168187,2019-11-15 00:00:00+03:00,out,False,937812,True,1,0,20,20
168187,2019-11-15 00:00:00+03:00,in,False,937788,False,3,518,550,32
168187,2019-11-15 00:00:00+03:00,in,False,937808,False,5,208,257,49
168187,2019-11-15 00:00:00+03:00,out,False,937810,False,5,808,878,70
168187,2019-11-15 00:00:00+03:00,in,False,937966,False,1,65,73,8
168187,2019-11-15 00:00:00+03:00,in,False,937678,False,1,66,73,7
168187,2019-11-15 00:00:00+03:00,out,False,937868,False,4,442,521,79
168187,2019-11-15 00:00:00+03:00,in,False,937962,False,1,286,302,16
168187,2019-11-15 00:00:00+03:00,out,False,937860,False,39,1877,2584,707
168187,2019-11-15 00:00:00+03:00,out,False,937854,True,7,0,140,140
168187,2019-11-15 00:00:00+03:00,out,False,937988,False,15,2388,2817,429
168187,2019-11-15 00:00:00+03:00,out,False,937732,True,2,0,2,2
168187,2019-11-15 00:00:00+03:00,in,False,-1,True,94,0,3229,3229
168187,2019-11-15 00:00:00+03:00,in,False,937732,True,1,0,69,69
168187,2019-11-15 00:00:00+03:00,out,False,937812,False,2,119,152,33
168187,2019-11-15 00:00:00+03:00,in,False,937960,False,5,716,756,40
168187,2019-11-15 00:00:00+03:00,out,False,937780,False,8,925,1102,177
168187,2019-11-15 00:00:00+03:00,in,False,937810,False,3,328,354,26
168187,2019-11-15 00:00:00+03:00,out,False,937736,False,23,1771,2212,441
168187,2019-11-15 00:00:00+03:00,out,False,937708,True,11,0,371,371
168187,2019-11-15 00:00:00+03:00,out,False,937902,True,22,0,700,700
168187,2019-11-15 00:00:00+03:00,in,False,937708,False,10,891,981,90
168187,2019-11-15 00:00:00+03:00,out,False,937762,True,6,0,172,172
168187,2019-11-15 00:00:00+03:00,out,True,937752,True,1,0,0,0
168187,2019-11-15 00:00:00+03:00,out,False,937888,False,15,1599,1928,329
168187,2019-11-15 00:00:00+03:00,out,False,937966,False,1,114,123,9
168187,2019-11-15 00:00:00+03:00,in,False,937774,False,14,1008,1110,102
168187,2019-11-15 00:00:00+03:00,in,False,937902,False,13,1636,1853,217
168187,2019-11-15 00:00:00+03:00,out,False,937808,True,20,0,552,552
168187,2019-11-15 00:00:00+03:00,in,False,937854,False,4,106,133,27
168187,2019-11-15 00:00:00+03:00,out,False,937868,True,4,0,108,108
168187,2019-11-15 00:00:00+03:00,out,False,937736,True,25,0,735,735
168187,2019-11-15 00:00:00+03:00,in,False,937868,False,2,73,88,15
168187,2019-11-15 00:00:00+03:00,in,False,937860,False,10,1137,1249,112
168187,2019-11-15 00:00:00+03:00,out,False,937732,False,1,46,55,9
168187,2019-11-15 00:00:00+03:00,out,False,937808,False,17,1283,1669,386
168187,2019-11-15 00:00:00+03:00,in,False,937956,False,27,2574,2596,22
168187,2019-11-15 00:00:00+03:00,out,False,937780,True,27,0,996,996
168187,2019-11-15 00:00:00+03:00,in,False,937864,False,2,155,168,13
168187,2019-11-15 00:00:00+03:00,out,False,937788,False,2,211,250,39
168187,2019-11-15 00:00:00+03:00,in,False,937888,False,10,958,1038,80
168187,2019-11-15 00:00:00+03:00,out,False,937782,False,1,44,56,12
168187,2019-11-15 00:00:00+03:00,in,False,948286,False,1,8,29,21
168187,2019-11-15 00:00:00+03:00,out,False,937810,True,2,0,121,121
168187,2019-11-15 00:00:00+03:00,out,False,937752,False,20,1750,2072,322
168187,2019-11-15 00:00:00+03:00,out,False,937708,False,8,599,753,154
168187,2019-11-15 00:00:00+03:00,out,False,937988,True,9,0,317,317
168187,2019-11-15 00:00:00+03:00,out,False,937774,False,3,1090,1158,68
168187,2019-11-15 00:00:00+03:00,in,False,937732,False,2,96,124,28
168187,2019-11-15 00:00:00+03:00,out,False,937888,True,16,0,540,540
168187,2019-11-15 00:00:00+03:00,out,False,937854,False,8,952,1061,109
168187,2019-11-15 00:00:00+03:00,in,False,937762,False,8,1131,1249,118
168187,2019-11-15 00:00:00+03:00,in,False,937956,True,5,0,5,5
168187,2019-11-15 00:00:00+03:00,out,False,937902,False,12,311,630,319
168187,2019-11-15 00:00:00+03:00,out,False,937788,False,2,211,250,39
168187,2019-11-15 00:00:00+03:00,in,False,937678,False,1,66,73,7
168187,2019-11-15 00:00:00+03:00,out,False,937988,True,9,0,317,317
168187,2019-11-15 00:00:00+03:00,out,False,937810,True,2,0,121,121
168187,2019-11-15 00:00:00+03:00,in,False,937988,False,2,59,94,35
168187,2019-11-15 00:00:00+03:00,out,False,937808,False,17,1283,1669,386
168187,2019-11-15 00:00:00+03:00,out,False,937860,False,39,1877,2584,707
168187,2019-11-16 00:00:00+03:00,in,False,937962,False,2,251,283,32
168187,2019-11-16 00:00:00+03:00,in,False,937960,False,5,482,522,40
168187,2019-11-16 00:00:00+03:00,in,False,937958,False,9,540,568,28
168187,2019-11-16 00:00:00+03:00,in,False,937810,False,1,28,45,17
168187,2019-11-16 00:00:00+03:00,in,False,948286,False,2,34,70,36
168187,2019-11-16 00:00:00+03:00,in,False,937752,False,1,2,24,22
168187,2019-11-16 00:00:00+03:00,in,False,937782,False,1,25,33,8
168187,2019-11-16 00:00:00+03:00,in,False,937956,False,29,6349,6373,24
168187,2019-11-16 00:00:00+03:00,in,False,-1,True,12,0,173,173
168187,2019-11-16 00:00:00+03:00,in,False,937888,False,1,54,67,13
168187,2019-11-16 00:00:00+03:00,in,False,937956,False,29,6349,6373,24
168187,2019-11-17 00:00:00+03:00,in,False,937958,False,10,1115,1174,59
168187,2019-11-17 00:00:00+03:00,in,False,937752,False,1,48,72,24
168187,2019-11-17 00:00:00+03:00,in,False,-1,True,12,0,224,224
168187,2019-11-17 00:00:00+03:00,in,False,937962,False,5,269,344,75
168187,2019-11-17 00:00:00+03:00,in,False,948286,False,4,53,127,74
168187,2019-11-17 00:00:00+03:00,in,False,937956,True,1,0,1,1
168187,2019-11-17 00:00:00+03:00,in,False,937956,False,15,2058,2083,25
168187,2019-11-17 00:00:00+03:00,in,False,937960,False,5,250,303,53
168187,2019-11-17 00:00:00+03:00,in,False,-1,True,12,0,224,224
168187,2019-11-18 00:00:00+03:00,out,False,937678,False,2,272,324,52
168187,2019-11-18 00:00:00+03:00,in,False,937808,False,1,74,86,12
168187,2019-11-18 00:00:00+03:00,out,False,937860,True,18,0,492,492
168187,2019-11-18 00:00:00+03:00,in,False,937782,False,2,544,565,21
168187,2019-11-18 00:00:00+03:00,in,False,937860,False,6,1481,1545,64
168187,2019-11-18 00:00:00+03:00,out,False,937868,False,2,84,134,50
168187,2019-11-18 00:00:00+03:00,out,False,937902,True,7,0,247,247
168187,2019-11-18 00:00:00+03:00,in,False,937902,False,5,188,231,43
168187,2019-11-18 00:00:00+03:00,in,False,937960,False,4,595,629,34
168187,2019-11-18 00:00:00+03:00,out,False,937774,True,17,0,586,586
168187,2019-11-18 00:00:00+03:00,in,False,937956,False,27,3314,3339,25
168187,2019-11-18 00:00:00+03:00,out,False,937862,False,10,1239,1430,191
168187,2019-11-18 00:00:00+03:00,out,False,937732,True,4,0,59,59
168187,2019-11-18 00:00:00+03:00,in,False,937962,False,5,1240,1310,70
168187,2019-11-18 00:00:00+03:00,out,False,937864,True,4,0,14,14
168187,2019-11-18 00:00:00+03:00,out,False,937854,False,12,1014,1264,250
168187,2019-11-18 00:00:00+03:00,out,False,937988,True,6,0,244,244
168187,2019-11-18 00:00:00+03:00,in,False,937988,False,2,68,89,21
168187,2019-11-18 00:00:00+03:00,out,False,937888,False,10,634,840,206
168187,2019-11-18 00:00:00+03:00,out,False,937736,False,13,412,629,217
168187,2019-11-18 00:00:00+03:00,out,False,937780,True,1,0,59,59
168187,2019-11-18 00:00:00+03:00,out,False,937736,True,19,0,450,450
168187,2019-11-18 00:00:00+03:00,out,False,937808,True,2,0,42,42
168187,2019-11-18 00:00:00+03:00,in,False,937780,False,3,207,229,22
168187,2019-11-18 00:00:00+03:00,in,False,937888,False,14,2520,2630,110
168187,2019-11-18 00:00:00+03:00,out,False,937762,False,3,41,117,76
168187,2019-11-18 00:00:00+03:00,in,False,937810,False,6,272,319,47
168187,2019-11-18 00:00:00+03:00,in,False,937966,False,14,864,964,100
168187,2019-11-18 00:00:00+03:00,in,False,937732,False,4,288,337,49
168187,2019-11-18 00:00:00+03:00,out,False,937856,True,1,0,36,36
168187,2019-11-18 00:00:00+03:00,out,False,937760,True,20,0,435,435
168187,2019-11-18 00:00:00+03:00,out,False,937988,False,9,233,531,298
168187,2019-11-18 00:00:00+03:00,out,False,937708,False,11,558,810,252
168187,2019-11-18 00:00:00+03:00,out,False,937708,True,13,0,365,365
168187,2019-11-18 00:00:00+03:00,in,False,937788,False,6,406,472,66
168187,2019-11-18 00:00:00+03:00,out,False,937854,True,4,0,134,134
168187,2019-11-18 00:00:00+03:00,out,False,937862,True,2,0,123,123
168187,2019-11-18 00:00:00+03:00,out,False,937782,False,1,5,16,11
168187,2019-11-18 00:00:00+03:00,out,False,937788,True,9,0,261,261
168187,2019-11-18 00:00:00+03:00,out,False,937678,True,3,0,88,88
168187,2019-11-18 00:00:00+03:00,out,False,937888,True,10,0,305,305
168187,2019-11-18 00:00:00+03:00,out,False,937984,True,2,0,120,120
168187,2019-11-18 00:00:00+03:00,in,False,937812,False,10,929,1058,129
168187,2019-11-18 00:00:00+03:00,out,False,937812,False,5,550,679,129
168187,2019-11-18 00:00:00+03:00,in,False,-1,True,97,0,2833,2833
168187,2019-11-18 00:00:00+03:00,out,False,937868,True,2,0,61,61
168187,2019-11-18 00:00:00+03:00,in,False,948286,False,18,899,1239,340
168187,2019-11-18 00:00:00+03:00,in,False,948288,False,2,65,78,13
168187,2019-11-18 00:00:00+03:00,in,False,937862,False,3,129,172,43
168187,2019-11-18 00:00:00+03:00,out,False,937860,False,16,930,1243,313
168187,2019-11-18 00:00:00+03:00,in,False,937958,False,13,804,885,81
168187,2019-11-18 00:00:00+03:00,out,False,937902,False,3,238,295,57
168187,2019-11-18 00:00:00+03:00,out,False,937752,True,26,0,555,555
168187,2019-11-18 00:00:00+03:00,out,False,937760,False,12,1724,1952,228
168187,2019-11-18 00:00:00+03:00,in,False,937736,False,4,191,229,38
168187,2019-11-18 00:00:00+03:00,out,False,937788,False,2,229,270,41
168187,2019-11-18 00:00:00+03:00,in,False,937752,False,12,1025,1166,141
168187,2019-11-18 00:00:00+03:00,out,False,937812,True,4,0,25,25
168187,2019-11-18 00:00:00+03:00,out,False,937762,True,2,0,28,28
168187,2019-11-18 00:00:00+03:00,out,False,937780,False,7,303,493,190
168187,2019-11-18 00:00:00+03:00,out,False,937808,False,9,378,577,199
168187,2019-11-18 00:00:00+03:00,out,False,937732,False,2,145,169,24
168187,2019-11-18 00:00:00+03:00,out,False,937966,False,22,946,1329,383
168187,2019-11-18 00:00:00+03:00,in,False,937762,False,3,159,184,25
168187,2019-11-18 00:00:00+03:00,in,False,937864,False,1,69,80,11
168187,2019-11-18 00:00:00+03:00,in,False,937774,False,42,2503,2741,238
168187,2019-11-18 00:00:00+03:00,out,False,937966,True,31,0,614,614
168187,2019-11-18 00:00:00+03:00,in,False,937854,False,5,579,615,36
168187,2019-11-18 00:00:00+03:00,in,False,937708,False,10,953,1051,98
168187,2019-11-18 00:00:00+03:00,out,False,937810,False,2,93,170,77
168187,2019-11-18 00:00:00+03:00,out,False,937774,False,21,1301,1947,646
168187,2019-11-18 00:00:00+03:00,in,False,937678,False,1,66,74,8
168187,2019-11-18 00:00:00+03:00,out,False,937856,False,2,62,120,58
168187,2019-11-18 00:00:00+03:00,in,False,937760,False,11,935,1017,82
168187,2019-11-18 00:00:00+03:00,out,False,937752,False,25,5121,5591,470
168187,2019-11-18 00:00:00+03:00,in,False,937988,False,2,68,89,21
168187,2019-11-18 00:00:00+03:00,in,False,937960,False,4,595,629,34
168187,2019-11-18 00:00:00+03:00,out,False,937762,False,3,41,117,76
168187,2019-11-18 00:00:00+03:00,out,False,937864,True,4,0,14,14
168187,2019-11-18 00:00:00+03:00,out,False,937812,True,4,0,25,25
168187,2019-11-18 00:00:00+03:00,out,False,937780,True,1,0,59,59
168187,2019-11-18 00:00:00+03:00,in,False,948288,False,2,65,78,13
168187,2019-11-19 00:00:00+03:00,out,False,937732,False,7,1316,1418,102
168187,2019-11-19 00:00:00+03:00,in,False,937708,False,7,869,917,48
168187,2019-11-19 00:00:00+03:00,out,False,937708,False,8,600,806,206
168187,2019-11-19 00:00:00+03:00,in,False,937966,False,4,204,241,37
168187,2019-11-19 00:00:00+03:00,out,False,937854,True,8,0,299,299
168187,2019-11-19 00:00:00+03:00,out,False,937812,True,3,0,103,103
168187,2019-11-19 00:00:00+03:00,out,False,937708,True,15,0,519,519
168187,2019-11-19 00:00:00+03:00,out,False,937988,True,3,0,167,167
168187,2019-11-19 00:00:00+03:00,out,False,937760,True,12,0,289,289
168187,2019-11-19 00:00:00+03:00,in,False,937774,False,2,57,77,20
168187,2019-11-19 00:00:00+03:00,out,False,937678,False,4,104,181,77
168187,2019-11-19 00:00:00+03:00,out,False,937808,True,5,0,96,96
168187,2019-11-19 00:00:00+03:00,out,False,937760,False,9,819,1030,211
168187,2019-11-19 00:00:00+03:00,out,False,937780,True,23,0,743,743
168187,2019-11-19 00:00:00+03:00,out,False,937860,True,54,0,1339,1339
168187,2019-11-19 00:00:00+03:00,in,False,948286,False,7,548,666,118
168187,2019-11-19 00:00:00+03:00,in,False,937762,True,1,1,16,15
168187,2019-11-19 00:00:00+03:00,out,False,937774,True,1,0,52,52
168187,2019-11-19 00:00:00+03:00,in,False,937780,True,1,0,34,34
168187,2019-11-19 00:00:00+03:00,out,False,937888,False,13,851,1093,242
168187,2019-11-19 00:00:00+03:00,out,False,937868,True,2,0,49,49
168187,2019-11-19 00:00:00+03:00,in,False,937888,False,3,100,121,21
168187,2019-11-19 00:00:00+03:00,out,False,937780,False,20,1196,1685,489
168187,2019-11-19 00:00:00+03:00,out,False,937812,False,5,870,1020,150
168187,2019-11-19 00:00:00+03:00,out,False,937902,False,23,3077,3556,479
168187,2019-11-19 00:00:00+03:00,out,False,937788,False,9,905,1062,157
168187,2019-11-19 00:00:00+03:00,in,False,937956,False,32,3986,4037,51
168187,2019-11-19 00:00:00+03:00,in,False,937736,False,14,865,1006,141
168187,2019-11-19 00:00:00+03:00,in,False,937810,False,3,410,439,29
168187,2019-11-19 00:00:00+03:00,in,False,937812,False,12,1731,1927,196
168187,2019-11-19 00:00:00+03:00,in,False,-1,True,17,0,123,123
168187,2019-11-19 00:00:00+03:00,out,False,937736,False,31,1213,1897,684
168187,2019-11-19 00:00:00+03:00,out,False,937810,True,6,0,112,112
168187,2019-11-19 00:00:00+03:00,out,False,937862,False,6,690,885,195
168187,2019-11-19 00:00:00+03:00,out,False,937868,False,8,742,954,212
168187,2019-11-19 00:00:00+03:00,out,False,937678,True,8,0,173,173
168187,2019-11-19 00:00:00+03:00,out,False,937762,True,1,0,40,40
168187,2019-11-19 00:00:00+03:00,out,False,937966,True,20,0,399,399
168187,2019-11-19 00:00:00+03:00,in,False,937788,False,3,341,370,29
168187,2019-11-19 00:00:00+03:00,out,False,937870,True,1,0,12,12
168187,2019-11-19 00:00:00+03:00,out,False,937864,False,11,2840,3044,204
168187,2019-11-19 00:00:00+03:00,in,False,937752,False,13,675,814,139
168187,2019-11-19 00:00:00+03:00,in,False,937902,False,9,561,627,66
168187,2019-11-19 00:00:00+03:00,out,False,937752,True,25,0,478,478
168187,2019-11-19 00:00:00+03:00,in,False,937678,False,2,203,219,16
168187,2019-11-19 00:00:00+03:00,out,False,937966,False,8,1034,1199,165
168187,2019-11-19 00:00:00+03:00,out,False,937762,False,5,77,171,94
168187,2019-11-19 00:00:00+03:00,in,False,937762,False,5,131,182,51
168187,2019-11-19 00:00:00+03:00,in,False,937862,False,2,41,58,17
168187,2019-11-19 00:00:00+03:00,out,False,937810,False,4,296,383,87
168187,2019-11-19 00:00:00+03:00,in,False,937868,False,1,47,60,13
168187,2019-11-19 00:00:00+03:00,in,False,937860,False,6,673,735,62
168187,2019-11-19 00:00:00+03:00,out,False,937988,False,26,1267,1988,721
168187,2019-11-19 00:00:00+03:00,out,False,937860,False,59,4270,5368,1098
168187,2019-11-19 00:00:00+03:00,out,False,937854,False,15,644,930,286
168187,2019-11-19 00:00:00+03:00,in,False,937854,False,17,1178,1383,205
168187,2019-11-19 00:00:00+03:00,in,True,937888,False,1,30,36,6
168187,2019-11-19 00:00:00+03:00,in,False,937962,False,6,1774,1854,80
168187,2019-11-19 00:00:00+03:00,in,False,948286,True,5,2,19,17
168187,2019-11-19 00:00:00+03:00,in,False,937780,False,4,344,373,29
168187,2019-11-19 00:00:00+03:00,out,False,937752,False,23,2824,3172,348
168187,2019-11-19 00:00:00+03:00,in,False,937808,False,7,807,959,152
168187,2019-11-19 00:00:00+03:00,in,False,937808,True,1,0,35,35
168187,2019-11-19 00:00:00+03:00,in,True,937810,False,2,83,106,23
168187,2019-11-19 00:00:00+03:00,in,False,937960,False,7,1554,1611,57
168187,2019-11-19 00:00:00+03:00,out,False,937736,True,56,0,1105,1105
168187,2019-11-19 00:00:00+03:00,in,False,937760,False,4,526,559,33
168187,2019-11-19 00:00:00+03:00,out,False,937864,True,3,0,81,81
168187,2019-11-19 00:00:00+03:00,in,False,937732,False,4,258,322,64
168187,2019-11-19 00:00:00+03:00,in,False,937988,False,3,194,219,25
168187,2019-11-19 00:00:00+03:00,out,False,937862,True,5,0,179,179
168187,2019-11-19 00:00:00+03:00,in,False,937958,False,4,768,787,19
168187,2019-11-19 00:00:00+03:00,out,False,937732,True,1,0,19,19
168187,2019-11-19 00:00:00+03:00,out,False,937808,False,11,2336,2541,205
168187,2019-11-19 00:00:00+03:00,out,False,937888,True,8,0,337,337
168187,2019-11-19 00:00:00+03:00,out,False,937902,True,26,0,883,883
168187,2019-11-19 00:00:00+03:00,in,False,-1,True,123,0,3674,3674
168187,2019-11-19 00:00:00+03:00,out,False,937788,True,2,0,48,48
168187,2019-11-19 00:00:00+03:00,in,False,937956,False,32,3986,4037,51
168187,2019-11-19 00:00:00+03:00,in,True,937810,False,2,83,106,23
168187,2019-11-19 00:00:00+03:00,in,False,937808,False,7,807,959,152
168187,2019-11-19 00:00:00+03:00,in,False,937678,False,2,203,219,16
168187,2019-11-19 00:00:00+03:00,out,False,937862,False,6,690,885,195
168187,2019-11-19 00:00:00+03:00,in,False,937854,False,17,1178,1383,205
168187,2019-11-19 00:00:00+03:00,out,False,937736,True,56,0,1105,1105
168187,2019-11-19 00:00:00+03:00,out,False,937752,False,23,2824,3172,348
168187,2019-11-20 00:00:00+03:00,in,False,937732,False,5,960,1017,57
168187,2019-11-20 00:00:00+03:00,in,False,937774,False,21,3317,3475,158
168187,2019-11-20 00:00:00+03:00,out,False,937782,True,2,0,55,55
168187,2019-11-20 00:00:00+03:00,out,False,937760,False,11,1414,1585,171
168187,2019-11-20 00:00:00+03:00,out,False,937810,False,4,229,281,52
168187,2019-11-20 00:00:00+03:00,out,False,937988,False,16,1182,1648,466
168187,2019-11-20 00:00:00+03:00,out,False,937888,False,18,2024,2358,334
168187,2019-11-20 00:00:00+03:00,out,False,937788,True,6,0,107,107
168187,2019-11-20 00:00:00+03:00,out,False,937708,False,20,1543,1969,426
168187,2019-11-20 00:00:00+03:00,in,False,937854,False,5,310,371,61
168187,2019-11-20 00:00:00+03:00,in,True,937864,False,1,9,17,8
168187,2019-11-20 00:00:00+03:00,in,False,-1,True,69,0,1586,1586
168187,2019-11-20 00:00:00+03:00,out,False,937808,True,3,0,68,68
168187,2019-11-20 00:00:00+03:00,in,False,937888,False,8,1227,1275,48
168187,2019-11-20 00:00:00+03:00,out,False,937868,True,1,0,37,37
168187,2019-11-20 00:00:00+03:00,out,False,937788,False,6,592,702,110
168187,2019-11-20 00:00:00+03:00,out,False,937862,False,15,5330,5656,326
168187,2019-11-20 00:00:00+03:00,in,False,937808,False,5,893,933,40
168187,2019-11-20 00:00:00+03:00,in,False,937762,False,4,71,122,51
168187,2019-11-20 00:00:00+03:00,in,False,937864,False,3,388,407,19
168187,2019-11-20 00:00:00+03:00,out,False,937862,True,13,0,329,329
168187,2019-11-20 00:00:00+03:00,out,False,-1,True,1,0,0,0
168187,2019-11-20 00:00:00+03:00,out,False,937760,True,18,0,301,301
168187,2019-11-20 00:00:00+03:00,in,False,937958,True,1,0,19,19
168187,2019-11-20 00:00:00+03:00,in,False,937812,False,8,889,1017,128
168187,2019-11-20 00:00:00+03:00,out,False,937888,True,19,0,528,528
168187,2019-11-20 00:00:00+03:00,in,False,937788,False,1,30,35,5
168187,2019-11-20 00:00:00+03:00,out,False,937708,True,19,0,523,523
168187,2019-11-20 00:00:00+03:00,out,False,937736,True,38,0,909,909
168187,2019-11-20 00:00:00+03:00,out,False,937762,False,2,21,71,50
168187,2019-11-20 00:00:00+03:00,out,False,937808,False,9,905,1045,140
168187,2019-11-20 00:00:00+03:00,in,False,937860,False,7,719,770,51
168187,2019-11-20 00:00:00+03:00,in,False,937862,False,5,1953,1991,38
168187,2019-11-20 00:00:00+03:00,out,False,937770,True,1,0,37,37
168187,2019-11-20 00:00:00+03:00,in,False,937958,False,18,2164,2242,78
168187,2019-11-20 00:00:00+03:00,out,False,937854,False,9,893,1071,178
168187,2019-11-20 00:00:00+03:00,out,False,937678,True,4,0,125,125
168187,2019-11-20 00:00:00+03:00,in,False,948288,False,3,391,415,24
168187,2019-11-20 00:00:00+03:00,out,False,937864,False,7,588,745,157
168187,2019-11-20 00:00:00+03:00,out,False,937752,False,29,4337,4806,469
168187,2019-11-20 00:00:00+03:00,out,False,937988,True,6,0,226,226
168187,2019-11-20 00:00:00+03:00,out,False,937780,False,21,496,1036,540
168187,2019-11-20 00:00:00+03:00,out,False,937732,False,2,530,564,34
168187,2019-11-20 00:00:00+03:00,out,False,937774,False,10,2786,3028,242
168187,2019-11-20 00:00:00+03:00,out,False,937780,True,19,0,462,462
168187,2019-11-20 00:00:00+03:00,out,False,937752,True,31,0,762,762
168187,2019-11-20 00:00:00+03:00,out,False,937864,True,7,0,186,186
168187,2019-11-20 00:00:00+03:00,in,False,937752,False,20,4833,5025,192
168187,2019-11-20 00:00:00+03:00,out,False,937812,True,3,0,74,74
168187,2019-11-20 00:00:00+03:00,in,False,937856,False,1,130,140,10
168187,2019-11-20 00:00:00+03:00,out,False,937762,True,6,0,164,164
168187,2019-11-20 00:00:00+03:00,out,False,937810,True,3,0,67,67
168187,2019-11-20 00:00:00+03:00,in,False,948286,False,33,1181,1766,585
168187,2019-11-20 00:00:00+03:00,out,False,937966,False,9,2194,2366,172
168187,2019-11-20 00:00:00+03:00,in,False,937962,False,4,436,489,53
168187,2019-11-20 00:00:00+03:00,in,False,937782,False,2,86,188,102
168187,2019-11-20 00:00:00+03:00,out,False,937732,True,5,0,38,38
168187,2019-11-20 00:00:00+03:00,out,False,937966,True,13,0,291,291
168187,2019-11-20 00:00:00+03:00,in,False,937708,False,3,474,497,23
168187,2019-11-20 00:00:00+03:00,out,False,937902,False,22,1471,2032,561
168187,2019-11-20 00:00:00+03:00,in,False,937780,False,13,1817,1944,127
168187,2019-11-20 00:00:00+03:00,in,False,937960,False,10,1140,1236,96
168187,2019-11-20 00:00:00+03:00,out,False,937902,True,27,0,772,772
168187,2019-11-20 00:00:00+03:00,in,False,937988,False,4,378,442,64
168187,2019-11-20 00:00:00+03:00,out,False,937736,False,29,1030,1656,626
168187,2019-11-20 00:00:00+03:00,in,False,937902,False,3,224,242,18
168187,2019-11-20 00:00:00+03:00,out,False,937860,True,53,0,1194,1194
168187,2019-11-20 00:00:00+03:00,in,False,937868,False,1,162,171,9
168187,2019-11-20 00:00:00+03:00,out,False,937774,True,9,0,290,290
168187,2019-11-20 00:00:00+03:00,in,False,937760,False,8,548,606,58
168187,2019-11-20 00:00:00+03:00,in,False,-1,True,7,0,28,28
168187,2019-11-20 00:00:00+03:00,out,False,937868,False,2,31,70,39
168187,2019-11-20 00:00:00+03:00,in,False,937736,False,12,1140,1286,146
168187,2019-11-20 00:00:00+03:00,in,False,937966,False,10,1298,1358,60
168187,2019-11-20 00:00:00+03:00,in,False,937956,False,25,3879,3919,40
168187,2019-11-20 00:00:00+03:00,in,False,948286,True,2,0,7,7
168187,2019-11-20 00:00:00+03:00,in,False,937810,False,1,6,16,10
168187,2019-11-20 00:00:00+03:00,in,False,937742,False,3,205,246,41
168187,2019-11-20 00:00:00+03:00,out,False,937854,True,9,0,292,292
168187,2019-11-20 00:00:00+03:00,out,False,937812,False,8,1031,1279,248
168187,2019-11-20 00:00:00+03:00,out,False,937860,False,61,2662,3906,1244
168187,2019-11-20 00:00:00+03:00,in,False,937742,False,3,205,246,41
168187,2019-11-20 00:00:00+03:00,in,False,937812,False,8,889,1017,128
168187,2019-11-20 00:00:00+03:00,in,False,937988,False,4,378,442,64
168187,2019-11-20 00:00:00+03:00,out,False,937864,False,7,588,745,157
168187,2019-11-20 00:00:00+03:00,out,False,937678,True,4,0,125,125
168187,2019-11-20 00:00:00+03:00,in,False,937732,False,5,960,1017,57
168187,2019-11-20 00:00:00+03:00,out,False,937966,True,13,0,291,291
168187,2019-11-20 00:00:00+03:00,out,False,937708,False,20,1543,1969,426
168187,2019-11-20 00:00:00+03:00,in,False,937958,True,1,0,19,19
168187,2019-11-20 00:00:00+03:00,in,False,937888,False,8,1227,1275,48
168187,2019-11-21 00:00:00+03:00,out,False,937760,False,10,527,727,200
168187,2019-11-21 00:00:00+03:00,out,False,937760,True,14,0,216,216
168187,2019-11-21 00:00:00+03:00,out,False,937854,False,6,196,356,160
168187,2019-11-21 00:00:00+03:00,in,False,937958,False,9,1048,1151,103
168187,2019-11-21 00:00:00+03:00,out,False,937752,True,27,0,535,535
168187,2019-11-21 00:00:00+03:00,out,False,937864,False,3,633,682,49
168187,2019-11-21 00:00:00+03:00,in,False,937812,False,1,134,152,18
168187,2019-11-21 00:00:00+03:00,in,False,937808,False,1,52,67,15
168187,2019-11-21 00:00:00+03:00,out,False,937860,True,55,0,1427,1427
168187,2019-11-21 00:00:00+03:00,out,False,937902,False,22,1537,2072,535
168187,2019-11-21 00:00:00+03:00,in,False,937752,False,6,706,760,54
168187,2019-11-21 00:00:00+03:00,in,False,937862,False,2,128,211,83
168187,2019-11-21 00:00:00+03:00,out,False,937678,False,1,223,242,19
168187,2019-11-21 00:00:00+03:00,out,False,937966,False,2,60,114,54
168187,2019-11-21 00:00:00+03:00,out,False,937864,True,3,0,94,94
168187,2019-11-21 00:00:00+03:00,in,False,-1,True,37,0,1304,1304
168187,2019-11-21 00:00:00+03:00,out,False,937708,False,14,2518,2843,325
168187,2019-11-21 00:00:00+03:00,in,False,937888,False,4,394,423,29
168187,2019-11-21 00:00:00+03:00,in,False,937732,False,1,81,89,8
168187,2019-11-21 00:00:00+03:00,out,False,937732,False,5,486,571,85
168187,2019-11-21 00:00:00+03:00,out,False,937708,True,14,0,342,342
168187,2019-11-21 00:00:00+03:00,in,True,937780,False,3,70,96,26
168187,2019-11-21 00:00:00+03:00,out,False,937762,True,1,0,56,56
168187,2019-11-21 00:00:00+03:00,in,False,948286,False,7,608,735,127
168187,2019-11-21 00:00:00+03:00,out,False,937678,True,3,0,132,132
168187,2019-11-21 00:00:00+03:00,in,False,937810,False,3,268,292,24
168187,2019-11-21 00:00:00+03:00,in,False,937860,False,2,495,511,16
168187,2019-11-21 00:00:00+03:00,in,True,937854,False,1,368,376,8
168187,2019-11-21 00:00:00+03:00,in,True,937812,False,6,315,431,116
168187,2019-11-21 00:00:00+03:00,in,False,937962,False,1,240,251,11
168187,2019-11-21 00:00:00+03:00,out,False,937808,False,9,352,546,194
168187,2019-11-21 00:00:00+03:00,in,False,937960,False,5,779,829,50
168187,2019-11-21 00:00:00+03:00,in,False,937902,False,3,388,424,36
168187,2019-11-21 00:00:00+03:00,out,False,937762,False,1,2,41,39
168187,2019-11-21 00:00:00+03:00,in,True,937962,False,1,7,7,0
168187,2019-11-21 00:00:00+03:00,in,False,937708,False,4,523,635,112
168187,2019-11-21 00:00:00+03:00,in,True,937868,False,2,499,528,29
168187,2019-11-21 00:00:00+03:00,in,False,937856,False,2,16,37,21
168187,2019-11-21 00:00:00+03:00,in,True,937708,False,2,644,657,13
168187,2019-11-21 00:00:00+03:00,out,False,937868,False,7,1373,1479,106
168187,2019-11-21 00:00:00+03:00,out,False,937812,True,1,0,41,41
168187,2019-11-21 00:00:00+03:00,in,True,937888,False,3,562,599,37
168187,2019-11-21 00:00:00+03:00,in,True,937902,False,3,123,143,20
168187,2019-11-21 00:00:00+03:00,out,False,937854,True,5,0,125,125
168187,2019-11-21 00:00:00+03:00,out,False,937988,False,2,407,451,44
168187,2019-11-21 00:00:00+03:00,out,False,937862,False,6,1610,1743,133
168187,2019-11-21 00:00:00+03:00,out,False,937812,False,2,557,612,55
168187,2019-11-21 00:00:00+03:00,in,True,937760,False,6,326,421,95
168187,2019-11-21 00:00:00+03:00,in,False,937854,False,3,97,116,19
168187,2019-11-21 00:00:00+03:00,out,False,937810,False,5,160,232,72
168187,2019-11-21 00:00:00+03:00,out,False,937732,True,12,0,47,47
168187,2019-11-21 00:00:00+03:00,in,False,937762,False,5,272,320,48
168187,2019-11-21 00:00:00+03:00,out,False,937862,True,3,0,126,126
168187,2019-11-21 00:00:00+03:00,in,True,937860,False,1,5,13,8
168187,2019-11-21 00:00:00+03:00,in,False,937736,False,4,305,374,69
168187,2019-11-21 00:00:00+03:00,in,True,948286,False,1,14,15,1
168187,2019-11-21 00:00:00+03:00,out,False,937860,False,49,3654,4629,975
168187,2019-11-21 00:00:00+03:00,in,False,937988,False,1,292,315,23
168187,2019-11-21 00:00:00+03:00,in,False,-1,True,38,0,865,865
168187,2019-11-21 00:00:00+03:00,out,False,937888,False,21,584,966,382
168187,2019-11-21 00:00:00+03:00,out,False,937780,False,22,1834,2380,546
168187,2019-11-21 00:00:00+03:00,out,False,937888,True,28,0,523,523
168187,2019-11-21 00:00:00+03:00,out,False,937902,True,8,0,163,163
168187,2019-11-21 00:00:00+03:00,in,True,937966,False,6,613,660,47
168187,2019-11-21 00:00:00+03:00,in,False,937742,False,2,61,98,37
168187,2019-11-21 00:00:00+03:00,out,False,937868,True,4,0,55,55
168187,2019-11-21 00:00:00+03:00,in,True,937862,False,1,34,47,13
168187,2019-11-21 00:00:00+03:00,in,True,937752,False,4,72,119,47
168187,2019-11-21 00:00:00+03:00,out,False,937752,False,19,1588,1895,307
168187,2019-11-21 00:00:00+03:00,in,False,937780,False,6,766,819,53
168187,2019-11-21 00:00:00+03:00,in,False,937966,False,4,702,736,34
168187,2019-11-21 00:00:00+03:00,in,True,937808,False,3,89,115,26
168187,2019-11-21 00:00:00+03:00,in,False,937760,False,4,128,306,178
168187,2019-11-21 00:00:00+03:00,out,False,937736,True,24,0,624,624
168187,2019-11-21 00:00:00+03:00,out,False,937808,True,11,0,327,327
168187,2019-11-21 00:00:00+03:00,in,False,937956,False,33,6388,6423,35
168187,2019-11-21 00:00:00+03:00,out,False,937966,True,10,0,248,248
168187,2019-11-21 00:00:00+03:00,in,True,937736,False,16,1918,2094,176
168187,2019-11-21 00:00:00+03:00,in,True,937732,False,2,704,739,35
168187,2019-11-21 00:00:00+03:00,out,False,937810,True,2,0,18,18
168187,2019-11-21 00:00:00+03:00,out,False,937780,True,15,0,418,418
168187,2019-11-21 00:00:00+03:00,out,False,937988,True,3,0,134,134
168187,2019-11-21 00:00:00+03:00,out,False,937736,False,13,790,1046,256
168187,2019-11-21 00:00:00+03:00,in,True,937760,False,6,326,421,95
168187,2019-11-21 00:00:00+03:00,out,False,937862,True,3,0,126,126
168187,2019-11-21 00:00:00+03:00,in,False,937966,False,4,702,736,34
168187,2019-11-21 00:00:00+03:00,out,False,937678,False,1,223,242,19
168187,2019-11-21 00:00:00+03:00,out,False,937708,True,14,0,342,342
168187,2019-11-21 00:00:00+03:00,in,True,937962,False,1,7,7,0
168187,2019-11-21 00:00:00+03:00,out,False,937780,False,22,1834,2380,546
168187,2019-11-21 00:00:00+03:00,out,False,937862,False,6,1610,1743,133
168187,2019-11-21 00:00:00+03:00,out,False,937902,True,8,0,163,163
168187,2019-11-22 00:00:00+03:00,out,False,937678,True,1,0,23,23
168187,2019-11-22 00:00:00+03:00,in,True,937854,False,6,868,920,52
168187,2019-11-22 00:00:00+03:00,out,False,937874,True,2,0,75,75
168187,2019-11-22 00:00:00+03:00,in,True,937958,False,1,183,183,0
168187,2019-11-22 00:00:00+03:00,in,True,937808,False,4,143,193,50
168187,2019-11-22 00:00:00+03:00,in,False,937752,False,4,60,88,28
168187,2019-11-22 00:00:00+03:00,out,False,937708,True,7,0,173,173
168187,2019-11-22 00:00:00+03:00,out,False,937902,True,5,0,142,142
168187,2019-11-22 00:00:00+03:00,in,False,937760,False,1,58,64,6
168187,2019-11-22 00:00:00+03:00,in,False,948288,False,2,57,68,11
168187,2019-11-22 00:00:00+03:00,out,False,937862,True,4,0,168,168
168187,2019-11-22 00:00:00+03:00,in,True,937788,False,4,302,339,37
168187,2019-11-22 00:00:00+03:00,in,False,937966,False,1,163,170,7
168187,2019-11-22 00:00:00+03:00,in,True,937752,False,8,607,687,80
168187,2019-11-22 00:00:00+03:00,in,False,937888,False,3,32,49,17
168187,2019-11-22 00:00:00+03:00,out,False,937788,True,4,0,123,123
168187,2019-11-22 00:00:00+03:00,out,False,937854,False,17,1282,1559,277
168187,2019-11-22 00:00:00+03:00,in,True,937780,False,7,752,822,70
168187,2019-11-22 00:00:00+03:00,out,False,937752,False,12,859,1048,189
168187,2019-11-22 00:00:00+03:00,out,False,937860,True,32,0,996,996
168187,2019-11-22 00:00:00+03:00,out,False,937716,True,1,0,19,19
168187,2019-11-22 00:00:00+03:00,in,True,937760,False,16,1482,1622,140
168187,2019-11-22 00:00:00+03:00,out,False,937870,False,6,104,200,96
168187,2019-11-22 00:00:00+03:00,out,False,937902,False,13,1814,2070,256
168187,2019-11-22 00:00:00+03:00,out,False,937888,True,20,0,451,451
168187,2019-11-22 00:00:00+03:00,out,False,937678,False,2,21,46,25
168187,2019-11-22 00:00:00+03:00,out,False,937868,True,3,0,120,120
168187,2019-11-22 00:00:00+03:00,in,True,937708,False,4,426,446,20
168187,2019-11-22 00:00:00+03:00,in,False,937742,False,1,91,102,11
168187,2019-11-22 00:00:00+03:00,out,False,937780,True,10,0,266,266
168187,2019-11-22 00:00:00+03:00,in,True,937874,False,1,192,201,9
168187,2019-11-22 00:00:00+03:00,out,False,937860,False,24,1604,2008,404
168187,2019-11-22 00:00:00+03:00,in,False,937864,False,1,17,23,6
168187,2019-11-22 00:00:00+03:00,out,False,937732,True,2,0,3,3
168187,2019-11-22 00:00:00+03:00,in,True,937966,False,8,505,565,60
168187,2019-11-22 00:00:00+03:00,in,False,937810,False,3,92,123,31
168187,2019-11-22 00:00:00+03:00,out,False,937788,False,2,67,100,33
168187,2019-11-22 00:00:00+03:00,in,True,937956,False,2,74,75,1
168187,2019-11-22 00:00:00+03:00,out,False,937762,False,7,263,404,141
168187,2019-11-22 00:00:00+03:00,out,False,937762,True,2,0,82,82
168187,2019-11-22 00:00:00+03:00,in,False,948286,True,4,0,12,12
168187,2019-11-22 00:00:00+03:00,in,False,937960,False,21,4190,4409,219
168187,2019-11-22 00:00:00+03:00,out,False,937966,True,11,0,211,211
168187,2019-11-22 00:00:00+03:00,out,False,937874,False,12,917,1194,277
168187,2019-11-22 00:00:00+03:00,out,False,937888,False,8,667,828,161
168187,2019-11-22 00:00:00+03:00,in,True,937678,False,1,79,85,6
168187,2019-11-22 00:00:00+03:00,in,True,937862,False,2,120,142,22
168187,2019-11-22 00:00:00+03:00,out,False,937966,False,5,147,249,102
168187,2019-11-22 00:00:00+03:00,out,False,937736,True,18,0,431,431
168187,2019-11-22 00:00:00+03:00,out,False,937732,False,1,1,21,20
168187,2019-11-22 00:00:00+03:00,out,False,937760,False,16,942,1224,282
168187,2019-11-22 00:00:00+03:00,in,False,937956,False,12,1510,1534,24
168187,2019-11-22 00:00:00+03:00,in,False,-1,True,30,0,402,402
168187,2019-11-22 00:00:00+03:00,out,False,937708,False,10,538,839,301
168187,2019-11-22 00:00:00+03:00,out,False,937752,True,17,0,413,413
168187,2019-11-22 00:00:00+03:00,in,True,948286,False,4,88,91,3
168187,2019-11-22 00:00:00+03:00,in,True,937736,False,7,1406,1480,74
168187,2019-11-22 00:00:00+03:00,in,False,-1,True,59,0,1948,1948
168187,2019-11-22 00:00:00+03:00,out,False,937862,False,12,1590,1875,285
168187,2019-11-22 00:00:00+03:00,out,False,937854,True,11,0,250,250
168187,2019-11-22 00:00:00+03:00,in,True,937902,False,5,477,512,35
168187,2019-11-22 00:00:00+03:00,in,False,937962,False,1,55,71,16
168187,2019-11-22 00:00:00+03:00,in,True,937960,False,2,51,52,1
168187,2019-11-22 00:00:00+03:00,out,False,937780,False,13,1038,1376,338
168187,2019-11-22 00:00:00+03:00,in,True,937888,False,4,880,903,23
168187,2019-11-22 00:00:00+03:00,out,False,937870,True,4,0,73,73
168187,2019-11-22 00:00:00+03:00,in,True,937812,False,11,1040,1152,112
168187,2019-11-22 00:00:00+03:00,out,False,937736,False,11,586,809,223
168187,2019-11-22 00:00:00+03:00,out,True,937854,False,1,585,595,10
168187,2019-11-22 00:00:00+03:00,out,False,937812,False,5,941,1066,125
168187,2019-11-22 00:00:00+03:00,in,True,937860,False,7,1518,1571,53
168187,2019-11-22 00:00:00+03:00,in,True,937750,False,1,442,448,6
168187,2019-11-22 00:00:00+03:00,out,False,937808,False,12,334,627,293
168187,2019-11-22 00:00:00+03:00,out,False,937808,True,12,0,401,401
168187,2019-11-22 00:00:00+03:00,in,False,948286,False,30,1851,2400,549
168187,2019-11-22 00:00:00+03:00,in,True,937732,False,5,598,674,76
168187,2019-11-22 00:00:00+03:00,out,False,937868,False,7,3051,3229,178
168187,2019-11-22 00:00:00+03:00,in,False,937780,False,1,2,18,16
168187,2019-11-22 00:00:00+03:00,in,True,937962,False,1,91,92,1
168187,2019-11-22 00:00:00+03:00,in,False,937958,False,8,662,701,39
168187,2019-11-22 00:00:00+03:00,out,False,937760,True,22,0,498,498
168187,2019-11-22 00:00:00+03:00,in,False,937762,False,2,51,64,13
168187,2019-11-22 00:00:00+03:00,out,False,937808,False,12,334,627,293
168187,2019-11-22 00:00:00+03:00,in,True,937956,False,2,74,75,1
168187,2019-11-22 00:00:00+03:00,in,False,937742,False,1,91,102,11
168187,2019-11-22 00:00:00+03:00,in,False,948286,False,30,1851,2400,549
168187,2019-11-22 00:00:00+03:00,out,False,937812,False,5,941,1066,125
168187,2019-11-22 00:00:00+03:00,out,False,937860,False,24,1604,2008,404
168187,2019-11-22 00:00:00+03:00,out,False,937788,False,2,67,100,33
168187,2019-11-22 00:00:00+03:00,out,False,937868,True,3,0,120,120
168187,2019-11-22 00:00:00+03:00,in,False,937888,False,3,32,49,17
168187,2019-11-22 00:00:00+03:00,out,False,937762,True,2,0,82,82
168187,2019-11-23 00:00:00+03:00,in,False,948288,False,2,56,83,27
168187,2019-11-23 00:00:00+03:00,in,False,937888,False,1,203,228,25
168187,2019-11-23 00:00:00+03:00,in,False,937956,False,25,2793,2812,19
168187,2019-11-23 00:00:00+03:00,in,False,937962,False,1,67,83,16
168187,2019-11-23 00:00:00+03:00,in,False,937762,False,3,93,146,53
168187,2019-11-23 00:00:00+03:00,in,False,948286,False,26,667,1140,473
168187,2019-11-23 00:00:00+03:00,in,False,-1,True,17,0,196,196
168187,2019-11-23 00:00:00+03:00,in,False,937958,False,7,1146,1196,50
168187,2019-11-23 00:00:00+03:00,in,False,937752,False,1,50,129,79
168187,2019-11-23 00:00:00+03:00,in,False,937960,False,2,455,476,21
168187,2019-11-23 00:00:00+03:00,in,False,-1,True,1,0,17,17
168187,2019-11-23 00:00:00+03:00,in,False,948286,False,26,667,1140,473
168187,2019-11-24 00:00:00+03:00,in,False,-1,True,6,0,65,65
168187,2019-11-24 00:00:00+03:00,in,False,937956,False,50,5613,5654,41
168187,2019-11-24 00:00:00+03:00,in,False,948286,False,11,918,1123,205
168187,2019-11-24 00:00:00+03:00,in,False,937752,False,4,716,802,86
168187,2019-11-24 00:00:00+03:00,in,False,948288,False,2,113,125,12
168187,2019-11-24 00:00:00+03:00,in,False,937958,False,11,943,973,30
168187,2019-11-25 00:00:00+03:00,in,False,937902,False,4,245,311,66
168187,2019-11-25 00:00:00+03:00,out,False,937760,False,21,2000,2433,433
168187,2019-11-25 00:00:00+03:00,out,False,937762,False,3,127,216,89
168187,2019-11-25 00:00:00+03:00,in,False,937780,False,5,442,495,53
168187,2019-11-25 00:00:00+03:00,out,False,937736,True,32,0,902,902
168187,2019-11-25 00:00:00+03:00,out,False,937752,False,19,4030,4401,371
168187,2019-11-25 00:00:00+03:00,in,True,937860,False,1,131,138,7
168187,2019-11-25 00:00:00+03:00,in,False,948288,True,1,0,4,4
168187,2019-11-25 00:00:00+03:00,out,False,937862,True,15,0,466,466
168187,2019-11-25 00:00:00+03:00,out,False,937984,True,1,0,60,60
168187,2019-11-25 00:00:00+03:00,out,False,937780,True,13,0,303,303
168187,2019-11-25 00:00:00+03:00,out,False,937860,False,57,6359,7436,1077
168187,2019-11-25 00:00:00+03:00,in,False,937862,False,4,206,249,43
168187,2019-11-25 00:00:00+03:00,out,False,937854,False,15,970,1300,330
168187,2019-11-25 00:00:00+03:00,out,False,937752,True,32,0,699,699
168187,2019-11-25 00:00:00+03:00,in,False,948286,True,3,0,12,12
168187,2019-11-25 00:00:00+03:00,in,False,937860,False,11,2059,2145,86
168187,2019-11-25 00:00:00+03:00,in,False,937742,False,1,1,27,26
168187,2019-11-25 00:00:00+03:00,out,False,937810,False,2,141,176,35
168187,2019-11-25 00:00:00+03:00,out,False,937810,True,8,0,290,290
168187,2019-11-25 00:00:00+03:00,in,True,937956,False,4,160,169,9
168187,2019-11-25 00:00:00+03:00,in,False,937962,False,8,521,622,101
168187,2019-11-25 00:00:00+03:00,in,False,937966,False,3,287,309,22
168187,2019-11-25 00:00:00+03:00,out,False,937788,True,7,0,152,152
168187,2019-11-25 00:00:00+03:00,in,False,937732,False,4,315,358,43
168187,2019-11-25 00:00:00+03:00,in,False,-1,True,99,0,2593,2593
168187,2019-11-25 00:00:00+03:00,in,False,937812,False,7,545,646,101
168187,2019-11-25 00:00:00+03:00,out,False,937854,True,11,0,360,360
168187,2019-11-25 00:00:00+03:00,out,False,937708,True,4,0,126,126
168187,2019-11-25 00:00:00+03:00,out,False,937862,False,16,1474,1842,368
168187,2019-11-25 00:00:00+03:00,in,False,937874,False,8,1521,1578,57
168187,2019-11-25 00:00:00+03:00,in,False,937868,False,2,139,151,12
168187,2019-11-25 00:00:00+03:00,in,False,937874,True,1,0,8,8
168187,2019-11-25 00:00:00+03:00,in,False,937960,False,6,867,925,58
168187,2019-11-25 00:00:00+03:00,in,False,948288,False,2,120,152,32
168187,2019-11-25 00:00:00+03:00,in,False,948284,False,1,3,77,74
168187,2019-11-25 00:00:00+03:00,in,False,937782,False,2,187,215,28
168187,2019-11-25 00:00:00+03:00,out,False,937868,False,13,2092,2370,278
168187,2019-11-25 00:00:00+03:00,out,False,937966,False,9,635,763,128
168187,2019-11-25 00:00:00+03:00,out,False,937808,True,20,0,671,671
168187,2019-11-25 00:00:00+03:00,out,False,937732,False,7,890,1002,112
168187,2019-11-25 00:00:00+03:00,in,False,937762,False,2,175,193,18
168187,2019-11-25 00:00:00+03:00,in,False,937736,False,11,493,665,172
168187,2019-11-25 00:00:00+03:00,out,False,937902,True,3,0,75,75
168187,2019-11-25 00:00:00+03:00,out,False,937902,False,7,1648,1797,149
168187,2019-11-25 00:00:00+03:00,out,False,937762,True,1,0,42,42
168187,2019-11-25 00:00:00+03:00,in,False,-1,True,2,0,15,15
168187,2019-11-25 00:00:00+03:00,in,False,937958,False,7,903,951,48
168187,2019-11-25 00:00:00+03:00,in,False,937888,False,6,759,810,51
168187,2019-11-25 00:00:00+03:00,in,False,937808,False,13,1272,1394,122
168187,2019-11-25 00:00:00+03:00,in,False,937810,False,5,811,858,47
168187,2019-11-25 00:00:00+03:00,out,False,937708,False,4,148,254,106
168187,2019-11-25 00:00:00+03:00,out,False,937736,False,33,1996,2750,754
168187,2019-11-25 00:00:00+03:00,in,False,937962,True,1,0,16,16
168187,2019-11-25 00:00:00+03:00,out,False,937874,True,4,0,176,176
168187,2019-11-25 00:00:00+03:00,out,False,937856,False,2,50,117,67
168187,2019-11-25 00:00:00+03:00,out,False,937874,False,18,1443,1884,441
168187,2019-11-25 00:00:00+03:00,out,False,937868,True,8,0,229,229
168187,2019-11-25 00:00:00+03:00,out,False,937860,True,35,0,1038,1038
168187,2019-11-25 00:00:00+03:00,out,False,937812,True,1,0,7,7
168187,2019-11-25 00:00:00+03:00,out,False,937808,False,16,1573,1926,353
168187,2019-11-25 00:00:00+03:00,in,False,948286,False,26,2104,2466,362
168187,2019-11-25 00:00:00+03:00,out,False,937788,False,6,396,487,91
168187,2019-11-25 00:00:00+03:00,out,False,937760,True,16,0,413,413
168187,2019-11-25 00:00:00+03:00,out,False,937812,False,3,39,97,58
168187,2019-11-25 00:00:00+03:00,in,False,937774,False,1,26,36,10
168187,2019-11-25 00:00:00+03:00,in,False,937708,False,10,1020,1178,158
168187,2019-11-25 00:00:00+03:00,in,False,937956,False,28,4300,4348,48
168187,2019-11-25 00:00:00+03:00,out,False,937742,False,1,89,109,20
168187,2019-11-25 00:00:00+03:00,out,False,937888,False,8,362,539,177
168187,2019-11-25 00:00:00+03:00,in,True,937780,False,1,117,129,12
168187,2019-11-25 00:00:00+03:00,in,False,937854,False,3,300,328,28
168187,2019-11-25 00:00:00+03:00,out,False,937966,True,15,0,259,259
168187,2019-11-25 00:00:00+03:00,in,False,937788,False,4,244,287,43
168187,2019-11-25 00:00:00+03:00,in,False,937760,False,13,829,981,152
168187,2019-11-25 00:00:00+03:00,out,False,937678,True,6,0,190,190
168187,2019-11-25 00:00:00+03:00,out,False,937888,True,8,0,300,300
168187,2019-11-25 00:00:00+03:00,in,False,937752,False,29,5042,5403,361
168187,2019-11-25 00:00:00+03:00,out,False,937780,False,27,3636,4256,620
168187,2019-11-25 00:00:00+03:00,out,False,937732,True,12,0,108,108
168187,2019-11-25 00:00:00+03:00,in,False,937732,False,4,315,358,43
168187,2019-11-25 00:00:00+03:00,in,False,948286,True,3,0,12,12
168187,2019-11-25 00:00:00+03:00,in,False,937812,False,7,545,646,101
168187,2019-11-25 00:00:00+03:00,out,False,937902,False,7,1648,1797,149
168187,2019-11-25 00:00:00+03:00,in,True,937860,False,1,131,138,7
168187,2019-11-25 00:00:00+03:00,out,False,937752,True,32,0,699,699
168187,2019-11-25 00:00:00+03:00,in,False,937962,False,8,521,622,101
168187,2019-11-25 00:00:00+03:00,in,False,-1,True,99,0,2593,2593
168187,2019-11-25 00:00:00+03:00,in,False,937810,False,5,811,858,47
168187,2019-11-25 00:00:00+03:00,in,False,937762,False,2,175,193,18
168187,2019-11-26 00:00:00+03:00,in,False,937752,False,31,2860,3214,354
168187,2019-11-26 00:00:00+03:00,in,False,937774,False,1,29,37,8
168187,2019-11-26 00:00:00+03:00,in,False,937958,False,14,1778,1846,68
168187,2019-11-26 00:00:00+03:00,in,False,937956,False,17,3792,3831,39
168187,2019-11-26 00:00:00+03:00,out,False,937860,False,23,816,1146,330
168187,2019-11-26 00:00:00+03:00,in,False,937902,True,1,0,28,28
168187,2019-11-26 00:00:00+03:00,in,False,937810,False,2,27,50,23
168187,2019-11-26 00:00:00+03:00,out,False,937808,False,21,822,1234,412
168187,2019-11-26 00:00:00+03:00,out,True,937786,False,2,56,67,11
168187,2019-11-26 00:00:00+03:00,out,False,937736,True,15,0,442,442
168187,2019-11-26 00:00:00+03:00,in,False,937780,False,5,712,757,45
168187,2019-11-26 00:00:00+03:00,out,False,937808,True,21,0,447,447
168187,2019-11-26 00:00:00+03:00,in,False,937860,False,11,1469,1574,105
168187,2019-11-26 00:00:00+03:00,in,False,937962,False,5,876,946,70
168187,2019-11-26 00:00:00+03:00,out,True,937984,False,2,194,208,14
168187,2019-11-26 00:00:00+03:00,out,False,937708,True,20,0,481,481
168187,2019-11-26 00:00:00+03:00,in,False,-1,True,60,0,1980,1980
168187,2019-11-26 00:00:00+03:00,out,False,937874,True,7,0,158,158
168187,2019-11-26 00:00:00+03:00,out,False,937752,True,23,0,526,526
168187,2019-11-26 00:00:00+03:00,in,True,937780,False,1,225,239,14
168187,2019-11-26 00:00:00+03:00,out,False,937854,True,8,0,258,258
168187,2019-11-26 00:00:00+03:00,in,False,937958,True,1,0,1,1
168187,2019-11-26 00:00:00+03:00,in,True,937786,False,1,284,292,8
168187,2019-11-26 00:00:00+03:00,out,False,937966,False,4,150,208,58
168187,2019-11-26 00:00:00+03:00,out,False,937762,True,3,0,110,110
168187,2019-11-26 00:00:00+03:00,in,False,937888,False,9,878,952,74
168187,2019-11-26 00:00:00+03:00,in,False,937708,False,6,2176,2235,59
168187,2019-11-26 00:00:00+03:00,out,False,937888,False,18,973,1305,332
168187,2019-11-26 00:00:00+03:00,in,True,948286,False,1,32,33,1
168187,2019-11-26 00:00:00+03:00,out,False,937742,False,1,49,63,14
168187,2019-11-26 00:00:00+03:00,out,False,937862,True,6,0,230,230
168187,2019-11-26 00:00:00+03:00,in,False,937760,False,7,557,652,95
168187,2019-11-26 00:00:00+03:00,in,False,937862,False,5,729,775,46
168187,2019-11-26 00:00:00+03:00,in,False,937788,False,8,660,747,87
168187,2019-11-26 00:00:00+03:00,out,False,937812,False,1,23,33,10
168187,2019-11-26 00:00:00+03:00,out,False,937752,False,11,1146,1354,208
168187,2019-11-26 00:00:00+03:00,in,False,937854,False,4,268,317,49
168187,2019-11-26 00:00:00+03:00,in,False,948288,False,2,92,114,22
168187,2019-11-26 00:00:00+03:00,out,False,937678,False,2,63,112,49
168187,2019-11-26 00:00:00+03:00,out,False,937678,True,2,0,70,70
168187,2019-11-26 00:00:00+03:00,out,False,937788,True,9,0,211,211
168187,2019-11-26 00:00:00+03:00,in,False,937736,False,5,237,311,74
168187,2019-11-26 00:00:00+03:00,out,False,937708,False,17,881,1191,310
168187,2019-11-26 00:00:00+03:00,out,False,937736,False,19,847,1263,416
168187,2019-11-26 00:00:00+03:00,in,False,948286,False,19,943,1160,217
168187,2019-11-26 00:00:00+03:00,in,False,937902,False,7,395,445,50
168187,2019-11-26 00:00:00+03:00,out,False,937902,True,26,0,681,681
168187,2019-11-26 00:00:00+03:00,out,False,937868,True,2,0,30,30
168187,2019-11-26 00:00:00+03:00,in,False,937874,False,4,416,454,38
168187,2019-11-26 00:00:00+03:00,out,True,937780,True,1,0,2,2
168187,2019-11-26 00:00:00+03:00,out,False,937760,True,16,0,439,439
168187,2019-11-26 00:00:00+03:00,out,True,937780,False,4,18,46,28
168187,2019-11-26 00:00:00+03:00,out,False,937966,True,8,0,100,100
168187,2019-11-26 00:00:00+03:00,in,False,937960,False,10,1413,1507,94
168187,2019-11-26 00:00:00+03:00,in,False,937808,False,5,732,782,50
168187,2019-11-26 00:00:00+03:00,in,True,937736,False,1,5,13,8
168187,2019-11-26 00:00:00+03:00,in,False,937732,False,5,934,1002,68
168187,2019-11-26 00:00:00+03:00,in,False,937750,False,1,25,99,74
168187,2019-11-26 00:00:00+03:00,out,False,937810,False,3,113,176,63
168187,2019-11-26 00:00:00+03:00,in,False,937966,False,10,622,715,93
168187,2019-11-26 00:00:00+03:00,out,False,937874,False,27,1884,2570,686
168187,2019-11-26 00:00:00+03:00,out,False,937888,True,21,0,717,717
168187,2019-11-26 00:00:00+03:00,out,False,937860,True,41,0,1133,1133
168187,2019-11-26 00:00:00+03:00,out,False,937854,False,10,1247,1456,209
168187,2019-11-26 00:00:00+03:00,out,False,937862,False,7,244,363,119
168187,2019-11-26 00:00:00+03:00,out,False,937788,False,8,206,343,137
168187,2019-11-26 00:00:00+03:00,in,False,937678,False,2,394,419,25
168187,2019-11-26 00:00:00+03:00,out,False,937760,False,9,280,426,146
168187,2019-11-26 00:00:00+03:00,out,False,937810,True,9,0,169,169
168187,2019-11-26 00:00:00+03:00,out,False,937902,False,17,1186,1556,370
168187,2019-11-26 00:00:00+03:00,out,False,937732,False,1,15,26,11
168187,2019-11-26 00:00:00+03:00,in,False,948284,False,1,32,48,16
168187,2019-11-26 00:00:00+03:00,out,False,937780,False,15,1796,2149,353
168187,2019-11-26 00:00:00+03:00,out,False,937780,True,14,0,257,257
168187,2019-11-26 00:00:00+03:00,out,False,937812,True,3,0,111,111
168187,2019-11-26 00:00:00+03:00,out,False,937868,False,6,2167,2303,136
168187,2019-11-26 00:00:00+03:00,out,False,937762,False,3,134,196,62
168187,2019-11-26 00:00:00+03:00,in,False,937812,False,8,1772,1904,132
168187,2019-11-26 00:00:00+03:00,in,True,937962,False,1,3,4,1
168187,2019-11-26 00:00:00+03:00,out,False,937966,True,8,0,100,100
168187,2019-11-26 00:00:00+03:00,in,False,937752,False,31,2860,3214,354
168187,2019-11-26 00:00:00+03:00,out,False,937888,True,21,0,717,717
168187,2019-11-26 00:00:00+03:00,out,False,937736,False,19,847,1263,416
168187,2019-11-26 00:00:00+03:00,out,False,937736,True,15,0,442,442
168187,2019-11-26 00:00:00+03:00,in,False,937708,False,6,2176,2235,59
168187,2019-11-26 00:00:00+03:00,out,False,937902,True,26,0,681,681
168187,2019-11-27 00:00:00+03:00,in,False,937760,False,11,436,544,108
168187,2019-11-27 00:00:00+03:00,out,False,937874,True,15,0,495,495
168187,2019-11-27 00:00:00+03:00,in,False,937874,False,4,470,517,47
168187,2019-11-27 00:00:00+03:00,out,False,937760,False,8,380,527,147
168187,2019-11-27 00:00:00+03:00,in,False,937812,False,8,995,1111,116
168187,2019-11-27 00:00:00+03:00,out,False,937868,True,4,0,88,88
168187,2019-11-27 00:00:00+03:00,out,False,937888,False,4,205,277,72
168187,2019-11-27 00:00:00+03:00,out,False,937780,True,16,0,391,391
168187,2019-11-27 00:00:00+03:00,in,False,948286,False,10,1036,1205,169
168187,2019-11-27 00:00:00+03:00,out,False,937708,False,12,1834,2059,225
168187,2019-11-27 00:00:00+03:00,out,False,937786,False,4,96,153,57
168187,2019-11-27 00:00:00+03:00,in,False,948284,False,1,32,48,16
168187,2019-11-27 00:00:00+03:00,in,False,-1,True,76,0,3812,3812
168187,2019-11-27 00:00:00+03:00,in,False,937868,False,3,483,511,28
168187,2019-11-27 00:00:00+03:00,in,True,937780,True,1,20,28,8
168187,2019-11-27 00:00:00+03:00,in,False,937860,False,14,2424,2526,102
168187,2019-11-27 00:00:00+03:00,out,False,937736,True,12,0,367,367
168187,2019-11-27 00:00:00+03:00,out,False,937966,False,4,618,690,72
168187,2019-11-27 00:00:00+03:00,in,False,948282,False,1,60,61,1
168187,2019-11-27 00:00:00+03:00,out,False,937752,False,14,1302,1577,275
168187,2019-11-27 00:00:00+03:00,out,False,937774,True,7,0,167,167
168187,2019-11-27 00:00:00+03:00,in,False,937960,False,12,1661,1783,122
168187,2019-11-27 00:00:00+03:00,out,False,937902,True,20,0,646,646
168187,2019-11-27 00:00:00+03:00,in,False,937862,False,3,390,411,21
168187,2019-11-27 00:00:00+03:00,in,False,937966,False,10,1034,1222,188
168187,2019-11-27 00:00:00+03:00,out,False,937708,True,14,0,284,284
168187,2019-11-27 00:00:00+03:00,in,False,937962,False,8,989,1092,103
168187,2019-11-27 00:00:00+03:00,out,False,937788,True,11,0,246,246
168187,2019-11-27 00:00:00+03:00,in,False,937808,False,4,792,822,30
168187,2019-11-27 00:00:00+03:00,out,False,937860,True,29,0,692,692
168187,2019-11-27 00:00:00+03:00,in,False,937860,True,1,0,9,9
168187,2019-11-27 00:00:00+03:00,out,False,937780,False,20,1089,1537,448
168187,2019-11-27 00:00:00+03:00,out,False,937900,True,3,0,73,73
168187,2019-11-27 00:00:00+03:00,out,False,937810,False,6,291,395,104
168187,2019-11-27 00:00:00+03:00,out,False,937966,True,13,0,188,188
168187,2019-11-27 00:00:00+03:00,out,False,937732,False,3,272,322,50
168187,2019-11-27 00:00:00+03:00,out,False,937854,False,8,492,674,182
168187,2019-11-27 00:00:00+03:00,out,False,937810,True,5,0,107,107
168187,2019-11-27 00:00:00+03:00,in,False,937888,False,7,1299,1376,77
168187,2019-11-27 00:00:00+03:00,out,True,937984,False,4,653,704,51
168187,2019-11-27 00:00:00+03:00,out,False,937736,False,16,877,1194,317
168187,2019-11-27 00:00:00+03:00,in,False,937788,False,4,497,523,26
168187,2019-11-27 00:00:00+03:00,in,False,937902,False,8,503,581,78
168187,2019-11-27 00:00:00+03:00,out,False,937854,True,6,0,185,185
168187,2019-11-27 00:00:00+03:00,out,False,937856,True,2,0,9,9
168187,2019-11-27 00:00:00+03:00,out,False,937862,False,13,1908,2136,228
168187,2019-11-27 00:00:00+03:00,in,False,937736,False,5,400,442,42
168187,2019-11-27 00:00:00+03:00,in,False,937732,False,4,480,548,68
168187,2019-11-27 00:00:00+03:00,out,False,937788,False,8,520,664,144
168187,2019-11-27 00:00:00+03:00,in,True,937860,False,3,394,416,22
168187,2019-11-27 00:00:00+03:00,in,True,937780,False,4,120,150,30
168187,2019-11-27 00:00:00+03:00,out,False,937808,True,5,0,115,115
168187,2019-11-27 00:00:00+03:00,in,False,937762,False,5,316,421,105
168187,2019-11-27 00:00:00+03:00,in,False,937774,False,1,119,129,10
168187,2019-11-27 00:00:00+03:00,out,False,937900,False,1,61,100,39
168187,2019-11-27 00:00:00+03:00,out,False,937874,False,22,1196,1712,516
168187,2019-11-27 00:00:00+03:00,out,False,937678,True,12,0,246,246
168187,2019-11-27 00:00:00+03:00,in,False,937810,False,2,131,145,14
168187,2019-11-27 00:00:00+03:00,out,False,937862,True,11,0,290,290
168187,2019-11-27 00:00:00+03:00,out,False,937860,False,33,3288,3918,630
168187,2019-11-27 00:00:00+03:00,out,True,937780,True,1,0,8,8
168187,2019-11-27 00:00:00+03:00,out,True,937984,True,3,0,2,2
168187,2019-11-27 00:00:00+03:00,out,False,937808,False,11,600,837,237
168187,2019-11-27 00:00:00+03:00,in,True,937786,False,2,60,79,19
168187,2019-11-27 00:00:00+03:00,out,False,937678,False,6,120,211,91
168187,2019-11-27 00:00:00+03:00,out,False,937762,True,1,0,42,42
168187,2019-11-27 00:00:00+03:00,in,False,-1,True,1,0,6,6
168187,2019-11-27 00:00:00+03:00,out,False,937868,False,10,795,1017,222
168187,2019-11-27 00:00:00+03:00,in,False,937854,False,5,517,560,43
168187,2019-11-27 00:00:00+03:00,out,False,937888,True,5,0,117,117
168187,2019-11-27 00:00:00+03:00,out,False,937902,False,19,1189,1627,438
168187,2019-11-27 00:00:00+03:00,out,False,937812,False,1,34,49,15
168187,2019-11-27 00:00:00+03:00,out,False,937760,True,21,0,502,502
168187,2019-11-27 00:00:00+03:00,in,False,937780,False,13,1099,1268,169
168187,2019-11-27 00:00:00+03:00,in,False,937856,False,1,8,15,7
168187,2019-11-27 00:00:00+03:00,out,False,937856,False,1,57,78,21
168187,2019-11-27 00:00:00+03:00,in,False,948288,False,4,113,141,28
168187,2019-11-27 00:00:00+03:00,in,False,937956,False,12,1348,1388,40
168187,2019-11-27 00:00:00+03:00,in,False,937752,False,14,1892,2020,128
168187,2019-11-27 00:00:00+03:00,out,False,937752,True,34,0,774,774
168187,2019-11-27 00:00:00+03:00,in,False,937708,False,2,451,476,25
168187,2019-11-27 00:00:00+03:00,out,False,937762,False,3,324,396,72
168187,2019-11-27 00:00:00+03:00,out,False,937732,True,11,0,135,135
168187,2019-11-27 00:00:00+03:00,out,False,937786,True,2,0,65,65
168187,2019-11-27 00:00:00+03:00,in,False,937958,False,11,1639,1711,72
168187,2019-11-27 00:00:00+03:00,out,False,937774,False,7,448,565,117
168187,2019-11-27 00:00:00+03:00,out,False,937856,False,1,57,78,21
168187,2019-11-27 00:00:00+03:00,in,False,937810,False,2,131,145,14
168187,2019-11-27 00:00:00+03:00,in,False,937874,False,4,470,517,47
168187,2019-11-27 00:00:00+03:00,out,False,937788,False,8,520,664,144
168187,2019-11-27 00:00:00+03:00,out,False,937774,False,7,448,565,117
168187,2019-11-28 00:00:00+03:00,out,False,937752,False,11,1056,1227,171
168187,2019-11-28 00:00:00+03:00,out,False,937854,True,11,0,487,487
168187,2019-11-28 00:00:00+03:00,in,False,948288,False,2,429,552,123
168187,2019-11-28 00:00:00+03:00,out,False,937874,True,6,0,276,276
168187,2019-11-28 00:00:00+03:00,in,False,937732,False,4,310,379,69
168187,2019-11-28 00:00:00+03:00,out,False,937966,False,7,294,441,147
168187,2019-11-28 00:00:00+03:00,out,False,937854,False,22,1186,1587,401
168187,2019-11-28 00:00:00+03:00,in,False,937898,True,2,37,51,14
168187,2019-11-28 00:00:00+03:00,out,False,937678,True,1,0,8,8
168187,2019-11-28 00:00:00+03:00,out,False,937760,True,21,0,370,370
168187,2019-11-28 00:00:00+03:00,in,False,937860,True,3,72,87,15
168187,2019-11-28 00:00:00+03:00,in,False,937780,False,5,824,869,45
168187,2019-11-28 00:00:00+03:00,out,False,937898,False,6,213,347,134
168187,2019-11-28 00:00:00+03:00,out,True,937984,True,3,0,0,0
168187,2019-11-28 00:00:00+03:00,out,False,937788,True,17,0,413,413
168187,2019-11-28 00:00:00+03:00,out,False,937812,True,5,0,141,141
168187,2019-11-28 00:00:00+03:00,out,False,937868,True,8,0,184,184
168187,2019-11-28 00:00:00+03:00,in,False,937966,False,2,122,132,10
168187,2019-11-28 00:00:00+03:00,out,False,937786,False,1,528,547,19
168187,2019-11-28 00:00:00+03:00,in,False,937888,False,4,540,568,28
168187,2019-11-28 00:00:00+03:00,in,False,937860,False,8,652,720,68
168187,2019-11-28 00:00:00+03:00,out,False,937780,True,15,0,340,340
168187,2019-11-28 00:00:00+03:00,in,False,937862,False,6,656,723,67
168187,2019-11-28 00:00:00+03:00,in,False,937898,False,7,2017,2071,54
168187,2019-11-28 00:00:00+03:00,out,True,937864,True,3,0,7,7
168187,2019-11-28 00:00:00+03:00,in,False,937966,True,1,0,8,8
168187,2019-11-28 00:00:00+03:00,out,False,946072,True,1,0,1,1
168187,2019-11-28 00:00:00+03:00,in,False,937742,False,1,90,100,10
168187,2019-11-28 00:00:00+03:00,out,False,937810,False,7,369,528,159
168187,2019-11-28 00:00:00+03:00,out,False,937902,True,26,0,571,571
168187,2019-11-28 00:00:00+03:00,in,False,937960,False,12,2250,2357,107
168187,2019-11-28 00:00:00+03:00,in,False,937902,False,7,847,912,65
168187,2019-11-28 00:00:00+03:00,out,False,937812,False,15,1597,1952,355
168187,2019-11-28 00:00:00+03:00,out,False,937856,False,1,2,36,34
168187,2019-11-28 00:00:00+03:00,out,False,937862,False,5,1406,1531,125
168187,2019-11-28 00:00:00+03:00,out,False,937888,True,15,0,555,555
168187,2019-11-28 00:00:00+03:00,in,False,937958,False,13,2319,2385,66
168187,2019-11-28 00:00:00+03:00,in,False,937874,False,1,135,148,13
168187,2019-11-28 00:00:00+03:00,in,False,937760,False,15,752,895,143
168187,2019-11-28 00:00:00+03:00,in,False,948286,False,2,43,45,2
168187,2019-11-28 00:00:00+03:00,out,False,937678,False,2,957,985,28
168187,2019-11-28 00:00:00+03:00,in,False,937774,False,1,94,104,10
168187,2019-11-28 00:00:00+03:00,out,False,937760,False,10,1353,1544,191
168187,2019-11-28 00:00:00+03:00,in,False,937736,False,6,463,511,48
168187,2019-11-28 00:00:00+03:00,in,False,-1,True,110,0,2336,2336
168187,2019-11-28 00:00:00+03:00,in,False,937962,False,1,3,19,16
168187,2019-11-28 00:00:00+03:00,out,False,937736,True,20,0,554,554
168187,2019-11-28 00:00:00+03:00,out,False,937762,True,4,0,95,95
168187,2019-11-28 00:00:00+03:00,out,False,937902,False,34,2913,3625,712
168187,2019-11-28 00:00:00+03:00,out,False,937808,False,17,488,855,367
168187,2019-11-28 00:00:00+03:00,out,False,937860,True,17,0,267,267
168187,2019-11-28 00:00:00+03:00,out,False,937780,False,30,1025,1598,573
168187,2019-11-28 00:00:00+03:00,in,False,937812,True,1,61,69,8
168187,2019-11-28 00:00:00+03:00,in,False,937810,False,1,25,36,11
168187,2019-11-28 00:00:00+03:00,out,False,937966,True,15,0,261,261
168187,2019-11-28 00:00:00+03:00,in,True,937732,False,2,237,281,44
168187,2019-11-28 00:00:00+03:00,out,True,937898,False,6,539,569,30
168187,2019-11-28 00:00:00+03:00,out,False,937810,True,4,0,91,91
168187,2019-11-28 00:00:00+03:00,out,False,937708,False,12,609,832,223
168187,2019-11-28 00:00:00+03:00,out,True,937984,False,4,739,766,27
168187,2019-11-28 00:00:00+03:00,in,False,937868,False,1,39,46,7
168187,2019-11-28 00:00:00+03:00,out,False,937786,True,3,0,81,81
168187,2019-11-28 00:00:00+03:00,in,False,937956,False,14,1295,1306,11
168187,2019-11-28 00:00:00+03:00,in,False,937762,False,1,17,25,8
168187,2019-11-28 00:00:00+03:00,in,False,937962,True,1,0,16,16
168187,2019-11-28 00:00:00+03:00,out,False,937860,False,12,1265,1467,202
168187,2019-11-28 00:00:00+03:00,in,False,937864,False,1,240,245,5
168187,2019-11-28 00:00:00+03:00,in,False,937788,False,12,817,1049,232
168187,2019-11-28 00:00:00+03:00,out,False,937984,True,2,0,64,64
168187,2019-11-28 00:00:00+03:00,out,False,937874,False,18,635,1136,501
168187,2019-11-28 00:00:00+03:00,out,False,937736,False,18,1176,1559,383
168187,2019-11-28 00:00:00+03:00,out,False,937708,True,10,0,344,344
168187,2019-11-28 00:00:00+03:00,in,False,937752,False,23,3752,3999,247
168187,2019-11-28 00:00:00+03:00,out,False,937898,True,20,0,470,470
168187,2019-11-28 00:00:00+03:00,out,False,937788,False,15,1320,1614,294
168187,2019-11-28 00:00:00+03:00,out,False,937888,False,19,1047,1442,395
168187,2019-11-28 00:00:00+03:00,out,False,937862,True,3,0,93,93
168187,2019-11-28 00:00:00+03:00,out,False,937868,False,8,1563,1798,235
168187,2019-11-28 00:00:00+03:00,out,False,937808,True,9,0,314,314
168187,2019-11-28 00:00:00+03:00,in,False,937808,False,7,392,480,88
168187,2019-11-28 00:00:00+03:00,out,False,937732,False,2,991,1020,29
168187,2019-11-28 00:00:00+03:00,in,False,937812,False,13,1289,1408,119
168187,2019-11-28 00:00:00+03:00,out,False,937752,True,12,0,230,230
168187,2019-11-28 00:00:00+03:00,in,True,946072,False,1,175,181,6
168187,2019-11-28 00:00:00+03:00,out,True,937864,False,8,875,932,57
168187,2019-11-28 00:00:00+03:00,in,False,937854,False,3,114,146,32
168187,2019-11-28 00:00:00+03:00,in,False,937708,False,12,913,1025,112
168187,2019-11-28 00:00:00+03:00,out,False,937856,True,2,0,44,44
168187,2019-11-28 00:00:00+03:00,out,False,937788,False,15,1320,1614,294
168187,2019-11-28 00:00:00+03:00,out,False,937678,False,2,957,985,28
168187,2019-11-28 00:00:00+03:00,out,False,937808,False,17,488,855,367
168187,2019-11-28 00:00:00+03:00,out,False,937780,True,15,0,340,340
168187,2019-11-28 00:00:00+03:00,in,False,948286,False,2,43,45,2
168187,2019-11-28 00:00:00+03:00,in,False,937860,True,3,72,87,15
168187,2019-11-28 00:00:00+03:00,out,False,937856,False,1,2,36,34
168187,2019-11-28 00:00:00+03:00,out,False,937898,False,6,213,347,134
168187,2019-11-28 00:00:00+03:00,in,False,937780,False,5,824,869,45
168187,2019-11-28 00:00:00+03:00,out,False,937966,True,15,0,261,261
168187,2019-11-28 00:00:00+03:00,in,False,937960,False,12,2250,2357,107
168187,2019-11-28 00:00:00+03:00,in,False,937812,True,1,61,69,8
168187,2019-11-28 00:00:00+03:00,out,False,937874,False,18,635,1136,501
168187,2019-11-28 00:00:00+03:00,out,False,937780,False,30,1025,1598,573
168187,2019-11-28 00:00:00+03:00,out,False,937860,False,12,1265,1467,202
168190,2019-10-24 00:00:00+03:00,in,False,-1,True,1,0,2,2
168190,2019-10-28 00:00:00+03:00,in,False,-1,True,1,0,2,2
168190,2019-11-01 00:00:00+03:00,in,False,952982,False,1,5,6,1
168190,2019-11-01 00:00:00+03:00,in,False,-1,True,4,0,8,8
168190,2019-11-01 00:00:00+03:00,in,False,952982,False,1,5,6,1
168190,2019-11-13 00:00:00+03:00,in,False,-1,True,16,0,100,100
168190,2019-11-13 00:00:00+03:00,in,False,952982,False,1,17,17,0
168190,2019-11-15 00:00:00+03:00,in,False,952982,False,1,114,115,1
168190,2019-11-18 00:00:00+03:00,in,False,952982,False,2,121,123,2
168190,2019-11-21 00:00:00+03:00,in,False,952982,False,2,90,92,2
168190,2019-11-23 00:00:00+03:00,in,False,952982,False,1,44,45,1
168193,2019-10-22 00:00:00+03:00,in,False,-1,True,1,0,2,2
168193,2019-10-24 00:00:00+03:00,in,False,-1,True,1,0,2,2
168193,2019-10-28 00:00:00+03:00,out,False,947816,False,1,2,15,13
168193,2019-10-28 00:00:00+03:00,in,False,-1,True,1,0,10,10
168193,2019-10-29 00:00:00+03:00,out,False,947818,True,1,0,13,13
168193,2019-10-29 00:00:00+03:00,out,False,947816,True,1,0,16,16
168193,2019-10-29 00:00:00+03:00,in,False,947816,False,2,30,57,27
168193,2019-10-29 00:00:00+03:00,out,False,947816,False,1,5,15,10
168193,2019-10-30 00:00:00+03:00,in,False,-1,True,1,0,21,21
168193,2019-10-30 00:00:00+03:00,out,False,948150,True,2,0,23,23
168193,2019-11-01 00:00:00+03:00,out,False,947816,False,6,264,346,82
168193,2019-11-01 00:00:00+03:00,in,False,947816,False,1,98,149,51
168193,2019-11-01 00:00:00+03:00,in,False,947818,False,2,30,46,16
168193,2019-11-01 00:00:00+03:00,out,False,947818,False,2,66,96,30
168193,2019-11-01 00:00:00+03:00,out,True,947816,True,1,0,60,60
168193,2019-11-01 00:00:00+03:00,in,False,-1,True,5,0,190,190
168193,2019-11-01 00:00:00+03:00,out,False,947816,True,2,0,56,56
168193,2019-11-01 00:00:00+03:00,out,False,947818,False,2,66,96,30
168193,2019-11-01 00:00:00+03:00,out,True,947816,True,1,0,60,60
168193,2019-11-02 00:00:00+03:00,out,True,947816,False,1,155,196,41
168193,2019-11-02 00:00:00+03:00,out,False,947816,False,1,103,121,18
168193,2019-11-02 00:00:00+03:00,in,False,948150,False,14,467,625,158
168193,2019-11-02 00:00:00+03:00,out,False,948150,False,2,28,59,31
168193,2019-11-02 00:00:00+03:00,in,False,947816,False,1,220,238,18
168193,2019-11-02 00:00:00+03:00,out,False,948150,True,2,0,30,30
168193,2019-11-02 00:00:00+03:00,in,False,947818,False,1,61,68,7
168193,2019-11-02 00:00:00+03:00,in,False,-1,True,7,0,111,111
168193,2019-11-02 00:00:00+03:00,in,False,947816,False,1,220,238,18
168193,2019-11-07 00:00:00+03:00,in,False,-1,True,1,0,25,25
168193,2019-11-07 00:00:00+03:00,in,False,948170,False,1,29,55,26
168193,2019-11-07 00:00:00+03:00,in,False,-1,True,1,0,25,25
168193,2019-11-08 00:00:00+03:00,in,False,947816,False,2,125,149,24
168193,2019-11-08 00:00:00+03:00,in,False,-1,True,9,0,235,235
168193,2019-11-08 00:00:00+03:00,out,False,947816,True,1,0,2,2
168193,2019-11-08 00:00:00+03:00,in,False,948150,False,2,33,64,31
168193,2019-11-08 00:00:00+03:00,in,False,947816,False,2,125,149,24
168193,2019-11-11 00:00:00+03:00,out,False,947818,False,13,480,608,128
168193,2019-11-11 00:00:00+03:00,out,False,947818,True,1,0,1,1
168193,2019-11-11 00:00:00+03:00,out,False,947816,False,4,45,73,28
168193,2019-11-11 00:00:00+03:00,in,False,947816,False,3,40,55,15
168193,2019-11-11 00:00:00+03:00,in,False,947818,False,3,108,124,16
168193,2019-11-11 00:00:00+03:00,out,False,947816,True,2,0,43,43
168193,2019-11-11 00:00:00+03:00,in,False,-1,True,1,0,16,16
168193,2019-11-11 00:00:00+03:00,out,False,951046,False,2,73,92,19
168193,2019-11-11 00:00:00+03:00,in,False,947818,False,3,108,124,16
168193,2019-11-12 00:00:00+03:00,out,False,947818,True,1,0,4,4
168193,2019-11-12 00:00:00+03:00,out,False,951046,False,6,245,359,114
168193,2019-11-12 00:00:00+03:00,in,False,948170,False,1,23,27,4
168193,2019-11-12 00:00:00+03:00,out,False,947818,False,5,450,537,87
168193,2019-11-12 00:00:00+03:00,out,False,951046,True,2,0,47,47
168193,2019-11-12 00:00:00+03:00,in,False,951046,False,1,14,36,22
168193,2019-11-12 00:00:00+03:00,out,False,947816,False,3,624,660,36
168193,2019-11-13 00:00:00+03:00,out,False,951046,True,2,0,95,95
168193,2019-11-13 00:00:00+03:00,out,False,948170,False,3,240,287,47
168193,2019-11-13 00:00:00+03:00,in,False,-1,True,1,0,59,59
168193,2019-11-13 00:00:00+03:00,out,False,951046,False,6,244,328,84
168193,2019-11-13 00:00:00+03:00,out,False,947818,False,1,25,38,13
168193,2019-11-13 00:00:00+03:00,out,False,951046,False,6,244,328,84
168193,2019-11-14 00:00:00+03:00,out,True,948150,False,2,64,77,13
168193,2019-11-14 00:00:00+03:00,out,False,948150,False,1,83,94,11
168193,2019-11-14 00:00:00+03:00,out,False,947820,False,8,327,402,75
168193,2019-11-14 00:00:00+03:00,out,False,947820,True,1,0,3,3
168193,2019-11-14 00:00:00+03:00,in,False,948150,False,8,332,397,65
168193,2019-11-14 00:00:00+03:00,in,False,-1,True,1,0,3,3
168193,2019-11-14 00:00:00+03:00,out,False,947820,False,8,327,402,75
168193,2019-11-14 00:00:00+03:00,in,False,948150,False,8,332,397,65
168193,2019-11-20 00:00:00+03:00,in,False,951046,False,1,39,54,15
168193,2019-11-20 00:00:00+03:00,in,False,-1,True,1,0,30,30
168193,2019-11-27 00:00:00+03:00,out,False,947818,True,2,0,31,31
168193,2019-11-27 00:00:00+03:00,out,False,947818,True,2,0,31,31
168193,2019-11-28 00:00:00+03:00,in,False,947816,False,2,194,279,85
168193,2019-11-28 00:00:00+03:00,out,True,951046,True,1,0,0,0
168193,2019-11-28 00:00:00+03:00,out,False,947816,False,1,45,59,14
168193,2019-11-28 00:00:00+03:00,in,False,951046,False,1,4,9,5
168193,2019-11-28 00:00:00+03:00,in,False,947818,False,6,168,266,98
168193,2019-11-28 00:00:00+03:00,in,False,-1,True,2,0,72,72
168193,2019-11-28 00:00:00+03:00,out,False,947818,False,6,91,165,74
168193,2019-11-28 00:00:00+03:00,out,False,951046,True,7,0,20,20
168193,2019-11-28 00:00:00+03:00,out,False,951046,False,8,409,474,65
168193,2019-11-28 00:00:00+03:00,out,False,947818,True,1,0,10,10
168193,2019-11-28 00:00:00+03:00,out,False,947816,True,4,0,126,126
168193,2019-11-28 00:00:00+03:00,in,False,-1,True,2,0,72,72
168193,2019-11-28 00:00:00+03:00,out,False,951046,True,7,0,20,20
168193,2019-11-28 00:00:00+03:00,out,False,951046,False,8,409,474,65
168202,2019-10-21 00:00:00+03:00,in,False,-1,True,1,0,3,3
168202,2019-10-29 00:00:00+03:00,in,False,944564,False,1,21,34,13
168202,2019-11-05 00:00:00+03:00,in,False,944564,False,1,19,34,15
168221,2019-10-24 00:00:00+03:00,out,False,944474,True,3,0,30,30
168221,2019-10-24 00:00:00+03:00,out,False,944474,False,1,8,21,13
168221,2019-10-24 00:00:00+03:00,out,False,944474,False,1,8,21,13
168221,2019-10-25 00:00:00+03:00,out,False,944474,True,1,0,9,9
168221,2019-10-25 00:00:00+03:00,out,False,944474,False,6,15,170,155
168221,2019-10-26 00:00:00+03:00,out,False,944476,True,1,0,10,10
168221,2019-10-27 00:00:00+03:00,out,False,944476,True,1,0,14,14
168221,2019-10-28 00:00:00+03:00,out,False,944476,True,3,0,54,54
168221,2019-10-29 00:00:00+03:00,out,False,-1,True,1,0,17,17
168221,2019-10-31 00:00:00+03:00,in,False,944474,False,3,46,84,38
168221,2019-10-31 00:00:00+03:00,in,False,-1,True,9,0,249,249
168221,2019-10-31 00:00:00+03:00,out,False,-1,True,1,0,14,14
168221,2019-10-31 00:00:00+03:00,in,False,944476,False,3,70,90,20
168221,2019-10-31 00:00:00+03:00,out,False,944474,True,1,0,5,5
168221,2019-10-31 00:00:00+03:00,out,False,944476,True,9,0,42,42
168221,2019-11-01 00:00:00+03:00,in,False,-1,True,4,0,88,88
168221,2019-11-01 00:00:00+03:00,in,False,944476,False,3,91,111,20
168221,2019-11-02 00:00:00+03:00,in,False,-1,True,5,0,160,160
168221,2019-11-05 00:00:00+03:00,in,False,944476,False,1,17,25,8
168221,2019-11-05 00:00:00+03:00,out,False,-1,True,1,0,12,12
168221,2019-11-05 00:00:00+03:00,in,False,-1,True,11,0,274,274
168221,2019-11-05 00:00:00+03:00,in,False,944474,False,3,84,196,112
168221,2019-11-05 00:00:00+03:00,out,False,-1,True,1,0,12,12
168221,2019-11-06 00:00:00+03:00,out,False,-1,True,1,0,20,20
168221,2019-11-06 00:00:00+03:00,in,False,-1,True,19,0,402,402
168221,2019-11-06 00:00:00+03:00,in,False,944476,False,9,592,648,56
168221,2019-11-07 00:00:00+03:00,in,False,-1,True,3,0,60,60
168221,2019-11-07 00:00:00+03:00,in,False,944476,False,7,557,610,53
168221,2019-11-08 00:00:00+03:00,in,False,944476,False,10,451,532,81
168221,2019-11-09 00:00:00+03:00,in,False,944476,False,8,467,553,86
168221,2019-11-09 00:00:00+03:00,in,False,-1,True,1,0,2,2
168221,2019-11-09 00:00:00+03:00,in,False,944476,False,8,467,553,86
168221,2019-11-10 00:00:00+03:00,in,False,944476,False,6,368,432,64
168221,2019-11-10 00:00:00+03:00,in,False,-1,True,1,0,40,40
168221,2019-11-11 00:00:00+03:00,in,False,944476,False,11,865,927,62
168221,2019-11-12 00:00:00+03:00,in,False,-1,True,5,0,107,107
168221,2019-11-12 00:00:00+03:00,in,False,944476,False,14,1981,2117,136
168221,2019-11-13 00:00:00+03:00,in,False,-1,True,6,0,101,101
168221,2019-11-13 00:00:00+03:00,in,False,944476,False,10,994,1174,180
168221,2019-11-14 00:00:00+03:00,in,False,944476,False,8,631,770,139
168221,2019-11-14 00:00:00+03:00,in,False,-1,True,1,0,49,49
168221,2019-11-14 00:00:00+03:00,in,False,-1,True,1,0,49,49
168221,2019-11-15 00:00:00+03:00,in,False,944476,False,6,402,521,119
168221,2019-11-15 00:00:00+03:00,in,False,944476,False,6,402,521,119
168221,2019-11-16 00:00:00+03:00,in,False,944476,False,8,459,590,131
168221,2019-11-16 00:00:00+03:00,in,False,-1,True,1,0,38,38
168221,2019-11-16 00:00:00+03:00,out,False,944476,False,1,33,44,11
168221,2019-11-16 00:00:00+03:00,out,False,944476,False,1,33,44,11
168221,2019-11-17 00:00:00+03:00,in,False,-1,True,5,0,248,248
168221,2019-11-17 00:00:00+03:00,in,False,952292,False,2,451,532,81
168221,2019-11-17 00:00:00+03:00,in,False,944476,False,5,98,169,71
168221,2019-11-18 00:00:00+03:00,in,False,-1,True,1,0,9,9
168221,2019-11-18 00:00:00+03:00,in,False,944476,False,6,228,316,88
168221,2019-11-19 00:00:00+03:00,in,False,944476,False,3,264,337,73
168221,2019-11-19 00:00:00+03:00,in,False,-1,True,3,0,100,100
168221,2019-11-20 00:00:00+03:00,in,False,944476,False,10,909,1084,175
168221,2019-11-20 00:00:00+03:00,in,False,-1,True,1,0,14,14
168221,2019-11-21 00:00:00+03:00,in,False,-1,True,3,0,116,116
168221,2019-11-21 00:00:00+03:00,in,False,944476,False,12,1067,1239,172
168221,2019-11-22 00:00:00+03:00,in,False,-1,True,3,0,88,88
168221,2019-11-22 00:00:00+03:00,in,False,944476,False,10,491,675,184
168221,2019-11-23 00:00:00+03:00,in,False,-1,True,1,0,113,113
168221,2019-11-23 00:00:00+03:00,in,False,944476,False,7,314,423,109
168221,2019-11-24 00:00:00+03:00,in,False,-1,True,3,0,7,7
168221,2019-11-24 00:00:00+03:00,in,False,944476,False,6,518,609,91
168221,2019-11-25 00:00:00+03:00,in,False,-1,True,15,0,728,728
168221,2019-11-25 00:00:00+03:00,in,False,944476,False,2,248,277,29
168221,2019-11-26 00:00:00+03:00,out,False,944476,False,1,14,22,8
168221,2019-11-26 00:00:00+03:00,in,False,-1,True,1,0,2,2
168221,2019-11-26 00:00:00+03:00,in,False,944476,False,12,1070,1278,208
168221,2019-11-26 00:00:00+03:00,in,False,-1,True,1,0,2,2
168221,2019-11-27 00:00:00+03:00,in,False,944476,False,4,195,262,67
168221,2019-11-27 00:00:00+03:00,in,False,-1,True,6,0,51,51
168221,2019-11-28 00:00:00+03:00,in,False,-1,True,1,0,4,4
168221,2019-11-28 00:00:00+03:00,in,False,944476,False,8,612,734,122
168225,2019-11-28 00:00:00+03:00,out,False,970242,True,5,0,62,62
168225,2019-11-28 00:00:00+03:00,out,True,970242,True,2,0,8,8
168225,2019-11-28 00:00:00+03:00,out,False,970244,True,1,0,11,11
168225,2019-11-28 00:00:00+03:00,in,False,970254,False,3,117,238,121
168225,2019-11-28 00:00:00+03:00,out,False,970254,True,4,0,149,149
168225,2019-11-28 00:00:00+03:00,out,False,970252,False,2,141,188,47
168225,2019-11-28 00:00:00+03:00,out,True,970244,False,1,7,12,5
168225,2019-11-28 00:00:00+03:00,out,False,970254,False,2,105,123,18
168225,2019-11-28 00:00:00+03:00,in,False,-1,True,20,0,559,559
168225,2019-11-28 00:00:00+03:00,out,True,970254,False,2,7,29,22
168225,2019-11-28 00:00:00+03:00,out,False,970252,True,3,0,29,29
168225,2019-11-28 00:00:00+03:00,out,False,970258,True,1,0,11,11
168225,2019-11-28 00:00:00+03:00,out,True,970254,True,1,0,5,5
168225,2019-11-28 00:00:00+03:00,out,False,970242,False,3,1106,1146,40
168225,2019-11-28 00:00:00+03:00,in,False,970240,False,1,20,64,44
168225,2019-11-28 00:00:00+03:00,out,False,970240,True,1,0,9,9
168225,2019-11-28 00:00:00+03:00,in,False,970244,False,2,141,222,81
168225,2019-11-28 00:00:00+03:00,out,False,970250,True,1,0,8,8
168225,2019-11-28 00:00:00+03:00,in,False,970252,False,1,4,29,25
168225,2019-11-28 00:00:00+03:00,out,False,970252,False,2,141,188,47
168228,2019-10-18 00:00:00+03:00,out,True,939684,True,1,0,6,6
168228,2019-10-18 00:00:00+03:00,out,True,939736,True,5,0,48,48
168228,2019-10-18 00:00:00+03:00,in,False,939684,False,2,100,115,15
168228,2019-10-18 00:00:00+03:00,in,False,-1,True,7,0,11,11
168228,2019-10-19 00:00:00+03:00,out,True,939736,True,1,0,13,13
168228,2019-10-19 00:00:00+03:00,out,False,939684,False,1,28,39,11
168228,2019-10-19 00:00:00+03:00,out,True,939738,True,2,0,27,27
168228,2019-10-19 00:00:00+03:00,in,False,-1,True,2,0,22,22
168228,2019-10-20 00:00:00+03:00,in,False,-1,True,1,0,2,2
168228,2019-10-20 00:00:00+03:00,in,False,-1,True,1,0,2,2
168228,2019-10-21 00:00:00+03:00,out,False,939684,False,17,1257,1370,113
168228,2019-10-21 00:00:00+03:00,out,True,939684,True,2,0,8,8
168228,2019-10-21 00:00:00+03:00,out,False,939684,True,19,0,225,225
168228,2019-10-21 00:00:00+03:00,out,True,939736,True,6,0,35,35
168228,2019-10-21 00:00:00+03:00,out,True,939738,True,1,0,6,6
168228,2019-10-21 00:00:00+03:00,in,False,-1,True,4,0,72,72
168228,2019-10-21 00:00:00+03:00,out,False,939738,False,1,18,35,17
168228,2019-10-22 00:00:00+03:00,out,False,939738,True,3,0,109,109
168228,2019-10-22 00:00:00+03:00,out,False,939738,False,7,286,377,91
168228,2019-10-22 00:00:00+03:00,out,False,939684,False,6,533,570,37
168228,2019-10-22 00:00:00+03:00,out,True,939684,True,2,0,0,0
168228,2019-10-22 00:00:00+03:00,out,False,939684,True,3,0,67,67
168228,2019-10-23 00:00:00+03:00,out,False,939738,True,8,0,81,81
168228,2019-10-23 00:00:00+03:00,out,True,939738,True,1,0,16,16
168228,2019-10-23 00:00:00+03:00,out,False,939738,False,5,471,521,50
168228,2019-10-23 00:00:00+03:00,out,True,939738,False,1,33,48,15
168228,2019-10-24 00:00:00+03:00,out,True,939738,True,1,0,6,6
168228,2019-10-24 00:00:00+03:00,out,False,939738,True,3,0,38,38
168228,2019-10-24 00:00:00+03:00,out,False,939738,False,2,368,419,51
168228,2019-10-24 00:00:00+03:00,out,False,939738,False,2,368,419,51
168228,2019-10-25 00:00:00+03:00,out,False,939738,True,8,0,190,190
168228,2019-10-25 00:00:00+03:00,in,False,-1,True,1,0,2,2
168228,2019-10-25 00:00:00+03:00,out,True,939684,True,1,0,0,0
168228,2019-10-25 00:00:00+03:00,out,False,939738,False,9,1189,1256,67
168228,2019-10-25 00:00:00+03:00,out,False,939684,True,6,0,142,142
168228,2019-10-25 00:00:00+03:00,out,False,939684,False,3,770,812,42
168228,2019-10-25 00:00:00+03:00,out,False,939684,False,3,770,812,42
168228,2019-10-27 00:00:00+03:00,out,False,939738,False,2,439,473,34
168228,2019-10-27 00:00:00+03:00,out,False,939738,True,1,0,22,22
168228,2019-10-27 00:00:00+03:00,in,False,-1,True,2,0,4,4
168228,2019-10-27 00:00:00+03:00,out,False,939738,False,2,439,473,34
168228,2019-10-28 00:00:00+03:00,out,False,939738,True,3,0,4,4
168228,2019-10-28 00:00:00+03:00,out,False,939736,False,1,5,12,7
168228,2019-10-28 00:00:00+03:00,in,False,-1,True,2,0,11,11
168228,2019-10-28 00:00:00+03:00,out,False,939738,False,2,280,323,43
168228,2019-10-29 00:00:00+03:00,out,False,939738,False,1,46,61,15
168228,2019-10-29 00:00:00+03:00,out,False,939736,False,1,7,23,16
168228,2019-10-29 00:00:00+03:00,in,False,-1,True,1,0,6,6
168228,2019-10-30 00:00:00+03:00,out,False,939738,False,2,41,85,44
168228,2019-10-30 00:00:00+03:00,out,False,939738,True,1,0,39,39
168228,2019-10-31 00:00:00+03:00,in,False,-1,True,1,0,6,6
168228,2019-10-31 00:00:00+03:00,out,False,939738,False,7,1007,1075,68
168228,2019-10-31 00:00:00+03:00,out,True,939684,True,1,0,0,0
168228,2019-10-31 00:00:00+03:00,out,False,939684,True,4,0,84,84
168228,2019-10-31 00:00:00+03:00,out,False,939738,True,14,0,333,333
168228,2019-10-31 00:00:00+03:00,out,False,939684,False,5,703,751,48
168228,2019-11-01 00:00:00+03:00,out,True,939736,True,1,0,8,8
168228,2019-11-01 00:00:00+03:00,out,False,939736,True,2,0,3,3
168228,2019-11-01 00:00:00+03:00,out,False,939684,True,5,0,146,146
168228,2019-11-01 00:00:00+03:00,out,True,939684,True,1,0,0,0
168228,2019-11-01 00:00:00+03:00,out,False,939738,True,4,0,69,69
168228,2019-11-01 00:00:00+03:00,out,False,939738,False,10,551,637,86
168228,2019-11-01 00:00:00+03:00,out,False,939736,False,2,140,163,23
168228,2019-11-01 00:00:00+03:00,in,False,-1,True,3,0,25,25
168228,2019-11-01 00:00:00+03:00,out,False,939684,False,7,456,521,65
168228,2019-11-04 00:00:00+03:00,in,False,-1,True,1,0,32,32
168228,2019-11-05 00:00:00+03:00,out,False,939684,True,7,0,186,186
168228,2019-11-05 00:00:00+03:00,in,False,-1,True,1,0,7,7
168228,2019-11-05 00:00:00+03:00,in,False,939684,False,1,23,42,19
168228,2019-11-05 00:00:00+03:00,out,False,939684,False,6,801,883,82
168228,2019-11-05 00:00:00+03:00,out,False,939738,True,6,0,96,96
168228,2019-11-05 00:00:00+03:00,out,False,939738,False,12,947,1033,86
168228,2019-11-05 00:00:00+03:00,out,False,939738,True,6,0,96,96
168228,2019-11-06 00:00:00+03:00,out,False,939738,False,27,2505,2821,316
168228,2019-11-06 00:00:00+03:00,out,False,939684,False,9,1413,1501,88
168228,2019-11-06 00:00:00+03:00,out,False,939738,True,33,0,235,235
168228,2019-11-06 00:00:00+03:00,out,False,939684,True,3,0,94,94
168228,2019-11-06 00:00:00+03:00,out,True,939684,True,1,0,0,0
168228,2019-11-06 00:00:00+03:00,in,False,939684,False,2,107,160,53
168228,2019-11-06 00:00:00+03:00,out,False,939684,True,3,0,94,94
168228,2019-11-06 00:00:00+03:00,in,False,939684,False,2,107,160,53
168228,2019-11-07 00:00:00+03:00,out,False,939684,True,4,0,120,120
168228,2019-11-07 00:00:00+03:00,out,False,939684,False,8,1185,1286,101
168228,2019-11-07 00:00:00+03:00,out,False,939738,True,10,0,25,25
168228,2019-11-07 00:00:00+03:00,out,False,939738,False,18,1278,1434,156
168228,2019-11-07 00:00:00+03:00,out,True,939684,True,1,0,0,0
168228,2019-11-07 00:00:00+03:00,out,False,939738,False,18,1278,1434,156
168228,2019-11-07 00:00:00+03:00,out,False,939684,True,4,0,120,120
168228,2019-11-08 00:00:00+03:00,in,False,-1,True,3,0,11,11
168228,2019-11-08 00:00:00+03:00,out,False,939738,False,16,1007,1151,144
168228,2019-11-08 00:00:00+03:00,out,False,939738,True,12,0,225,225
168228,2019-11-08 00:00:00+03:00,in,False,939684,False,1,1,20,19
168228,2019-11-09 00:00:00+03:00,in,False,-1,True,1,0,2,2
168228,2019-11-11 00:00:00+03:00,out,False,939738,True,11,0,126,126
168228,2019-11-11 00:00:00+03:00,out,True,939684,True,1,0,0,0
168228,2019-11-11 00:00:00+03:00,out,False,939738,False,14,1253,1408,155
168228,2019-11-12 00:00:00+03:00,out,False,939738,False,17,786,1002,216
168228,2019-11-12 00:00:00+03:00,out,False,939684,False,1,221,222,1
168228,2019-11-12 00:00:00+03:00,out,False,939684,True,1,0,1,1
168228,2019-11-12 00:00:00+03:00,out,False,939738,True,7,0,37,37
168228,2019-11-12 00:00:00+03:00,out,False,939738,False,17,786,1002,216
168228,2019-11-13 00:00:00+03:00,out,False,939738,False,10,1141,1241,100
168228,2019-11-13 00:00:00+03:00,in,False,939684,False,1,71,91,20
168228,2019-11-13 00:00:00+03:00,out,False,939738,True,11,0,39,39
168228,2019-11-14 00:00:00+03:00,out,False,939738,False,8,632,711,79
168228,2019-11-14 00:00:00+03:00,in,False,939684,False,1,40,59,19
168228,2019-11-14 00:00:00+03:00,out,False,939738,True,6,0,37,37
168228,2019-11-15 00:00:00+03:00,out,False,939738,False,6,472,521,49
168228,2019-11-18 00:00:00+03:00,in,False,-1,True,2,0,37,37
168228,2019-11-18 00:00:00+03:00,out,False,939738,True,24,0,460,460
168228,2019-11-18 00:00:00+03:00,in,False,939684,False,1,81,102,21
168228,2019-11-18 00:00:00+03:00,out,False,939738,False,31,2292,2571,279
168228,2019-11-19 00:00:00+03:00,out,False,939738,False,20,1341,1489,148
168228,2019-11-19 00:00:00+03:00,out,False,939738,True,13,0,162,162
168228,2019-11-20 00:00:00+03:00,out,False,939738,True,6,0,85,85
168228,2019-11-20 00:00:00+03:00,in,False,-1,True,3,0,25,25
168228,2019-11-20 00:00:00+03:00,out,False,939738,False,23,2549,2770,221
168228,2019-11-21 00:00:00+03:00,out,False,939738,True,10,0,184,184
168228,2019-11-21 00:00:00+03:00,out,False,939738,False,13,1254,1358,104
168228,2019-11-21 00:00:00+03:00,in,False,-1,True,2,0,23,23
168228,2019-11-21 00:00:00+03:00,out,False,939738,False,13,1254,1358,104
168228,2019-11-22 00:00:00+03:00,out,False,939738,False,20,2167,2401,234
168228,2019-11-22 00:00:00+03:00,out,False,939738,True,8,0,206,206
168228,2019-11-22 00:00:00+03:00,in,False,939684,False,2,151,164,13
168228,2019-11-25 00:00:00+03:00,out,False,939738,True,19,0,140,140
168228,2019-11-25 00:00:00+03:00,in,False,939684,False,4,626,653,27
168228,2019-11-25 00:00:00+03:00,out,False,939738,False,11,1015,1140,125
168228,2019-11-26 00:00:00+03:00,out,False,939738,False,24,1686,1946,260
168228,2019-11-26 00:00:00+03:00,out,False,939684,True,1,0,2,2
168228,2019-11-26 00:00:00+03:00,out,False,939738,True,14,0,80,80
168228,2019-11-26 00:00:00+03:00,out,False,939684,True,1,0,2,2
168228,2019-11-27 00:00:00+03:00,out,False,939738,True,20,0,211,211
168228,2019-11-27 00:00:00+03:00,out,False,939738,False,20,1420,1595,175
168228,2019-11-27 00:00:00+03:00,out,True,939684,True,4,0,0,0
168228,2019-11-28 00:00:00+03:00,out,False,939738,True,18,0,448,448
168228,2019-11-28 00:00:00+03:00,in,False,-1,True,1,0,1,1
168228,2019-11-28 00:00:00+03:00,out,False,939738,False,17,1262,1434,172
168228,2019-11-28 00:00:00+03:00,in,False,939684,False,2,156,170,14
168252,2019-10-17 00:00:00+03:00,out,False,939716,True,1,0,18,18
168252,2019-10-17 00:00:00+03:00,in,False,939716,False,6,487,516,29
168252,2019-10-17 00:00:00+03:00,out,False,939716,False,4,34,102,68
168252,2019-10-17 00:00:00+03:00,out,False,939718,True,5,0,11,11
168252,2019-10-17 00:00:00+03:00,in,False,-1,True,1,0,6,6
168252,2019-10-17 00:00:00+03:00,out,False,-1,False,1,69,79,10
168252,2019-10-17 00:00:00+03:00,in,False,939716,False,6,487,516,29
168252,2019-10-18 00:00:00+03:00,out,True,940616,True,15,0,176,176
168252,2019-10-18 00:00:00+03:00,out,True,940624,False,1,32,41,9
168252,2019-10-18 00:00:00+03:00,out,True,940788,False,1,57,62,5
168252,2019-10-18 00:00:00+03:00,out,True,940782,False,3,241,276,35
168252,2019-10-18 00:00:00+03:00,in,False,939716,False,2,296,307,11
168252,2019-10-18 00:00:00+03:00,out,True,940634,False,3,121,146,25
168252,2019-10-18 00:00:00+03:00,out,True,940616,False,4,129,167,38
168252,2019-10-18 00:00:00+03:00,out,False,940610,False,1,33,66,33
168252,2019-10-18 00:00:00+03:00,out,False,-1,False,1,170,177,7
168252,2019-10-18 00:00:00+03:00,in,True,940616,True,1,31,34,3
168252,2019-10-18 00:00:00+03:00,out,True,940788,True,1,0,4,4
168252,2019-10-18 00:00:00+03:00,out,True,940782,True,2,0,4,4
168252,2019-10-18 00:00:00+03:00,out,False,940616,True,3,0,20,20
168252,2019-10-18 00:00:00+03:00,in,False,-1,False,1,202,214,12
168252,2019-10-18 00:00:00+03:00,out,False,939716,True,1,0,19,19
168252,2019-10-18 00:00:00+03:00,out,False,940624,True,2,0,17,17
168252,2019-10-18 00:00:00+03:00,out,False,939718,False,1,15,28,13
168252,2019-10-18 00:00:00+03:00,out,True,940782,False,3,241,276,35
168252,2019-10-18 00:00:00+03:00,out,False,-1,False,1,170,177,7
168252,2019-10-21 00:00:00+03:00,in,True,940630,True,2,162,175,13
168252,2019-10-21 00:00:00+03:00,in,True,940634,True,1,101,107,6
168252,2019-10-21 00:00:00+03:00,in,True,940568,False,2,156,164,8
168252,2019-10-21 00:00:00+03:00,in,True,940772,False,2,306,315,9
168252,2019-10-21 00:00:00+03:00,out,True,939716,False,1,38,49,11
168252,2019-10-21 00:00:00+03:00,in,True,940634,False,1,33,39,6
168252,2019-10-21 00:00:00+03:00,out,False,939718,True,1,0,10,10
168252,2019-10-21 00:00:00+03:00,out,True,940630,False,2,58,75,17
168252,2019-10-21 00:00:00+03:00,in,True,940630,False,2,174,185,11
168252,2019-10-21 00:00:00+03:00,in,False,-1,True,9,0,115,115
168252,2019-10-21 00:00:00+03:00,out,True,940568,False,1,79,87,8
168252,2019-10-21 00:00:00+03:00,out,True,940842,False,1,57,82,25
168252,2019-10-21 00:00:00+03:00,out,True,939716,True,1,0,9,9
168252,2019-10-21 00:00:00+03:00,out,False,-1,False,1,60,68,8
168252,2019-10-22 00:00:00+03:00,out,False,940616,True,1,0,4,4
168252,2019-10-22 00:00:00+03:00,in,False,-1,False,5,3129,3155,26
168252,2019-10-22 00:00:00+03:00,out,True,940588,True,1,0,0,0
168252,2019-10-22 00:00:00+03:00,in,False,940588,False,7,1137,1166,29
168252,2019-10-22 00:00:00+03:00,in,False,-1,True,8,0,221,221
168252,2019-10-22 00:00:00+03:00,in,True,940624,False,1,28,41,13
168252,2019-10-22 00:00:00+03:00,out,False,940630,True,1,0,10,10
168252,2019-10-22 00:00:00+03:00,in,True,940596,False,1,96,100,4
168252,2019-10-22 00:00:00+03:00,in,False,940658,False,85,3693,3997,304
168252,2019-10-22 00:00:00+03:00,in,True,940568,False,1,90,100,10
168252,2019-10-22 00:00:00+03:00,in,True,940630,False,3,237,257,20
168252,2019-10-22 00:00:00+03:00,in,False,-1,True,2,0,56,56
168252,2019-10-22 00:00:00+03:00,in,False,940630,False,41,2684,2917,233
168252,2019-10-22 00:00:00+03:00,in,False,940616,False,39,2446,2681,235
168252,2019-10-22 00:00:00+03:00,in,True,940588,False,1,39,50,11
168252,2019-10-22 00:00:00+03:00,in,True,940588,False,1,39,50,11
168252,2019-10-23 00:00:00+03:00,in,False,-1,True,7,0,215,215
168252,2019-10-23 00:00:00+03:00,in,False,940588,False,8,521,543,22
168252,2019-10-23 00:00:00+03:00,in,False,940588,True,1,162,171,9
168252,2019-10-23 00:00:00+03:00,in,False,-1,False,4,1195,1215,20
168252,2019-10-23 00:00:00+03:00,out,False,939718,True,3,0,17,17
168252,2019-10-23 00:00:00+03:00,out,False,-1,False,1,81,100,19
168252,2019-10-23 00:00:00+03:00,in,False,940630,False,67,5245,5520,275
168252,2019-10-23 00:00:00+03:00,in,False,940616,False,6,217,242,25
168252,2019-10-23 00:00:00+03:00,in,False,940658,False,43,3013,3205,192
168252,2019-10-23 00:00:00+03:00,in,False,940634,False,2,69,128,59
168252,2019-10-24 00:00:00+03:00,in,False,940634,False,5,383,399,16
168252,2019-10-24 00:00:00+03:00,out,False,940616,True,1,0,2,2
168252,2019-10-24 00:00:00+03:00,in,False,940634,True,1,91,100,9
168252,2019-10-24 00:00:00+03:00,in,False,940658,False,10,468,516,48
168252,2019-10-24 00:00:00+03:00,in,False,940616,False,1,18,24,6
168252,2019-10-24 00:00:00+03:00,in,False,940630,False,15,1048,1109,61
168252,2019-10-24 00:00:00+03:00,in,False,940588,False,1,48,50,2
168252,2019-10-24 00:00:00+03:00,in,False,-1,False,11,6320,6420,100
168252,2019-10-24 00:00:00+03:00,in,False,-1,True,6,0,127,127
168252,2019-10-24 00:00:00+03:00,in,False,940634,False,5,383,399,16
168252,2019-10-24 00:00:00+03:00,in,False,940634,True,1,91,100,9
168252,2019-10-25 00:00:00+03:00,in,False,-1,False,2,145,159,14
168252,2019-10-25 00:00:00+03:00,in,False,940588,True,1,153,163,10
168252,2019-10-25 00:00:00+03:00,in,False,-1,False,5,2059,2078,19
168252,2019-10-25 00:00:00+03:00,in,False,-1,True,1,0,0,0
168252,2019-10-25 00:00:00+03:00,in,True,940610,False,1,78,82,4
168252,2019-10-25 00:00:00+03:00,in,False,-1,True,1,0,28,28
168252,2019-10-25 00:00:00+03:00,in,False,940616,False,1,41,45,4
168252,2019-10-25 00:00:00+03:00,in,False,940588,False,3,142,156,14
168252,2019-10-25 00:00:00+03:00,in,True,940630,False,1,18,24,6
168252,2019-10-25 00:00:00+03:00,in,False,940634,False,3,457,485,28
168252,2019-10-25 00:00:00+03:00,in,True,940588,False,1,24,27,3
168252,2019-10-25 00:00:00+03:00,in,True,940624,False,13,1128,1217,89
168252,2019-10-25 00:00:00+03:00,in,False,940630,False,4,182,202,20
168252,2019-10-25 00:00:00+03:00,in,False,940624,False,11,972,1034,62
168252,2019-10-25 00:00:00+03:00,in,True,940624,True,3,188,200,12
168252,2019-10-25 00:00:00+03:00,in,True,940610,False,1,78,82,4
168252,2019-10-26 00:00:00+03:00,in,False,940630,True,1,150,157,7
168252,2019-10-26 00:00:00+03:00,in,False,-1,False,2,1752,1764,12
168252,2019-10-27 00:00:00+03:00,in,False,-1,True,6,0,41,41
168252,2019-10-27 00:00:00+03:00,out,False,-1,False,1,578,590,12
168252,2019-10-28 00:00:00+03:00,in,False,940658,False,79,7138,7510,372
168252,2019-10-28 00:00:00+03:00,in,False,940624,False,48,3857,4166,309
168252,2019-10-28 00:00:00+03:00,in,False,940616,False,22,1553,1656,103
168252,2019-10-28 00:00:00+03:00,in,True,940624,False,1,36,40,4
168252,2019-10-28 00:00:00+03:00,in,False,940634,True,1,548,553,5
168252,2019-10-28 00:00:00+03:00,out,True,940568,False,1,123,130,7
168252,2019-10-28 00:00:00+03:00,in,True,940588,False,1,76,95,19
168252,2019-10-28 00:00:00+03:00,in,True,940630,False,1,45,51,6
168252,2019-10-28 00:00:00+03:00,in,False,940630,False,52,5720,6011,291
168252,2019-10-28 00:00:00+03:00,in,False,-1,False,1,67,70,3
168252,2019-10-28 00:00:00+03:00,in,False,940658,True,3,670,681,11
168252,2019-10-28 00:00:00+03:00,out,False,940616,True,1,0,1,1
168252,2019-10-28 00:00:00+03:00,in,False,-1,True,9,0,189,189
168252,2019-10-28 00:00:00+03:00,in,False,940634,False,48,2760,3030,270
168252,2019-10-28 00:00:00+03:00,in,False,940630,True,4,636,652,16
168252,2019-10-28 00:00:00+03:00,in,False,940624,True,2,518,526,8
168252,2019-10-28 00:00:00+03:00,in,True,940658,False,1,34,39,5
168252,2019-10-28 00:00:00+03:00,in,False,940588,False,20,1196,1285,89
168252,2019-10-28 00:00:00+03:00,in,True,940634,False,1,7,21,14
168252,2019-10-28 00:00:00+03:00,in,False,-1,False,14,7979,8228,249
168252,2019-10-28 00:00:00+03:00,in,False,940624,True,2,518,526,8
168252,2019-10-28 00:00:00+03:00,in,True,940588,False,1,76,95,19
168252,2019-10-28 00:00:00+03:00,in,False,-1,True,9,0,189,189
168252,2019-10-29 00:00:00+03:00,in,True,940630,False,2,359,367,8
168252,2019-10-29 00:00:00+03:00,out,False,940658,True,100,0,1425,1425
168252,2019-10-29 00:00:00+03:00,in,True,940588,False,1,28,37,9
168252,2019-10-29 00:00:00+03:00,in,False,940588,True,1,194,196,2
168252,2019-10-29 00:00:00+03:00,in,False,940616,False,77,4409,4774,365
168252,2019-10-29 00:00:00+03:00,out,False,940630,False,6,111,218,107
168252,2019-10-29 00:00:00+03:00,in,False,940658,False,36,2324,2467,143
168252,2019-10-29 00:00:00+03:00,out,True,940658,False,1,5,12,7
168252,2019-10-29 00:00:00+03:00,out,False,940634,True,52,0,778,778
168252,2019-10-29 00:00:00+03:00,in,False,940616,True,1,0,9,9
168252,2019-10-29 00:00:00+03:00,in,False,-1,True,38,0,577,577
168252,2019-10-29 00:00:00+03:00,in,False,-1,False,3,2017,2027,10
168252,2019-10-29 00:00:00+03:00,in,True,940658,False,3,45,59,14
168252,2019-10-29 00:00:00+03:00,out,False,940588,False,5,165,223,58
168252,2019-10-29 00:00:00+03:00,in,False,940630,False,114,7455,7986,531
168252,2019-10-29 00:00:00+03:00,out,False,940616,False,44,1304,2020,716
168252,2019-10-29 00:00:00+03:00,out,False,940588,True,5,0,91,91
168252,2019-10-29 00:00:00+03:00,out,False,940658,False,77,3669,4737,1068
168252,2019-10-29 00:00:00+03:00,out,False,940634,False,32,1163,1674,511
168252,2019-10-29 00:00:00+03:00,out,False,940616,True,42,0,619,619
168252,2019-10-29 00:00:00+03:00,in,False,940634,False,114,5512,6094,582
168252,2019-10-29 00:00:00+03:00,in,False,940588,False,121,6865,7361,496
168252,2019-10-29 00:00:00+03:00,in,False,-1,True,1,0,27,27
168252,2019-10-29 00:00:00+03:00,in,False,940624,False,30,1274,1447,173
168252,2019-10-29 00:00:00+03:00,out,False,940630,True,13,0,164,164
168252,2019-10-29 00:00:00+03:00,in,False,940630,False,114,7455,7986,531
168252,2019-10-29 00:00:00+03:00,in,True,940658,False,3,45,59,14
168252,2019-10-30 00:00:00+03:00,in,False,940658,True,1,0,3,3
168252,2019-10-30 00:00:00+03:00,out,False,940658,True,49,0,850,850
168252,2019-10-30 00:00:00+03:00,in,True,940630,False,1,45,50,5
168252,2019-10-30 00:00:00+03:00,out,False,-1,False,1,951,967,16
168252,2019-10-30 00:00:00+03:00,out,False,940616,False,59,2483,3451,968
168252,2019-10-30 00:00:00+03:00,in,False,940658,False,19,1840,1948,108
168252,2019-10-30 00:00:00+03:00,out,False,940588,False,6,225,322,97
168252,2019-10-30 00:00:00+03:00,out,False,940658,False,46,1789,2415,626
168252,2019-10-30 00:00:00+03:00,in,False,-1,False,1,432,437,5
168252,2019-10-30 00:00:00+03:00,in,False,-1,True,19,0,335,335
168252,2019-10-30 00:00:00+03:00,in,False,940634,False,22,2005,2113,108
168252,2019-10-30 00:00:00+03:00,out,False,940634,False,119,5175,7231,2056
168252,2019-10-30 00:00:00+03:00,in,False,940588,False,72,5713,5941,228
168252,2019-10-30 00:00:00+03:00,out,False,940634,True,54,0,1551,1551
168252,2019-10-30 00:00:00+03:00,in,False,940630,False,49,6577,6847,270
168252,2019-10-30 00:00:00+03:00,in,False,940616,False,10,1120,1168,48
168252,2019-10-30 00:00:00+03:00,out,False,940588,True,5,0,25,25
168252,2019-10-30 00:00:00+03:00,out,False,940616,True,98,0,1410,1410
168252,2019-10-30 00:00:00+03:00,out,False,-1,False,1,951,967,16
168252,2019-10-30 00:00:00+03:00,out,False,940634,True,54,0,1551,1551
168252,2019-10-30 00:00:00+03:00,in,False,940634,False,22,2005,2113,108
168252,2019-10-31 00:00:00+03:00,in,False,940616,False,14,977,1036,59
168252,2019-10-31 00:00:00+03:00,out,False,940658,True,29,0,507,507
168252,2019-10-31 00:00:00+03:00,in,False,940630,False,59,6727,7039,312
168252,2019-10-31 00:00:00+03:00,in,False,-1,True,25,0,358,358
168252,2019-10-31 00:00:00+03:00,in,False,940588,False,75,6470,6716,246
168252,2019-10-31 00:00:00+03:00,out,False,940634,False,61,6309,7470,1161
168252,2019-10-31 00:00:00+03:00,in,True,940624,False,1,3,10,7
168252,2019-10-31 00:00:00+03:00,out,False,940658,False,43,1523,2133,610
168252,2019-10-31 00:00:00+03:00,out,False,940588,True,4,0,17,17
168252,2019-10-31 00:00:00+03:00,in,False,-1,False,2,1290,1296,6
168252,2019-10-31 00:00:00+03:00,out,False,940616,False,51,1447,2368,921
168252,2019-10-31 00:00:00+03:00,out,False,940634,True,25,0,655,655
168252,2019-10-31 00:00:00+03:00,in,False,940624,False,71,4604,4956,352
168252,2019-10-31 00:00:00+03:00,in,False,940658,False,40,2509,2717,208
168252,2019-10-31 00:00:00+03:00,in,False,940624,True,1,1,6,5
168252,2019-10-31 00:00:00+03:00,out,False,940616,True,39,0,740,740
168252,2019-10-31 00:00:00+03:00,out,False,940588,False,7,93,269,176
168252,2019-10-31 00:00:00+03:00,out,False,940624,False,1,61,104,43
168252,2019-10-31 00:00:00+03:00,in,False,940634,False,5,172,201,29
168252,2019-10-31 00:00:00+03:00,out,False,-1,False,2,2084,2110,26
168252,2019-10-31 00:00:00+03:00,out,False,940624,False,1,61,104,43
168252,2019-11-01 00:00:00+03:00,out,False,940616,False,62,2618,3759,1141
168252,2019-11-01 00:00:00+03:00,in,False,940616,False,20,1804,1953,149
168252,2019-11-01 00:00:00+03:00,in,False,940630,True,1,0,30,30
168252,2019-11-01 00:00:00+03:00,in,False,940588,True,1,231,234,3
168252,2019-11-01 00:00:00+03:00,out,False,940616,True,33,0,850,850
168252,2019-11-01 00:00:00+03:00,out,True,940782,True,1,0,2,2
168252,2019-11-01 00:00:00+03:00,in,False,940588,False,73,10963,11189,226
168252,2019-11-01 00:00:00+03:00,out,False,940624,True,35,0,720,720
168252,2019-11-01 00:00:00+03:00,out,False,940588,True,1,0,2,2
168252,2019-11-01 00:00:00+03:00,in,False,940630,False,86,10136,10541,405
168252,2019-11-01 00:00:00+03:00,out,False,-1,False,2,1442,1481,39
168252,2019-11-01 00:00:00+03:00,out,False,940782,False,2,11,52,41
168252,2019-11-01 00:00:00+03:00,out,False,940588,False,2,119,183,64
168252,2019-11-01 00:00:00+03:00,out,False,940624,False,76,1973,3192,1219
168252,2019-11-01 00:00:00+03:00,in,False,940624,False,20,2460,2588,128
168252,2019-11-01 00:00:00+03:00,in,False,-1,False,13,7394,7439,45
168252,2019-11-01 00:00:00+03:00,in,False,-1,True,28,0,338,338
168252,2019-11-01 00:00:00+03:00,in,False,940624,False,20,2460,2588,128
168252,2019-11-02 00:00:00+03:00,in,False,940624,False,1,42,52,10
168252,2019-11-02 00:00:00+03:00,in,False,940658,False,15,1479,1620,141
168252,2019-11-02 00:00:00+03:00,out,False,940634,True,29,0,877,877
168252,2019-11-02 00:00:00+03:00,out,False,-1,False,2,1113,1148,35
168252,2019-11-02 00:00:00+03:00,in,False,-1,True,33,0,643,643
168252,2019-11-02 00:00:00+03:00,out,False,940634,False,45,6121,6966,845
168252,2019-11-02 00:00:00+03:00,out,False,940658,True,8,0,166,166
168252,2019-11-02 00:00:00+03:00,out,False,940658,False,15,2127,2369,242
168252,2019-11-02 00:00:00+03:00,in,False,940634,False,8,860,904,44
168252,2019-11-02 00:00:00+03:00,in,False,940624,False,1,42,52,10
168252,2019-11-03 00:00:00+03:00,out,False,940624,False,26,2854,3302,448
168252,2019-11-03 00:00:00+03:00,in,True,940630,False,1,54,65,11
168252,2019-11-03 00:00:00+03:00,in,False,-1,True,17,0,306,306
168252,2019-11-03 00:00:00+03:00,out,False,940624,True,13,0,331,331
168252,2019-11-03 00:00:00+03:00,in,False,-1,False,1,735,738,3
168252,2019-11-03 00:00:00+03:00,in,False,940624,False,16,1386,1506,120
168252,2019-11-03 00:00:00+03:00,in,False,940630,False,74,6630,6946,316
168252,2019-11-04 00:00:00+03:00,out,False,940634,True,24,0,737,737
168252,2019-11-04 00:00:00+03:00,out,False,940616,True,43,0,1111,1111
168252,2019-11-04 00:00:00+03:00,out,False,940624,False,39,1816,2460,644
168252,2019-11-04 00:00:00+03:00,in,False,940624,False,26,1780,1912,132
168252,2019-11-04 00:00:00+03:00,out,False,940658,True,19,0,415,415
168252,2019-11-04 00:00:00+03:00,out,True,940634,False,1,45,57,12
168252,2019-11-04 00:00:00+03:00,in,False,940588,False,99,10478,10734,256
168252,2019-11-04 00:00:00+03:00,in,False,940634,False,10,1664,1780,116
168252,2019-11-04 00:00:00+03:00,in,False,-1,True,24,0,264,264
168252,2019-11-04 00:00:00+03:00,out,False,940658,False,30,3605,3981,376
168252,2019-11-04 00:00:00+03:00,out,False,-1,False,2,1235,1260,25
168252,2019-11-04 00:00:00+03:00,in,False,-1,False,5,4034,4047,13
168252,2019-11-04 00:00:00+03:00,in,False,940616,False,13,1210,1281,71
168252,2019-11-04 00:00:00+03:00,in,False,940658,False,15,1709,1777,68
168252,2019-11-04 00:00:00+03:00,in,True,940588,False,1,25,29,4
168252,2019-11-04 00:00:00+03:00,out,False,940616,False,54,1850,2904,1054
168252,2019-11-04 00:00:00+03:00,out,False,940634,False,71,5214,6465,1251
168252,2019-11-04 00:00:00+03:00,out,False,940624,True,32,0,788,788
168252,2019-11-04 00:00:00+03:00,in,False,940634,False,10,1664,1780,116
168252,2019-11-05 00:00:00+03:00,in,False,940616,False,19,1561,1670,109
168252,2019-11-05 00:00:00+03:00,in,False,940630,False,111,9261,9742,481
168252,2019-11-05 00:00:00+03:00,in,False,940588,False,72,7185,7407,222
168252,2019-11-05 00:00:00+03:00,out,False,-1,False,3,2128,2184,56
168252,2019-11-05 00:00:00+03:00,out,False,940634,True,42,0,1083,1083
168252,2019-11-05 00:00:00+03:00,out,False,940658,True,22,0,484,484
168252,2019-11-05 00:00:00+03:00,out,False,940630,False,1,29,39,10
168252,2019-11-05 00:00:00+03:00,in,False,940630,True,1,130,135,5
168252,2019-11-05 00:00:00+03:00,in,False,940624,False,32,2087,2310,223
168252,2019-11-05 00:00:00+03:00,in,False,940634,False,13,2348,2457,109
168252,2019-11-05 00:00:00+03:00,out,False,940624,False,42,1323,1992,669
168252,2019-11-05 00:00:00+03:00,out,False,940616,True,42,0,765,765
168252,2019-11-05 00:00:00+03:00,out,False,940616,False,52,2120,2927,807
168252,2019-11-05 00:00:00+03:00,out,False,940624,True,34,0,799,799
168252,2019-11-05 00:00:00+03:00,out,False,940658,False,23,1410,1760,350
168252,2019-11-05 00:00:00+03:00,in,False,-1,True,36,0,484,484
168252,2019-11-05 00:00:00+03:00,in,False,-1,False,11,4937,4975,38
168252,2019-11-05 00:00:00+03:00,out,False,940634,False,52,3939,4952,1013
168252,2019-11-05 00:00:00+03:00,in,False,940658,False,15,2610,2669,59
168252,2019-11-05 00:00:00+03:00,in,False,940658,False,15,2610,2669,59
168252,2019-11-05 00:00:00+03:00,out,False,940616,False,52,2120,2927,807
168252,2019-11-05 00:00:00+03:00,in,False,-1,False,11,4937,4975,38
168252,2019-11-05 00:00:00+03:00,in,False,940634,False,13,2348,2457,109
168252,2019-11-06 00:00:00+03:00,out,True,940842,False,1,17,69,52
168252,2019-11-06 00:00:00+03:00,in,False,-1,True,27,0,371,371
168252,2019-11-06 00:00:00+03:00,in,False,940624,False,13,1322,1395,73
168252,2019-11-06 00:00:00+03:00,out,False,940616,False,78,3295,4594,1299
168252,2019-11-06 00:00:00+03:00,out,False,940624,False,16,778,1001,223
168252,2019-11-06 00:00:00+03:00,out,False,940616,True,50,0,1094,1094
168252,2019-11-06 00:00:00+03:00,in,False,-1,True,2,0,150,150
168252,2019-11-06 00:00:00+03:00,in,False,940588,False,74,5994,6255,261
168252,2019-11-06 00:00:00+03:00,out,False,-1,False,5,3225,3287,62
168252,2019-11-06 00:00:00+03:00,out,False,940624,True,11,0,216,216
168252,2019-11-06 00:00:00+03:00,in,False,940616,False,25,2194,2406,212
168252,2019-11-06 00:00:00+03:00,in,False,-1,False,10,7286,7322,36
168252,2019-11-06 00:00:00+03:00,in,False,940630,False,119,9736,10394,658
168252,2019-11-06 00:00:00+03:00,in,False,940588,False,74,5994,6255,261
168252,2019-11-07 00:00:00+03:00,in,True,940658,False,1,12,16,4
168252,2019-11-07 00:00:00+03:00,in,True,944310,False,2,157,169,12
168252,2019-11-07 00:00:00+03:00,out,True,940652,True,1,0,7,7
168252,2019-11-07 00:00:00+03:00,in,False,940634,True,1,0,4,4
168252,2019-11-07 00:00:00+03:00,in,False,940634,False,21,2878,3029,151
168252,2019-11-07 00:00:00+03:00,out,False,940634,True,40,0,847,847
168252,2019-11-07 00:00:00+03:00,out,True,940614,True,1,0,6,6
168252,2019-11-07 00:00:00+03:00,in,False,-1,True,549,0,14421,14421
168252,2019-11-07 00:00:00+03:00,in,False,-1,False,12,5378,5452,74
168252,2019-11-07 00:00:00+03:00,in,False,940622,True,1,132,145,13
168252,2019-11-07 00:00:00+03:00,out,False,940634,False,65,4607,5712,1105
168252,2019-11-07 00:00:00+03:00,in,False,-1,True,3,0,0,0
168252,2019-11-07 00:00:00+03:00,out,False,940848,False,1,47,96,49
168252,2019-11-07 00:00:00+03:00,out,False,940658,True,30,0,547,547
168252,2019-11-07 00:00:00+03:00,out,False,940802,True,2,0,67,67
168252,2019-11-07 00:00:00+03:00,in,True,940622,False,1,52,60,8
168252,2019-11-07 00:00:00+03:00,out,True,940622,False,3,203,243,40
168252,2019-11-07 00:00:00+03:00,out,True,940802,False,1,10,28,18
168252,2019-11-07 00:00:00+03:00,out,False,940848,True,1,0,14,14
168252,2019-11-07 00:00:00+03:00,in,False,956080,False,1,38,78,40
168252,2019-11-07 00:00:00+03:00,in,False,940658,False,30,2092,2302,210
168252,2019-11-07 00:00:00+03:00,out,False,-1,False,11,5545,5708,163
168252,2019-11-07 00:00:00+03:00,out,True,940622,True,2,0,19,19
168252,2019-11-07 00:00:00+03:00,in,False,940588,False,39,3340,3496,156
168252,2019-11-07 00:00:00+03:00,in,False,940622,False,2,57,72,15
168252,2019-11-07 00:00:00+03:00,out,False,940658,False,57,4369,5288,919
168252,2019-11-07 00:00:00+03:00,in,False,940630,False,69,8204,8458,254
168252,2019-11-07 00:00:00+03:00,in,False,940652,False,2,105,118,13
168252,2019-11-07 00:00:00+03:00,in,True,940630,False,2,13,25,12
168252,2019-11-07 00:00:00+03:00,in,False,940622,True,1,132,145,13
168252,2019-11-08 00:00:00+03:00,in,False,940588,True,1,90,92,2
168252,2019-11-08 00:00:00+03:00,out,False,940614,True,6,0,51,51
168252,2019-11-08 00:00:00+03:00,out,True,940616,False,7,377,448,71
168252,2019-11-08 00:00:00+03:00,out,False,940634,False,54,4184,5036,852
168252,2019-11-08 00:00:00+03:00,out,True,939716,False,3,173,192,19
168252,2019-11-08 00:00:00+03:00,out,False,940616,True,42,0,913,913
168252,2019-11-08 00:00:00+03:00,out,False,940616,False,51,2729,3550,821
168252,2019-11-08 00:00:00+03:00,in,False,-1,False,11,3955,3998,43
168252,2019-11-08 00:00:00+03:00,out,False,940802,True,1,0,27,27
168252,2019-11-08 00:00:00+03:00,in,False,940652,False,4,135,172,37
168252,2019-11-08 00:00:00+03:00,in,True,940658,False,1,7,9,2
168252,2019-11-08 00:00:00+03:00,out,False,-1,False,13,7390,7564,174
168252,2019-11-08 00:00:00+03:00,in,False,940634,False,8,1060,1095,35
168252,2019-11-08 00:00:00+03:00,out,False,940634,True,42,0,787,787
168252,2019-11-08 00:00:00+03:00,in,False,940616,False,7,1050,1104,54
168252,2019-11-08 00:00:00+03:00,in,False,940588,False,40,3380,3500,120
168252,2019-11-08 00:00:00+03:00,out,False,940658,False,26,2667,2993,326
168252,2019-11-08 00:00:00+03:00,out,False,940658,True,20,0,468,468
168252,2019-11-08 00:00:00+03:00,out,False,940614,False,4,146,213,67
168252,2019-11-08 00:00:00+03:00,out,False,939716,True,1,0,2,2
168252,2019-11-08 00:00:00+03:00,out,False,940814,True,1,0,14,14
168252,2019-11-08 00:00:00+03:00,in,False,-1,True,37,0,715,715
168252,2019-11-08 00:00:00+03:00,out,False,940802,False,1,44,58,14
168252,2019-11-08 00:00:00+03:00,out,False,940814,False,1,9,34,25
168252,2019-11-08 00:00:00+03:00,in,False,940658,False,21,2594,2696,102
168252,2019-11-08 00:00:00+03:00,in,False,940588,False,40,3380,3500,120
168252,2019-11-08 00:00:00+03:00,in,False,940634,False,8,1060,1095,35
168252,2019-11-09 00:00:00+03:00,in,False,940614,False,1,311,317,6
168252,2019-11-09 00:00:00+03:00,out,False,940588,False,4,69,127,58
168252,2019-11-09 00:00:00+03:00,in,False,940634,False,3,273,283,10
168252,2019-11-09 00:00:00+03:00,out,False,940614,False,1,34,86,52
168252,2019-11-09 00:00:00+03:00,out,True,940828,False,1,40,48,8
168252,2019-11-09 00:00:00+03:00,in,False,944310,False,1,95,98,3
168252,2019-11-09 00:00:00+03:00,in,False,940624,False,18,3726,3816,90
168252,2019-11-09 00:00:00+03:00,out,False,940652,False,3,579,635,56
168252,2019-11-09 00:00:00+03:00,in,False,940652,False,53,2357,2585,228
168252,2019-11-09 00:00:00+03:00,out,False,940624,True,12,0,416,416
168252,2019-11-09 00:00:00+03:00,in,True,940614,False,3,481,495,14
168252,2019-11-09 00:00:00+03:00,out,False,940624,False,23,965,1375,410
168252,2019-11-09 00:00:00+03:00,in,False,-1,True,15,0,191,191
168252,2019-11-09 00:00:00+03:00,in,True,940828,False,1,55,57,2
168252,2019-11-09 00:00:00+03:00,in,True,940624,False,1,24,27,3
168252,2019-11-09 00:00:00+03:00,out,False,940588,True,11,0,181,181
168252,2019-11-09 00:00:00+03:00,out,False,940634,False,48,3804,4675,871
168252,2019-11-09 00:00:00+03:00,in,False,-1,False,2,128,135,7
168252,2019-11-09 00:00:00+03:00,out,False,940634,True,28,0,785,785
168252,2019-11-09 00:00:00+03:00,out,True,940652,False,1,14,25,11
168252,2019-11-09 00:00:00+03:00,in,False,-1,False,8,4681,4705,24
168252,2019-11-09 00:00:00+03:00,in,False,940588,False,80,7197,7374,177
168252,2019-11-09 00:00:00+03:00,out,False,-1,False,3,1640,1682,42
168252,2019-11-09 00:00:00+03:00,in,True,940828,False,1,55,57,2
168252,2019-11-09 00:00:00+03:00,out,False,940624,True,12,0,416,416
168252,2019-11-10 00:00:00+03:00,in,False,-1,True,55,0,326,326
168252,2019-11-10 00:00:00+03:00,in,False,940622,False,77,3654,4011,357
168252,2019-11-10 00:00:00+03:00,in,False,940622,True,1,231,236,5
168252,2019-11-10 00:00:00+03:00,out,False,940634,False,48,3156,3981,825
168252,2019-11-10 00:00:00+03:00,out,False,-1,False,3,3678,3724,46
168252,2019-11-10 00:00:00+03:00,out,False,940634,True,40,0,829,829
168252,2019-11-10 00:00:00+03:00,in,True,940622,False,1,39,45,6
168252,2019-11-10 00:00:00+03:00,in,False,-1,False,1,427,431,4
168252,2019-11-10 00:00:00+03:00,in,False,940634,False,12,1950,2002,52
168252,2019-11-10 00:00:00+03:00,in,False,940630,False,56,6351,6532,181
168252,2019-11-10 00:00:00+03:00,in,False,-1,True,55,0,326,326
168252,2019-11-11 00:00:00+03:00,out,False,940658,False,57,4560,5415,855
168252,2019-11-11 00:00:00+03:00,out,False,940624,False,1,72,81,9
168252,2019-11-11 00:00:00+03:00,out,False,940634,False,78,3749,4995,1246
168252,2019-11-11 00:00:00+03:00,in,False,940616,False,22,2264,2371,107
168252,2019-11-11 00:00:00+03:00,in,False,940622,False,57,2855,3092,237
168252,2019-11-11 00:00:00+03:00,out,False,940616,False,87,3113,4462,1349
168252,2019-11-11 00:00:00+03:00,in,False,940622,True,3,570,582,12
168252,2019-11-11 00:00:00+03:00,in,False,-1,False,22,13479,13557,78
168252,2019-11-11 00:00:00+03:00,in,False,940658,False,16,1916,1971,55
168252,2019-11-11 00:00:00+03:00,in,False,940630,False,85,7997,8251,254
168252,2019-11-11 00:00:00+03:00,in,False,-1,True,37,0,483,483
168252,2019-11-11 00:00:00+03:00,in,False,940588,False,68,7850,8012,162
168252,2019-11-11 00:00:00+03:00,out,False,940616,True,67,0,1543,1543
168252,2019-11-11 00:00:00+03:00,out,False,940658,True,40,0,872,872
168252,2019-11-11 00:00:00+03:00,in,False,940652,False,8,285,317,32
168252,2019-11-11 00:00:00+03:00,out,False,-1,False,11,6492,6670,178
168252,2019-11-11 00:00:00+03:00,out,False,940634,True,54,0,1323,1323
168252,2019-11-11 00:00:00+03:00,out,False,940624,True,3,0,45,45
168252,2019-11-11 00:00:00+03:00,in,False,940634,False,15,1175,1535,360
168252,2019-11-11 00:00:00+03:00,in,False,940624,False,2,60,69,9
168252,2019-11-11 00:00:00+03:00,in,False,940624,False,2,60,69,9
168252,2019-11-11 00:00:00+03:00,in,False,-1,True,37,0,483,483
168252,2019-11-11 00:00:00+03:00,in,False,940658,False,16,1916,1971,55
168252,2019-11-12 00:00:00+03:00,out,False,940658,False,39,3851,4405,554
168252,2019-11-12 00:00:00+03:00,out,False,940616,True,40,0,1036,1036
168252,2019-11-12 00:00:00+03:00,in,False,940658,False,27,2809,2939,130
168252,2019-11-12 00:00:00+03:00,out,False,940624,True,33,0,733,733
168252,2019-11-12 00:00:00+03:00,in,False,940588,True,3,638,651,13
168252,2019-11-12 00:00:00+03:00,in,False,-1,True,4,0,51,51
168252,2019-11-12 00:00:00+03:00,in,True,940630,False,9,102,128,26
168252,2019-11-12 00:00:00+03:00,out,False,940622,False,97,5024,6849,1825
168252,2019-11-12 00:00:00+03:00,out,False,940616,False,76,3754,4934,1180
168252,2019-11-12 00:00:00+03:00,out,False,940588,False,2,34,58,24
168252,2019-11-12 00:00:00+03:00,in,False,940630,False,69,5129,5364,235
168252,2019-11-12 00:00:00+03:00,in,False,-1,True,71,0,1074,1074
168252,2019-11-12 00:00:00+03:00,in,False,-1,False,1,49,54,5
168252,2019-11-12 00:00:00+03:00,out,False,940624,False,57,2760,3693,933
168252,2019-11-12 00:00:00+03:00,out,False,940658,True,22,0,491,491
168252,2019-11-12 00:00:00+03:00,in,False,940614,False,31,1965,2066,101
168252,2019-11-12 00:00:00+03:00,out,True,940616,False,6,119,157,38
168252,2019-11-12 00:00:00+03:00,out,False,940614,False,12,597,818,221
168252,2019-11-12 00:00:00+03:00,in,False,940652,False,2,74,80,6
168252,2019-11-12 00:00:00+03:00,out,True,940658,False,6,61,114,53
168252,2019-11-12 00:00:00+03:00,in,True,940616,False,4,42,55,13
168252,2019-11-12 00:00:00+03:00,in,True,940588,False,9,279,315,36
168252,2019-11-12 00:00:00+03:00,out,False,940614,True,2,0,24,24
168252,2019-11-12 00:00:00+03:00,out,True,940630,False,3,20,39,19
168252,2019-11-12 00:00:00+03:00,in,False,940614,True,1,217,219,2
168252,2019-11-12 00:00:00+03:00,out,True,940622,False,1,6,18,12
168252,2019-11-12 00:00:00+03:00,out,False,940622,True,56,0,1135,1135
168252,2019-11-12 00:00:00+03:00,in,False,940624,False,18,1713,1806,93
168252,2019-11-12 00:00:00+03:00,in,False,940616,False,27,1271,1388,117
168252,2019-11-12 00:00:00+03:00,out,True,940658,True,1,0,1,1
168252,2019-11-12 00:00:00+03:00,out,False,940588,True,2,0,61,61
168252,2019-11-12 00:00:00+03:00,out,False,-1,False,1,49,59,10
168252,2019-11-12 00:00:00+03:00,out,True,940622,True,1,0,13,13
168252,2019-11-12 00:00:00+03:00,in,False,-1,False,23,14063,14181,118
168252,2019-11-12 00:00:00+03:00,out,True,940588,False,2,24,42,18
168252,2019-11-12 00:00:00+03:00,in,False,940588,False,57,4949,5152,203
168252,2019-11-12 00:00:00+03:00,out,False,-1,False,12,8890,9054,164
168252,2019-11-12 00:00:00+03:00,in,True,940658,False,13,194,305,111
168252,2019-11-12 00:00:00+03:00,in,False,940658,False,27,2809,2939,130
168252,2019-11-12 00:00:00+03:00,out,False,940614,True,2,0,24,24
168252,2019-11-12 00:00:00+03:00,in,False,940616,False,27,1271,1388,117
168252,2019-11-12 00:00:00+03:00,out,False,940622,False,97,5024,6849,1825
168252,2019-11-12 00:00:00+03:00,out,False,-1,False,12,8890,9054,164
168252,2019-11-12 00:00:00+03:00,out,False,940616,True,40,0,1036,1036
168252,2019-11-12 00:00:00+03:00,out,True,940658,True,1,0,1,1
168252,2019-11-12 00:00:00+03:00,out,False,940588,False,2,34,58,24
168252,2019-11-13 00:00:00+03:00,out,False,940624,True,36,0,1025,1025
168252,2019-11-13 00:00:00+03:00,out,False,940616,False,62,2989,3981,992
168252,2019-11-13 00:00:00+03:00,out,False,940616,True,44,0,1050,1050
168252,2019-11-13 00:00:00+03:00,in,False,940624,False,16,2040,2081,41
168252,2019-11-13 00:00:00+03:00,out,False,940622,False,60,6554,7617,1063
168252,2019-11-13 00:00:00+03:00,in,False,940652,False,5,581,595,14
168252,2019-11-13 00:00:00+03:00,in,False,940588,True,1,162,164,2
168252,2019-11-13 00:00:00+03:00,out,False,-1,True,3,0,10,10
168252,2019-11-13 00:00:00+03:00,in,False,940588,False,77,7668,7846,178
168252,2019-11-13 00:00:00+03:00,in,False,940658,False,20,1820,1969,149
168252,2019-11-13 00:00:00+03:00,out,False,940658,False,62,3170,4000,830
168252,2019-11-13 00:00:00+03:00,out,False,940652,False,3,252,283,31
168252,2019-11-13 00:00:00+03:00,out,False,940652,True,1,0,4,4
168252,2019-11-13 00:00:00+03:00,in,False,-1,False,23,13305,13391,86
168252,2019-11-13 00:00:00+03:00,out,False,-1,False,20,10412,10705,293
168252,2019-11-13 00:00:00+03:00,in,False,940630,False,92,7805,8077,272
168252,2019-11-13 00:00:00+03:00,in,False,940616,False,18,1890,1976,86
168252,2019-11-13 00:00:00+03:00,in,False,940614,False,40,2631,2751,120
168252,2019-11-13 00:00:00+03:00,out,False,940624,False,38,1192,1863,671
168252,2019-11-13 00:00:00+03:00,in,False,940652,True,1,94,96,2
168252,2019-11-13 00:00:00+03:00,in,False,-1,True,50,0,715,715
168252,2019-11-13 00:00:00+03:00,in,False,940630,True,2,223,227,4
168252,2019-11-13 00:00:00+03:00,out,False,940622,True,37,0,851,851
168252,2019-11-13 00:00:00+03:00,out,False,940658,True,53,0,968,968
168252,2019-11-13 00:00:00+03:00,in,False,940616,True,1,0,3,3
168252,2019-11-14 00:00:00+03:00,in,False,940652,False,5,388,409,21
168252,2019-11-14 00:00:00+03:00,in,False,940588,False,88,8204,8557,353
168252,2019-11-14 00:00:00+03:00,out,True,940652,False,1,26,33,7
168252,2019-11-14 00:00:00+03:00,out,False,-1,False,1,56,62,6
168252,2019-11-14 00:00:00+03:00,in,True,940588,False,1,19,21,2
168252,2019-11-14 00:00:00+03:00,in,False,-1,False,23,13574,13662,88
168252,2019-11-14 00:00:00+03:00,in,True,940624,False,1,30,39,9
168252,2019-11-14 00:00:00+03:00,in,False,940588,True,4,601,624,23
168252,2019-11-14 00:00:00+03:00,out,False,940624,True,13,0,468,468
168252,2019-11-14 00:00:00+03:00,out,False,940624,False,21,2358,2633,275
168252,2019-11-14 00:00:00+03:00,out,True,939716,False,1,120,127,7
168252,2019-11-14 00:00:00+03:00,in,False,940652,True,1,103,105,2
168252,2019-11-14 00:00:00+03:00,out,False,-1,False,1,369,385,16
168252,2019-11-14 00:00:00+03:00,in,False,-1,False,2,203,208,5
168252,2019-11-14 00:00:00+03:00,out,False,940622,False,4,161,225,64
168252,2019-11-14 00:00:00+03:00,out,False,940652,False,21,1262,1653,391
168252,2019-11-14 00:00:00+03:00,out,False,940622,True,4,0,113,113
168252,2019-11-14 00:00:00+03:00,in,False,940622,False,75,4389,4717,328
168252,2019-11-14 00:00:00+03:00,in,False,-1,True,92,0,902,902
168252,2019-11-14 00:00:00+03:00,in,False,940624,False,26,4498,4725,227
168252,2019-11-14 00:00:00+03:00,in,False,940630,False,85,9262,9557,295
168252,2019-11-14 00:00:00+03:00,out,True,940788,False,5,232,384,152
168252,2019-11-14 00:00:00+03:00,in,False,940622,True,2,318,327,9
168252,2019-11-14 00:00:00+03:00,out,False,940652,True,8,0,246,246
168252,2019-11-14 00:00:00+03:00,in,True,940588,False,1,19,21,2
168252,2019-11-14 00:00:00+03:00,out,False,940624,False,21,2358,2633,275
168252,2019-11-15 00:00:00+03:00,out,True,940616,True,1,0,0,0
168252,2019-11-15 00:00:00+03:00,in,False,940658,False,26,2300,2395,95
168252,2019-11-15 00:00:00+03:00,out,False,940658,False,39,3839,4354,515
168252,2019-11-15 00:00:00+03:00,out,False,940622,False,2,120,160,40
168252,2019-11-15 00:00:00+03:00,in,False,940622,False,1,44,47,3
168252,2019-11-15 00:00:00+03:00,in,False,940624,False,12,2123,2177,54
168252,2019-11-15 00:00:00+03:00,in,False,-1,False,13,6551,6583,32
168252,2019-11-15 00:00:00+03:00,in,False,940588,False,74,8207,8380,173
168252,2019-11-15 00:00:00+03:00,out,False,940616,False,99,3722,5425,1703
168252,2019-11-15 00:00:00+03:00,in,False,940652,False,4,152,162,10
168252,2019-11-15 00:00:00+03:00,out,False,-1,False,16,8164,8366,202
168252,2019-11-15 00:00:00+03:00,in,False,940616,False,26,2231,2353,122
168252,2019-11-15 00:00:00+03:00,out,False,940624,True,20,0,407,407
168252,2019-11-15 00:00:00+03:00,out,False,940624,False,30,2104,2574,470
168252,2019-11-15 00:00:00+03:00,out,False,-1,True,2,0,7,7
168252,2019-11-15 00:00:00+03:00,out,False,940658,True,22,0,485,485
168252,2019-11-15 00:00:00+03:00,in,False,-1,True,26,0,250,250
168252,2019-11-15 00:00:00+03:00,in,False,940658,True,1,0,3,3
168252,2019-11-15 00:00:00+03:00,out,True,940788,False,1,22,45,23
168252,2019-11-15 00:00:00+03:00,in,True,940616,False,1,48,51,3
168252,2019-11-15 00:00:00+03:00,out,False,940616,True,52,0,1199,1199
168252,2019-11-15 00:00:00+03:00,out,False,940658,False,39,3839,4354,515
168252,2019-11-15 00:00:00+03:00,out,False,940616,False,99,3722,5425,1703
168252,2019-11-16 00:00:00+03:00,out,False,-1,False,4,2613,2675,62
168252,2019-11-16 00:00:00+03:00,in,False,940614,False,27,1164,1230,66
168252,2019-11-16 00:00:00+03:00,out,False,940614,True,4,0,78,78
168252,2019-11-16 00:00:00+03:00,in,False,940616,False,18,950,1025,75
168252,2019-11-16 00:00:00+03:00,in,False,940652,False,4,146,160,14
168252,2019-11-16 00:00:00+03:00,out,False,940624,False,39,2868,3605,737
168252,2019-11-16 00:00:00+03:00,in,False,940624,False,14,2228,2287,59
168252,2019-11-16 00:00:00+03:00,out,False,940624,True,43,0,1264,1264
168252,2019-11-16 00:00:00+03:00,out,False,940616,False,26,1079,1548,469
168252,2019-11-16 00:00:00+03:00,in,False,940652,True,1,99,101,2
168252,2019-11-16 00:00:00+03:00,out,False,940616,True,27,0,628,628
168252,2019-11-16 00:00:00+03:00,out,False,940614,False,1,28,49,21
168252,2019-11-16 00:00:00+03:00,in,False,-1,False,4,1212,1222,10
168252,2019-11-16 00:00:00+03:00,in,False,-1,True,39,0,435,435
168252,2019-11-17 00:00:00+03:00,out,False,940622,False,1,29,67,38
168252,2019-11-17 00:00:00+03:00,in,False,940630,False,61,5112,5361,249
168252,2019-11-17 00:00:00+03:00,out,False,940658,True,9,0,202,202
168252,2019-11-17 00:00:00+03:00,out,False,940658,False,10,1289,1461,172
168252,2019-11-17 00:00:00+03:00,in,False,940630,True,1,450,452,2
168252,2019-11-17 00:00:00+03:00,in,False,-1,True,80,0,650,650
168252,2019-11-17 00:00:00+03:00,in,False,-1,False,5,4126,4150,24
168252,2019-11-17 00:00:00+03:00,in,False,940622,False,30,1091,1200,109
168252,2019-11-17 00:00:00+03:00,out,False,-1,False,3,1524,1559,35
168252,2019-11-17 00:00:00+03:00,in,False,940658,False,4,229,263,34
168252,2019-11-17 00:00:00+03:00,in,False,940614,False,29,1282,1347,65
168252,2019-11-18 00:00:00+03:00,out,False,940616,True,63,0,1693,1693
168252,2019-11-18 00:00:00+03:00,out,False,950972,True,4,0,63,63
168252,2019-11-18 00:00:00+03:00,in,False,940658,False,28,3330,3440,110
168252,2019-11-18 00:00:00+03:00,out,False,940652,True,9,0,286,286
168252,2019-11-18 00:00:00+03:00,in,True,940622,False,1,28,31,3
168252,2019-11-18 00:00:00+03:00,out,True,940596,False,5,1119,1198,79
168252,2019-11-18 00:00:00+03:00,out,False,950972,False,3,271,318,47
168252,2019-11-18 00:00:00+03:00,in,False,940658,True,1,233,235,2
168252,2019-11-18 00:00:00+03:00,in,False,-1,True,66,0,1391,1391
168252,2019-11-18 00:00:00+03:00,out,False,940658,True,42,0,730,730
168252,2019-11-18 00:00:00+03:00,out,False,940622,False,13,1095,1385,290
168252,2019-11-18 00:00:00+03:00,out,True,940658,True,1,0,0,0
168252,2019-11-18 00:00:00+03:00,out,False,940596,False,4,91,149,58
168252,2019-11-18 00:00:00+03:00,out,True,940788,True,1,0,2,2
168252,2019-11-18 00:00:00+03:00,out,False,940658,False,65,2208,3108,900
168252,2019-11-18 00:00:00+03:00,out,False,940622,True,6,0,243,243
168252,2019-11-18 00:00:00+03:00,out,False,940616,False,107,4609,6409,1800
168252,2019-11-18 00:00:00+03:00,in,False,940616,False,31,3297,3452,155
168252,2019-11-18 00:00:00+03:00,in,False,940588,False,67,8230,8379,149
168252,2019-11-18 00:00:00+03:00,out,False,-1,False,12,4954,5132,178
168252,2019-11-18 00:00:00+03:00,out,False,940614,True,25,0,847,847
168252,2019-11-18 00:00:00+03:00,out,False,-1,False,1,46,55,9
168252,2019-11-18 00:00:00+03:00,in,False,940622,False,55,2553,2794,241
168252,2019-11-18 00:00:00+03:00,in,False,940652,False,3,357,378,21
168252,2019-11-18 00:00:00+03:00,in,False,940630,False,86,10059,10355,296
168252,2019-11-18 00:00:00+03:00,out,False,940652,False,18,1932,2303,371
168252,2019-11-18 00:00:00+03:00,in,True,940630,False,1,20,22,2
168252,2019-11-18 00:00:00+03:00,in,False,-1,False,14,7603,7638,35
168252,2019-11-18 00:00:00+03:00,out,False,940614,False,51,3922,4885,963
168252,2019-11-18 00:00:00+03:00,out,False,-1,False,1,46,55,9
168252,2019-11-18 00:00:00+03:00,out,False,940658,True,42,0,730,730
168252,2019-11-18 00:00:00+03:00,in,False,940588,False,67,8230,8379,149
168252,2019-11-18 00:00:00+03:00,out,False,940616,False,107,4609,6409,1800
168252,2019-11-19 00:00:00+03:00,out,False,940588,False,8,212,317,105
168252,2019-11-19 00:00:00+03:00,out,False,961064,False,58,3970,4928,958
168252,2019-11-19 00:00:00+03:00,out,False,940658,True,58,0,1235,1235
168252,2019-11-19 00:00:00+03:00,out,False,964666,True,37,0,1161,1161
168252,2019-11-19 00:00:00+03:00,out,False,940616,True,91,0,1811,1811
168252,2019-11-19 00:00:00+03:00,out,False,940622,True,8,0,332,332
168252,2019-11-19 00:00:00+03:00,out,False,964666,False,66,7680,8972,1292
168252,2019-11-19 00:00:00+03:00,out,False,-1,False,14,6429,6633,204
168252,2019-11-19 00:00:00+03:00,in,False,940622,True,1,175,177,2
168252,2019-11-19 00:00:00+03:00,out,False,940624,False,46,3316,4061,745
168252,2019-11-19 00:00:00+03:00,out,False,961064,True,66,0,1594,1594
168252,2019-11-19 00:00:00+03:00,out,False,950972,False,127,8066,10613,2547
168252,2019-11-19 00:00:00+03:00,out,False,940622,False,14,889,1128,239
168252,2019-11-19 00:00:00+03:00,out,False,940616,False,103,3547,5175,1628
168252,2019-11-19 00:00:00+03:00,in,True,940652,True,1,51,53,2
168252,2019-11-19 00:00:00+03:00,out,False,950972,True,42,0,1202,1202
168252,2019-11-19 00:00:00+03:00,in,False,961064,False,1,48,57,9
168252,2019-11-19 00:00:00+03:00,in,False,940588,False,74,8388,8545,157
168252,2019-11-19 00:00:00+03:00,out,False,940624,True,23,0,730,730
168252,2019-11-19 00:00:00+03:00,in,False,950972,False,1,15,111,96
168252,2019-11-19 00:00:00+03:00,in,False,940616,False,28,2791,2985,194
168252,2019-11-19 00:00:00+03:00,in,False,964666,False,2,4,35,31
168252,2019-11-19 00:00:00+03:00,out,False,940658,False,42,2912,3531,619
168252,2019-11-19 00:00:00+03:00,in,False,-1,False,33,17524,17608,84
168252,2019-11-19 00:00:00+03:00,in,False,940624,False,10,1567,1605,38
168252,2019-11-19 00:00:00+03:00,in,False,940588,True,1,142,144,2
168252,2019-11-19 00:00:00+03:00,in,False,940652,True,2,263,269,6
168252,2019-11-19 00:00:00+03:00,in,False,940630,False,73,9390,9653,263
168252,2019-11-19 00:00:00+03:00,in,False,940652,False,48,2321,2479,158
168252,2019-11-19 00:00:00+03:00,in,False,940622,False,46,2124,2299,175
168252,2019-11-19 00:00:00+03:00,in,False,940658,False,22,3462,3530,68
168252,2019-11-19 00:00:00+03:00,out,True,940788,True,1,0,2,2
168252,2019-11-19 00:00:00+03:00,out,False,940588,True,2,0,70,70
168252,2019-11-19 00:00:00+03:00,in,False,-1,True,93,0,1343,1343
168252,2019-11-19 00:00:00+03:00,in,False,940622,False,46,2124,2299,175
168252,2019-11-19 00:00:00+03:00,in,False,940622,True,1,175,177,2
168252,2019-11-19 00:00:00+03:00,out,False,940658,False,42,2912,3531,619
168252,2019-11-19 00:00:00+03:00,out,False,940588,False,8,212,317,105
168252,2019-11-19 00:00:00+03:00,in,False,964666,False,2,4,35,31
168252,2019-11-19 00:00:00+03:00,in,False,961064,False,1,48,57,9
168252,2019-11-20 00:00:00+03:00,out,False,950972,True,54,0,1696,1696
168252,2019-11-20 00:00:00+03:00,out,False,940622,True,3,0,63,63
168252,2019-11-20 00:00:00+03:00,out,False,-1,False,17,7799,7999,200
168252,2019-11-20 00:00:00+03:00,out,False,964666,True,74,0,2077,2077
168252,2019-11-20 00:00:00+03:00,out,False,964666,False,107,5118,7298,2180
168252,2019-11-20 00:00:00+03:00,in,False,940616,False,50,4833,5090,257
168252,2019-11-20 00:00:00+03:00,in,False,940630,False,95,9037,9391,354
168252,2019-11-20 00:00:00+03:00,out,False,961064,True,40,0,966,966
168252,2019-11-20 00:00:00+03:00,in,False,940622,False,4,187,208,21
168252,2019-11-20 00:00:00+03:00,out,False,940616,True,63,0,1359,1359
168252,2019-11-20 00:00:00+03:00,in,False,961064,False,1,25,29,4
168252,2019-11-20 00:00:00+03:00,in,False,940624,False,11,2062,2106,44
168252,2019-11-20 00:00:00+03:00,in,False,940588,False,71,7532,7747,215
168252,2019-11-20 00:00:00+03:00,out,False,940624,True,8,0,146,146
168252,2019-11-20 00:00:00+03:00,in,False,940588,True,2,525,529,4
168252,2019-11-20 00:00:00+03:00,in,False,964666,False,2,45,61,16
168252,2019-11-20 00:00:00+03:00,out,False,950972,False,77,5179,6681,1502
168252,2019-11-20 00:00:00+03:00,in,False,940652,False,41,2318,2471,153
168252,2019-11-20 00:00:00+03:00,in,False,940616,True,1,0,3,3
168252,2019-11-20 00:00:00+03:00,out,False,961064,False,69,4138,5395,1257
168252,2019-11-20 00:00:00+03:00,out,False,940616,False,103,3550,5247,1697
168252,2019-11-20 00:00:00+03:00,in,False,-1,False,26,15278,15352,74
168252,2019-11-20 00:00:00+03:00,in,False,-1,True,115,0,1854,1854
168252,2019-11-20 00:00:00+03:00,out,False,940624,False,6,222,387,165
168252,2019-11-20 00:00:00+03:00,in,False,940588,False,71,7532,7747,215
168252,2019-11-20 00:00:00+03:00,in,False,-1,True,115,0,1854,1854
168252,2019-11-20 00:00:00+03:00,in,False,940622,False,4,187,208,21
168252,2019-11-20 00:00:00+03:00,out,False,950972,False,77,5179,6681,1502
168252,2019-11-21 00:00:00+03:00,in,False,-1,True,101,0,1943,1943
168252,2019-11-21 00:00:00+03:00,in,False,964666,False,5,534,552,18
168252,2019-11-21 00:00:00+03:00,in,False,940634,False,16,2815,2901,86
168252,2019-11-21 00:00:00+03:00,in,False,-1,False,37,21446,21563,117
168252,2019-11-21 00:00:00+03:00,in,False,940588,True,6,532,544,12
168252,2019-11-21 00:00:00+03:00,out,False,940614,True,34,0,727,727
168252,2019-11-21 00:00:00+03:00,in,True,966686,False,2,178,211,33
168252,2019-11-21 00:00:00+03:00,out,True,939716,False,2,124,141,17
168252,2019-11-21 00:00:00+03:00,in,False,940616,False,23,2748,2882,134
168252,2019-11-21 00:00:00+03:00,in,False,940652,False,43,2159,2307,148
168252,2019-11-21 00:00:00+03:00,in,False,950972,False,1,18,25,7
168252,2019-11-21 00:00:00+03:00,out,False,961064,False,49,5364,6193,829
168252,2019-11-21 00:00:00+03:00,out,False,940652,True,45,0,1215,1215
168252,2019-11-21 00:00:00+03:00,out,False,950972,True,23,0,812,812
168252,2019-11-21 00:00:00+03:00,out,False,-1,False,1,53,62,9
168252,2019-11-21 00:00:00+03:00,out,False,964666,False,82,7183,8690,1507
168252,2019-11-21 00:00:00+03:00,in,False,964666,True,2,198,211,13
168252,2019-11-21 00:00:00+03:00,out,False,940596,True,32,0,643,643
168252,2019-11-21 00:00:00+03:00,out,False,950972,False,61,3623,4854,1231
168252,2019-11-21 00:00:00+03:00,in,False,940634,True,1,443,476,33
168252,2019-11-21 00:00:00+03:00,in,False,961064,False,3,111,173,62
168252,2019-11-21 00:00:00+03:00,out,False,940634,True,28,0,646,646
168252,2019-11-21 00:00:00+03:00,in,False,940588,False,89,5906,6101,195
168252,2019-11-21 00:00:00+03:00,out,False,961064,True,35,0,951,951
168252,2019-11-21 00:00:00+03:00,in,False,940630,True,1,55,58,3
168252,2019-11-21 00:00:00+03:00,out,True,940596,False,2,15,37,22
168252,2019-11-21 00:00:00+03:00,out,False,940652,False,60,4394,5428,1034
168252,2019-11-21 00:00:00+03:00,out,False,940624,False,33,1754,2399,645
168252,2019-11-21 00:00:00+03:00,out,True,966686,False,1,176,186,10
168252,2019-11-21 00:00:00+03:00,out,False,940616,False,42,1494,2195,701
168252,2019-11-21 00:00:00+03:00,out,False,940624,True,19,0,589,589
168252,2019-11-21 00:00:00+03:00,out,False,940616,True,27,0,592,592
168252,2019-11-21 00:00:00+03:00,out,False,964666,True,33,0,869,869
168252,2019-11-21 00:00:00+03:00,out,False,940596,False,61,3014,4162,1148
168252,2019-11-21 00:00:00+03:00,out,False,940634,False,51,2612,3559,947
168252,2019-11-21 00:00:00+03:00,out,True,940614,False,3,1211,1247,36
168252,2019-11-21 00:00:00+03:00,out,False,-1,False,22,10506,10893,387
168252,2019-11-21 00:00:00+03:00,in,False,940624,False,21,2843,2914,71
168252,2019-11-21 00:00:00+03:00,in,False,940630,False,56,7073,7249,176
168252,2019-11-21 00:00:00+03:00,out,False,939716,True,1,0,12,12
168252,2019-11-21 00:00:00+03:00,out,False,940614,False,38,1407,1943,536
168252,2019-11-21 00:00:00+03:00,out,False,940652,False,60,4394,5428,1034
168252,2019-11-21 00:00:00+03:00,out,False,940634,True,28,0,646,646
168252,2019-11-22 00:00:00+03:00,out,False,940624,True,32,0,1002,1002
168252,2019-11-22 00:00:00+03:00,out,False,961064,True,66,0,1345,1345
168252,2019-11-22 00:00:00+03:00,out,False,940652,False,48,5521,6288,767
168252,2019-11-22 00:00:00+03:00,in,False,964666,False,10,168,569,401
168252,2019-11-22 00:00:00+03:00,out,True,940596,False,1,12,22,10
168252,2019-11-22 00:00:00+03:00,out,False,940634,False,58,3709,4503,794
168252,2019-11-22 00:00:00+03:00,in,False,961064,False,7,280,302,22
168252,2019-11-22 00:00:00+03:00,out,False,940624,False,57,1528,2498,970
168252,2019-11-22 00:00:00+03:00,in,False,940624,False,19,3516,3608,92
168252,2019-11-22 00:00:00+03:00,in,False,940658,False,43,2583,2759,176
168252,2019-11-22 00:00:00+03:00,in,False,940588,True,2,221,225,4
168252,2019-11-22 00:00:00+03:00,out,True,940624,True,1,0,1,1
168252,2019-11-22 00:00:00+03:00,in,False,940614,False,4,123,156,33
168252,2019-11-22 00:00:00+03:00,out,False,964666,True,47,0,1343,1343
168252,2019-11-22 00:00:00+03:00,out,False,940658,False,40,1484,2051,567
168252,2019-11-22 00:00:00+03:00,out,False,940652,True,39,0,1092,1092
168252,2019-11-22 00:00:00+03:00,out,True,964666,False,1,18,25,7
168252,2019-11-22 00:00:00+03:00,out,False,940596,True,34,0,809,809
168252,2019-11-22 00:00:00+03:00,in,False,940622,True,2,379,388,9
168252,2019-11-22 00:00:00+03:00,out,False,940616,False,93,1937,3473,1536
168252,2019-11-22 00:00:00+03:00,out,False,940622,False,43,2339,3113,774
168252,2019-11-22 00:00:00+03:00,out,False,940622,True,32,0,688,688
168252,2019-11-22 00:00:00+03:00,in,False,950972,False,1,27,38,11
168252,2019-11-22 00:00:00+03:00,out,False,940596,False,64,2474,3532,1058
168252,2019-11-22 00:00:00+03:00,in,False,940614,True,1,71,79,8
168252,2019-11-22 00:00:00+03:00,out,False,940614,False,56,2817,3701,884
168252,2019-11-22 00:00:00+03:00,in,False,940588,False,157,10251,10640,389
168252,2019-11-22 00:00:00+03:00,in,False,-1,False,52,26175,26347,172
168252,2019-11-22 00:00:00+03:00,out,False,950972,False,60,3461,4586,1125
168252,2019-11-22 00:00:00+03:00,out,False,961064,False,73,5102,6427,1325
168252,2019-11-22 00:00:00+03:00,out,False,940658,True,54,0,811,811
168252,2019-11-22 00:00:00+03:00,out,False,940614,True,67,0,1190,1190
168252,2019-11-22 00:00:00+03:00,out,False,940634,True,34,0,931,931
168252,2019-11-22 00:00:00+03:00,in,False,-1,True,146,0,2207,2207
168252,2019-11-22 00:00:00+03:00,out,False,-1,False,34,19737,20221,484
168252,2019-11-22 00:00:00+03:00,in,False,940634,False,19,2448,2697,249
168252,2019-11-22 00:00:00+03:00,in,False,940652,False,33,1349,1519,170
168252,2019-11-22 00:00:00+03:00,out,False,940616,True,65,0,1580,1580
168252,2019-11-22 00:00:00+03:00,in,False,940616,True,2,2,16,14
168252,2019-11-22 00:00:00+03:00,in,False,940622,False,45,2636,2879,243
168252,2019-11-22 00:00:00+03:00,out,False,950972,True,28,0,680,680
168252,2019-11-22 00:00:00+03:00,out,False,964666,False,63,8701,9939,1238
168252,2019-11-22 00:00:00+03:00,in,False,940616,False,30,2134,2307,173
168252,2019-11-22 00:00:00+03:00,out,False,940652,False,48,5521,6288,767
168252,2019-11-22 00:00:00+03:00,out,False,940614,True,67,0,1190,1190
168252,2019-11-22 00:00:00+03:00,in,False,-1,False,52,26175,26347,172
168252,2019-11-22 00:00:00+03:00,out,False,940596,False,64,2474,3532,1058
168252,2019-11-23 00:00:00+03:00,out,False,940652,True,66,0,1767,1767
168252,2019-11-23 00:00:00+03:00,in,False,-1,True,4,0,111,111
168252,2019-11-23 00:00:00+03:00,out,False,940658,False,34,1987,2439,452
168252,2019-11-23 00:00:00+03:00,in,True,940652,False,2,58,107,49
168252,2019-11-23 00:00:00+03:00,in,False,-1,True,120,0,1029,1029
168252,2019-11-23 00:00:00+03:00,in,False,940658,True,1,0,4,4
168252,2019-11-23 00:00:00+03:00,in,False,-1,False,18,8544,8623,79
168252,2019-11-23 00:00:00+03:00,in,False,940622,False,40,2804,2990,186
168252,2019-11-23 00:00:00+03:00,out,False,940652,False,78,3996,5549,1553
168252,2019-11-23 00:00:00+03:00,out,False,940622,False,50,2575,3663,1088
168252,2019-11-23 00:00:00+03:00,out,False,940634,True,31,0,732,732
168252,2019-11-23 00:00:00+03:00,out,False,940622,True,22,0,854,854
168252,2019-11-23 00:00:00+03:00,in,False,940658,False,13,744,821,77
168252,2019-11-23 00:00:00+03:00,in,False,940652,False,17,777,843,66
168252,2019-11-23 00:00:00+03:00,out,False,940658,True,60,0,1151,1151
168252,2019-11-23 00:00:00+03:00,in,False,940634,False,10,950,1064,114
168252,2019-11-23 00:00:00+03:00,in,False,940622,True,1,269,274,5
168252,2019-11-23 00:00:00+03:00,out,False,-1,False,5,2126,2185,59
168252,2019-11-23 00:00:00+03:00,out,False,940634,False,31,1491,2074,583
168252,2019-11-23 00:00:00+03:00,in,False,940658,False,13,744,821,77
168252,2019-11-24 00:00:00+03:00,in,False,940652,False,3,110,125,15
168252,2019-11-24 00:00:00+03:00,out,False,-1,False,5,2906,2977,71
168252,2019-11-24 00:00:00+03:00,in,False,-1,False,2,1229,1241,12
168252,2019-11-24 00:00:00+03:00,in,False,-1,True,46,0,342,342
168252,2019-11-24 00:00:00+03:00,in,False,940630,True,1,0,12,12
168252,2019-11-24 00:00:00+03:00,out,False,940630,True,36,0,630,630
168252,2019-11-24 00:00:00+03:00,out,False,940634,False,34,1132,1638,506
168252,2019-11-24 00:00:00+03:00,out,False,940630,False,53,1465,2308,843
168252,2019-11-24 00:00:00+03:00,in,False,940634,False,15,1893,1998,105
168252,2019-11-24 00:00:00+03:00,in,False,940630,False,11,2040,2103,63
168252,2019-11-24 00:00:00+03:00,in,False,-1,True,1,0,0,0
168252,2019-11-24 00:00:00+03:00,out,False,940634,True,52,0,819,819
168252,2019-11-24 00:00:00+03:00,out,False,940630,False,53,1465,2308,843
168252,2019-11-25 00:00:00+03:00,in,False,940614,False,7,234,286,52
168252,2019-11-25 00:00:00+03:00,out,True,940652,False,1,31,48,17
168252,2019-11-25 00:00:00+03:00,out,True,940596,False,2,21,40,19
168252,2019-11-25 00:00:00+03:00,out,False,961064,False,73,5009,6278,1269
168252,2019-11-25 00:00:00+03:00,out,True,940624,False,1,14,25,11
168252,2019-11-25 00:00:00+03:00,out,False,940630,True,4,0,13,13
168252,2019-11-25 00:00:00+03:00,out,False,940652,True,80,0,2003,2003
168252,2019-11-25 00:00:00+03:00,out,False,950972,False,85,4855,6408,1553
168252,2019-11-25 00:00:00+03:00,out,False,950972,True,31,0,689,689
168252,2019-11-25 00:00:00+03:00,out,True,940630,False,1,6,15,9
168252,2019-11-25 00:00:00+03:00,in,False,940630,True,2,741,747,6
168252,2019-11-25 00:00:00+03:00,in,False,964666,False,15,394,462,68
168252,2019-11-25 00:00:00+03:00,out,True,940596,True,4,0,51,51
168252,2019-11-25 00:00:00+03:00,out,True,940652,True,1,0,48,48
168252,2019-11-25 00:00:00+03:00,in,False,-1,False,49,23658,23854,196
168252,2019-11-25 00:00:00+03:00,out,False,964666,True,61,0,1929,1929
168252,2019-11-25 00:00:00+03:00,out,False,-1,False,11,6287,6432,145
168252,2019-11-25 00:00:00+03:00,in,False,961064,False,6,187,250,63
168252,2019-11-25 00:00:00+03:00,in,False,940652,False,52,2236,2437,201
168252,2019-11-25 00:00:00+03:00,out,True,940630,True,2,0,13,13
168252,2019-11-25 00:00:00+03:00,in,False,940588,False,110,9940,10370,430
168252,2019-11-25 00:00:00+03:00,out,False,940596,True,59,0,1445,1445
168252,2019-11-25 00:00:00+03:00,out,False,940630,False,5,211,290,79
168252,2019-11-25 00:00:00+03:00,out,False,940652,False,76,6776,8183,1407
168252,2019-11-25 00:00:00+03:00,in,False,940652,True,2,317,331,14
168252,2019-11-25 00:00:00+03:00,in,False,940614,True,1,93,97,4
168252,2019-11-25 00:00:00+03:00,out,True,940658,True,1,0,0,0
168252,2019-11-25 00:00:00+03:00,in,False,940588,True,4,463,472,9
168252,2019-11-25 00:00:00+03:00,in,True,940630,False,1,37,40,3
168252,2019-11-25 00:00:00+03:00,out,False,964666,False,100,10873,12811,1938
168252,2019-11-25 00:00:00+03:00,out,False,940622,False,3,47,99,52
168252,2019-11-25 00:00:00+03:00,in,False,940630,False,93,6233,6611,378
168252,2019-11-25 00:00:00+03:00,out,False,940622,True,1,0,7,7
168252,2019-11-25 00:00:00+03:00,out,False,940624,True,13,0,210,210
168252,2019-11-25 00:00:00+03:00,in,False,-1,True,9,0,83,83
168252,2019-11-25 00:00:00+03:00,out,False,940658,True,46,0,920,920
168252,2019-11-25 00:00:00+03:00,in,False,940658,False,44,3878,4087,209
168252,2019-11-25 00:00:00+03:00,out,False,940614,True,42,0,697,697
168252,2019-11-25 00:00:00+03:00,in,False,-1,True,1679,0,42251,42251
168252,2019-11-25 00:00:00+03:00,in,False,956080,False,2,1112,1236,124
168252,2019-11-25 00:00:00+03:00,out,False,961064,True,60,0,1431,1431
168252,2019-11-25 00:00:00+03:00,out,False,940596,False,77,4106,5443,1337
168252,2019-11-25 00:00:00+03:00,in,False,940622,False,79,4301,4687,386
168252,2019-11-25 00:00:00+03:00,out,False,940614,False,79,4566,5681,1115
168252,2019-11-25 00:00:00+03:00,in,False,940624,False,23,2784,2926,142
168252,2019-11-25 00:00:00+03:00,out,False,940568,True,4,0,12,12
168252,2019-11-25 00:00:00+03:00,out,False,940658,False,50,3242,4049,807
168252,2019-11-25 00:00:00+03:00,out,False,940568,False,1,69,81,12
168252,2019-11-25 00:00:00+03:00,out,False,940624,False,18,1677,2025,348
168252,2019-11-25 00:00:00+03:00,in,True,964666,False,1,19,24,5
168252,2019-11-25 00:00:00+03:00,out,False,940614,False,79,4566,5681,1115
168252,2019-11-25 00:00:00+03:00,out,False,964666,True,61,0,1929,1929
168252,2019-11-25 00:00:00+03:00,in,True,940630,False,1,37,40,3
168252,2019-11-26 00:00:00+03:00,out,True,940652,False,1,15,23,8
168252,2019-11-26 00:00:00+03:00,in,False,940652,False,22,2263,2383,120
168252,2019-11-26 00:00:00+03:00,out,False,940658,False,59,3454,4227,773
168252,2019-11-26 00:00:00+03:00,out,False,940624,True,28,0,768,768
168252,2019-11-26 00:00:00+03:00,out,False,961064,False,51,5257,6106,849
168252,2019-11-26 00:00:00+03:00,out,False,950972,True,24,0,633,633
168252,2019-11-26 00:00:00+03:00,out,False,-1,False,19,12591,12870,279
168252,2019-11-26 00:00:00+03:00,out,False,940652,True,38,0,1025,1025
168252,2019-11-26 00:00:00+03:00,out,False,940616,False,116,4849,6557,1708
168252,2019-11-26 00:00:00+03:00,out,True,940788,True,1,0,2,2
168252,2019-11-26 00:00:00+03:00,out,False,940596,True,19,0,428,428
168252,2019-11-26 00:00:00+03:00,out,False,-1,False,1,72,90,18
168252,2019-11-26 00:00:00+03:00,in,False,-1,True,2,0,55,55
168252,2019-11-26 00:00:00+03:00,in,False,940616,False,40,1794,2084,290
168252,2019-11-26 00:00:00+03:00,out,False,940624,False,51,2364,3169,805
168252,2019-11-26 00:00:00+03:00,out,False,940828,False,4,167,219,52
168252,2019-11-26 00:00:00+03:00,in,False,940630,False,154,8798,9365,567
168252,2019-11-26 00:00:00+03:00,out,False,940616,True,61,0,1586,1586
168252,2019-11-26 00:00:00+03:00,out,False,940828,True,2,0,60,60
168252,2019-11-26 00:00:00+03:00,in,False,956080,False,2,37,125,88
168252,2019-11-26 00:00:00+03:00,in,False,940588,True,1,109,111,2
168252,2019-11-26 00:00:00+03:00,in,False,940658,True,3,0,39,39
168252,2019-11-26 00:00:00+03:00,out,False,940652,False,60,3324,4488,1164
168252,2019-11-26 00:00:00+03:00,in,False,964666,False,5,445,467,22
168252,2019-11-26 00:00:00+03:00,in,False,940658,False,77,5798,6256,458
168252,2019-11-26 00:00:00+03:00,in,False,940624,False,41,2355,2565,210
168252,2019-11-26 00:00:00+03:00,in,False,940588,False,147,9342,9957,615
168252,2019-11-26 00:00:00+03:00,out,False,940658,True,64,0,1242,1242
168252,2019-11-26 00:00:00+03:00,in,False,940622,False,63,2501,2779,278
168252,2019-11-26 00:00:00+03:00,in,False,964666,True,1,90,94,4
168252,2019-11-26 00:00:00+03:00,out,False,940622,False,60,3697,4894,1197
168252,2019-11-26 00:00:00+03:00,out,False,940622,True,35,0,286,286
168252,2019-11-26 00:00:00+03:00,out,False,950972,False,43,5522,6298,776
168252,2019-11-26 00:00:00+03:00,out,False,964666,True,48,0,1497,1497
168252,2019-11-26 00:00:00+03:00,out,False,961064,True,23,0,635,635
168252,2019-11-26 00:00:00+03:00,in,False,940622,True,1,78,83,5
168252,2019-11-26 00:00:00+03:00,in,False,-1,True,1590,0,42667,42667
168252,2019-11-26 00:00:00+03:00,out,False,964666,False,95,13205,14989,1784
168252,2019-11-26 00:00:00+03:00,out,False,940596,False,42,1795,2476,681
168252,2019-11-26 00:00:00+03:00,in,False,940630,True,1,382,384,2
168252,2019-11-26 00:00:00+03:00,in,False,-1,False,41,17606,17742,136
168252,2019-11-26 00:00:00+03:00,in,False,940658,True,3,0,39,39
168252,2019-11-26 00:00:00+03:00,out,False,940828,False,4,167,219,52
168252,2019-11-26 00:00:00+03:00,in,False,940616,False,40,1794,2084,290
168252,2019-11-26 00:00:00+03:00,out,False,940596,True,19,0,428,428
168252,2019-11-26 00:00:00+03:00,out,False,940828,True,2,0,60,60
168252,2019-11-27 00:00:00+03:00,in,False,-1,False,52,23706,23894,188
168252,2019-11-27 00:00:00+03:00,out,False,961064,False,120,4896,7111,2215
168252,2019-11-27 00:00:00+03:00,out,False,961064,True,44,0,1049,1049
168252,2019-11-27 00:00:00+03:00,out,False,950972,False,64,4308,5599,1291
168252,2019-11-27 00:00:00+03:00,out,False,940652,False,81,5641,7339,1698
168252,2019-11-27 00:00:00+03:00,out,False,940622,False,48,2367,3240,873
168252,2019-11-27 00:00:00+03:00,in,False,940630,False,68,5565,5797,232
168252,2019-11-27 00:00:00+03:00,out,False,940658,True,43,0,702,702
168252,2019-11-27 00:00:00+03:00,out,False,940652,True,42,0,1079,1079
168252,2019-11-27 00:00:00+03:00,in,False,940622,False,36,1904,2067,163
168252,2019-11-27 00:00:00+03:00,out,False,940624,True,25,0,665,665
168252,2019-11-27 00:00:00+03:00,in,False,940634,False,33,3508,3779,271
168252,2019-11-27 00:00:00+03:00,out,False,940658,False,41,1090,1683,593
168252,2019-11-27 00:00:00+03:00,out,False,-1,False,27,17925,18283,358
168252,2019-11-27 00:00:00+03:00,out,False,940622,True,24,0,753,753
168252,2019-11-27 00:00:00+03:00,in,False,940652,False,25,1552,1675,123
168252,2019-11-27 00:00:00+03:00,in,False,940588,False,106,10449,10713,264
168252,2019-11-27 00:00:00+03:00,in,False,940624,False,22,4034,4208,174
168252,2019-11-27 00:00:00+03:00,in,False,940622,True,3,263,278,15
168252,2019-11-27 00:00:00+03:00,in,False,940658,False,56,6339,6653,314
168252,2019-11-27 00:00:00+03:00,out,False,940634,False,63,3557,4503,946
168252,2019-11-27 00:00:00+03:00,out,False,950972,True,37,0,1172,1172
168252,2019-11-27 00:00:00+03:00,in,False,-1,True,142,0,1662,1662
168252,2019-11-27 00:00:00+03:00,out,False,940624,False,43,2804,3422,618
168252,2019-11-27 00:00:00+03:00,out,False,940634,True,41,0,774,774
168252,2019-11-27 00:00:00+03:00,in,False,950972,False,1,200,203,3
168252,2019-11-27 00:00:00+03:00,in,False,961064,False,5,69,82,13
168252,2019-11-27 00:00:00+03:00,in,False,940634,True,1,1,8,7
168252,2019-11-28 00:00:00+03:00,out,False,940652,True,28,0,859,859
168252,2019-11-28 00:00:00+03:00,out,False,940624,True,17,0,462,462
168252,2019-11-28 00:00:00+03:00,out,False,940622,False,39,1969,2733,764
168252,2019-11-28 00:00:00+03:00,in,True,940634,False,2,33,37,4
168252,2019-11-28 00:00:00+03:00,in,False,-1,False,2,265,274,9
168252,2019-11-28 00:00:00+03:00,in,False,940622,True,1,0,12,12
168252,2019-11-28 00:00:00+03:00,in,False,940652,False,29,1451,1538,87
168252,2019-11-28 00:00:00+03:00,out,False,961064,False,39,2633,3319,686
168252,2019-11-28 00:00:00+03:00,in,False,-1,True,1,0,0,0
168252,2019-11-28 00:00:00+03:00,in,False,940652,True,1,84,87,3
168252,2019-11-28 00:00:00+03:00,in,False,940658,False,48,5108,5254,146
168252,2019-11-28 00:00:00+03:00,out,False,940658,True,38,0,497,497
168252,2019-11-28 00:00:00+03:00,out,False,950972,True,21,0,530,530
168252,2019-11-28 00:00:00+03:00,out,False,950972,False,32,2443,2963,520
168252,2019-11-28 00:00:00+03:00,in,False,940624,False,27,3125,3291,166
168252,2019-11-28 00:00:00+03:00,out,False,940624,False,48,1386,2154,768
168252,2019-11-28 00:00:00+03:00,out,True,940634,True,2,0,9,9
168252,2019-11-28 00:00:00+03:00,in,False,940622,False,48,2338,2551,213
168252,2019-11-28 00:00:00+03:00,in,False,940588,False,109,9433,9805,372
168252,2019-11-28 00:00:00+03:00,in,False,940588,True,1,135,148,13
168252,2019-11-28 00:00:00+03:00,in,False,-1,False,45,23765,23897,132
168252,2019-11-28 00:00:00+03:00,out,True,940622,False,1,22,44,22
168252,2019-11-28 00:00:00+03:00,in,False,-1,True,95,0,1159,1159
168252,2019-11-28 00:00:00+03:00,out,False,940634,False,53,2044,2881,837
168252,2019-11-28 00:00:00+03:00,out,False,961064,True,38,0,1200,1200
168252,2019-11-28 00:00:00+03:00,in,False,940634,False,40,5178,5642,464
168252,2019-11-28 00:00:00+03:00,out,False,940634,True,38,0,799,799
168252,2019-11-28 00:00:00+03:00,out,True,940622,True,1,0,60,60
168252,2019-11-28 00:00:00+03:00,out,False,940658,False,33,3249,3658,409
168252,2019-11-28 00:00:00+03:00,out,False,-1,False,22,11904,12211,307
168252,2019-11-28 00:00:00+03:00,out,False,-1,False,1,159,168,9
168252,2019-11-28 00:00:00+03:00,out,False,940622,True,47,0,1164,1164
168252,2019-11-28 00:00:00+03:00,out,False,940652,False,50,4751,5624,873
168252,2019-11-28 00:00:00+03:00,in,True,940588,False,4,207,230,23
168252,2019-11-28 00:00:00+03:00,out,False,940624,True,17,0,462,462
168252,2019-11-28 00:00:00+03:00,out,False,940634,True,38,0,799,799
168253,2019-10-24 00:00:00+03:00,in,False,-1,True,3,0,6,6
168253,2019-10-29 00:00:00+03:00,in,False,-1,True,2,0,4,4
168253,2019-11-01 00:00:00+03:00,in,False,-1,True,10,0,40,40
168253,2019-11-01 00:00:00+03:00,in,False,952954,False,1,7,8,1
168253,2019-11-01 00:00:00+03:00,out,False,952948,True,1,0,13,13
168253,2019-11-01 00:00:00+03:00,in,False,952948,False,6,39,63,24
168253,2019-11-01 00:00:00+03:00,in,False,-1,True,10,0,40,40
168253,2019-11-03 00:00:00+03:00,out,True,952948,True,2,0,0,0
168253,2019-11-03 00:00:00+03:00,out,True,952948,True,2,0,0,0
168253,2019-11-05 00:00:00+03:00,out,False,952948,True,18,0,211,211
168253,2019-11-05 00:00:00+03:00,out,False,-1,True,1,0,0,0
168253,2019-11-05 00:00:00+03:00,in,False,952948,False,118,11590,11723,133
168253,2019-11-05 00:00:00+03:00,out,False,952948,False,19,1702,1891,189
168253,2019-11-06 00:00:00+03:00,out,False,952948,False,30,2985,3306,321
168253,2019-11-06 00:00:00+03:00,out,False,952948,True,22,0,470,470
168253,2019-11-06 00:00:00+03:00,out,True,952948,True,1,0,0,0
168253,2019-11-06 00:00:00+03:00,in,False,952948,False,132,15663,15843,180
168253,2019-11-06 00:00:00+03:00,out,True,952948,True,1,0,0,0
168253,2019-11-07 00:00:00+03:00,out,False,952948,True,14,0,257,257
168253,2019-11-07 00:00:00+03:00,in,False,952948,False,165,20371,20603,232
168253,2019-11-07 00:00:00+03:00,in,False,952948,True,1,0,1,1
168253,2019-11-07 00:00:00+03:00,out,False,952948,False,45,5026,5518,492
168253,2019-11-07 00:00:00+03:00,out,True,952948,True,1,0,0,0
168253,2019-11-08 00:00:00+03:00,out,True,952948,True,1,0,0,0
168253,2019-11-08 00:00:00+03:00,in,False,952948,False,170,20097,20349,252
168253,2019-11-08 00:00:00+03:00,out,False,952948,True,18,0,182,182
168253,2019-11-08 00:00:00+03:00,out,False,952948,False,38,3592,4086,494
168253,2019-11-08 00:00:00+03:00,out,True,952948,True,1,0,0,0
168253,2019-11-09 00:00:00+03:00,out,False,952948,True,7,0,252,252
168253,2019-11-09 00:00:00+03:00,out,False,952948,False,7,244,319,75
168253,2019-11-09 00:00:00+03:00,in,False,952948,False,45,4924,4977,53
168253,2019-11-10 00:00:00+03:00,out,False,952948,False,5,280,364,84
168253,2019-11-10 00:00:00+03:00,in,False,-1,True,2,0,110,110
168253,2019-11-10 00:00:00+03:00,out,False,952948,True,4,0,119,119
168253,2019-11-10 00:00:00+03:00,in,False,952948,False,14,1030,1180,150
168253,2019-11-10 00:00:00+03:00,in,False,952948,False,14,1030,1180,150
168253,2019-11-11 00:00:00+03:00,out,True,952948,True,1,0,0,0
168253,2019-11-11 00:00:00+03:00,out,False,952948,False,27,2693,3027,334
168253,2019-11-11 00:00:00+03:00,out,False,952948,True,2,0,54,54
168253,2019-11-11 00:00:00+03:00,in,False,952948,False,175,19480,19712,232
168253,2019-11-11 00:00:00+03:00,in,False,952948,False,175,19480,19712,232
168253,2019-11-12 00:00:00+03:00,out,False,952948,False,55,4440,5034,594
168253,2019-11-12 00:00:00+03:00,out,False,952948,True,35,0,663,663
168253,2019-11-12 00:00:00+03:00,in,False,952948,False,192,21684,22014,330
168253,2019-11-12 00:00:00+03:00,in,False,952948,False,192,21684,22014,330
168253,2019-11-12 00:00:00+03:00,out,False,952948,True,35,0,663,663
168253,2019-11-13 00:00:00+03:00,in,False,-1,True,2,0,13,13
168253,2019-11-13 00:00:00+03:00,in,False,952948,False,187,20502,20801,299
168253,2019-11-13 00:00:00+03:00,out,True,952948,True,1,0,0,0
168253,2019-11-13 00:00:00+03:00,out,False,952948,False,44,4918,5398,480
168253,2019-11-13 00:00:00+03:00,out,False,952948,True,23,0,552,552
168253,2019-11-13 00:00:00+03:00,in,False,952948,True,1,0,2,2
168253,2019-11-14 00:00:00+03:00,out,False,952948,False,29,3425,3744,319
168253,2019-11-14 00:00:00+03:00,out,True,952948,True,4,0,0,0
168253,2019-11-14 00:00:00+03:00,out,False,952948,True,10,0,389,389
168253,2019-11-14 00:00:00+03:00,in,False,952948,False,148,15253,15436,183
168253,2019-11-15 00:00:00+03:00,out,False,952948,False,31,2696,3029,333
168253,2019-11-15 00:00:00+03:00,out,True,952948,True,3,0,0,0
168253,2019-11-15 00:00:00+03:00,out,False,952948,True,5,0,96,96
168253,2019-11-15 00:00:00+03:00,in,False,952948,False,176,19220,19421,201
168253,2019-11-16 00:00:00+03:00,in,False,952948,False,59,6386,6458,72
168253,2019-11-16 00:00:00+03:00,out,False,952948,True,3,0,51,51
168253,2019-11-16 00:00:00+03:00,in,False,-1,True,1,0,0,0
168253,2019-11-16 00:00:00+03:00,out,False,952948,False,9,1677,1769,92
168253,2019-11-17 00:00:00+03:00,in,False,-1,True,1,0,91,91
168253,2019-11-17 00:00:00+03:00,in,False,952948,False,27,2261,2607,346
168253,2019-11-17 00:00:00+03:00,out,False,952948,False,8,1410,1502,92
168253,2019-11-17 00:00:00+03:00,out,False,952948,True,2,0,15,15
168253,2019-11-17 00:00:00+03:00,out,False,952948,True,2,0,15,15
168253,2019-11-17 00:00:00+03:00,in,False,-1,True,1,0,91,91
168253,2019-11-18 00:00:00+03:00,out,False,952948,False,16,2177,2400,223
168253,2019-11-18 00:00:00+03:00,in,False,-1,True,1,0,1,1
168253,2019-11-18 00:00:00+03:00,in,False,952948,False,223,21441,21738,297
168253,2019-11-18 00:00:00+03:00,out,True,952948,True,2,0,0,0
168253,2019-11-18 00:00:00+03:00,out,False,952948,True,5,0,26,26
168253,2019-11-18 00:00:00+03:00,out,True,952948,True,2,0,0,0
168253,2019-11-19 00:00:00+03:00,out,False,952948,True,15,0,149,149
168253,2019-11-19 00:00:00+03:00,in,False,952948,False,190,21318,21731,413
168253,2019-11-19 00:00:00+03:00,in,False,-1,True,1,0,26,26
168253,2019-11-19 00:00:00+03:00,out,False,952948,False,26,3716,3935,219
168253,2019-11-20 00:00:00+03:00,out,False,952948,True,18,0,234,234
168253,2019-11-20 00:00:00+03:00,in,False,952948,True,1,0,1,1
168253,2019-11-20 00:00:00+03:00,out,False,952948,False,13,1199,1308,109
168253,2019-11-20 00:00:00+03:00,in,False,952948,False,165,19647,19853,206
168253,2019-11-20 00:00:00+03:00,in,False,-1,True,1,0,1,1
168253,2019-11-21 00:00:00+03:00,out,False,952948,True,29,0,438,438
168253,2019-11-21 00:00:00+03:00,out,False,952948,False,56,6017,6502,485
168253,2019-11-21 00:00:00+03:00,in,False,952948,True,1,0,1,1
168253,2019-11-21 00:00:00+03:00,in,False,952948,False,189,19927,20202,275
168253,2019-11-21 00:00:00+03:00,out,True,952948,True,4,0,0,0
168253,2019-11-21 00:00:00+03:00,out,False,952948,True,29,0,438,438
168253,2019-11-21 00:00:00+03:00,in,False,952948,False,189,19927,20202,275
168253,2019-11-22 00:00:00+03:00,out,False,952948,True,23,0,383,383
168253,2019-11-22 00:00:00+03:00,in,False,952954,False,1,8,9,1
168253,2019-11-22 00:00:00+03:00,in,False,952948,False,203,22926,23244,318
168253,2019-11-22 00:00:00+03:00,out,True,952948,True,1,0,0,0
168253,2019-11-22 00:00:00+03:00,out,False,952948,False,38,4144,4581,437
168253,2019-11-22 00:00:00+03:00,in,False,-1,True,2,0,13,13
168253,2019-11-22 00:00:00+03:00,out,False,952948,True,23,0,383,383
168253,2019-11-22 00:00:00+03:00,in,False,952954,False,1,8,9,1
168253,2019-11-22 00:00:00+03:00,out,False,952948,False,38,4144,4581,437
168253,2019-11-23 00:00:00+03:00,out,False,952948,False,10,911,1021,110
168253,2019-11-23 00:00:00+03:00,in,False,952948,False,62,9023,9106,83
168253,2019-11-23 00:00:00+03:00,out,True,952948,True,3,0,0,0
168253,2019-11-23 00:00:00+03:00,out,False,952948,True,8,0,86,86
168253,2019-11-23 00:00:00+03:00,in,False,-1,True,1,0,91,91
168253,2019-11-24 00:00:00+03:00,out,False,952948,True,1,0,32,32
168253,2019-11-24 00:00:00+03:00,out,False,952948,False,8,494,582,88
168253,2019-11-24 00:00:00+03:00,in,False,952948,False,13,1445,1573,128
168253,2019-11-25 00:00:00+03:00,out,True,952948,True,8,0,0,0
168253,2019-11-25 00:00:00+03:00,in,False,-1,True,2,0,25,25
168253,2019-11-25 00:00:00+03:00,in,False,952948,False,273,33897,34280,383
168253,2019-11-25 00:00:00+03:00,out,False,952948,False,68,5502,6386,884
168253,2019-11-25 00:00:00+03:00,out,False,952948,True,54,0,812,812
168253,2019-11-26 00:00:00+03:00,in,False,952948,True,1,0,1,1
168253,2019-11-26 00:00:00+03:00,in,False,952948,False,234,27651,28001,350
168253,2019-11-26 00:00:00+03:00,out,False,952948,True,29,0,546,546
168253,2019-11-26 00:00:00+03:00,out,False,952948,False,79,6678,7646,968
168253,2019-11-27 00:00:00+03:00,in,False,-1,True,2,0,40,40
168253,2019-11-27 00:00:00+03:00,in,False,952948,True,1,0,1,1
168253,2019-11-27 00:00:00+03:00,in,False,952948,False,175,18657,18892,235
168253,2019-11-27 00:00:00+03:00,out,False,952948,True,26,0,811,811
168253,2019-11-27 00:00:00+03:00,out,False,952948,False,48,5823,6459,636
168253,2019-11-27 00:00:00+03:00,in,False,-1,True,2,0,40,40
168253,2019-11-28 00:00:00+03:00,out,False,952948,False,36,2602,3027,425
168253,2019-11-28 00:00:00+03:00,in,False,952948,True,2,0,2,2
168253,2019-11-28 00:00:00+03:00,out,True,952948,True,1,0,0,0
168253,2019-11-28 00:00:00+03:00,in,False,952948,False,191,22586,22838,252
168253,2019-11-28 00:00:00+03:00,out,False,952948,True,28,0,608,608
168264,2019-10-28 00:00:00+03:00,in,False,-1,True,1,0,2,2
168264,2019-10-29 00:00:00+03:00,in,False,-1,True,1,0,2,2
168264,2019-10-30 00:00:00+03:00,in,False,-1,True,1,0,2,2
168264,2019-10-31 00:00:00+03:00,in,False,-1,True,3,0,6,6
168264,2019-10-31 00:00:00+03:00,in,False,951490,True,1,1,11,10
168264,2019-10-31 00:00:00+03:00,in,False,951490,False,1,18,38,20
168264,2019-11-02 00:00:00+03:00,in,False,951490,False,1,409,423,14
168264,2019-11-05 00:00:00+03:00,in,False,951490,False,1,19,29,10
168264,2019-11-06 00:00:00+03:00,in,False,951490,False,1,306,321,15
168264,2019-11-08 00:00:00+03:00,in,False,951490,False,1,145,153,8
168264,2019-11-09 00:00:00+03:00,in,False,-1,True,2,0,140,140
168264,2019-11-09 00:00:00+03:00,in,False,951490,False,2,17,47,30
168264,2019-11-11 00:00:00+03:00,in,False,-1,True,1,0,1,1
168264,2019-11-12 00:00:00+03:00,in,False,951490,False,2,114,134,20
168264,2019-11-12 00:00:00+03:00,in,False,951490,False,2,114,134,20
168264,2019-11-15 00:00:00+03:00,in,False,951490,False,1,291,303,12
168264,2019-11-15 00:00:00+03:00,in,False,951490,False,1,291,303,12
168264,2019-11-18 00:00:00+03:00,in,False,951490,False,1,187,198,11
168264,2019-11-18 00:00:00+03:00,in,False,-1,True,1,0,1,1
168264,2019-11-19 00:00:00+03:00,in,False,951490,False,1,32,41,9
168264,2019-11-20 00:00:00+03:00,in,False,951490,False,3,583,703,120
168264,2019-11-21 00:00:00+03:00,in,False,951490,False,1,368,384,16
168264,2019-11-21 00:00:00+03:00,in,False,-1,True,2,0,47,47
168264,2019-11-22 00:00:00+03:00,in,False,-1,True,1,0,22,22
168264,2019-11-22 00:00:00+03:00,in,False,951490,False,4,532,578,46
168264,2019-11-25 00:00:00+03:00,in,False,951490,False,3,302,334,32
168264,2019-11-26 00:00:00+03:00,in,False,-1,True,1,0,4,4
168264,2019-11-26 00:00:00+03:00,in,False,-1,True,7,0,113,113
168264,2019-11-26 00:00:00+03:00,in,False,-1,True,7,0,113,113
168264,2019-11-27 00:00:00+03:00,in,False,951490,False,3,315,342,27
168264,2019-11-27 00:00:00+03:00,in,False,951490,False,3,315,342,27
168271,2019-10-25 00:00:00+03:00,out,False,944764,False,2,36,73,37
168271,2019-10-25 00:00:00+03:00,in,False,944764,False,3,94,139,45
168271,2019-10-25 00:00:00+03:00,in,False,-1,True,3,0,50,50
168271,2019-10-25 00:00:00+03:00,out,False,944764,False,2,36,73,37
168271,2019-10-29 00:00:00+03:00,in,False,-1,True,3,0,35,35
168271,2019-10-29 00:00:00+03:00,out,False,944766,True,1,0,22,22
168271,2019-11-01 00:00:00+03:00,out,False,944764,False,2,81,107,26
168271,2019-11-01 00:00:00+03:00,in,False,944766,False,1,65,68,3
168271,2019-11-01 00:00:00+03:00,in,False,944764,False,5,139,217,78
168271,2019-11-01 00:00:00+03:00,in,False,-1,True,2,0,9,9
168271,2019-11-01 00:00:00+03:00,out,False,944766,False,3,70,92,22
168271,2019-11-01 00:00:00+03:00,in,False,-1,True,2,0,9,9
168271,2019-11-01 00:00:00+03:00,out,False,944766,False,3,70,92,22
168271,2019-11-05 00:00:00+03:00,out,False,954650,False,2,16,41,25
168271,2019-11-06 00:00:00+03:00,in,False,-1,True,2,0,22,22
168271,2019-11-07 00:00:00+03:00,in,False,944764,False,3,81,94,13
168271,2019-11-07 00:00:00+03:00,out,False,944764,True,1,0,8,8
168271,2019-11-07 00:00:00+03:00,in,False,954650,False,1,9,17,8
168271,2019-11-07 00:00:00+03:00,out,False,954650,True,1,0,9,9
168271,2019-11-07 00:00:00+03:00,in,False,-1,True,3,0,37,37
168271,2019-11-07 00:00:00+03:00,out,False,944766,False,1,46,71,25
168271,2019-11-07 00:00:00+03:00,in,False,944766,False,1,11,22,11
168271,2019-11-08 00:00:00+03:00,in,False,954650,False,37,4811,5274,463
168271,2019-11-08 00:00:00+03:00,out,True,954650,True,5,0,0,0
168271,2019-11-08 00:00:00+03:00,in,False,944764,False,2,30,50,20
168271,2019-11-08 00:00:00+03:00,out,False,944766,True,4,0,59,59
168271,2019-11-08 00:00:00+03:00,out,False,954650,False,22,1144,1506,362
168271,2019-11-08 00:00:00+03:00,out,False,944766,False,14,469,677,208
168271,2019-11-08 00:00:00+03:00,in,False,-1,True,20,0,359,359
168271,2019-11-08 00:00:00+03:00,in,False,944766,False,20,2422,2584,162
168271,2019-11-08 00:00:00+03:00,out,False,954650,True,21,0,492,492
168271,2019-11-08 00:00:00+03:00,out,True,954650,True,5,0,0,0
168271,2019-11-09 00:00:00+03:00,in,False,954650,False,14,1198,1332,134
168271,2019-11-09 00:00:00+03:00,in,False,944766,False,18,1257,1383,126
168271,2019-11-09 00:00:00+03:00,in,False,-1,True,43,0,173,173
168271,2019-11-09 00:00:00+03:00,in,False,944764,False,4,64,94,30
168271,2019-11-09 00:00:00+03:00,out,False,944766,False,50,1690,2541,851
168271,2019-11-09 00:00:00+03:00,out,False,944766,True,21,0,612,612
168271,2019-11-09 00:00:00+03:00,in,False,944766,True,1,1,10,9
168271,2019-11-09 00:00:00+03:00,out,False,954650,False,32,1308,1945,637
168271,2019-11-09 00:00:00+03:00,out,False,944764,True,1,0,12,12
168271,2019-11-09 00:00:00+03:00,out,False,954650,True,18,0,605,605
168271,2019-11-09 00:00:00+03:00,out,True,954650,False,2,17,55,38
168271,2019-11-09 00:00:00+03:00,out,False,954650,False,32,1308,1945,637
168271,2019-11-09 00:00:00+03:00,out,False,944764,True,1,0,12,12
168271,2019-11-10 00:00:00+03:00,in,False,-1,True,7,0,154,154
168271,2019-11-11 00:00:00+03:00,in,False,944766,False,33,3308,3583,275
168271,2019-11-11 00:00:00+03:00,in,False,954650,True,1,1,11,10
168271,2019-11-11 00:00:00+03:00,out,False,954650,False,64,2315,3328,1013
168271,2019-11-11 00:00:00+03:00,out,False,954650,True,18,0,477,477
168271,2019-11-11 00:00:00+03:00,in,False,-1,True,50,0,1062,1062
168271,2019-11-11 00:00:00+03:00,out,False,944766,True,2,0,66,66
168271,2019-11-11 00:00:00+03:00,in,False,954650,False,60,5643,6337,694
168271,2019-11-11 00:00:00+03:00,out,False,944766,False,10,170,267,97
168271,2019-11-12 00:00:00+03:00,out,True,954650,True,5,0,0,0
168271,2019-11-12 00:00:00+03:00,in,False,944764,False,1,10,38,28
168271,2019-11-12 00:00:00+03:00,in,False,-1,True,27,0,574,574
168271,2019-11-12 00:00:00+03:00,in,False,954650,False,54,5558,6090,532
168271,2019-11-12 00:00:00+03:00,out,False,954650,True,21,0,559,559
168271,2019-11-12 00:00:00+03:00,out,False,954650,False,44,1554,2271,717
168271,2019-11-12 00:00:00+03:00,in,False,944766,False,12,729,821,92
168271,2019-11-13 00:00:00+03:00,in,False,944764,False,1,17,35,18
168271,2019-11-13 00:00:00+03:00,in,False,954650,False,40,2895,3303,408
168271,2019-11-13 00:00:00+03:00,out,False,954650,True,11,0,252,252
168271,2019-11-13 00:00:00+03:00,out,True,954650,True,4,0,0,0
168271,2019-11-13 00:00:00+03:00,out,False,954650,False,26,954,1367,413
168271,2019-11-13 00:00:00+03:00,in,False,-1,True,17,0,292,292
168271,2019-11-13 00:00:00+03:00,in,False,-1,True,17,0,292,292
168271,2019-11-13 00:00:00+03:00,out,True,954650,True,4,0,0,0
168271,2019-11-14 00:00:00+03:00,in,False,954650,False,42,4997,5396,399
168271,2019-11-14 00:00:00+03:00,out,False,954650,False,25,1079,1416,337
168271,2019-11-14 00:00:00+03:00,in,False,944764,False,2,39,50,11
168271,2019-11-14 00:00:00+03:00,out,True,954650,True,2,0,0,0
168271,2019-11-14 00:00:00+03:00,in,False,954650,True,2,1,17,16
168271,2019-11-14 00:00:00+03:00,out,False,944766,False,6,154,243,89
168271,2019-11-14 00:00:00+03:00,out,False,954650,True,14,0,357,357
168271,2019-11-14 00:00:00+03:00,out,False,944766,True,8,0,230,230
168271,2019-11-14 00:00:00+03:00,in,False,-1,True,15,0,268,268
168271,2019-11-14 00:00:00+03:00,in,False,944766,False,11,1168,1297,129
168271,2019-11-14 00:00:00+03:00,out,False,944764,False,2,42,58,16
168271,2019-11-14 00:00:00+03:00,out,False,954650,False,25,1079,1416,337
168271,2019-11-14 00:00:00+03:00,in,False,-1,True,15,0,268,268
168271,2019-11-15 00:00:00+03:00,in,False,-1,True,32,0,455,455
168271,2019-11-15 00:00:00+03:00,out,False,944766,False,11,370,546,176
168271,2019-11-15 00:00:00+03:00,out,False,944764,False,1,25,32,7
168271,2019-11-15 00:00:00+03:00,out,False,944766,True,2,0,97,97
168271,2019-11-15 00:00:00+03:00,in,False,944766,False,17,1554,1705,151
168271,2019-11-15 00:00:00+03:00,out,False,954650,False,9,412,528,116
168271,2019-11-15 00:00:00+03:00,in,False,954650,False,39,4261,4631,370
168271,2019-11-15 00:00:00+03:00,in,False,944764,False,3,127,161,34
168271,2019-11-16 00:00:00+03:00,in,False,954650,False,9,1041,1124,83
168271,2019-11-16 00:00:00+03:00,out,False,954650,False,40,1411,2155,744
168271,2019-11-16 00:00:00+03:00,in,False,-1,True,15,0,325,325
168271,2019-11-16 00:00:00+03:00,out,False,954650,True,14,0,333,333
168271,2019-11-16 00:00:00+03:00,in,False,944766,False,16,1793,1965,172
168271,2019-11-17 00:00:00+03:00,in,False,-1,True,10,0,206,206
168271,2019-11-18 00:00:00+03:00,in,False,954650,False,48,5450,5970,520
168271,2019-11-18 00:00:00+03:00,out,False,944766,False,5,112,183,71
168271,2019-11-18 00:00:00+03:00,in,False,944764,False,1,16,23,7
168271,2019-11-18 00:00:00+03:00,out,False,944766,True,2,0,19,19
168271,2019-11-18 00:00:00+03:00,out,False,954650,False,58,2394,3362,968
168271,2019-11-18 00:00:00+03:00,in,False,-1,True,22,0,472,472
168271,2019-11-18 00:00:00+03:00,in,False,944766,False,21,1500,1728,228
168271,2019-11-18 00:00:00+03:00,out,False,954650,True,12,0,326,326
168271,2019-11-19 00:00:00+03:00,in,False,944766,False,1,43,59,16
168271,2019-11-19 00:00:00+03:00,in,False,944764,False,9,972,1027,55
168271,2019-11-19 00:00:00+03:00,out,False,954650,False,24,759,1139,380
168271,2019-11-19 00:00:00+03:00,in,False,954650,False,48,3765,4243,478
168271,2019-11-19 00:00:00+03:00,in,False,-1,True,24,0,541,541
168271,2019-11-19 00:00:00+03:00,out,False,954650,True,12,0,262,262
168271,2019-11-19 00:00:00+03:00,out,False,944764,True,2,0,18,18
168271,2019-11-19 00:00:00+03:00,out,False,944764,False,2,101,123,22
168271,2019-11-19 00:00:00+03:00,in,False,-1,True,24,0,541,541
168271,2019-11-19 00:00:00+03:00,out,False,954650,True,12,0,262,262
168271,2019-11-20 00:00:00+03:00,in,False,954650,False,9,994,1083,89
168271,2019-11-20 00:00:00+03:00,out,False,944764,True,4,0,165,165
168271,2019-11-20 00:00:00+03:00,in,False,944764,False,42,4756,5019,263
168271,2019-11-20 00:00:00+03:00,out,False,944764,False,15,398,573,175
168271,2019-11-20 00:00:00+03:00,in,False,944764,True,1,0,5,5
168271,2019-11-20 00:00:00+03:00,out,False,954650,True,12,0,328,328
168271,2019-11-20 00:00:00+03:00,out,False,954650,False,41,1537,2205,668
168271,2019-11-20 00:00:00+03:00,in,False,-1,True,7,0,87,87
168271,2019-11-21 00:00:00+03:00,in,False,-1,True,7,0,189,189
168271,2019-11-21 00:00:00+03:00,in,False,954650,False,11,1364,1469,105
168271,2019-11-21 00:00:00+03:00,out,False,954650,True,14,0,580,580
168271,2019-11-21 00:00:00+03:00,in,False,944764,False,38,5277,5528,251
168271,2019-11-21 00:00:00+03:00,out,False,944764,False,23,997,1400,403
168271,2019-11-21 00:00:00+03:00,out,False,944764,True,9,0,338,338
168271,2019-11-21 00:00:00+03:00,out,False,954650,False,20,707,1076,369
168271,2019-11-21 00:00:00+03:00,out,False,954650,True,14,0,580,580
168271,2019-11-22 00:00:00+03:00,in,False,-1,True,4,0,48,48
168271,2019-11-22 00:00:00+03:00,in,False,954650,False,5,275,329,54
168271,2019-11-22 00:00:00+03:00,out,False,954650,True,15,0,368,368
168271,2019-11-22 00:00:00+03:00,in,False,944764,False,36,2512,2773,261
168271,2019-11-22 00:00:00+03:00,out,False,954650,False,17,582,840,258
168271,2019-11-22 00:00:00+03:00,out,False,944764,True,9,0,326,326
168271,2019-11-22 00:00:00+03:00,out,False,944764,False,19,514,750,236
168271,2019-11-23 00:00:00+03:00,in,False,954650,False,1,17,37,20
168271,2019-11-23 00:00:00+03:00,in,False,-1,True,11,0,168,168
168271,2019-11-23 00:00:00+03:00,out,False,944764,False,2,41,68,27
168271,2019-11-23 00:00:00+03:00,out,False,954650,True,29,0,549,549
168271,2019-11-23 00:00:00+03:00,out,False,944764,True,2,0,37,37
168271,2019-11-23 00:00:00+03:00,out,False,954650,False,34,871,1364,493
168271,2019-11-23 00:00:00+03:00,in,False,944764,False,25,1705,1851,146
168271,2019-11-24 00:00:00+03:00,in,False,-1,True,12,0,293,293
168271,2019-11-25 00:00:00+03:00,in,False,954650,False,18,1898,2115,217
168271,2019-11-25 00:00:00+03:00,out,False,944764,True,25,0,559,559
168271,2019-11-25 00:00:00+03:00,in,False,944764,True,1,0,5,5
168271,2019-11-25 00:00:00+03:00,out,False,944764,False,39,2282,2946,664
168271,2019-11-25 00:00:00+03:00,out,False,954650,False,20,815,1126,311
168271,2019-11-25 00:00:00+03:00,out,False,954650,True,2,0,71,71
168271,2019-11-25 00:00:00+03:00,in,False,-1,True,23,0,404,404
168271,2019-11-25 00:00:00+03:00,in,False,944764,False,55,5199,5591,392
168271,2019-11-26 00:00:00+03:00,out,False,954650,False,19,540,836,296
168271,2019-11-26 00:00:00+03:00,out,False,944764,True,1,0,29,29
168271,2019-11-26 00:00:00+03:00,out,False,944764,False,8,458,589,131
168271,2019-11-26 00:00:00+03:00,in,False,-1,True,10,0,157,157
168271,2019-11-26 00:00:00+03:00,out,False,954650,True,10,0,267,267
168271,2019-11-26 00:00:00+03:00,in,False,954650,False,7,348,432,84
168271,2019-11-26 00:00:00+03:00,in,False,944764,False,48,4761,5102,341
168271,2019-11-26 00:00:00+03:00,out,False,954650,False,19,540,836,296
168271,2019-11-27 00:00:00+03:00,out,False,944764,False,31,1193,1709,516
168271,2019-11-27 00:00:00+03:00,out,False,954650,False,36,1662,2305,643
168271,2019-11-27 00:00:00+03:00,in,False,-1,True,9,0,245,245
168271,2019-11-27 00:00:00+03:00,in,False,944764,False,37,3553,3776,223
168271,2019-11-27 00:00:00+03:00,out,False,954650,True,7,0,333,333
168271,2019-11-27 00:00:00+03:00,in,False,954650,False,8,546,598,52
168271,2019-11-27 00:00:00+03:00,out,False,944764,True,20,0,403,403
168271,2019-11-27 00:00:00+03:00,in,False,-1,True,9,0,245,245
168271,2019-11-27 00:00:00+03:00,out,False,944764,False,31,1193,1709,516
168271,2019-11-27 00:00:00+03:00,out,False,954650,True,7,0,333,333
168271,2019-11-27 00:00:00+03:00,out,False,954650,False,36,1662,2305,643
168271,2019-11-28 00:00:00+03:00,in,False,944764,False,38,3811,4058,247
168271,2019-11-28 00:00:00+03:00,out,False,954650,True,23,0,579,579
168271,2019-11-28 00:00:00+03:00,in,False,-1,True,6,0,158,158
168271,2019-11-28 00:00:00+03:00,out,False,944764,True,13,0,252,252
168271,2019-11-28 00:00:00+03:00,out,False,954650,False,32,1156,1697,541
168271,2019-11-28 00:00:00+03:00,out,False,944764,False,23,851,1256,405
168271,2019-11-28 00:00:00+03:00,in,False,954650,False,8,528,601,73
168271,2019-11-28 00:00:00+03:00,out,False,954650,True,23,0,579,579
168275,2019-10-19 00:00:00+03:00,in,False,-1,True,4,0,0,0
168275,2019-10-20 00:00:00+03:00,in,False,-1,True,2,0,79,79
168275,2019-10-21 00:00:00+03:00,in,False,-1,True,4,0,102,102
168275,2019-10-29 00:00:00+03:00,in,False,-1,True,4,0,226,226
168275,2019-10-31 00:00:00+03:00,in,False,-1,True,3,0,43,43
168275,2019-11-01 00:00:00+03:00,in,False,-1,True,6,0,2,2
168275,2019-11-01 00:00:00+03:00,in,False,-1,True,6,0,2,2
168275,2019-11-03 00:00:00+03:00,in,False,-1,True,3,0,55,55
168275,2019-11-05 00:00:00+03:00,in,False,940952,False,5,54,58,4
168275,2019-11-05 00:00:00+03:00,in,False,-1,True,2,0,32,32
168275,2019-11-06 00:00:00+03:00,in,False,-1,True,20,0,311,311
168275,2019-11-06 00:00:00+03:00,out,False,940952,False,1,8,19,11
168275,2019-11-06 00:00:00+03:00,out,False,940952,True,2,0,65,65
168275,2019-11-06 00:00:00+03:00,in,False,940952,False,15,119,142,23
168275,2019-11-07 00:00:00+03:00,in,False,-1,True,1,0,16,16
168275,2019-11-07 00:00:00+03:00,in,False,940952,False,1,2,7,5
168275,2019-11-08 00:00:00+03:00,out,False,940952,True,1,0,30,30
168275,2019-11-11 00:00:00+03:00,in,False,-1,True,3,0,47,47
168275,2019-11-11 00:00:00+03:00,out,False,940952,True,3,0,30,30
168275,2019-11-11 00:00:00+03:00,out,False,940952,False,1,7,15,8
168275,2019-11-11 00:00:00+03:00,in,False,940952,False,2,20,32,12
168275,2019-11-11 00:00:00+03:00,in,False,-1,True,3,0,47,47
168275,2019-11-13 00:00:00+03:00,out,False,940952,True,13,0,201,201
168275,2019-11-13 00:00:00+03:00,in,False,940952,False,10,80,213,133
168275,2019-11-13 00:00:00+03:00,out,False,940952,False,2,10,21,11
168275,2019-11-13 00:00:00+03:00,in,False,-1,True,12,0,145,145
168275,2019-11-13 00:00:00+03:00,in,False,940952,False,10,80,213,133
168275,2019-11-14 00:00:00+03:00,in,False,-1,True,4,0,57,57
168275,2019-11-14 00:00:00+03:00,in,False,940952,False,2,13,69,56
168275,2019-11-15 00:00:00+03:00,in,False,940952,False,13,72,215,143
168275,2019-11-15 00:00:00+03:00,in,False,-1,True,52,0,536,536
168275,2019-11-15 00:00:00+03:00,out,False,940952,True,23,0,161,161
168275,2019-11-15 00:00:00+03:00,out,False,940952,False,10,72,145,73
168275,2019-11-15 00:00:00+03:00,in,False,940952,False,13,72,215,143
168275,2019-11-16 00:00:00+03:00,out,False,940952,True,16,0,263,263
168275,2019-11-16 00:00:00+03:00,out,False,940952,False,9,92,204,112
168275,2019-11-16 00:00:00+03:00,in,False,-1,True,56,0,605,605
168275,2019-11-16 00:00:00+03:00,in,False,940952,False,25,180,469,289
168275,2019-11-17 00:00:00+03:00,in,False,940952,False,18,124,412,288
168275,2019-11-17 00:00:00+03:00,out,False,940952,True,3,0,14,14
168275,2019-11-17 00:00:00+03:00,in,False,-1,True,80,0,681,681
168275,2019-11-18 00:00:00+03:00,out,False,940952,True,1,0,10,10
168275,2019-11-18 00:00:00+03:00,in,False,-1,True,3,0,16,16
168275,2019-11-19 00:00:00+03:00,out,False,940952,True,1,0,8,8
168275,2019-11-22 00:00:00+03:00,in,False,940952,False,1,9,11,2
168275,2019-11-22 00:00:00+03:00,in,False,-1,True,3,0,26,26
168275,2019-11-23 00:00:00+03:00,out,False,940952,True,2,0,7,7
168275,2019-11-23 00:00:00+03:00,in,False,940952,False,5,42,152,110
168275,2019-11-23 00:00:00+03:00,in,False,-1,True,11,0,148,148
168275,2019-11-24 00:00:00+03:00,in,False,-1,True,54,0,598,598
168275,2019-11-24 00:00:00+03:00,in,False,940952,False,15,196,450,254
168275,2019-11-24 00:00:00+03:00,out,False,940952,True,11,0,140,140
168275,2019-11-25 00:00:00+03:00,in,False,940952,False,29,295,790,495
168275,2019-11-25 00:00:00+03:00,out,False,940952,True,8,0,194,194
168275,2019-11-25 00:00:00+03:00,out,False,940952,False,2,41,56,15
168275,2019-11-25 00:00:00+03:00,in,False,-1,True,59,0,663,663
168275,2019-11-26 00:00:00+03:00,in,False,-1,True,12,0,148,148
168275,2019-11-26 00:00:00+03:00,out,False,940952,False,1,19,26,7
168275,2019-11-28 00:00:00+03:00,in,False,-1,True,1,0,13,13
168291,2019-11-18 00:00:00+03:00,in,False,-1,True,1,0,2,2
168291,2019-11-18 00:00:00+03:00,in,False,-1,True,1,0,2,2
168291,2019-11-22 00:00:00+03:00,out,False,946454,True,8,0,0,0
168291,2019-11-28 00:00:00+03:00,in,False,-1,True,5,0,92,92
168291,2019-11-28 00:00:00+03:00,out,False,946454,True,5,0,0,0
168291,2019-11-28 00:00:00+03:00,out,False,-1,True,3,0,93,93
168295,2019-10-22 00:00:00+03:00,in,False,-1,True,3,0,6,6
168295,2019-10-24 00:00:00+03:00,in,False,-1,True,3,0,6,6
168295,2019-10-25 00:00:00+03:00,in,False,-1,True,6,0,13,13
168295,2019-10-28 00:00:00+03:00,in,False,-1,True,7,0,15,15
168295,2019-10-29 00:00:00+03:00,in,False,-1,True,8,0,16,16
168295,2019-11-13 00:00:00+03:00,in,False,960620,False,1,21,31,10
168295,2019-11-13 00:00:00+03:00,out,False,960620,False,1,14,33,19
168295,2019-11-13 00:00:00+03:00,in,False,-1,True,7,0,60,60
168295,2019-11-13 00:00:00+03:00,out,False,960648,True,1,0,0,0
168295,2019-11-13 00:00:00+03:00,out,False,960620,True,1,0,4,4
168295,2019-11-13 00:00:00+03:00,out,False,960620,False,1,14,33,19
168295,2019-11-15 00:00:00+03:00,in,False,-1,True,2,0,0,0
168295,2019-11-15 00:00:00+03:00,in,False,-1,True,2,0,0,0
168295,2019-11-18 00:00:00+03:00,out,False,960648,True,1,0,31,31
168295,2019-11-18 00:00:00+03:00,in,False,960620,False,2,54,83,29
168295,2019-11-18 00:00:00+03:00,out,False,960620,False,5,393,451,58
168295,2019-11-18 00:00:00+03:00,in,False,960648,False,1,24,32,8
168295,2019-11-18 00:00:00+03:00,out,False,960648,False,4,454,524,70
168295,2019-11-18 00:00:00+03:00,out,False,960620,False,5,393,451,58
168295,2019-11-19 00:00:00+03:00,out,False,960620,False,2,76,104,28
168295,2019-11-19 00:00:00+03:00,out,False,960648,False,2,191,228,37
168295,2019-11-19 00:00:00+03:00,in,False,-1,True,1,0,30,30
168295,2019-11-19 00:00:00+03:00,out,False,960620,True,3,0,23,23
168295,2019-11-19 00:00:00+03:00,in,False,960648,False,8,792,928,136
168295,2019-11-19 00:00:00+03:00,out,False,960648,True,1,0,14,14
168295,2019-11-19 00:00:00+03:00,in,False,960620,False,2,194,228,34
168295,2019-11-20 00:00:00+03:00,out,False,960648,False,3,883,914,31
168295,2019-11-20 00:00:00+03:00,in,False,960620,False,7,624,745,121
168295,2019-11-20 00:00:00+03:00,out,False,960620,False,3,521,566,45
168295,2019-11-20 00:00:00+03:00,in,False,-1,True,3,0,90,90
168295,2019-11-20 00:00:00+03:00,out,False,960620,True,2,0,75,75
168295,2019-11-20 00:00:00+03:00,in,False,960648,False,3,660,709,49
168295,2019-11-21 00:00:00+03:00,out,False,960620,False,5,293,365,72
168295,2019-11-21 00:00:00+03:00,out,True,960648,True,1,0,0,0
168295,2019-11-21 00:00:00+03:00,in,False,-1,True,4,0,104,104
168295,2019-11-21 00:00:00+03:00,out,False,960620,True,3,0,62,62
168295,2019-11-21 00:00:00+03:00,out,False,960648,False,8,2280,2381,101
168295,2019-11-21 00:00:00+03:00,in,False,960648,False,6,151,332,181
168295,2019-11-21 00:00:00+03:00,out,False,960648,True,4,0,63,63
168295,2019-11-21 00:00:00+03:00,in,False,960620,False,10,516,640,124
168295,2019-11-21 00:00:00+03:00,in,False,960620,False,10,516,640,124
168295,2019-11-22 00:00:00+03:00,in,False,960620,False,13,1209,1367,158
168295,2019-11-22 00:00:00+03:00,in,False,-1,True,6,0,200,200
168295,2019-11-22 00:00:00+03:00,out,False,960620,True,8,0,286,286
168295,2019-11-22 00:00:00+03:00,out,False,960620,False,3,279,324,45
168295,2019-11-22 00:00:00+03:00,in,False,960648,False,1,23,41,18
168295,2019-11-22 00:00:00+03:00,in,False,960620,False,13,1209,1367,158
168295,2019-11-25 00:00:00+03:00,in,False,-1,True,4,0,16,16
168295,2019-11-25 00:00:00+03:00,out,False,960648,False,7,1924,2032,108
168295,2019-11-25 00:00:00+03:00,in,False,960648,False,4,657,700,43
168295,2019-11-25 00:00:00+03:00,out,False,960620,True,3,0,79,79
168295,2019-11-25 00:00:00+03:00,out,False,960620,False,2,193,220,27
168295,2019-11-25 00:00:00+03:00,in,False,960620,False,6,1180,1264,84
168295,2019-11-25 00:00:00+03:00,out,False,960648,True,4,0,178,178
168295,2019-11-26 00:00:00+03:00,out,False,960620,True,1,0,13,13
168295,2019-11-26 00:00:00+03:00,out,False,960648,True,10,0,114,114
168295,2019-11-26 00:00:00+03:00,out,False,960620,False,1,78,85,7
168295,2019-11-26 00:00:00+03:00,in,False,960648,False,7,1353,1456,103
168295,2019-11-26 00:00:00+03:00,out,False,960648,False,13,1092,1408,316
168295,2019-11-26 00:00:00+03:00,in,False,-1,True,19,0,224,224
168295,2019-11-27 00:00:00+03:00,out,False,960620,False,9,815,934,119
168295,2019-11-27 00:00:00+03:00,out,False,960648,True,1,0,46,46
168295,2019-11-27 00:00:00+03:00,in,False,-1,True,37,0,294,294
168295,2019-11-27 00:00:00+03:00,out,False,960620,True,3,0,65,65
168295,2019-11-27 00:00:00+03:00,out,False,960648,False,4,823,886,63
168295,2019-11-27 00:00:00+03:00,in,False,960620,False,6,554,657,103
168295,2019-11-27 00:00:00+03:00,in,False,960620,False,6,554,657,103
168295,2019-11-28 00:00:00+03:00,out,False,960648,False,8,1247,1401,154
168295,2019-11-28 00:00:00+03:00,in,False,960648,False,3,207,248,41
168295,2019-11-28 00:00:00+03:00,out,False,960648,True,7,0,211,211
168295,2019-11-28 00:00:00+03:00,in,False,960620,True,1,0,14,14
168295,2019-11-28 00:00:00+03:00,out,False,960620,False,3,95,120,25
168295,2019-11-28 00:00:00+03:00,in,False,-1,True,6,0,136,136
168295,2019-11-28 00:00:00+03:00,in,False,960620,False,2,182,253,71
168303,2019-10-29 00:00:00+03:00,in,False,-1,True,1,0,11,11
168303,2019-10-29 00:00:00+03:00,in,False,949252,False,1,18,30,12
168303,2019-11-03 00:00:00+03:00,in,False,-1,True,1,0,10,10
168303,2019-11-25 00:00:00+03:00,in,False,949252,False,2,282,310,28
168307,2019-10-23 00:00:00+03:00,in,False,-1,True,1,0,2,2
168307,2019-10-23 00:00:00+03:00,in,False,-1,True,2,0,4,4
168307,2019-10-23 00:00:00+03:00,in,False,945046,False,2,46,110,64
168307,2019-10-23 00:00:00+03:00,in,True,945052,False,1,7,27,20
168307,2019-10-23 00:00:00+03:00,in,False,945058,False,1,13,33,20
168307,2019-10-24 00:00:00+03:00,in,False,945046,False,3,90,145,55
168307,2019-10-24 00:00:00+03:00,in,False,-1,True,2,0,31,31
168307,2019-10-24 00:00:00+03:00,in,False,945058,False,3,32,87,55
168307,2019-10-25 00:00:00+03:00,in,False,945052,False,4,544,610,66
168307,2019-10-25 00:00:00+03:00,in,False,-1,True,6,0,174,174
168307,2019-10-25 00:00:00+03:00,in,False,945046,False,6,650,742,92
168307,2019-10-26 00:00:00+03:00,in,False,945046,False,4,299,382,83
168307,2019-10-26 00:00:00+03:00,in,False,945052,False,3,314,357,43
168307,2019-10-26 00:00:00+03:00,in,False,-1,True,12,0,358,358
168307,2019-10-27 00:00:00+03:00,in,False,-1,True,9,0,350,350
168307,2019-10-28 00:00:00+03:00,in,True,945046,False,1,5,15,10
168307,2019-10-28 00:00:00+03:00,in,False,945046,True,1,0,40,40
168307,2019-10-28 00:00:00+03:00,out,False,945052,True,1,0,9,9
168307,2019-10-28 00:00:00+03:00,in,False,945052,False,10,1252,1409,157
168307,2019-10-28 00:00:00+03:00,out,False,945058,True,1,0,10,10
168307,2019-10-28 00:00:00+03:00,in,False,-1,True,15,0,377,377
168307,2019-10-28 00:00:00+03:00,in,False,-1,True,1,0,35,35
168307,2019-10-28 00:00:00+03:00,in,False,945046,False,8,424,614,190
168307,2019-10-29 00:00:00+03:00,out,False,945052,True,4,0,63,63
168307,2019-10-29 00:00:00+03:00,in,False,945052,False,15,1686,1875,189
168307,2019-10-29 00:00:00+03:00,in,False,-1,True,12,0,246,246
168307,2019-10-29 00:00:00+03:00,out,False,945052,False,1,11,20,9
168307,2019-10-29 00:00:00+03:00,in,False,945046,True,2,1,83,82
168307,2019-10-29 00:00:00+03:00,in,False,945046,False,12,1550,1825,275
168307,2019-10-29 00:00:00+03:00,in,False,945046,False,12,1550,1825,275
168307,2019-10-29 00:00:00+03:00,out,False,945052,True,4,0,63,63
168307,2019-10-29 00:00:00+03:00,in,False,945052,False,15,1686,1875,189
168307,2019-10-30 00:00:00+03:00,in,False,945046,False,8,1449,1491,42
168307,2019-10-30 00:00:00+03:00,out,False,945052,True,1,0,42,42
168307,2019-10-30 00:00:00+03:00,in,False,945046,True,1,0,3,3
168307,2019-10-30 00:00:00+03:00,out,False,945052,False,1,395,405,10
168307,2019-10-30 00:00:00+03:00,in,False,-1,True,10,0,111,111
168307,2019-10-30 00:00:00+03:00,out,True,945046,True,1,0,0,0
168307,2019-10-30 00:00:00+03:00,out,False,945046,True,3,0,107,107
168307,2019-10-30 00:00:00+03:00,in,False,945052,False,10,1314,1417,103
168307,2019-10-30 00:00:00+03:00,out,False,945046,False,7,415,537,122
168307,2019-10-30 00:00:00+03:00,out,True,945052,True,1,0,0,0
168307,2019-10-30 00:00:00+03:00,in,False,945052,True,2,56,70,14
168307,2019-10-30 00:00:00+03:00,in,False,945046,True,1,0,3,3
168307,2019-10-30 00:00:00+03:00,out,False,945052,False,1,395,405,10
168307,2019-10-31 00:00:00+03:00,out,False,945052,False,1,209,218,9
168307,2019-10-31 00:00:00+03:00,in,False,945046,False,11,1317,1443,126
168307,2019-10-31 00:00:00+03:00,in,False,945052,False,12,1768,1909,141
168307,2019-10-31 00:00:00+03:00,out,True,945052,True,2,0,0,0
168307,2019-10-31 00:00:00+03:00,out,False,945046,False,6,648,741,93
168307,2019-10-31 00:00:00+03:00,out,False,945052,True,3,0,5,5
168307,2019-10-31 00:00:00+03:00,out,False,945046,True,8,0,133,133
168307,2019-10-31 00:00:00+03:00,in,False,-1,True,3,0,121,121
168307,2019-10-31 00:00:00+03:00,in,False,-1,True,3,0,121,121
168307,2019-11-01 00:00:00+03:00,out,True,945052,True,1,0,0,0
168307,2019-11-01 00:00:00+03:00,in,False,-1,True,11,0,24,24
168307,2019-11-01 00:00:00+03:00,out,True,945046,True,1,0,0,0
168307,2019-11-01 00:00:00+03:00,in,False,945052,False,2,589,602,13
168307,2019-11-01 00:00:00+03:00,out,False,945046,False,3,71,111,40
168307,2019-11-01 00:00:00+03:00,out,False,945046,False,3,71,111,40
168307,2019-11-01 00:00:00+03:00,out,True,945052,True,1,0,0,0
168307,2019-11-02 00:00:00+03:00,in,False,-1,True,3,0,2,2
168307,2019-11-04 00:00:00+03:00,in,False,-1,True,4,0,1,1
168307,2019-11-04 00:00:00+03:00,in,False,-1,True,4,0,1,1
168307,2019-11-05 00:00:00+03:00,in,False,-1,True,2,0,1,1
168307,2019-11-06 00:00:00+03:00,in,False,-1,True,5,0,4,4
168307,2019-11-07 00:00:00+03:00,in,False,-1,True,2,0,1,1
168307,2019-11-08 00:00:00+03:00,in,False,-1,True,14,0,12,12
168307,2019-11-11 00:00:00+03:00,in,False,-1,True,8,0,7,7
168307,2019-11-12 00:00:00+03:00,in,False,-1,True,2,0,0,0
168307,2019-11-14 00:00:00+03:00,in,False,-1,True,5,0,3,3
168307,2019-11-15 00:00:00+03:00,in,False,-1,True,6,0,5,5
168307,2019-11-18 00:00:00+03:00,in,False,-1,True,3,0,3,3
168307,2019-11-20 00:00:00+03:00,in,False,-1,True,2,0,3,3
168307,2019-11-21 00:00:00+03:00,in,False,-1,True,4,0,2,2
168307,2019-11-22 00:00:00+03:00,in,False,-1,True,2,0,1,1
168307,2019-11-24 00:00:00+03:00,in,False,-1,True,2,0,1,1
168307,2019-11-25 00:00:00+03:00,in,False,-1,True,21,0,23,23
168307,2019-11-26 00:00:00+03:00,in,False,-1,True,1,0,2,2
168307,2019-11-27 00:00:00+03:00,in,False,-1,True,1,0,2,2
168307,2019-11-28 00:00:00+03:00,in,False,-1,True,6,0,12,12
168315,2019-10-31 00:00:00+03:00,in,False,-1,True,1,0,3,3
168315,2019-11-01 00:00:00+03:00,in,False,952734,False,8,329,337,8
168315,2019-11-01 00:00:00+03:00,in,False,-1,True,5,0,12,12
168315,2019-11-03 00:00:00+03:00,in,False,952734,False,2,69,70,1
168315,2019-11-04 00:00:00+03:00,in,False,952734,False,1,16,17,1
168315,2019-11-05 00:00:00+03:00,in,False,952734,False,17,4771,4791,20
168315,2019-11-06 00:00:00+03:00,in,False,952734,False,63,20223,20289,66
168315,2019-11-07 00:00:00+03:00,in,False,952734,False,35,9613,9651,38
168315,2019-11-08 00:00:00+03:00,in,False,952734,False,25,8970,8998,28
168315,2019-11-11 00:00:00+03:00,in,False,952734,False,55,14110,14167,57
168315,2019-11-11 00:00:00+03:00,in,False,-1,True,1,0,0,0
168315,2019-11-12 00:00:00+03:00,in,False,952734,False,35,8898,8954,56
168315,2019-11-13 00:00:00+03:00,in,False,952734,False,62,19747,19810,63
168315,2019-11-14 00:00:00+03:00,in,False,952734,False,35,9174,9209,35
168315,2019-11-15 00:00:00+03:00,in,False,952734,False,43,12405,12452,47
168315,2019-11-15 00:00:00+03:00,in,False,952734,False,43,12405,12452,47
168315,2019-11-16 00:00:00+03:00,in,False,952734,False,1,16,17,1
168315,2019-11-18 00:00:00+03:00,in,False,952734,False,12,1314,1329,15
168315,2019-11-19 00:00:00+03:00,in,False,952734,False,7,1588,1595,7
168315,2019-11-20 00:00:00+03:00,in,False,952734,False,5,656,662,6
168315,2019-11-21 00:00:00+03:00,in,False,952734,False,1,155,156,1
168315,2019-11-22 00:00:00+03:00,in,False,952734,False,1,87,88,1
168315,2019-11-27 00:00:00+03:00,in,False,952734,False,1,121,122,1
168329,2019-10-31 00:00:00+03:00,in,False,-1,True,4,0,8,8
168329,2019-11-01 00:00:00+03:00,in,False,-1,True,2,0,4,4
168329,2019-11-05 00:00:00+03:00,in,False,-1,True,1,0,2,2
168329,2019-11-07 00:00:00+03:00,in,False,-1,True,1,0,2,2
168329,2019-11-08 00:00:00+03:00,in,False,-1,True,1,0,2,2
168336,2019-10-25 00:00:00+03:00,in,False,947304,False,2,43,52,9
168336,2019-10-25 00:00:00+03:00,out,True,947304,False,1,219,232,13
168336,2019-10-25 00:00:00+03:00,in,False,-1,True,1,0,6,6
168336,2019-10-25 00:00:00+03:00,out,False,947304,True,1,0,11,11
168336,2019-10-25 00:00:00+03:00,in,False,947306,False,1,21,31,10
168336,2019-10-25 00:00:00+03:00,in,False,947306,False,1,21,31,10
168336,2019-10-25 00:00:00+03:00,out,False,947304,True,1,0,11,11
168336,2019-10-25 00:00:00+03:00,in,False,947304,False,2,43,52,9
168336,2019-10-28 00:00:00+03:00,out,False,947304,False,16,1114,1205,91
168336,2019-10-28 00:00:00+03:00,out,False,947304,True,10,0,146,146
168336,2019-10-28 00:00:00+03:00,in,False,947304,False,1,868,875,7
168336,2019-10-28 00:00:00+03:00,out,False,947304,False,16,1114,1205,91
168336,2019-10-29 00:00:00+03:00,out,False,947304,False,5,369,406,37
168336,2019-10-29 00:00:00+03:00,out,True,947304,True,2,0,0,0
168336,2019-10-29 00:00:00+03:00,out,False,947304,True,10,0,107,107
168336,2019-10-30 00:00:00+03:00,out,False,948758,True,7,0,78,78
168336,2019-10-30 00:00:00+03:00,out,False,948758,False,12,1226,1356,130
168336,2019-10-30 00:00:00+03:00,out,False,947304,True,6,0,48,48
168336,2019-10-30 00:00:00+03:00,out,True,948756,True,5,0,8,8
168336,2019-10-30 00:00:00+03:00,in,False,-1,True,2,0,79,79
168336,2019-10-30 00:00:00+03:00,out,False,948756,False,9,894,954,60
168336,2019-10-30 00:00:00+03:00,in,False,948756,True,1,50,58,8
168336,2019-10-30 00:00:00+03:00,out,False,947304,False,7,1075,1109,34
168336,2019-10-30 00:00:00+03:00,out,False,948756,True,11,0,191,191
168336,2019-10-30 00:00:00+03:00,out,True,948758,True,3,0,7,7
168336,2019-10-30 00:00:00+03:00,out,True,947304,True,1,0,0,0
168336,2019-10-30 00:00:00+03:00,in,False,947304,False,1,128,135,7
168336,2019-10-30 00:00:00+03:00,in,False,-1,True,2,0,79,79
168336,2019-10-31 00:00:00+03:00,in,False,948758,False,1,666,670,4
168336,2019-10-31 00:00:00+03:00,out,False,948756,True,1,0,2,2
168336,2019-10-31 00:00:00+03:00,out,False,947304,True,20,0,539,539
168336,2019-10-31 00:00:00+03:00,out,False,948758,True,18,0,330,330
168336,2019-10-31 00:00:00+03:00,out,False,948756,False,2,118,123,5
168336,2019-10-31 00:00:00+03:00,out,True,947304,True,4,0,9,9
168336,2019-10-31 00:00:00+03:00,out,True,948758,True,1,0,0,0
168336,2019-10-31 00:00:00+03:00,out,False,947304,False,31,3196,3534,338
168336,2019-10-31 00:00:00+03:00,out,False,948758,False,24,3085,3291,206
168336,2019-10-31 00:00:00+03:00,in,False,947304,False,3,385,408,23
168336,2019-10-31 00:00:00+03:00,out,False,947304,True,20,0,539,539
168336,2019-10-31 00:00:00+03:00,out,True,947304,True,4,0,9,9
168336,2019-10-31 00:00:00+03:00,out,False,947304,False,31,3196,3534,338
168336,2019-10-31 00:00:00+03:00,out,False,948756,True,1,0,2,2
168336,2019-11-01 00:00:00+03:00,out,False,948756,True,1,0,10,10
168336,2019-11-01 00:00:00+03:00,in,False,947304,True,1,1,20,19
168336,2019-11-01 00:00:00+03:00,in,False,-1,True,4,0,114,114
168336,2019-11-01 00:00:00+03:00,out,False,948758,True,4,0,67,67
168336,2019-11-01 00:00:00+03:00,out,False,947304,False,20,2538,2691,153
168336,2019-11-01 00:00:00+03:00,in,False,947304,False,2,126,153,27
168336,2019-11-01 00:00:00+03:00,out,False,947304,True,5,0,106,106
168336,2019-11-01 00:00:00+03:00,out,False,948758,False,12,1936,2058,122
168336,2019-11-05 00:00:00+03:00,out,False,948758,False,11,1180,1312,132
168336,2019-11-05 00:00:00+03:00,out,True,947304,True,1,0,0,0
168336,2019-11-05 00:00:00+03:00,out,False,947304,False,38,2543,2855,312
168336,2019-11-05 00:00:00+03:00,in,False,947304,False,2,83,87,4
168336,2019-11-05 00:00:00+03:00,out,False,947304,True,12,0,221,221
168336,2019-11-05 00:00:00+03:00,out,False,948758,True,3,0,112,112
168336,2019-11-05 00:00:00+03:00,in,False,-1,True,1,0,5,5
168336,2019-11-05 00:00:00+03:00,out,False,948756,True,1,0,8,8
168336,2019-11-05 00:00:00+03:00,out,False,948758,False,11,1180,1312,132
168336,2019-11-05 00:00:00+03:00,out,False,947304,False,38,2543,2855,312
168336,2019-11-05 00:00:00+03:00,in,False,947304,False,2,83,87,4
168336,2019-11-06 00:00:00+03:00,out,False,948756,False,30,2485,2713,228
168336,2019-11-06 00:00:00+03:00,out,False,947304,False,7,624,686,62
168336,2019-11-06 00:00:00+03:00,out,False,948756,True,6,0,180,180
168336,2019-11-06 00:00:00+03:00,in,False,947304,False,1,21,23,2
168336,2019-11-06 00:00:00+03:00,out,False,948758,False,13,1536,1646,110
168336,2019-11-06 00:00:00+03:00,out,False,948758,True,1,0,11,11
168336,2019-11-06 00:00:00+03:00,out,True,947304,True,1,0,0,0
168336,2019-11-06 00:00:00+03:00,out,False,947304,True,2,0,90,90
168336,2019-11-06 00:00:00+03:00,out,True,947304,True,1,0,0,0
168336,2019-11-06 00:00:00+03:00,in,False,947304,False,1,21,23,2
168336,2019-11-06 00:00:00+03:00,out,False,947304,True,2,0,90,90
168336,2019-11-07 00:00:00+03:00,out,False,948758,True,6,0,115,115
168336,2019-11-07 00:00:00+03:00,in,False,947304,False,2,948,955,7
168336,2019-11-07 00:00:00+03:00,out,False,948756,False,51,4584,4871,287
168336,2019-11-07 00:00:00+03:00,out,False,947304,False,37,3338,3585,247
168336,2019-11-07 00:00:00+03:00,out,False,947304,True,17,0,331,331
168336,2019-11-07 00:00:00+03:00,in,False,948758,False,1,5,10,5
168336,2019-11-07 00:00:00+03:00,out,False,948758,False,6,1204,1267,63
168336,2019-11-07 00:00:00+03:00,out,False,948756,True,12,0,271,271
168336,2019-11-07 00:00:00+03:00,in,False,-1,True,1,0,3,3
168336,2019-11-07 00:00:00+03:00,out,True,947304,False,1,786,790,4
168336,2019-11-07 00:00:00+03:00,out,False,948758,False,6,1204,1267,63
168336,2019-11-08 00:00:00+03:00,in,False,948758,False,1,804,816,12
168336,2019-11-08 00:00:00+03:00,out,False,948758,True,3,0,53,53
168336,2019-11-08 00:00:00+03:00,in,False,-1,True,4,0,40,40
168336,2019-11-08 00:00:00+03:00,out,False,947304,False,22,2712,2895,183
168336,2019-11-08 00:00:00+03:00,out,False,948758,False,9,1517,1563,46
168336,2019-11-08 00:00:00+03:00,out,False,948756,True,4,0,103,103
168336,2019-11-08 00:00:00+03:00,in,False,947304,False,3,561,578,17
168336,2019-11-08 00:00:00+03:00,out,False,947304,True,8,0,94,94
168336,2019-11-08 00:00:00+03:00,out,False,948756,False,16,1480,1553,73
168336,2019-11-08 00:00:00+03:00,out,False,947304,False,22,2712,2895,183
168336,2019-11-09 00:00:00+03:00,in,False,-1,True,5,0,10,10
168336,2019-11-10 00:00:00+03:00,in,False,-1,True,3,0,6,6
168336,2019-11-11 00:00:00+03:00,out,False,958418,False,9,1572,1638,66
168336,2019-11-11 00:00:00+03:00,out,False,958416,True,2,0,15,15
168336,2019-11-11 00:00:00+03:00,in,False,947304,False,4,1773,1795,22
168336,2019-11-11 00:00:00+03:00,out,False,947304,False,37,3475,3730,255
168336,2019-11-11 00:00:00+03:00,out,False,947304,True,16,0,219,219
168336,2019-11-11 00:00:00+03:00,out,True,947304,True,3,0,5,5
168336,2019-11-11 00:00:00+03:00,out,False,958418,True,3,0,26,26
168336,2019-11-11 00:00:00+03:00,in,False,-1,True,12,0,111,111
168336,2019-11-12 00:00:00+03:00,out,False,947304,False,30,2688,2901,213
168336,2019-11-12 00:00:00+03:00,in,False,947304,False,2,167,183,16
168336,2019-11-12 00:00:00+03:00,out,False,958418,False,34,2237,2414,177
168336,2019-11-12 00:00:00+03:00,out,False,947304,True,16,0,283,283
168336,2019-11-12 00:00:00+03:00,out,False,958418,True,15,0,80,80
168336,2019-11-12 00:00:00+03:00,in,False,947304,True,1,69,72,3
168336,2019-11-12 00:00:00+03:00,out,True,947304,True,1,0,0,0
168336,2019-11-12 00:00:00+03:00,out,False,958418,True,15,0,80,80
168336,2019-11-13 00:00:00+03:00,out,False,947304,False,32,3415,3752,337
168336,2019-11-13 00:00:00+03:00,in,False,-1,True,2,0,9,9
168336,2019-11-13 00:00:00+03:00,out,True,958418,True,2,0,0,0
168336,2019-11-13 00:00:00+03:00,out,False,947304,True,27,0,545,545
168336,2019-11-13 00:00:00+03:00,out,False,958418,True,6,0,109,109
168336,2019-11-13 00:00:00+03:00,out,False,958418,False,32,5408,5650,242
168336,2019-11-13 00:00:00+03:00,in,False,-1,True,2,0,9,9
168336,2019-11-14 00:00:00+03:00,out,False,958418,False,33,2543,2687,144
168336,2019-11-14 00:00:00+03:00,out,False,947304,False,32,3665,3936,271
168336,2019-11-14 00:00:00+03:00,out,False,958418,True,8,0,17,17
168336,2019-11-14 00:00:00+03:00,out,False,947304,True,20,0,416,416
168336,2019-11-14 00:00:00+03:00,in,False,-1,True,1,0,4,4
168336,2019-11-14 00:00:00+03:00,in,False,947304,False,2,255,262,7
168336,2019-11-14 00:00:00+03:00,in,False,-1,False,1,169,174,5
168336,2019-11-14 00:00:00+03:00,in,False,958416,False,1,28,33,5
168336,2019-11-14 00:00:00+03:00,out,False,958416,False,1,98,106,8
168336,2019-11-14 00:00:00+03:00,in,False,947304,False,2,255,262,7
168336,2019-11-15 00:00:00+03:00,in,False,947304,False,3,289,307,18
168336,2019-11-15 00:00:00+03:00,out,False,958416,True,3,0,106,106
168336,2019-11-15 00:00:00+03:00,in,False,-1,True,17,0,2,2
168336,2019-11-15 00:00:00+03:00,out,False,958418,True,5,0,177,177
168336,2019-11-15 00:00:00+03:00,out,False,958418,False,24,1236,1385,149
168336,2019-11-15 00:00:00+03:00,out,False,947304,True,4,0,135,135
168336,2019-11-15 00:00:00+03:00,out,False,947304,False,25,3536,3801,265
168336,2019-11-15 00:00:00+03:00,out,False,958416,False,4,770,805,35
168336,2019-11-15 00:00:00+03:00,out,True,947304,True,2,0,6,6
168336,2019-11-15 00:00:00+03:00,in,False,947304,True,1,46,49,3
168336,2019-11-15 00:00:00+03:00,out,False,947304,True,4,0,135,135
168336,2019-11-15 00:00:00+03:00,in,False,947304,True,1,46,49,3
168336,2019-11-16 00:00:00+03:00,in,False,-1,True,1,0,0,0
168336,2019-11-17 00:00:00+03:00,in,False,-1,True,1,0,1,1
168336,2019-11-18 00:00:00+03:00,in,False,958418,False,3,543,565,22
168336,2019-11-18 00:00:00+03:00,out,False,958416,False,32,4135,4412,277
168336,2019-11-18 00:00:00+03:00,out,False,958418,False,24,2066,2268,202
168336,2019-11-18 00:00:00+03:00,out,True,958416,True,3,0,0,0
168336,2019-11-18 00:00:00+03:00,out,True,948756,True,8,0,20,20
168336,2019-11-18 00:00:00+03:00,out,False,958418,True,14,0,115,115
168336,2019-11-18 00:00:00+03:00,out,True,958418,False,3,81,87,6
168336,2019-11-18 00:00:00+03:00,out,True,947304,False,2,60,66,6
168336,2019-11-18 00:00:00+03:00,out,False,947304,True,11,0,272,272
168336,2019-11-18 00:00:00+03:00,in,False,958416,False,1,21,27,6
168336,2019-11-18 00:00:00+03:00,out,False,958416,True,14,0,381,381
168336,2019-11-18 00:00:00+03:00,out,True,958418,True,2,0,8,8
168336,2019-11-18 00:00:00+03:00,out,False,947304,False,24,4020,4232,212
168336,2019-11-18 00:00:00+03:00,out,True,958416,False,1,29,35,6
168336,2019-11-18 00:00:00+03:00,in,False,947304,False,1,81,84,3
168336,2019-11-18 00:00:00+03:00,out,True,947304,True,3,0,16,16
168336,2019-11-18 00:00:00+03:00,in,False,-1,True,1,0,15,15
168336,2019-11-18 00:00:00+03:00,out,False,948756,False,1,25,28,3
168336,2019-11-18 00:00:00+03:00,out,True,958418,False,3,81,87,6
168336,2019-11-18 00:00:00+03:00,out,False,958416,True,14,0,381,381
168336,2019-11-18 00:00:00+03:00,in,False,958418,False,3,543,565,22
168336,2019-11-18 00:00:00+03:00,in,False,-1,True,1,0,15,15
168336,2019-11-19 00:00:00+03:00,out,True,958418,True,1,0,0,0
168336,2019-11-19 00:00:00+03:00,out,False,958416,False,26,1761,1993,232
168336,2019-11-19 00:00:00+03:00,in,False,947304,False,3,140,154,14
168336,2019-11-19 00:00:00+03:00,out,False,958418,True,13,0,145,145
168336,2019-11-19 00:00:00+03:00,in,False,958416,False,1,7,21,14
168336,2019-11-19 00:00:00+03:00,out,False,958416,True,5,0,78,78
168336,2019-11-19 00:00:00+03:00,out,False,947304,True,22,0,662,662
168336,2019-11-19 00:00:00+03:00,out,True,958418,False,3,143,155,12
168336,2019-11-19 00:00:00+03:00,out,False,958418,False,14,1305,1445,140
168336,2019-11-19 00:00:00+03:00,out,True,947304,False,5,300,310,10
168336,2019-11-19 00:00:00+03:00,in,False,-1,True,2,0,6,6
168336,2019-11-19 00:00:00+03:00,out,True,948756,False,1,6,10,4
168336,2019-11-19 00:00:00+03:00,out,True,948758,True,1,0,2,2
168336,2019-11-19 00:00:00+03:00,out,False,948756,False,2,39,43,4
168336,2019-11-19 00:00:00+03:00,out,True,966158,False,1,10,22,12
168336,2019-11-19 00:00:00+03:00,out,True,966158,True,1,0,4,4
168336,2019-11-19 00:00:00+03:00,in,False,958418,False,2,34,64,30
168336,2019-11-19 00:00:00+03:00,out,True,948756,True,1,0,0,0
168336,2019-11-19 00:00:00+03:00,out,False,947304,False,48,4146,4550,404
168336,2019-11-19 00:00:00+03:00,out,False,958418,True,13,0,145,145
168336,2019-11-19 00:00:00+03:00,out,True,948756,False,1,6,10,4
168336,2019-11-20 00:00:00+03:00,out,False,948758,True,23,0,310,310
168336,2019-11-20 00:00:00+03:00,out,False,958418,True,6,0,103,103
168336,2019-11-20 00:00:00+03:00,out,False,948758,False,49,4534,4998,464
168336,2019-11-20 00:00:00+03:00,in,False,958418,False,3,639,657,18
168336,2019-11-20 00:00:00+03:00,out,False,958416,False,34,5913,6178,265
168336,2019-11-20 00:00:00+03:00,in,False,958416,False,1,2,6,4
168336,2019-11-20 00:00:00+03:00,out,True,967204,False,1,1,4,3
168336,2019-11-20 00:00:00+03:00,in,False,-1,True,1,0,50,50
168336,2019-11-20 00:00:00+03:00,out,False,958416,True,9,0,178,178
168336,2019-11-20 00:00:00+03:00,out,False,958418,False,12,1584,1685,101
168336,2019-11-20 00:00:00+03:00,out,True,958418,False,1,19,22,3
168336,2019-11-20 00:00:00+03:00,out,True,948758,True,2,0,0,0
168336,2019-11-20 00:00:00+03:00,out,True,966158,True,1,0,14,14
168336,2019-11-20 00:00:00+03:00,out,False,958418,True,6,0,103,103
168336,2019-11-20 00:00:00+03:00,out,False,948758,False,49,4534,4998,464
168336,2019-11-21 00:00:00+03:00,out,False,948758,False,26,2508,2781,273
168336,2019-11-21 00:00:00+03:00,out,True,958418,False,1,30,34,4
168336,2019-11-21 00:00:00+03:00,out,False,966158,True,4,0,182,182
168336,2019-11-21 00:00:00+03:00,out,False,958418,True,17,0,339,339
168336,2019-11-21 00:00:00+03:00,in,False,958416,False,2,444,470,26
168336,2019-11-21 00:00:00+03:00,out,True,967204,True,1,0,6,6
168336,2019-11-21 00:00:00+03:00,out,False,948758,True,15,0,318,318
168336,2019-11-21 00:00:00+03:00,in,False,966158,False,1,93,104,11
168336,2019-11-21 00:00:00+03:00,out,False,948756,True,1,0,14,14
168336,2019-11-21 00:00:00+03:00,out,False,958416,True,2,0,19,19
168336,2019-11-21 00:00:00+03:00,in,False,-1,True,5,0,125,125
168336,2019-11-21 00:00:00+03:00,in,False,-1,True,5,0,80,80
168336,2019-11-21 00:00:00+03:00,out,True,948758,False,2,130,135,5
168336,2019-11-21 00:00:00+03:00,out,False,958418,False,25,5884,6141,257
168336,2019-11-21 00:00:00+03:00,in,True,966158,False,1,3,22,19
168336,2019-11-21 00:00:00+03:00,out,False,966158,False,5,1136,1156,20
168336,2019-11-21 00:00:00+03:00,out,False,958416,False,14,2302,2385,83
168336,2019-11-21 00:00:00+03:00,out,False,948758,True,15,0,318,318
168336,2019-11-21 00:00:00+03:00,in,False,-1,True,5,0,125,125
168336,2019-11-22 00:00:00+03:00,out,True,958418,False,1,76,79,3
168336,2019-11-22 00:00:00+03:00,out,True,948758,True,1,0,8,8
168336,2019-11-22 00:00:00+03:00,out,False,948758,True,3,0,31,31
168336,2019-11-22 00:00:00+03:00,out,False,948758,False,17,1425,1573,148
168336,2019-11-22 00:00:00+03:00,out,False,958416,False,18,1755,1943,188
168336,2019-11-22 00:00:00+03:00,out,True,958416,True,1,0,0,0
168336,2019-11-22 00:00:00+03:00,in,False,-1,True,2,0,20,20
168336,2019-11-22 00:00:00+03:00,out,True,966158,False,1,14,17,3
168336,2019-11-22 00:00:00+03:00,out,False,966158,False,5,600,703,103
168336,2019-11-22 00:00:00+03:00,out,True,958418,True,1,0,0,0
168336,2019-11-22 00:00:00+03:00,out,True,948758,False,1,11,14,3
168336,2019-11-22 00:00:00+03:00,in,False,948758,False,1,28,49,21
168336,2019-11-22 00:00:00+03:00,out,False,958416,True,11,0,255,255
168336,2019-11-22 00:00:00+03:00,out,True,969386,True,1,0,19,19
168336,2019-11-22 00:00:00+03:00,out,False,958418,True,14,0,237,237
168336,2019-11-22 00:00:00+03:00,out,True,969262,True,1,0,17,17
168336,2019-11-22 00:00:00+03:00,out,True,969380,True,7,0,46,46
168336,2019-11-22 00:00:00+03:00,out,False,966158,True,1,0,31,31
168336,2019-11-22 00:00:00+03:00,out,False,958418,False,14,598,750,152
168336,2019-11-22 00:00:00+03:00,out,True,958416,True,1,0,0,0
168336,2019-11-22 00:00:00+03:00,out,True,969386,True,1,0,19,19
168336,2019-11-22 00:00:00+03:00,out,True,969380,True,7,0,46,46
168336,2019-11-23 00:00:00+03:00,in,False,-1,True,4,0,261,261
168336,2019-11-24 00:00:00+03:00,in,False,-1,True,3,0,225,225
168336,2019-11-24 00:00:00+03:00,in,False,-1,True,3,0,225,225
168336,2019-11-25 00:00:00+03:00,out,False,958418,False,29,4117,4372,255
168336,2019-11-25 00:00:00+03:00,out,True,966158,False,3,116,125,9
168336,2019-11-25 00:00:00+03:00,out,False,958416,False,34,3081,3345,264
168336,2019-11-25 00:00:00+03:00,out,False,966158,False,1,397,402,5
168336,2019-11-25 00:00:00+03:00,out,True,958416,True,1,0,0,0
168336,2019-11-25 00:00:00+03:00,out,True,969284,True,1,0,4,4
168336,2019-11-25 00:00:00+03:00,out,True,958418,False,3,78,88,10
168336,2019-11-25 00:00:00+03:00,out,True,948758,False,6,307,322,15
168336,2019-11-25 00:00:00+03:00,in,False,-1,True,6,0,51,51
168336,2019-11-25 00:00:00+03:00,out,False,948756,False,2,360,384,24
168336,2019-11-25 00:00:00+03:00,in,False,958416,False,1,72,88,16
168336,2019-11-25 00:00:00+03:00,out,False,948758,False,58,5170,5699,529
168336,2019-11-25 00:00:00+03:00,out,False,969386,False,10,604,705,101
168336,2019-11-25 00:00:00+03:00,out,False,969386,True,13,0,239,239
168336,2019-11-25 00:00:00+03:00,out,False,958418,True,10,0,160,160
168336,2019-11-25 00:00:00+03:00,out,False,958416,True,18,0,368,368
168336,2019-11-25 00:00:00+03:00,in,False,958418,False,1,40,55,15
168336,2019-11-25 00:00:00+03:00,in,False,948758,False,1,109,132,23
168336,2019-11-25 00:00:00+03:00,out,False,948758,True,17,0,426,426
168336,2019-11-25 00:00:00+03:00,in,False,948758,False,1,109,132,23
168336,2019-11-25 00:00:00+03:00,out,False,948758,False,58,5170,5699,529
168336,2019-11-26 00:00:00+03:00,out,True,958416,False,1,9,11,2
168336,2019-11-26 00:00:00+03:00,out,False,969286,False,2,344,363,19
168336,2019-11-26 00:00:00+03:00,out,False,966158,True,3,0,61,61
168336,2019-11-26 00:00:00+03:00,out,False,948758,False,40,4802,5144,342
168336,2019-11-26 00:00:00+03:00,out,True,948756,False,1,0,5,5
168336,2019-11-26 00:00:00+03:00,out,True,958416,True,3,0,0,0
168336,2019-11-26 00:00:00+03:00,out,False,969386,True,8,0,123,123
168336,2019-11-26 00:00:00+03:00,out,False,969386,False,15,587,718,131
168336,2019-11-26 00:00:00+03:00,out,True,948758,False,4,233,241,8
168336,2019-11-26 00:00:00+03:00,out,True,969268,False,2,7,26,19
168336,2019-11-26 00:00:00+03:00,in,False,-1,True,4,0,256,256
168336,2019-11-26 00:00:00+03:00,out,False,958418,False,32,4694,4991,297
168336,2019-11-26 00:00:00+03:00,out,False,948758,True,15,0,280,280
168336,2019-11-26 00:00:00+03:00,out,True,948758,True,2,0,18,18
168336,2019-11-26 00:00:00+03:00,out,True,958418,False,3,58,67,9
168336,2019-11-26 00:00:00+03:00,out,False,966158,False,4,3600,3611,11
168336,2019-11-26 00:00:00+03:00,out,False,958416,True,14,0,176,176
168336,2019-11-26 00:00:00+03:00,out,False,958418,True,9,0,175,175
168336,2019-11-26 00:00:00+03:00,out,False,958416,False,13,1357,1415,58
168336,2019-11-27 00:00:00+03:00,in,False,948758,True,1,0,41,41
168336,2019-11-27 00:00:00+03:00,out,False,958416,True,8,0,180,180
168336,2019-11-27 00:00:00+03:00,out,False,958416,False,21,1994,2120,126
168336,2019-11-27 00:00:00+03:00,out,False,948756,False,3,1671,1680,9
168336,2019-11-27 00:00:00+03:00,out,False,969286,False,2,874,900,26
168336,2019-11-27 00:00:00+03:00,in,False,-1,True,14,0,421,421
168336,2019-11-27 00:00:00+03:00,out,False,958418,True,6,0,54,54
168336,2019-11-27 00:00:00+03:00,out,False,969268,False,3,134,163,29
168336,2019-11-27 00:00:00+03:00,out,True,948756,False,1,2,6,4
168336,2019-11-27 00:00:00+03:00,out,False,966158,False,1,166,170,4
168336,2019-11-27 00:00:00+03:00,out,True,969286,True,2,0,7,7
168336,2019-11-27 00:00:00+03:00,out,False,958418,False,27,2646,2791,145
168336,2019-11-27 00:00:00+03:00,out,True,967204,False,1,14,17,3
168336,2019-11-27 00:00:00+03:00,in,False,958416,True,1,40,65,25
168336,2019-11-27 00:00:00+03:00,in,False,958416,False,3,640,735,95
168336,2019-11-27 00:00:00+03:00,out,False,948758,True,16,0,407,407
168336,2019-11-27 00:00:00+03:00,in,False,948758,False,7,274,538,264
168336,2019-11-27 00:00:00+03:00,out,False,969386,False,1,143,146,3
168336,2019-11-27 00:00:00+03:00,in,False,966158,False,1,169,184,15
168336,2019-11-27 00:00:00+03:00,out,False,948758,False,40,4252,4650,398
168336,2019-11-27 00:00:00+03:00,out,True,948758,True,1,0,0,0
168336,2019-11-27 00:00:00+03:00,out,True,958418,False,1,61,63,2
168336,2019-11-27 00:00:00+03:00,out,False,948756,False,3,1671,1680,9
168336,2019-11-28 00:00:00+03:00,in,False,948758,False,5,408,497,89
168336,2019-11-28 00:00:00+03:00,out,True,958416,True,1,0,0,0
168336,2019-11-28 00:00:00+03:00,out,False,948758,False,35,4722,5047,325
168336,2019-11-28 00:00:00+03:00,out,True,966158,False,3,37,45,8
168336,2019-11-28 00:00:00+03:00,out,False,948758,True,11,0,301,301
168336,2019-11-28 00:00:00+03:00,out,False,969386,False,5,332,398,66
168336,2019-11-28 00:00:00+03:00,out,False,969386,True,1,0,3,3
168336,2019-11-28 00:00:00+03:00,in,False,-1,True,4,0,47,47
168336,2019-11-28 00:00:00+03:00,in,False,958416,False,2,48,95,47
168336,2019-11-28 00:00:00+03:00,out,False,969286,False,1,15,27,12
168336,2019-11-28 00:00:00+03:00,in,False,969380,False,1,100,121,21
168336,2019-11-28 00:00:00+03:00,out,False,969286,True,1,0,49,49
168336,2019-11-28 00:00:00+03:00,out,False,958416,False,1,118,119,1
168336,2019-11-28 00:00:00+03:00,in,False,958416,False,2,48,95,47
168336,2019-11-28 00:00:00+03:00,in,False,-1,True,4,0,47,47
168340,2019-10-24 00:00:00+03:00,in,False,-1,True,1,0,2,2
168340,2019-10-29 00:00:00+03:00,in,False,-1,True,1,0,2,2
168361,2019-10-23 00:00:00+03:00,out,False,945322,False,33,3581,4309,728
168361,2019-10-23 00:00:00+03:00,in,False,-1,True,42,0,207,207
168361,2019-10-23 00:00:00+03:00,out,False,945282,False,16,3198,3553,355
168361,2019-10-23 00:00:00+03:00,out,False,945290,True,12,0,331,331
168361,2019-10-23 00:00:00+03:00,out,False,945302,False,2,52,72,20
168361,2019-10-23 00:00:00+03:00,out,False,945298,True,6,0,231,231
168361,2019-10-23 00:00:00+03:00,out,False,945282,True,5,0,149,149
168361,2019-10-23 00:00:00+03:00,out,False,945074,True,3,0,26,26
168361,2019-10-23 00:00:00+03:00,out,False,945312,True,4,0,152,152
168361,2019-10-23 00:00:00+03:00,out,False,945284,True,15,0,284,284
168361,2019-10-23 00:00:00+03:00,out,False,945298,False,10,1459,1574,115
168361,2019-10-23 00:00:00+03:00,out,False,945278,True,5,0,0,0
168361,2019-10-23 00:00:00+03:00,out,False,945280,True,38,0,339,339
168361,2019-10-23 00:00:00+03:00,out,False,945286,False,15,572,933,361
168361,2019-10-23 00:00:00+03:00,out,False,945316,False,14,1849,2234,385
168361,2019-10-23 00:00:00+03:00,out,False,945284,False,21,1148,1556,408
168361,2019-10-23 00:00:00+03:00,out,False,945312,False,15,2760,3088,328
168361,2019-10-23 00:00:00+03:00,out,False,945322,True,26,0,464,464
168361,2019-10-23 00:00:00+03:00,out,False,945274,False,1,1,15,14
168361,2019-10-23 00:00:00+03:00,out,False,945294,True,66,0,1334,1334
168361,2019-10-23 00:00:00+03:00,out,False,945316,True,25,0,397,397
168361,2019-10-23 00:00:00+03:00,out,False,945286,True,11,0,400,400
168361,2019-10-23 00:00:00+03:00,out,False,945296,True,22,0,205,205
168361,2019-10-23 00:00:00+03:00,out,False,945280,False,8,856,991,135
168361,2019-10-23 00:00:00+03:00,out,False,945290,False,15,470,754,284
168361,2019-10-23 00:00:00+03:00,out,False,945294,False,31,2593,3291,698
168361,2019-10-23 00:00:00+03:00,out,False,945308,True,6,0,10,10
168361,2019-10-23 00:00:00+03:00,out,False,945296,False,18,1726,2028,302
168361,2019-10-23 00:00:00+03:00,out,False,945294,True,66,0,1334,1334
168361,2019-10-23 00:00:00+03:00,out,False,945308,True,6,0,10,10
168361,2019-10-24 00:00:00+03:00,in,False,-1,True,269,0,1367,1367
168361,2019-10-24 00:00:00+03:00,out,False,945314,True,13,0,165,165
168361,2019-10-24 00:00:00+03:00,out,True,945310,False,2,1,1,0
168361,2019-10-24 00:00:00+03:00,out,False,945296,False,30,4331,4903,572
168361,2019-10-24 00:00:00+03:00,out,False,945296,True,11,0,194,194
168361,2019-10-24 00:00:00+03:00,out,False,945290,False,67,2807,4298,1491
168361,2019-10-24 00:00:00+03:00,out,False,945310,False,74,14353,15889,1536
168361,2019-10-24 00:00:00+03:00,out,False,945324,True,8,0,307,307
168361,2019-10-24 00:00:00+03:00,out,False,945304,False,52,6813,7866,1053
168361,2019-10-24 00:00:00+03:00,out,False,945316,False,34,7730,8462,732
168361,2019-10-24 00:00:00+03:00,out,False,945302,False,30,6782,7383,601
168361,2019-10-24 00:00:00+03:00,out,False,945314,False,26,4425,4863,438
168361,2019-10-24 00:00:00+03:00,out,False,945318,True,50,0,1261,1261
168361,2019-10-24 00:00:00+03:00,out,False,945290,True,38,0,1369,1369
168361,2019-10-24 00:00:00+03:00,out,False,945278,True,71,0,2104,2104
168361,2019-10-24 00:00:00+03:00,out,False,945288,False,77,7657,9101,1444
168361,2019-10-24 00:00:00+03:00,out,False,945288,True,35,0,992,992
168361,2019-10-24 00:00:00+03:00,out,False,945308,True,38,0,924,924
168361,2019-10-24 00:00:00+03:00,out,False,945310,True,96,0,1925,1925
168361,2019-10-24 00:00:00+03:00,out,False,945318,False,89,13817,15718,1901
168361,2019-10-24 00:00:00+03:00,out,False,945304,True,25,0,767,767
168361,2019-10-24 00:00:00+03:00,out,False,945316,True,21,0,328,328
168361,2019-10-24 00:00:00+03:00,out,False,945308,False,76,12911,14423,1512
168361,2019-10-24 00:00:00+03:00,out,False,945278,False,102,7072,9697,2625
168361,2019-10-24 00:00:00+03:00,out,False,945302,True,23,0,671,671
168361,2019-10-24 00:00:00+03:00,out,False,945320,True,64,0,1666,1666
168361,2019-10-24 00:00:00+03:00,out,False,945320,False,115,15116,17349,2233
168361,2019-10-24 00:00:00+03:00,out,False,945324,False,28,3339,3950,611
168361,2019-10-24 00:00:00+03:00,out,False,945304,False,52,6813,7866,1053
168361,2019-10-24 00:00:00+03:00,out,False,945308,True,38,0,924,924
168361,2019-10-24 00:00:00+03:00,out,False,945302,False,30,6782,7383,601
168361,2019-10-25 00:00:00+03:00,out,False,945322,False,96,8899,10945,2046
168361,2019-10-25 00:00:00+03:00,out,False,945288,True,29,0,903,903
168361,2019-10-25 00:00:00+03:00,out,False,945324,False,65,8287,9516,1229
168361,2019-10-25 00:00:00+03:00,out,False,945278,False,66,10394,11759,1365
168361,2019-10-25 00:00:00+03:00,out,False,945312,False,13,1332,1661,329
168361,2019-10-25 00:00:00+03:00,in,False,-1,True,497,0,2481,2481
168361,2019-10-25 00:00:00+03:00,out,False,945290,True,25,0,655,655
168361,2019-10-25 00:00:00+03:00,out,False,945320,True,21,0,694,694
168361,2019-10-25 00:00:00+03:00,out,False,945320,False,83,14637,16188,1551
168361,2019-10-25 00:00:00+03:00,out,False,945314,True,16,0,340,340
168361,2019-10-25 00:00:00+03:00,out,False,945318,False,68,10249,11489,1240
168361,2019-10-25 00:00:00+03:00,out,False,945286,True,107,0,1932,1932
168361,2019-10-25 00:00:00+03:00,out,False,945302,False,93,15752,17557,1805
168361,2019-10-25 00:00:00+03:00,out,False,945310,False,31,4058,4763,705
168361,2019-10-25 00:00:00+03:00,out,False,945322,True,65,0,1873,1873
168361,2019-10-25 00:00:00+03:00,out,False,945310,True,18,0,501,501
168361,2019-10-25 00:00:00+03:00,out,False,945314,False,51,7058,8112,1054
168361,2019-10-25 00:00:00+03:00,out,False,945278,True,40,0,734,734
168361,2019-10-25 00:00:00+03:00,out,False,945286,False,145,9146,12505,3359
168361,2019-10-25 00:00:00+03:00,out,False,945302,True,106,0,2302,2302
168361,2019-10-25 00:00:00+03:00,out,False,945308,True,41,0,1051,1051
168361,2019-10-25 00:00:00+03:00,out,False,945304,True,27,0,870,870
168361,2019-10-25 00:00:00+03:00,out,False,945304,False,82,10885,12291,1406
168361,2019-10-25 00:00:00+03:00,out,False,945324,True,27,0,1083,1083
168361,2019-10-25 00:00:00+03:00,out,False,945290,False,41,1296,2256,960
168361,2019-10-25 00:00:00+03:00,out,False,945288,False,116,11596,13553,1957
168361,2019-10-25 00:00:00+03:00,out,False,945312,True,7,0,373,373
168361,2019-10-25 00:00:00+03:00,out,False,945308,False,66,11973,13191,1218
168361,2019-10-25 00:00:00+03:00,out,False,945282,False,21,2547,2936,389
168361,2019-10-25 00:00:00+03:00,out,False,945318,True,31,0,699,699
168361,2019-10-25 00:00:00+03:00,out,False,945282,True,4,0,112,112
168361,2019-10-25 00:00:00+03:00,out,False,945296,True,52,0,1364,1364
168361,2019-10-25 00:00:00+03:00,out,False,945296,False,38,2104,2824,720
168361,2019-10-25 00:00:00+03:00,out,False,945308,False,66,11973,13191,1218
168361,2019-10-25 00:00:00+03:00,out,False,945318,True,31,0,699,699
168361,2019-10-25 00:00:00+03:00,out,False,945302,False,93,15752,17557,1805
168361,2019-10-25 00:00:00+03:00,out,False,945290,True,25,0,655,655
168361,2019-10-25 00:00:00+03:00,out,False,945296,True,52,0,1364,1364
168361,2019-10-26 00:00:00+03:00,out,False,945280,True,80,0,1465,1465
168361,2019-10-26 00:00:00+03:00,out,False,945302,True,139,0,2588,2588
168361,2019-10-26 00:00:00+03:00,out,False,945302,False,139,11450,14403,2953
168361,2019-10-26 00:00:00+03:00,out,False,945316,False,30,4679,5382,703
168361,2019-10-26 00:00:00+03:00,out,False,945308,True,34,0,1021,1021
168361,2019-10-26 00:00:00+03:00,out,False,945312,True,37,0,776,776
168361,2019-10-26 00:00:00+03:00,out,False,945280,False,82,12922,14381,1459
168361,2019-10-26 00:00:00+03:00,out,False,945314,False,70,7522,8870,1348
168361,2019-10-26 00:00:00+03:00,out,False,945298,True,13,0,324,324
168361,2019-10-26 00:00:00+03:00,out,False,945322,True,72,0,1705,1705
168361,2019-10-26 00:00:00+03:00,out,True,945314,True,1,0,0,0
168361,2019-10-26 00:00:00+03:00,out,False,945284,True,31,0,660,660
168361,2019-10-26 00:00:00+03:00,out,False,945296,True,12,0,316,316
168361,2019-10-26 00:00:00+03:00,out,False,945322,False,89,11665,13365,1700
168361,2019-10-26 00:00:00+03:00,out,False,945294,False,145,20320,23225,2905
168361,2019-10-26 00:00:00+03:00,out,False,945294,True,125,0,2505,2505
168361,2019-10-26 00:00:00+03:00,out,False,945298,False,72,9190,10603,1413
168361,2019-10-26 00:00:00+03:00,out,False,945290,True,54,0,1517,1517
168361,2019-10-26 00:00:00+03:00,out,False,945282,False,83,10667,12223,1556
168361,2019-10-26 00:00:00+03:00,out,False,945296,False,29,4559,5084,525
168361,2019-10-26 00:00:00+03:00,out,False,945312,False,83,13200,14849,1649
168361,2019-10-26 00:00:00+03:00,out,False,945308,False,35,3340,3989,649
168361,2019-10-26 00:00:00+03:00,out,True,945286,True,1,0,0,0
168361,2019-10-26 00:00:00+03:00,out,False,945290,False,39,1020,2010,990
168361,2019-10-26 00:00:00+03:00,out,False,945284,False,79,5940,7284,1344
168361,2019-10-26 00:00:00+03:00,in,False,-1,True,410,0,2010,2010
168361,2019-10-26 00:00:00+03:00,out,False,945286,False,124,6308,8792,2484
168361,2019-10-26 00:00:00+03:00,out,False,945282,True,26,0,629,629
168361,2019-10-26 00:00:00+03:00,out,False,945286,True,141,0,2342,2342
168361,2019-10-26 00:00:00+03:00,out,False,945314,True,48,0,1343,1343
168361,2019-10-26 00:00:00+03:00,out,False,945316,True,18,0,167,167
168361,2019-10-27 00:00:00+03:00,out,False,945312,False,70,11169,12684,1515
168361,2019-10-27 00:00:00+03:00,out,False,945294,True,104,0,2352,2352
168361,2019-10-27 00:00:00+03:00,out,False,945308,True,38,0,995,995
168361,2019-10-27 00:00:00+03:00,out,False,945316,True,84,0,1829,1829
168361,2019-10-27 00:00:00+03:00,out,False,945282,True,26,0,581,581
168361,2019-10-27 00:00:00+03:00,out,False,945286,True,51,0,1129,1129
168361,2019-10-27 00:00:00+03:00,in,False,-1,True,217,0,1047,1047
168361,2019-10-27 00:00:00+03:00,out,False,945322,True,31,0,812,812
168361,2019-10-27 00:00:00+03:00,out,False,945284,False,82,6649,8026,1377
168361,2019-10-27 00:00:00+03:00,out,False,945294,False,139,18465,21326,2861
168361,2019-10-27 00:00:00+03:00,out,False,945296,True,41,0,844,844
168361,2019-10-27 00:00:00+03:00,out,False,945298,True,29,0,956,956
168361,2019-10-27 00:00:00+03:00,out,False,945286,False,71,5633,7171,1538
168361,2019-10-27 00:00:00+03:00,out,False,945302,True,184,0,4258,4258
168361,2019-10-27 00:00:00+03:00,out,False,945298,False,62,7402,8612,1210
168361,2019-10-27 00:00:00+03:00,out,False,945280,True,77,0,1671,1671
168361,2019-10-27 00:00:00+03:00,out,False,945308,False,19,4158,4517,359
168361,2019-10-27 00:00:00+03:00,out,False,945280,False,63,10170,11252,1082
168361,2019-10-27 00:00:00+03:00,out,False,945312,True,27,0,663,663
168361,2019-10-27 00:00:00+03:00,out,False,945316,False,83,13158,14882,1724
168361,2019-10-27 00:00:00+03:00,out,False,945302,False,89,10242,12197,1955
168361,2019-10-27 00:00:00+03:00,out,False,945284,True,36,0,801,801
168361,2019-10-27 00:00:00+03:00,out,False,945296,False,68,8814,9915,1101
168361,2019-10-27 00:00:00+03:00,out,False,945282,False,75,11288,12653,1365
168361,2019-10-27 00:00:00+03:00,out,False,945322,False,72,10197,11560,1363
168361,2019-10-27 00:00:00+03:00,out,False,945312,False,70,11169,12684,1515
168361,2019-10-27 00:00:00+03:00,out,False,945284,True,36,0,801,801
168361,2019-10-27 00:00:00+03:00,out,False,945302,False,89,10242,12197,1955
168361,2019-10-28 00:00:00+03:00,out,False,945320,True,27,0,444,444
168361,2019-10-28 00:00:00+03:00,out,False,945302,True,44,0,947,947
168361,2019-10-28 00:00:00+03:00,out,False,945282,True,1,0,0,0
168361,2019-10-28 00:00:00+03:00,out,False,945296,True,48,0,924,924
168361,2019-10-28 00:00:00+03:00,in,False,-1,True,3,0,15,15
168361,2019-10-28 00:00:00+03:00,out,False,945288,False,91,10608,12068,1460
168361,2019-10-28 00:00:00+03:00,out,False,945316,True,17,0,466,466
168361,2019-10-28 00:00:00+03:00,out,False,945304,True,22,0,611,611
168361,2019-10-28 00:00:00+03:00,out,False,945308,True,48,0,1097,1097
168361,2019-10-28 00:00:00+03:00,out,False,945314,False,39,5380,6199,819
168361,2019-10-28 00:00:00+03:00,out,False,945302,False,32,5408,6001,593
168361,2019-10-28 00:00:00+03:00,out,False,945278,True,78,0,2056,2056
168361,2019-10-28 00:00:00+03:00,out,False,945304,False,95,14788,16506,1718
168361,2019-10-28 00:00:00+03:00,out,False,945314,True,22,0,531,531
168361,2019-10-28 00:00:00+03:00,out,False,945308,False,87,16126,17671,1545
168361,2019-10-28 00:00:00+03:00,out,False,945290,False,58,2241,3482,1241
168361,2019-10-28 00:00:00+03:00,out,False,945320,False,87,13178,14814,1636
168361,2019-10-28 00:00:00+03:00,out,False,945324,False,48,3816,4848,1032
168361,2019-10-28 00:00:00+03:00,in,False,-1,True,443,0,2234,2234
168361,2019-10-28 00:00:00+03:00,out,False,945318,True,34,0,528,528
168361,2019-10-28 00:00:00+03:00,out,False,945310,False,110,23052,25603,2551
168361,2019-10-28 00:00:00+03:00,out,False,945318,False,85,11833,13389,1556
168361,2019-10-28 00:00:00+03:00,out,False,945316,False,35,6035,6728,693
168361,2019-10-28 00:00:00+03:00,out,False,945288,True,31,0,717,717
168361,2019-10-28 00:00:00+03:00,out,False,945324,True,28,0,1211,1211
168361,2019-10-28 00:00:00+03:00,out,False,945278,False,169,10702,14266,3564
168361,2019-10-28 00:00:00+03:00,out,False,945290,True,43,0,1557,1557
168361,2019-10-28 00:00:00+03:00,out,False,945296,False,45,4361,5097,736
168361,2019-10-28 00:00:00+03:00,out,False,945310,True,51,0,891,891
168361,2019-10-28 00:00:00+03:00,out,False,945324,True,28,0,1211,1211
168361,2019-10-28 00:00:00+03:00,out,False,945320,True,27,0,444,444
168361,2019-10-28 00:00:00+03:00,out,False,945290,False,58,2241,3482,1241
168361,2019-10-28 00:00:00+03:00,out,False,945320,False,87,13178,14814,1636
168361,2019-10-29 00:00:00+03:00,out,False,945308,False,96,20282,22087,1805
168361,2019-10-29 00:00:00+03:00,out,False,945324,False,38,4068,4789,721
168361,2019-10-29 00:00:00+03:00,out,False,945318,False,95,14886,16670,1784
168361,2019-10-29 00:00:00+03:00,out,False,945310,False,111,19985,22469,2484
168361,2019-10-29 00:00:00+03:00,out,False,945302,True,82,0,2027,2027
168361,2019-10-29 00:00:00+03:00,out,False,945314,True,44,0,702,702
168361,2019-10-29 00:00:00+03:00,out,False,945278,False,92,14713,16573,1860
168361,2019-10-29 00:00:00+03:00,out,False,945310,True,70,0,1008,1008
168361,2019-10-29 00:00:00+03:00,out,False,945286,False,112,6682,9123,2441
168361,2019-10-29 00:00:00+03:00,out,False,945290,False,90,2430,4479,2049
168361,2019-10-29 00:00:00+03:00,out,False,945302,False,116,16683,18972,2289
168361,2019-10-29 00:00:00+03:00,out,False,945314,False,60,6139,7226,1087
168361,2019-10-29 00:00:00+03:00,out,False,945324,True,11,0,448,448
168361,2019-10-29 00:00:00+03:00,out,False,945296,True,19,0,493,493
168361,2019-10-29 00:00:00+03:00,out,False,945308,True,45,0,1076,1076
168361,2019-10-29 00:00:00+03:00,in,False,-1,True,666,0,3279,3279
168361,2019-10-29 00:00:00+03:00,out,False,945288,False,118,13037,15014,1977
168361,2019-10-29 00:00:00+03:00,out,False,945320,True,26,0,653,653
168361,2019-10-29 00:00:00+03:00,out,False,945304,True,30,0,858,858
168361,2019-10-29 00:00:00+03:00,out,False,-1,True,1,0,1,1
168361,2019-10-29 00:00:00+03:00,out,False,945304,False,96,15360,16899,1539
168361,2019-10-29 00:00:00+03:00,out,False,945320,False,98,15114,16763,1649
168361,2019-10-29 00:00:00+03:00,out,False,945278,True,66,0,1345,1345
168361,2019-10-29 00:00:00+03:00,out,False,945318,True,41,0,937,937
168361,2019-10-29 00:00:00+03:00,out,False,945296,False,22,2210,2590,380
168361,2019-10-29 00:00:00+03:00,out,False,945286,True,112,0,2663,2663
168361,2019-10-29 00:00:00+03:00,out,False,945290,True,73,0,1710,1710
168361,2019-10-29 00:00:00+03:00,out,False,945288,True,27,0,636,636
168361,2019-10-29 00:00:00+03:00,out,False,945318,True,41,0,937,937
168361,2019-10-29 00:00:00+03:00,out,False,945278,True,66,0,1345,1345
168361,2019-10-29 00:00:00+03:00,out,False,945278,False,92,14713,16573,1860
168361,2019-10-29 00:00:00+03:00,out,False,945304,False,96,15360,16899,1539
168361,2019-10-29 00:00:00+03:00,out,False,945304,True,30,0,858,858
168361,2019-10-30 00:00:00+03:00,out,False,945286,False,126,6333,8974,2641
168361,2019-10-30 00:00:00+03:00,out,False,945290,False,53,2225,3390,1165
168361,2019-10-30 00:00:00+03:00,out,False,945282,True,36,0,883,883
168361,2019-10-30 00:00:00+03:00,out,False,945298,True,1,0,60,60
168361,2019-10-30 00:00:00+03:00,out,False,945296,False,29,3472,3974,502
168361,2019-10-30 00:00:00+03:00,out,False,945284,True,31,0,579,579
168361,2019-10-30 00:00:00+03:00,out,False,945312,False,93,15158,16946,1788
168361,2019-10-30 00:00:00+03:00,out,False,945314,False,11,1423,1578,155
168361,2019-10-30 00:00:00+03:00,out,False,945294,True,91,0,1686,1686
168361,2019-10-30 00:00:00+03:00,out,False,945324,False,21,2358,2834,476
168361,2019-10-30 00:00:00+03:00,out,False,945316,False,30,4700,5300,600
168361,2019-10-30 00:00:00+03:00,out,False,945302,False,79,10801,12309,1508
168361,2019-10-30 00:00:00+03:00,out,False,945278,True,63,0,1054,1054
168361,2019-10-30 00:00:00+03:00,out,False,945302,True,62,0,1522,1522
168361,2019-10-30 00:00:00+03:00,out,False,945294,False,143,19630,22447,2817
168361,2019-10-30 00:00:00+03:00,out,False,945312,True,39,0,690,690
168361,2019-10-30 00:00:00+03:00,out,False,945324,True,19,0,586,586
168361,2019-10-30 00:00:00+03:00,out,False,945286,True,116,0,1964,1964
168361,2019-10-30 00:00:00+03:00,out,False,945296,True,13,0,295,295
168361,2019-10-30 00:00:00+03:00,out,False,945278,False,101,17284,19180,1896
168361,2019-10-30 00:00:00+03:00,out,False,945280,True,27,0,521,521
168361,2019-10-30 00:00:00+03:00,out,False,945280,False,83,14433,16068,1635
168361,2019-10-30 00:00:00+03:00,out,False,945314,True,12,0,538,538
168361,2019-10-30 00:00:00+03:00,out,False,945316,True,25,0,511,511
168361,2019-10-30 00:00:00+03:00,out,False,945282,False,116,13555,15411,1856
168361,2019-10-30 00:00:00+03:00,in,False,-1,True,597,0,2976,2976
168361,2019-10-30 00:00:00+03:00,out,False,945290,True,36,0,1017,1017
168361,2019-10-30 00:00:00+03:00,out,False,945298,False,3,268,290,22
168361,2019-10-30 00:00:00+03:00,out,False,945284,False,87,7441,8968,1527
168361,2019-10-30 00:00:00+03:00,out,False,945296,False,29,3472,3974,502
168361,2019-10-30 00:00:00+03:00,out,False,945302,True,62,0,1522,1522
168361,2019-10-31 00:00:00+03:00,out,False,945302,False,141,11919,14910,2991
168361,2019-10-31 00:00:00+03:00,out,False,945290,False,87,2908,4810,1902
168361,2019-10-31 00:00:00+03:00,out,False,945302,True,216,0,5246,5246
168361,2019-10-31 00:00:00+03:00,out,False,945316,False,67,10691,11933,1242
168361,2019-10-31 00:00:00+03:00,out,False,945324,True,48,0,1610,1610
168361,2019-10-31 00:00:00+03:00,out,False,945296,True,23,0,517,517
168361,2019-10-31 00:00:00+03:00,out,False,945308,True,10,0,242,242
168361,2019-10-31 00:00:00+03:00,out,False,945280,False,67,11978,13273,1295
168361,2019-10-31 00:00:00+03:00,out,False,945294,False,106,13581,15631,2050
168361,2019-10-31 00:00:00+03:00,out,False,945282,False,60,9686,10707,1021
168361,2019-10-31 00:00:00+03:00,out,False,945322,True,42,0,983,983
168361,2019-10-31 00:00:00+03:00,out,False,945324,False,59,3333,4466,1133
168361,2019-10-31 00:00:00+03:00,out,False,945296,False,57,7157,8077,920
168361,2019-10-31 00:00:00+03:00,out,False,945312,False,69,8692,9950,1258
168361,2019-10-31 00:00:00+03:00,out,False,945294,True,69,0,956,956
168361,2019-10-31 00:00:00+03:00,out,False,945284,True,31,0,657,657
168361,2019-10-31 00:00:00+03:00,out,False,945298,False,34,3130,3654,524
168361,2019-10-31 00:00:00+03:00,in,False,-1,True,629,0,3149,3149
168361,2019-10-31 00:00:00+03:00,out,False,945298,True,10,0,299,299
168361,2019-10-31 00:00:00+03:00,out,False,945286,True,86,0,1786,1786
168361,2019-10-31 00:00:00+03:00,out,False,945316,True,44,0,919,919
168361,2019-10-31 00:00:00+03:00,out,True,945286,True,1,0,0,0
168361,2019-10-31 00:00:00+03:00,out,False,945308,False,21,3369,3798,429
168361,2019-10-31 00:00:00+03:00,out,False,945312,True,16,0,563,563
168361,2019-10-31 00:00:00+03:00,out,False,945282,True,31,0,469,469
168361,2019-10-31 00:00:00+03:00,out,False,945284,False,56,4862,5749,887
168361,2019-10-31 00:00:00+03:00,out,False,945286,False,125,4928,7493,2565
168361,2019-10-31 00:00:00+03:00,out,False,945322,False,91,9993,11714,1721
168361,2019-10-31 00:00:00+03:00,out,False,945280,True,20,0,464,464
168361,2019-10-31 00:00:00+03:00,out,False,945290,True,102,0,1767,1767
168361,2019-10-31 00:00:00+03:00,out,False,945296,False,57,7157,8077,920
168361,2019-10-31 00:00:00+03:00,out,False,945308,False,21,3369,3798,429
168361,2019-10-31 00:00:00+03:00,out,False,945298,False,34,3130,3654,524
168361,2019-10-31 00:00:00+03:00,out,False,945290,True,102,0,1767,1767
168361,2019-10-31 00:00:00+03:00,out,False,945298,True,10,0,299,299
168361,2019-10-31 00:00:00+03:00,out,False,945286,False,125,4928,7493,2565
168361,2019-11-01 00:00:00+03:00,out,False,945318,False,58,8130,9187,1057
168361,2019-11-01 00:00:00+03:00,out,False,945314,True,8,0,204,204
168361,2019-11-01 00:00:00+03:00,out,False,945324,False,41,3295,4147,852
168361,2019-11-01 00:00:00+03:00,out,False,945302,False,28,5146,5586,440
168361,2019-11-01 00:00:00+03:00,out,False,945308,False,55,8547,9457,910
168361,2019-11-01 00:00:00+03:00,out,False,945288,True,25,0,571,571
168361,2019-11-01 00:00:00+03:00,out,False,945302,True,13,0,291,291
168361,2019-11-01 00:00:00+03:00,out,False,945322,False,65,4474,5943,1469
168361,2019-11-01 00:00:00+03:00,out,False,945322,True,79,0,2434,2434
168361,2019-11-01 00:00:00+03:00,out,False,945316,False,39,6512,7154,642
168361,2019-11-01 00:00:00+03:00,out,False,945308,True,29,0,619,619
168361,2019-11-01 00:00:00+03:00,out,False,945310,False,62,12809,14159,1350
168361,2019-11-01 00:00:00+03:00,out,False,945296,True,11,0,185,185
168361,2019-11-01 00:00:00+03:00,out,False,945310,True,57,0,1207,1207
168361,2019-11-01 00:00:00+03:00,in,False,-1,True,560,0,2796,2796
168361,2019-11-01 00:00:00+03:00,out,False,945324,True,23,0,926,926
168361,2019-11-01 00:00:00+03:00,in,False,-1,True,3,0,15,15
168361,2019-11-01 00:00:00+03:00,out,False,945314,False,29,3901,4413,512
168361,2019-11-01 00:00:00+03:00,out,False,945288,False,72,8479,9608,1129
168361,2019-11-01 00:00:00+03:00,out,False,945296,False,32,3920,4449,529
168361,2019-11-01 00:00:00+03:00,out,False,945304,True,36,0,906,906
168361,2019-11-01 00:00:00+03:00,out,False,945316,True,29,0,566,566
168361,2019-11-01 00:00:00+03:00,out,False,945290,True,47,0,1211,1211
168361,2019-11-01 00:00:00+03:00,out,False,945304,False,77,12882,14313,1431
168361,2019-11-01 00:00:00+03:00,out,False,945318,True,36,0,553,553
168361,2019-11-01 00:00:00+03:00,out,False,945320,True,21,0,275,275
168361,2019-11-01 00:00:00+03:00,out,False,945290,False,46,1212,2228,1016
168361,2019-11-01 00:00:00+03:00,out,False,945320,False,59,7485,8641,1156
168361,2019-11-01 00:00:00+03:00,out,False,945310,True,57,0,1207,1207
168361,2019-11-01 00:00:00+03:00,out,False,945288,True,25,0,571,571
168361,2019-11-01 00:00:00+03:00,out,False,945290,True,47,0,1211,1211
168361,2019-11-01 00:00:00+03:00,in,False,-1,True,3,0,15,15
168361,2019-11-02 00:00:00+03:00,out,False,945302,False,114,14046,16394,2348
168361,2019-11-02 00:00:00+03:00,out,False,945310,False,89,16181,18224,2043
168361,2019-11-02 00:00:00+03:00,out,False,945310,True,40,0,582,582
168361,2019-11-02 00:00:00+03:00,out,False,945288,False,93,8316,9956,1640
168361,2019-11-02 00:00:00+03:00,out,False,945314,False,29,5577,6087,510
168361,2019-11-02 00:00:00+03:00,out,False,945294,False,70,4295,5682,1387
168361,2019-11-02 00:00:00+03:00,out,False,945304,False,108,11978,14132,2154
168361,2019-11-02 00:00:00+03:00,out,False,945304,True,60,0,1450,1450
168361,2019-11-02 00:00:00+03:00,out,False,945296,True,70,0,1757,1757
168361,2019-11-02 00:00:00+03:00,out,False,945278,False,71,12475,13928,1453
168361,2019-11-02 00:00:00+03:00,out,False,945288,True,27,0,698,698
168361,2019-11-02 00:00:00+03:00,out,False,945320,True,3,0,63,63
168361,2019-11-02 00:00:00+03:00,in,False,-1,True,472,0,2333,2333
168361,2019-11-02 00:00:00+03:00,out,False,945314,True,24,0,342,342
168361,2019-11-02 00:00:00+03:00,out,False,945290,False,51,2023,3203,1180
168361,2019-11-02 00:00:00+03:00,out,False,945284,True,26,0,582,582
168361,2019-11-02 00:00:00+03:00,out,False,945286,True,100,0,1694,1694
168361,2019-11-02 00:00:00+03:00,out,False,945308,True,27,0,579,579
168361,2019-11-02 00:00:00+03:00,out,False,945278,True,48,0,899,899
168361,2019-11-02 00:00:00+03:00,out,False,945296,False,34,1428,2027,599
168361,2019-11-02 00:00:00+03:00,out,False,945284,False,61,4739,5738,999
168361,2019-11-02 00:00:00+03:00,out,False,945320,False,17,3315,3611,296
168361,2019-11-02 00:00:00+03:00,out,False,945290,True,38,0,1146,1146
168361,2019-11-02 00:00:00+03:00,out,False,945294,True,105,0,2225,2225
168361,2019-11-02 00:00:00+03:00,out,False,945308,False,59,9838,10916,1078
168361,2019-11-02 00:00:00+03:00,out,False,945286,False,126,6421,9012,2591
168361,2019-11-02 00:00:00+03:00,out,False,945302,True,93,0,1671,1671
168361,2019-11-02 00:00:00+03:00,out,False,945286,True,100,0,1694,1694
168361,2019-11-02 00:00:00+03:00,out,False,945284,True,26,0,582,582
168361,2019-11-02 00:00:00+03:00,out,False,945286,False,126,6421,9012,2591
168361,2019-11-03 00:00:00+03:00,out,False,945286,True,68,0,1282,1282
168361,2019-11-03 00:00:00+03:00,out,False,945312,False,66,8938,10232,1294
168361,2019-11-03 00:00:00+03:00,out,False,945322,True,80,0,1518,1518
168361,2019-11-03 00:00:00+03:00,out,False,945312,True,38,0,954,954
168361,2019-11-03 00:00:00+03:00,out,False,945296,False,28,2918,3488,570
168361,2019-11-03 00:00:00+03:00,out,False,945316,True,17,0,290,290
168361,2019-11-03 00:00:00+03:00,out,False,945296,True,15,0,338,338
168361,2019-11-03 00:00:00+03:00,out,False,945282,True,17,0,439,439
168361,2019-11-03 00:00:00+03:00,out,False,945294,True,92,0,1421,1421
168361,2019-11-03 00:00:00+03:00,out,False,945298,True,7,0,151,151
168361,2019-11-03 00:00:00+03:00,out,False,945298,False,36,4476,5035,559
168361,2019-11-03 00:00:00+03:00,out,False,945282,False,54,8688,9616,928
168361,2019-11-03 00:00:00+03:00,out,False,945316,False,21,3431,3882,451
168361,2019-11-03 00:00:00+03:00,out,False,945294,False,104,17216,19222,2006
168361,2019-11-03 00:00:00+03:00,out,False,945322,False,91,11021,12956,1935
168361,2019-11-03 00:00:00+03:00,out,False,945280,False,58,12430,13543,1113
168361,2019-11-03 00:00:00+03:00,out,False,945286,False,49,2862,3858,996
168361,2019-11-03 00:00:00+03:00,out,False,945284,False,69,5223,6375,1152
168361,2019-11-03 00:00:00+03:00,out,True,945322,True,2,0,0,0
168361,2019-11-03 00:00:00+03:00,out,False,945302,True,113,0,3142,3142
168361,2019-11-03 00:00:00+03:00,out,False,945284,True,33,0,733,733
168361,2019-11-03 00:00:00+03:00,out,True,945298,True,1,0,0,0
168361,2019-11-03 00:00:00+03:00,out,False,945314,True,4,0,136,136
168361,2019-11-03 00:00:00+03:00,out,False,945314,False,7,568,681,113
168361,2019-11-03 00:00:00+03:00,out,False,945302,False,123,13272,15941,2669
168361,2019-11-03 00:00:00+03:00,in,False,-1,True,212,0,1029,1029
168361,2019-11-03 00:00:00+03:00,out,False,945280,True,26,0,649,649
168361,2019-11-03 00:00:00+03:00,out,False,945286,False,49,2862,3858,996
168361,2019-11-04 00:00:00+03:00,out,False,945290,False,102,4055,6410,2355
168361,2019-11-04 00:00:00+03:00,out,False,945316,False,47,7760,8544,784
168361,2019-11-04 00:00:00+03:00,out,False,945322,False,73,8416,10037,1621
168361,2019-11-04 00:00:00+03:00,out,False,945280,False,42,9264,10011,747
168361,2019-11-04 00:00:00+03:00,out,False,945278,True,124,0,3584,3584
168361,2019-11-04 00:00:00+03:00,out,False,945286,True,137,0,2057,2057
168361,2019-11-04 00:00:00+03:00,out,False,945284,True,38,0,892,892
168361,2019-11-04 00:00:00+03:00,out,False,945280,True,16,0,364,364
168361,2019-11-04 00:00:00+03:00,out,False,945316,True,28,0,667,667
168361,2019-11-04 00:00:00+03:00,out,False,945302,False,125,9660,12669,3009
168361,2019-11-04 00:00:00+03:00,out,False,945278,False,103,11553,58027,46474
168361,2019-11-04 00:00:00+03:00,out,False,945298,False,13,1812,2082,270
168361,2019-11-04 00:00:00+03:00,out,False,945286,False,66,4874,6325,1451
168361,2019-11-04 00:00:00+03:00,out,False,945322,True,95,0,1109,1109
168361,2019-11-04 00:00:00+03:00,out,False,945294,False,77,12320,13816,1496
168361,2019-11-04 00:00:00+03:00,out,True,945286,True,1,0,0,0
168361,2019-11-04 00:00:00+03:00,out,False,945296,False,51,7445,8298,853
168361,2019-11-04 00:00:00+03:00,out,False,945282,True,17,0,361,361
168361,2019-11-04 00:00:00+03:00,out,False,945296,True,29,0,554,554
168361,2019-11-04 00:00:00+03:00,out,False,945282,False,45,5358,6122,764
168361,2019-11-04 00:00:00+03:00,out,False,945298,True,4,0,132,132
168361,2019-11-04 00:00:00+03:00,out,False,945312,True,25,0,545,545
168361,2019-11-04 00:00:00+03:00,in,False,-1,True,158,0,784,784
168361,2019-11-04 00:00:00+03:00,out,False,945290,True,89,0,1995,1995
168361,2019-11-04 00:00:00+03:00,out,False,945324,False,16,2022,2339,317
168361,2019-11-04 00:00:00+03:00,out,False,945294,True,57,0,746,746
168361,2019-11-04 00:00:00+03:00,out,False,945302,True,146,0,3632,3632
168361,2019-11-04 00:00:00+03:00,out,False,945312,False,45,9003,9742,739
168361,2019-11-04 00:00:00+03:00,out,False,945324,True,5,0,96,96
168361,2019-11-04 00:00:00+03:00,out,False,945284,False,60,4015,5067,1052
168361,2019-11-04 00:00:00+03:00,out,False,945322,True,95,0,1109,1109
168361,2019-11-04 00:00:00+03:00,out,False,945312,False,45,9003,9742,739
168361,2019-11-05 00:00:00+03:00,out,False,945302,False,16,4494,4801,307
168361,2019-11-05 00:00:00+03:00,out,False,945320,False,69,10099,11296,1197
168361,2019-11-05 00:00:00+03:00,out,False,945280,False,23,1123,1683,560
168361,2019-11-05 00:00:00+03:00,out,False,945316,True,20,0,538,538
168361,2019-11-05 00:00:00+03:00,out,False,945324,False,58,7199,8139,940
168361,2019-11-05 00:00:00+03:00,out,False,945314,True,8,0,129,129
168361,2019-11-05 00:00:00+03:00,out,False,945278,True,92,0,2417,2417
168361,2019-11-05 00:00:00+03:00,out,False,945324,True,17,0,550,550
168361,2019-11-05 00:00:00+03:00,out,False,945304,True,48,0,1086,1086
168361,2019-11-05 00:00:00+03:00,out,False,945322,True,62,0,1622,1622
168361,2019-11-05 00:00:00+03:00,out,False,945318,False,77,11911,13223,1312
168361,2019-11-05 00:00:00+03:00,in,False,-1,True,1006,0,5005,5005
168361,2019-11-05 00:00:00+03:00,out,False,945296,True,8,0,133,133
168361,2019-11-05 00:00:00+03:00,out,False,945280,True,27,0,1124,1124
168361,2019-11-05 00:00:00+03:00,out,False,945290,True,81,0,1950,1950
168361,2019-11-05 00:00:00+03:00,out,False,945304,False,85,13479,15123,1644
168361,2019-11-05 00:00:00+03:00,out,False,945312,True,8,0,332,332
168361,2019-11-05 00:00:00+03:00,out,False,945296,False,35,4884,5435,551
168361,2019-11-05 00:00:00+03:00,out,False,945278,False,174,10216,13896,3680
168361,2019-11-05 00:00:00+03:00,out,False,945282,False,18,1011,1349,338
168361,2019-11-05 00:00:00+03:00,out,False,945282,True,36,0,545,545
168361,2019-11-05 00:00:00+03:00,out,False,945308,False,71,11160,12410,1250
168361,2019-11-05 00:00:00+03:00,out,False,945288,True,25,0,370,370
168361,2019-11-05 00:00:00+03:00,out,False,945310,False,105,11202,13501,2299
168361,2019-11-05 00:00:00+03:00,out,False,945310,True,56,0,1361,1361
168361,2019-11-05 00:00:00+03:00,out,False,945302,True,5,0,138,138
168361,2019-11-05 00:00:00+03:00,out,False,945288,False,87,10751,12171,1420
168361,2019-11-05 00:00:00+03:00,out,False,945314,False,15,1897,2122,225
168361,2019-11-05 00:00:00+03:00,out,False,945290,False,56,1912,3294,1382
168361,2019-11-05 00:00:00+03:00,out,False,945320,True,31,0,252,252
168361,2019-11-05 00:00:00+03:00,out,False,945318,True,19,0,438,438
168361,2019-11-05 00:00:00+03:00,out,False,945308,True,65,0,1298,1298
168361,2019-11-05 00:00:00+03:00,out,False,945316,False,30,5842,6372,530
168361,2019-11-05 00:00:00+03:00,out,False,945322,False,123,9180,11684,2504
168361,2019-11-05 00:00:00+03:00,out,False,945312,False,12,1362,1653,291
168361,2019-11-05 00:00:00+03:00,out,False,945316,True,20,0,538,538
168361,2019-11-05 00:00:00+03:00,out,False,945282,True,36,0,545,545
168361,2019-11-05 00:00:00+03:00,out,False,945302,True,5,0,138,138
168361,2019-11-06 00:00:00+03:00,out,False,945282,True,8,0,54,54
168361,2019-11-06 00:00:00+03:00,out,False,945320,True,12,0,352,352
168361,2019-11-06 00:00:00+03:00,out,False,945314,True,13,0,365,365
168361,2019-11-06 00:00:00+03:00,out,False,945286,True,126,0,2374,2374
168361,2019-11-06 00:00:00+03:00,out,False,945288,True,20,0,609,609
168361,2019-11-06 00:00:00+03:00,out,False,945318,True,32,0,580,580
168361,2019-11-06 00:00:00+03:00,in,False,-1,True,1289,0,6534,6534
168361,2019-11-06 00:00:00+03:00,out,False,945302,True,41,0,938,938
168361,2019-11-06 00:00:00+03:00,out,False,945286,False,105,4881,6902,2021
168361,2019-11-06 00:00:00+03:00,out,False,945308,False,76,10776,12172,1396
168361,2019-11-06 00:00:00+03:00,out,False,945318,False,67,8623,9897,1274
168361,2019-11-06 00:00:00+03:00,out,False,945310,True,152,0,4370,4370
168361,2019-11-06 00:00:00+03:00,out,False,945322,True,66,0,1902,1902
168361,2019-11-06 00:00:00+03:00,out,False,945324,False,45,3789,4755,966
168361,2019-11-06 00:00:00+03:00,out,False,945324,True,47,0,1230,1230
168361,2019-11-06 00:00:00+03:00,out,False,945322,False,96,6589,8702,2113
168361,2019-11-06 00:00:00+03:00,out,False,945304,True,54,0,914,914
168361,2019-11-06 00:00:00+03:00,out,False,945282,False,13,1340,1567,227
168361,2019-11-06 00:00:00+03:00,out,False,945290,True,53,0,1083,1083
168361,2019-11-06 00:00:00+03:00,out,False,945320,False,66,12413,13476,1063
168361,2019-11-06 00:00:00+03:00,out,False,945308,True,28,0,470,470
168361,2019-11-06 00:00:00+03:00,out,False,945296,True,12,0,125,125
168361,2019-11-06 00:00:00+03:00,out,False,945314,False,20,2618,3011,393
168361,2019-11-06 00:00:00+03:00,out,False,945288,False,76,6964,8183,1219
168361,2019-11-06 00:00:00+03:00,out,False,945296,False,30,3574,4051,477
168361,2019-11-06 00:00:00+03:00,out,False,945278,False,151,9720,13094,3374
168361,2019-11-06 00:00:00+03:00,out,False,945302,False,84,11630,13270,1640
168361,2019-11-06 00:00:00+03:00,out,False,-1,True,2,0,4,4
168361,2019-11-06 00:00:00+03:00,out,False,945310,False,91,7307,9575,2268
168361,2019-11-06 00:00:00+03:00,out,False,945304,False,77,11528,13017,1489
168361,2019-11-06 00:00:00+03:00,out,False,945290,False,46,1694,2686,992
168361,2019-11-06 00:00:00+03:00,out,False,945278,True,89,0,2882,2882
168361,2019-11-06 00:00:00+03:00,out,False,945304,True,54,0,914,914
168361,2019-11-06 00:00:00+03:00,out,False,945310,False,91,7307,9575,2268
168361,2019-11-07 00:00:00+03:00,out,True,945286,True,1,0,0,0
168361,2019-11-07 00:00:00+03:00,out,False,945302,True,103,0,1227,1227
168361,2019-11-07 00:00:00+03:00,out,False,945314,False,17,2809,3160,351
168361,2019-11-07 00:00:00+03:00,out,False,945314,True,4,0,200,200
168361,2019-11-07 00:00:00+03:00,out,False,945316,False,47,7837,8740,903
168361,2019-11-07 00:00:00+03:00,out,False,945286,False,184,9446,13419,3973
168361,2019-11-07 00:00:00+03:00,out,False,945296,False,26,3353,3738,385
168361,2019-11-07 00:00:00+03:00,out,False,945284,False,93,6809,8408,1599
168361,2019-11-07 00:00:00+03:00,out,False,945322,False,101,15078,16891,1813
168361,2019-11-07 00:00:00+03:00,out,False,945302,False,116,15936,18090,2154
168361,2019-11-07 00:00:00+03:00,out,False,945282,False,116,13831,15827,1996
168361,2019-11-07 00:00:00+03:00,out,False,945298,True,11,0,358,358
168361,2019-11-07 00:00:00+03:00,out,False,945316,True,40,0,1003,1003
168361,2019-11-07 00:00:00+03:00,out,False,945282,True,43,0,800,800
168361,2019-11-07 00:00:00+03:00,in,False,-1,True,1083,0,5441,5441
168361,2019-11-07 00:00:00+03:00,out,False,945324,True,37,0,1427,1427
168361,2019-11-07 00:00:00+03:00,out,False,945298,False,90,14066,15562,1496
168361,2019-11-07 00:00:00+03:00,out,False,945294,True,62,0,1117,1117
168361,2019-11-07 00:00:00+03:00,out,False,945290,False,58,2001,3232,1231
168361,2019-11-07 00:00:00+03:00,out,False,-1,True,2,0,0,0
168361,2019-11-07 00:00:00+03:00,out,False,945296,True,32,0,622,622
168361,2019-11-07 00:00:00+03:00,out,False,945286,True,136,0,3451,3451
168361,2019-11-07 00:00:00+03:00,out,False,945284,True,35,0,855,855
168361,2019-11-07 00:00:00+03:00,out,False,945324,False,55,5292,6438,1146
168361,2019-11-07 00:00:00+03:00,out,False,945290,True,72,0,1710,1710
168361,2019-11-07 00:00:00+03:00,out,False,945322,True,36,0,682,682
168361,2019-11-07 00:00:00+03:00,out,False,945312,False,94,13332,15125,1793
168361,2019-11-07 00:00:00+03:00,out,False,945312,True,42,0,909,909
168361,2019-11-07 00:00:00+03:00,out,False,945294,False,125,19854,22318,2464
168361,2019-11-07 00:00:00+03:00,out,False,945298,False,90,14066,15562,1496
168361,2019-11-07 00:00:00+03:00,out,False,945282,False,116,13831,15827,1996
168361,2019-11-07 00:00:00+03:00,out,False,945290,True,72,0,1710,1710
168361,2019-11-08 00:00:00+03:00,out,False,945286,True,142,0,2339,2339
168361,2019-11-08 00:00:00+03:00,out,False,945302,False,134,8390,11464,3074
168361,2019-11-08 00:00:00+03:00,out,False,945322,True,81,0,1237,1237
168361,2019-11-08 00:00:00+03:00,out,False,945302,True,293,0,5251,5251
168361,2019-11-08 00:00:00+03:00,out,True,945286,True,1,0,0,0
168361,2019-11-08 00:00:00+03:00,out,False,945296,True,24,0,500,500
168361,2019-11-08 00:00:00+03:00,out,False,945284,True,36,0,716,716
168361,2019-11-08 00:00:00+03:00,out,False,945284,False,77,6621,7947,1326
168361,2019-11-08 00:00:00+03:00,out,False,-1,True,1,0,2,2
168361,2019-11-08 00:00:00+03:00,out,False,945298,True,10,0,349,349
168361,2019-11-08 00:00:00+03:00,out,False,945282,True,23,0,375,375
168361,2019-11-08 00:00:00+03:00,out,False,945280,False,70,15539,16827,1288
168361,2019-11-08 00:00:00+03:00,out,True,945298,True,1,0,0,0
168361,2019-11-08 00:00:00+03:00,out,False,945322,False,93,11940,13654,1714
168361,2019-11-08 00:00:00+03:00,out,False,945282,False,87,9704,11147,1443
168361,2019-11-08 00:00:00+03:00,out,False,945296,False,57,8575,9512,937
168361,2019-11-08 00:00:00+03:00,out,False,945316,True,28,0,522,522
168361,2019-11-08 00:00:00+03:00,out,False,945294,False,84,14490,16139,1649
168361,2019-11-08 00:00:00+03:00,out,False,945298,False,76,10143,11443,1300
168361,2019-11-08 00:00:00+03:00,out,False,945286,False,133,5746,8632,2886
168361,2019-11-08 00:00:00+03:00,out,False,945294,True,68,0,1044,1044
168361,2019-11-08 00:00:00+03:00,out,False,945312,False,88,12828,14457,1629
168361,2019-11-08 00:00:00+03:00,out,False,945280,True,17,0,416,416
168361,2019-11-08 00:00:00+03:00,in,False,-1,True,888,0,4476,4476
168361,2019-11-08 00:00:00+03:00,out,False,945316,False,63,9724,10857,1133
168361,2019-11-08 00:00:00+03:00,out,False,945312,True,29,0,586,586
168361,2019-11-08 00:00:00+03:00,out,False,945290,True,53,0,960,960
168361,2019-11-08 00:00:00+03:00,out,False,945290,False,56,2031,3243,1212
168361,2019-11-08 00:00:00+03:00,out,False,945302,False,134,8390,11464,3074
168361,2019-11-08 00:00:00+03:00,out,False,945290,False,56,2031,3243,1212
168361,2019-11-08 00:00:00+03:00,out,False,945312,False,88,12828,14457,1629
168361,2019-11-08 00:00:00+03:00,out,False,945284,False,77,6621,7947,1326
168361,2019-11-08 00:00:00+03:00,out,False,945296,False,57,8575,9512,937
168361,2019-11-09 00:00:00+03:00,out,False,945308,False,53,8769,9768,999
168361,2019-11-09 00:00:00+03:00,out,False,945288,False,47,5935,6749,814
168361,2019-11-09 00:00:00+03:00,out,False,945296,True,53,0,820,820
168361,2019-11-09 00:00:00+03:00,out,False,945322,False,70,4833,6287,1454
168361,2019-11-09 00:00:00+03:00,out,False,945288,True,54,0,503,503
168361,2019-11-09 00:00:00+03:00,out,False,945278,True,180,0,2912,2912
168361,2019-11-09 00:00:00+03:00,out,False,945304,True,86,0,1488,1488
168361,2019-11-09 00:00:00+03:00,out,False,945302,False,14,3203,3402,199
168361,2019-11-09 00:00:00+03:00,out,False,945302,True,37,0,273,273
168361,2019-11-09 00:00:00+03:00,out,False,945290,False,32,1170,1925,755
168361,2019-11-09 00:00:00+03:00,out,False,945296,False,22,2770,3173,403
168361,2019-11-09 00:00:00+03:00,out,False,945316,False,20,3903,4273,370
168361,2019-11-09 00:00:00+03:00,out,False,945318,True,72,0,810,810
168361,2019-11-09 00:00:00+03:00,out,False,945282,True,15,0,236,236
168361,2019-11-09 00:00:00+03:00,out,False,945280,True,57,0,2089,2089
168361,2019-11-09 00:00:00+03:00,out,False,945322,True,84,0,1550,1550
168361,2019-11-09 00:00:00+03:00,out,False,945282,False,15,1704,1982,278
168361,2019-11-09 00:00:00+03:00,out,False,945318,False,59,7277,8363,1086
168361,2019-11-09 00:00:00+03:00,out,False,945310,False,61,14038,15289,1251
168361,2019-11-09 00:00:00+03:00,out,False,945310,True,114,0,1262,1262
168361,2019-11-09 00:00:00+03:00,out,False,945320,False,45,7935,8693,758
168361,2019-11-09 00:00:00+03:00,out,False,945314,True,96,0,458,458
168361,2019-11-09 00:00:00+03:00,out,True,945278,True,1,0,1,1
168361,2019-11-09 00:00:00+03:00,out,False,945314,False,11,1396,1632,236
168361,2019-11-09 00:00:00+03:00,out,False,945308,True,84,0,740,740
168361,2019-11-09 00:00:00+03:00,out,False,945278,False,73,4485,6382,1897
168361,2019-11-09 00:00:00+03:00,out,False,945312,True,16,0,284,284
168361,2019-11-09 00:00:00+03:00,out,False,945280,False,48,2191,3215,1024
168361,2019-11-09 00:00:00+03:00,out,False,945316,True,14,0,334,334
168361,2019-11-09 00:00:00+03:00,out,False,945312,False,14,1990,2338,348
168361,2019-11-09 00:00:00+03:00,out,False,945290,True,52,0,1343,1343
168361,2019-11-09 00:00:00+03:00,out,False,945320,True,89,0,767,767
168361,2019-11-09 00:00:00+03:00,in,False,-1,True,6,0,14,14
168361,2019-11-09 00:00:00+03:00,out,False,945304,False,78,10946,12426,1480
168361,2019-11-09 00:00:00+03:00,in,False,-1,True,366,0,1438,1438
168361,2019-11-09 00:00:00+03:00,out,False,945314,False,11,1396,1632,236
168361,2019-11-09 00:00:00+03:00,out,False,945302,True,37,0,273,273
168361,2019-11-09 00:00:00+03:00,in,False,-1,True,366,0,1438,1438
168361,2019-11-10 00:00:00+03:00,out,False,945324,True,95,0,789,789
168361,2019-11-10 00:00:00+03:00,out,False,945314,True,14,0,403,403
168361,2019-11-10 00:00:00+03:00,out,False,945310,True,157,0,1696,1696
168361,2019-11-10 00:00:00+03:00,out,False,945322,True,117,0,2589,2589
168361,2019-11-10 00:00:00+03:00,out,False,945308,True,78,0,690,690
168361,2019-11-10 00:00:00+03:00,out,False,945286,True,154,0,2336,2336
168361,2019-11-10 00:00:00+03:00,out,True,945302,True,2,0,0,0
168361,2019-11-10 00:00:00+03:00,out,False,945288,True,74,0,994,994
168361,2019-11-10 00:00:00+03:00,out,False,945318,False,68,10987,12125,1138
168361,2019-11-10 00:00:00+03:00,out,False,945314,False,31,5619,6155,536
168361,2019-11-10 00:00:00+03:00,out,False,945304,False,75,11608,13019,1411
168361,2019-11-10 00:00:00+03:00,out,False,945324,False,26,2877,3330,453
168361,2019-11-10 00:00:00+03:00,out,False,945278,True,206,0,3110,3110
168361,2019-11-10 00:00:00+03:00,out,False,945302,True,136,0,1880,1880
168361,2019-11-10 00:00:00+03:00,out,False,945320,True,125,0,1481,1481
168361,2019-11-10 00:00:00+03:00,out,False,945310,False,75,16012,17713,1701
168361,2019-11-10 00:00:00+03:00,out,False,945320,False,61,9801,10912,1111
168361,2019-11-10 00:00:00+03:00,out,False,945286,False,58,2119,3546,1427
168361,2019-11-10 00:00:00+03:00,out,False,945322,False,72,3956,5516,1560
168361,2019-11-10 00:00:00+03:00,out,False,945304,True,131,0,1648,1648
168361,2019-11-10 00:00:00+03:00,out,False,945318,True,159,0,1482,1482
168361,2019-11-10 00:00:00+03:00,out,False,945288,False,82,9160,10548,1388
168361,2019-11-10 00:00:00+03:00,out,False,945302,False,108,14796,16855,2059
168361,2019-11-10 00:00:00+03:00,out,False,945278,False,83,4780,6602,1822
168361,2019-11-10 00:00:00+03:00,in,False,-1,True,98,0,249,249
168361,2019-11-10 00:00:00+03:00,out,False,945308,False,46,7091,7886,795
168361,2019-11-10 00:00:00+03:00,out,False,945322,False,72,3956,5516,1560
168361,2019-11-10 00:00:00+03:00,out,False,945320,True,125,0,1481,1481
168361,2019-11-10 00:00:00+03:00,out,False,945308,False,46,7091,7886,795
168361,2019-11-10 00:00:00+03:00,out,False,945304,False,75,11608,13019,1411
168361,2019-11-11 00:00:00+03:00,out,False,945286,False,153,6037,9314,3277
168361,2019-11-11 00:00:00+03:00,out,False,945296,False,39,5123,5863,740
168361,2019-11-11 00:00:00+03:00,out,False,945294,False,83,11492,13190,1698
168361,2019-11-11 00:00:00+03:00,in,False,-1,True,219,0,481,481
168361,2019-11-11 00:00:00+03:00,out,False,945314,True,1,0,42,42
168361,2019-11-11 00:00:00+03:00,out,False,945322,True,85,0,2575,2575
168361,2019-11-11 00:00:00+03:00,out,False,945316,False,29,4284,4835,551
168361,2019-11-11 00:00:00+03:00,out,False,945298,False,57,8685,9618,933
168361,2019-11-11 00:00:00+03:00,out,False,945324,False,76,7218,8924,1706
168361,2019-11-11 00:00:00+03:00,out,False,945282,True,22,0,376,376
168361,2019-11-11 00:00:00+03:00,out,False,945284,False,52,4654,5580,926
168361,2019-11-11 00:00:00+03:00,out,False,945280,True,29,0,597,597
168361,2019-11-11 00:00:00+03:00,out,False,-1,True,1,0,0,0
168361,2019-11-11 00:00:00+03:00,out,True,945298,True,4,0,0,0
168361,2019-11-11 00:00:00+03:00,out,False,945322,False,122,12625,15275,2650
168361,2019-11-11 00:00:00+03:00,out,False,945312,False,62,9535,10663,1128
168361,2019-11-11 00:00:00+03:00,out,False,945302,True,61,0,1953,1953
168361,2019-11-11 00:00:00+03:00,out,False,945294,True,31,0,517,517
168361,2019-11-11 00:00:00+03:00,out,False,945290,False,57,1898,3268,1370
168361,2019-11-11 00:00:00+03:00,out,False,945324,True,43,0,1462,1462
168361,2019-11-11 00:00:00+03:00,out,False,945316,True,26,0,390,390
168361,2019-11-11 00:00:00+03:00,out,False,945284,True,34,0,685,685
168361,2019-11-11 00:00:00+03:00,out,False,945302,False,65,9369,10609,1240
168361,2019-11-11 00:00:00+03:00,out,False,945290,True,79,0,2207,2207
168361,2019-11-11 00:00:00+03:00,out,False,945314,False,8,1482,1630,148
168361,2019-11-11 00:00:00+03:00,out,False,945286,True,153,0,2383,2383
168361,2019-11-11 00:00:00+03:00,out,False,945280,False,53,10008,10893,885
168361,2019-11-11 00:00:00+03:00,out,False,945312,True,29,0,653,653
168361,2019-11-11 00:00:00+03:00,out,False,945296,True,17,0,288,288
168361,2019-11-11 00:00:00+03:00,out,False,945298,True,10,0,276,276
168361,2019-11-11 00:00:00+03:00,out,False,945282,False,65,9481,10603,1122
168361,2019-11-11 00:00:00+03:00,out,False,945290,False,57,1898,3268,1370
168361,2019-11-11 00:00:00+03:00,out,False,945298,False,57,8685,9618,933
168361,2019-11-12 00:00:00+03:00,out,False,945322,True,49,0,1128,1128
168361,2019-11-12 00:00:00+03:00,out,False,945280,False,76,13066,14263,1197
168361,2019-11-12 00:00:00+03:00,out,False,945324,True,29,0,1009,1009
168361,2019-11-12 00:00:00+03:00,out,False,945312,True,32,0,656,656
168361,2019-11-12 00:00:00+03:00,out,False,945324,False,82,8622,10432,1810
168361,2019-11-12 00:00:00+03:00,out,False,945298,True,14,0,513,513
168361,2019-11-12 00:00:00+03:00,out,False,945284,True,16,0,406,406
168361,2019-11-12 00:00:00+03:00,in,False,-1,True,426,0,939,939
168361,2019-11-12 00:00:00+03:00,out,False,945302,True,93,0,2852,2852
168361,2019-11-12 00:00:00+03:00,out,False,945298,False,73,9450,10584,1134
168361,2019-11-12 00:00:00+03:00,out,False,945286,False,113,4331,6744,2413
168361,2019-11-12 00:00:00+03:00,out,False,945282,True,37,0,496,496
168361,2019-11-12 00:00:00+03:00,out,False,945294,True,46,0,1007,1007
168361,2019-11-12 00:00:00+03:00,out,False,945290,True,73,0,1697,1697
168361,2019-11-12 00:00:00+03:00,out,False,945316,False,72,10457,11786,1329
168361,2019-11-12 00:00:00+03:00,out,False,945282,False,79,9123,10536,1413
168361,2019-11-12 00:00:00+03:00,out,False,945296,True,34,0,695,695
168361,2019-11-12 00:00:00+03:00,out,False,945302,False,79,5702,7541,1839
168361,2019-11-12 00:00:00+03:00,out,False,945294,False,87,15390,17231,1841
168361,2019-11-12 00:00:00+03:00,out,False,945312,False,82,11791,13392,1601
168361,2019-11-12 00:00:00+03:00,out,False,945296,False,64,9628,10757,1129
168361,2019-11-12 00:00:00+03:00,out,True,945298,False,1,7,14,7
168361,2019-11-12 00:00:00+03:00,out,False,945322,False,101,8731,10662,1931
168361,2019-11-12 00:00:00+03:00,out,False,945286,True,132,0,2575,2575
168361,2019-11-12 00:00:00+03:00,out,False,945290,False,65,2692,4162,1470
168361,2019-11-12 00:00:00+03:00,out,False,945316,True,47,0,986,986
168361,2019-11-12 00:00:00+03:00,out,False,945280,True,105,0,1635,1635
168361,2019-11-12 00:00:00+03:00,out,False,945284,False,64,4627,5737,1110
168361,2019-11-12 00:00:00+03:00,out,False,945290,False,65,2692,4162,1470
168361,2019-11-12 00:00:00+03:00,out,False,945302,False,79,5702,7541,1839
168361,2019-11-13 00:00:00+03:00,out,False,945324,False,78,6055,7625,1570
168361,2019-11-13 00:00:00+03:00,out,False,945296,False,35,3863,4476,613
168361,2019-11-13 00:00:00+03:00,out,False,-1,True,1,0,0,0
168361,2019-11-13 00:00:00+03:00,out,False,945318,False,87,13133,14836,1703
168361,2019-11-13 00:00:00+03:00,out,False,945290,True,30,0,1071,1071
168361,2019-11-13 00:00:00+03:00,out,False,945310,False,111,22496,24660,2164
168361,2019-11-13 00:00:00+03:00,out,False,945296,True,31,0,563,563
168361,2019-11-13 00:00:00+03:00,out,False,945316,False,24,3255,3697,442
168361,2019-11-13 00:00:00+03:00,out,False,945304,False,92,12738,14599,1861
168361,2019-11-13 00:00:00+03:00,out,False,945308,False,81,12214,13737,1523
168361,2019-11-13 00:00:00+03:00,out,False,945288,True,22,0,645,645
168361,2019-11-13 00:00:00+03:00,out,False,945278,True,90,0,1978,1978
168361,2019-11-13 00:00:00+03:00,out,False,945314,True,23,0,554,554
168361,2019-11-13 00:00:00+03:00,out,False,945322,True,60,0,1162,1162
168361,2019-11-13 00:00:00+03:00,out,False,945308,True,48,0,1093,1093
168361,2019-11-13 00:00:00+03:00,out,False,945290,False,37,1130,1998,868
168361,2019-11-13 00:00:00+03:00,out,False,945316,True,14,0,278,278
168361,2019-11-13 00:00:00+03:00,out,False,945320,False,90,14183,15817,1634
168361,2019-11-13 00:00:00+03:00,in,False,-1,True,414,0,912,912
168361,2019-11-13 00:00:00+03:00,out,False,945310,True,45,0,854,854
168361,2019-11-13 00:00:00+03:00,out,False,945278,False,137,8752,11571,2819
168361,2019-11-13 00:00:00+03:00,out,False,945318,True,30,0,689,689
168361,2019-11-13 00:00:00+03:00,out,False,945314,False,39,4994,5771,777
168361,2019-11-13 00:00:00+03:00,out,False,945302,False,48,5800,6829,1029
168361,2019-11-13 00:00:00+03:00,out,False,945304,True,55,0,1286,1286
168361,2019-11-13 00:00:00+03:00,out,False,945288,False,102,11934,13528,1594
168361,2019-11-13 00:00:00+03:00,out,False,945320,True,25,0,661,661
168361,2019-11-13 00:00:00+03:00,out,False,945324,True,62,0,2321,2321
168361,2019-11-13 00:00:00+03:00,out,False,945302,True,15,0,250,250
168361,2019-11-13 00:00:00+03:00,in,False,-1,True,2,0,6,6
168361,2019-11-13 00:00:00+03:00,out,False,945322,False,48,2356,3434,1078
168361,2019-11-13 00:00:00+03:00,out,True,945324,False,1,4,8,4
168361,2019-11-13 00:00:00+03:00,out,False,945290,True,30,0,1071,1071
168361,2019-11-13 00:00:00+03:00,out,False,945296,False,35,3863,4476,613
168361,2019-11-13 00:00:00+03:00,out,False,945318,False,87,13133,14836,1703
168361,2019-11-13 00:00:00+03:00,out,False,945320,True,25,0,661,661
168361,2019-11-13 00:00:00+03:00,out,False,945322,False,48,2356,3434,1078
168361,2019-11-13 00:00:00+03:00,out,False,945296,True,31,0,563,563
168361,2019-11-14 00:00:00+03:00,out,False,945324,False,78,6484,7927,1443
168361,2019-11-14 00:00:00+03:00,out,False,945304,True,28,0,613,613
168361,2019-11-14 00:00:00+03:00,out,False,945290,True,53,0,1513,1513
168361,2019-11-14 00:00:00+03:00,out,False,945318,False,95,13848,15762,1914
168361,2019-11-14 00:00:00+03:00,out,False,945324,True,80,0,2776,2776
168361,2019-11-14 00:00:00+03:00,out,False,945320,False,87,12375,14117,1742
168361,2019-11-14 00:00:00+03:00,out,False,945304,False,111,14939,17107,2168
168361,2019-11-14 00:00:00+03:00,out,False,945296,True,20,0,380,380
168361,2019-11-14 00:00:00+03:00,out,False,945296,False,20,1754,2117,363
168361,2019-11-14 00:00:00+03:00,out,False,945308,True,30,0,774,774
168361,2019-11-14 00:00:00+03:00,out,False,945290,False,61,2177,3648,1471
168361,2019-11-14 00:00:00+03:00,out,False,945302,True,143,0,4000,4000
168361,2019-11-14 00:00:00+03:00,out,False,945310,False,104,21971,24064,2093
168361,2019-11-14 00:00:00+03:00,out,False,945314,True,18,0,552,552
168361,2019-11-14 00:00:00+03:00,out,False,945278,False,92,12907,14598,1691
168361,2019-11-14 00:00:00+03:00,out,False,945310,True,60,0,1176,1176
168361,2019-11-14 00:00:00+03:00,out,False,945320,True,28,0,630,630
168361,2019-11-14 00:00:00+03:00,out,False,945288,True,25,0,679,679
168361,2019-11-14 00:00:00+03:00,out,False,945318,True,29,0,986,986
168361,2019-11-14 00:00:00+03:00,out,False,945286,True,100,0,2403,2403
168361,2019-11-14 00:00:00+03:00,out,False,945278,True,53,0,844,844
168361,2019-11-14 00:00:00+03:00,out,False,945288,False,92,10687,12072,1385
168361,2019-11-14 00:00:00+03:00,in,False,-1,True,1,0,2,2
168361,2019-11-14 00:00:00+03:00,out,False,945314,False,49,5254,6257,1003
168361,2019-11-14 00:00:00+03:00,out,False,945322,True,88,0,996,996
168361,2019-11-14 00:00:00+03:00,out,False,945322,False,63,3171,4623,1452
168361,2019-11-14 00:00:00+03:00,out,False,945308,False,94,13409,15090,1681
168361,2019-11-14 00:00:00+03:00,in,False,-1,True,451,0,956,956
168361,2019-11-14 00:00:00+03:00,out,False,945286,False,90,5551,7384,1833
168361,2019-11-14 00:00:00+03:00,out,False,945302,False,153,16694,19650,2956
168361,2019-11-14 00:00:00+03:00,out,False,945320,False,87,12375,14117,1742
168361,2019-11-15 00:00:00+03:00,out,False,945322,True,22,0,664,664
168361,2019-11-15 00:00:00+03:00,out,False,945302,False,116,11234,13689,2455
168361,2019-11-15 00:00:00+03:00,out,False,945286,False,130,5074,8053,2979
168361,2019-11-15 00:00:00+03:00,out,True,945282,True,1,0,0,0
168361,2019-11-15 00:00:00+03:00,out,False,945286,True,81,0,1934,1934
168361,2019-11-15 00:00:00+03:00,out,False,945318,False,17,1281,1572,291
168361,2019-11-15 00:00:00+03:00,out,False,945296,True,24,0,558,558
168361,2019-11-15 00:00:00+03:00,out,False,945298,True,14,0,480,480
168361,2019-11-15 00:00:00+03:00,out,False,945284,True,27,0,674,674
168361,2019-11-15 00:00:00+03:00,out,False,945298,False,71,9323,10402,1079
168361,2019-11-15 00:00:00+03:00,out,False,945316,True,24,0,697,697
168361,2019-11-15 00:00:00+03:00,out,False,945294,False,97,14307,16204,1897
168361,2019-11-15 00:00:00+03:00,out,True,945296,True,2,0,0,0
168361,2019-11-15 00:00:00+03:00,out,False,945296,False,35,4796,5376,580
168361,2019-11-15 00:00:00+03:00,out,False,945314,False,17,1371,1738,367
168361,2019-11-15 00:00:00+03:00,out,False,945310,True,68,0,2189,2189
168361,2019-11-15 00:00:00+03:00,out,False,945282,False,70,8692,9893,1201
168361,2019-11-15 00:00:00+03:00,out,False,945290,True,39,0,1118,1118
168361,2019-11-15 00:00:00+03:00,out,False,945322,False,25,899,1456,557
168361,2019-11-15 00:00:00+03:00,out,False,945294,True,55,0,1067,1067
168361,2019-11-15 00:00:00+03:00,out,False,945318,True,20,0,594,594
168361,2019-11-15 00:00:00+03:00,out,False,945282,True,28,0,437,437
168361,2019-11-15 00:00:00+03:00,out,False,945280,False,72,10451,11579,1128
168361,2019-11-15 00:00:00+03:00,out,False,945284,False,65,5176,6308,1132
168361,2019-11-15 00:00:00+03:00,out,False,945312,False,82,10892,12456,1564
168361,2019-11-15 00:00:00+03:00,out,False,945290,False,40,1551,2495,944
168361,2019-11-15 00:00:00+03:00,out,False,945310,False,65,4377,5799,1422
168361,2019-11-15 00:00:00+03:00,out,False,945280,True,150,0,2262,2262
168361,2019-11-15 00:00:00+03:00,out,False,945314,True,26,0,648,648
168361,2019-11-15 00:00:00+03:00,in,False,-1,True,414,0,899,899
168361,2019-11-15 00:00:00+03:00,out,False,945312,True,42,0,933,933
168361,2019-11-15 00:00:00+03:00,out,False,945316,False,44,5756,6457,701
168361,2019-11-15 00:00:00+03:00,out,False,945302,True,121,0,3610,3610
168361,2019-11-15 00:00:00+03:00,out,False,945296,True,24,0,558,558
168361,2019-11-15 00:00:00+03:00,out,False,945322,False,25,899,1456,557
168361,2019-11-16 00:00:00+03:00,out,False,945304,False,65,3090,4376,1286
168361,2019-11-16 00:00:00+03:00,out,False,945294,False,90,12824,14471,1647
168361,2019-11-16 00:00:00+03:00,out,False,945322,True,40,0,1262,1262
168361,2019-11-16 00:00:00+03:00,in,False,-1,True,456,0,938,938
168361,2019-11-16 00:00:00+03:00,out,False,945316,False,68,9106,10320,1214
168361,2019-11-16 00:00:00+03:00,out,False,945280,True,16,0,422,422
168361,2019-11-16 00:00:00+03:00,out,False,945322,False,49,3657,4824,1167
168361,2019-11-16 00:00:00+03:00,out,False,945316,True,27,0,677,677
168361,2019-11-16 00:00:00+03:00,out,False,945290,True,55,0,1322,1322
168361,2019-11-16 00:00:00+03:00,out,False,945282,False,77,9737,10971,1234
168361,2019-11-16 00:00:00+03:00,out,False,945284,False,62,5144,6114,970
168361,2019-11-16 00:00:00+03:00,out,False,945286,False,104,4769,7115,2346
168361,2019-11-16 00:00:00+03:00,out,False,945298,False,73,7707,9044,1337
168361,2019-11-16 00:00:00+03:00,out,False,945312,True,42,0,754,754
168361,2019-11-16 00:00:00+03:00,out,False,945298,True,11,0,466,466
168361,2019-11-16 00:00:00+03:00,out,False,945290,False,41,1806,2691,885
168361,2019-11-16 00:00:00+03:00,out,False,945286,True,92,0,2497,2497
168361,2019-11-16 00:00:00+03:00,out,False,945304,True,35,0,1010,1010
168361,2019-11-16 00:00:00+03:00,out,False,945312,False,83,11693,13381,1688
168361,2019-11-16 00:00:00+03:00,out,False,945296,False,53,7314,8198,884
168361,2019-11-16 00:00:00+03:00,out,True,945284,True,2,0,0,0
168361,2019-11-16 00:00:00+03:00,out,False,945294,True,41,0,595,595
168361,2019-11-16 00:00:00+03:00,out,False,945282,True,27,0,485,485
168361,2019-11-16 00:00:00+03:00,out,False,945284,True,34,0,473,473
168361,2019-11-16 00:00:00+03:00,out,True,945286,True,2,0,0,0
168361,2019-11-16 00:00:00+03:00,out,False,945280,False,72,14290,15566,1276
168361,2019-11-16 00:00:00+03:00,out,False,945296,True,30,0,604,604
168361,2019-11-16 00:00:00+03:00,out,False,945316,True,27,0,677,677
168361,2019-11-16 00:00:00+03:00,out,False,945304,True,35,0,1010,1010
168361,2019-11-16 00:00:00+03:00,out,False,945312,False,83,11693,13381,1688
168361,2019-11-16 00:00:00+03:00,out,True,945286,True,2,0,0,0
168361,2019-11-17 00:00:00+03:00,out,False,945282,True,21,0,872,872
168361,2019-11-17 00:00:00+03:00,out,False,945288,True,25,0,843,843
168361,2019-11-17 00:00:00+03:00,out,False,945310,True,57,0,1468,1468
168361,2019-11-17 00:00:00+03:00,in,False,-1,True,197,0,401,401
168361,2019-11-17 00:00:00+03:00,out,False,945302,False,79,7628,9516,1888
168361,2019-11-17 00:00:00+03:00,out,False,945296,False,63,6630,7794,1164
168361,2019-11-17 00:00:00+03:00,out,False,945288,False,85,10862,12204,1342
168361,2019-11-17 00:00:00+03:00,out,False,945324,False,74,4497,6041,1544
168361,2019-11-17 00:00:00+03:00,out,False,945324,True,56,0,1907,1907
168361,2019-11-17 00:00:00+03:00,out,False,945318,True,31,0,863,863
168361,2019-11-17 00:00:00+03:00,out,False,945278,False,87,11253,12956,1703
168361,2019-11-17 00:00:00+03:00,out,False,945316,False,92,8628,10507,1879
168361,2019-11-17 00:00:00+03:00,out,False,945320,False,80,14552,16077,1525
168361,2019-11-17 00:00:00+03:00,out,False,945302,True,83,0,2115,2115
168361,2019-11-17 00:00:00+03:00,out,False,945278,True,66,0,1595,1595
168361,2019-11-17 00:00:00+03:00,out,False,945310,False,98,19069,21247,2178
168361,2019-11-17 00:00:00+03:00,out,False,945312,True,13,0,467,467
168361,2019-11-17 00:00:00+03:00,out,False,945320,True,25,0,470,470
168361,2019-11-17 00:00:00+03:00,out,False,945314,True,24,0,612,612
168361,2019-11-17 00:00:00+03:00,out,False,945312,False,15,1824,2125,301
168361,2019-11-17 00:00:00+03:00,out,False,945314,False,39,5274,6094,820
168361,2019-11-17 00:00:00+03:00,out,False,945304,True,59,0,587,587
168361,2019-11-17 00:00:00+03:00,out,False,945316,True,82,0,1851,1851
168361,2019-11-17 00:00:00+03:00,out,False,945282,False,28,2171,2874,703
168361,2019-11-17 00:00:00+03:00,out,False,945296,True,48,0,1104,1104
168361,2019-11-17 00:00:00+03:00,out,False,945318,False,84,11526,13089,1563
168361,2019-11-17 00:00:00+03:00,out,False,945304,False,87,14157,15816,1659
168361,2019-11-17 00:00:00+03:00,out,False,945278,True,66,0,1595,1595
168361,2019-11-17 00:00:00+03:00,out,False,945302,True,83,0,2115,2115
168361,2019-11-17 00:00:00+03:00,out,False,945296,False,63,6630,7794,1164
168361,2019-11-18 00:00:00+03:00,out,False,945302,False,149,14618,17723,3105
168361,2019-11-18 00:00:00+03:00,in,False,-1,True,448,0,983,983
168361,2019-11-18 00:00:00+03:00,out,False,945312,True,3,0,174,174
168361,2019-11-18 00:00:00+03:00,out,False,945288,False,74,8781,10055,1274
168361,2019-11-18 00:00:00+03:00,out,False,945316,False,37,1965,2761,796
168361,2019-11-18 00:00:00+03:00,out,False,945278,False,91,9724,11460,1736
168361,2019-11-18 00:00:00+03:00,out,False,945322,False,47,2993,4183,1190
168361,2019-11-18 00:00:00+03:00,out,False,945322,True,49,0,1329,1329
168361,2019-11-18 00:00:00+03:00,out,False,945310,False,77,16617,18297,1680
168361,2019-11-18 00:00:00+03:00,out,False,945296,False,18,1588,1911,323
168361,2019-11-18 00:00:00+03:00,out,False,945324,False,69,6225,7747,1522
168361,2019-11-18 00:00:00+03:00,out,False,945286,True,123,0,2250,2250
168361,2019-11-18 00:00:00+03:00,out,False,945324,True,49,0,1899,1899
168361,2019-11-18 00:00:00+03:00,out,False,945304,True,44,0,644,644
168361,2019-11-18 00:00:00+03:00,out,False,945314,True,26,0,443,443
168361,2019-11-18 00:00:00+03:00,out,False,945312,False,12,1939,2216,277
168361,2019-11-18 00:00:00+03:00,out,False,945304,False,75,12198,13791,1593
168361,2019-11-18 00:00:00+03:00,out,False,945320,True,26,0,492,492
168361,2019-11-18 00:00:00+03:00,out,True,945316,True,2,0,0,0
168361,2019-11-18 00:00:00+03:00,out,False,945290,False,48,1912,2977,1065
168361,2019-11-18 00:00:00+03:00,out,False,945278,True,66,0,1047,1047
168361,2019-11-18 00:00:00+03:00,out,False,945310,True,29,0,1136,1136
168361,2019-11-18 00:00:00+03:00,out,False,945282,False,35,4354,4922,568
168361,2019-11-18 00:00:00+03:00,out,False,945316,True,42,0,903,903
168361,2019-11-18 00:00:00+03:00,out,False,945282,True,30,0,651,651
168361,2019-11-18 00:00:00+03:00,out,False,945288,True,26,0,849,849
168361,2019-11-18 00:00:00+03:00,out,False,945302,True,155,0,3332,3332
168361,2019-11-18 00:00:00+03:00,out,False,945314,False,33,5319,5940,621
168361,2019-11-18 00:00:00+03:00,out,True,945314,True,1,0,0,0
168361,2019-11-18 00:00:00+03:00,out,False,945318,False,79,11753,13268,1515
168361,2019-11-18 00:00:00+03:00,out,False,945290,True,63,0,1709,1709
168361,2019-11-18 00:00:00+03:00,out,False,945320,False,72,9800,11106,1306
168361,2019-11-18 00:00:00+03:00,out,False,945318,True,32,0,858,858
168361,2019-11-18 00:00:00+03:00,out,False,945296,True,31,0,659,659
168361,2019-11-18 00:00:00+03:00,out,False,945286,False,135,5441,8275,2834
168361,2019-11-18 00:00:00+03:00,out,False,945312,False,12,1939,2216,277
168361,2019-11-18 00:00:00+03:00,out,False,945286,False,135,5441,8275,2834
168361,2019-11-18 00:00:00+03:00,out,False,945310,False,77,16617,18297,1680
168361,2019-11-18 00:00:00+03:00,out,False,945302,True,155,0,3332,3332
168361,2019-11-18 00:00:00+03:00,out,False,945288,True,26,0,849,849
168361,2019-11-19 00:00:00+03:00,out,False,945296,False,28,3950,4464,514
168361,2019-11-19 00:00:00+03:00,out,False,945322,True,34,0,714,714
168361,2019-11-19 00:00:00+03:00,in,False,-1,True,412,0,907,907
168361,2019-11-19 00:00:00+03:00,out,False,945296,True,18,0,372,372
168361,2019-11-19 00:00:00+03:00,out,False,945324,False,60,3614,4854,1240
168361,2019-11-19 00:00:00+03:00,out,False,945302,True,89,0,2081,2081
168361,2019-11-19 00:00:00+03:00,out,False,945312,True,25,0,615,615
168361,2019-11-19 00:00:00+03:00,out,False,965544,True,30,0,549,549
168361,2019-11-19 00:00:00+03:00,out,False,945284,True,67,0,1243,1243
168361,2019-11-19 00:00:00+03:00,out,False,945290,False,80,2694,4701,2007
168361,2019-11-19 00:00:00+03:00,out,False,965540,True,16,0,550,550
168361,2019-11-19 00:00:00+03:00,out,False,945314,False,9,1709,1894,185
168361,2019-11-19 00:00:00+03:00,out,False,-1,True,1,0,0,0
168361,2019-11-19 00:00:00+03:00,out,False,965538,False,12,666,1050,384
168361,2019-11-19 00:00:00+03:00,out,False,945280,False,43,5469,6271,802
168361,2019-11-19 00:00:00+03:00,out,False,965542,True,15,0,612,612
168361,2019-11-19 00:00:00+03:00,out,False,945310,False,45,3020,4180,1160
168361,2019-11-19 00:00:00+03:00,out,False,945312,False,54,10208,11180,972
168361,2019-11-19 00:00:00+03:00,out,False,945286,True,163,0,2549,2549
168361,2019-11-19 00:00:00+03:00,out,False,945290,True,68,0,1968,1968
168361,2019-11-19 00:00:00+03:00,out,False,945298,True,16,0,620,620
168361,2019-11-19 00:00:00+03:00,out,False,945314,True,2,0,9,9
168361,2019-11-19 00:00:00+03:00,out,False,945324,True,30,0,792,792
168361,2019-11-19 00:00:00+03:00,out,False,945282,False,58,6837,7981,1144
168361,2019-11-19 00:00:00+03:00,out,False,965544,False,22,3046,3516,470
168361,2019-11-19 00:00:00+03:00,out,False,945294,False,101,10777,12870,2093
168361,2019-11-19 00:00:00+03:00,out,False,945284,False,69,5372,6550,1178
168361,2019-11-19 00:00:00+03:00,out,False,945316,True,59,0,1255,1255
168361,2019-11-19 00:00:00+03:00,out,False,945298,False,52,6725,7693,968
168361,2019-11-19 00:00:00+03:00,out,False,965542,False,10,981,1176,195
168361,2019-11-19 00:00:00+03:00,out,False,945310,True,48,0,1479,1479
168361,2019-11-19 00:00:00+03:00,out,False,945322,False,64,6931,8143,1212
168361,2019-11-19 00:00:00+03:00,out,True,945298,True,6,0,0,0
168361,2019-11-19 00:00:00+03:00,out,True,965542,False,1,2,6,4
168361,2019-11-19 00:00:00+03:00,out,False,945286,False,124,4900,7682,2782
168361,2019-11-19 00:00:00+03:00,out,False,945316,False,52,6557,7540,983
168361,2019-11-19 00:00:00+03:00,out,False,965540,False,26,2188,2817,629
168361,2019-11-19 00:00:00+03:00,out,False,945280,True,58,0,733,733
168361,2019-11-19 00:00:00+03:00,out,False,945302,False,101,9092,11428,2336
168361,2019-11-19 00:00:00+03:00,out,False,945282,True,39,0,897,897
168361,2019-11-19 00:00:00+03:00,out,False,945294,True,46,0,649,649
168361,2019-11-19 00:00:00+03:00,out,True,945280,True,3,0,0,0
168361,2019-11-19 00:00:00+03:00,out,False,965538,True,21,0,404,404
168361,2019-11-19 00:00:00+03:00,out,False,965540,False,26,2188,2817,629
168361,2019-11-19 00:00:00+03:00,out,False,945296,True,18,0,372,372
168361,2019-11-19 00:00:00+03:00,out,False,965540,True,16,0,550,550
168361,2019-11-19 00:00:00+03:00,out,False,945286,False,124,4900,7682,2782
168361,2019-11-20 00:00:00+03:00,out,False,945312,False,102,13787,15704,1917
168361,2019-11-20 00:00:00+03:00,out,False,945322,True,64,0,1239,1239
168361,2019-11-20 00:00:00+03:00,out,False,945282,False,105,13130,14931,1801
168361,2019-11-20 00:00:00+03:00,out,False,-1,True,3,0,2,2
168361,2019-11-20 00:00:00+03:00,out,False,945290,False,58,2101,3479,1378
168361,2019-11-20 00:00:00+03:00,out,False,945286,False,151,5365,8786,3421
168361,2019-11-20 00:00:00+03:00,out,False,945296,True,47,0,854,854
168361,2019-11-20 00:00:00+03:00,out,False,945284,False,85,7640,9122,1482
168361,2019-11-20 00:00:00+03:00,out,False,965544,False,58,5214,6406,1192
168361,2019-11-20 00:00:00+03:00,out,False,945320,True,13,0,391,391
168361,2019-11-20 00:00:00+03:00,out,False,965542,True,88,0,2304,2304
168361,2019-11-20 00:00:00+03:00,out,True,965544,True,1,0,1,1
168361,2019-11-20 00:00:00+03:00,out,False,945320,False,20,1989,2399,410
168361,2019-11-20 00:00:00+03:00,out,False,945316,False,75,10276,11700,1424
168361,2019-11-20 00:00:00+03:00,out,False,945280,True,171,0,2238,2238
168361,2019-11-20 00:00:00+03:00,out,False,945324,False,64,3348,4761,1413
168361,2019-11-20 00:00:00+03:00,out,False,945316,True,36,0,642,642
168361,2019-11-20 00:00:00+03:00,out,True,945298,False,1,3,7,4
168361,2019-11-20 00:00:00+03:00,out,False,945312,True,42,0,759,759
168361,2019-11-20 00:00:00+03:00,out,False,945298,False,95,11971,13545,1574
168361,2019-11-20 00:00:00+03:00,out,False,945294,False,122,14729,17181,2452
168361,2019-11-20 00:00:00+03:00,out,True,965542,True,8,0,0,0
168361,2019-11-20 00:00:00+03:00,out,False,945282,True,44,0,644,644
168361,2019-11-20 00:00:00+03:00,out,False,945280,False,91,11363,12921,1558
168361,2019-11-20 00:00:00+03:00,out,False,945302,False,87,5933,7717,1784
168361,2019-11-20 00:00:00+03:00,out,False,945290,True,51,0,1653,1653
168361,2019-11-20 00:00:00+03:00,out,False,945296,False,52,7469,8356,887
168361,2019-11-20 00:00:00+03:00,out,False,965540,True,66,0,2136,2136
168361,2019-11-20 00:00:00+03:00,out,False,965542,False,93,10015,11703,1688
168361,2019-11-20 00:00:00+03:00,out,False,965544,True,57,0,1097,1097
168361,2019-11-20 00:00:00+03:00,out,False,945284,True,54,0,1070,1070
168361,2019-11-20 00:00:00+03:00,in,False,-1,True,495,0,1078,1078
168361,2019-11-20 00:00:00+03:00,out,False,945302,True,133,0,3513,3513
168361,2019-11-20 00:00:00+03:00,out,False,945294,True,67,0,1463,1463
168361,2019-11-20 00:00:00+03:00,out,False,945324,True,37,0,1398,1398
168361,2019-11-20 00:00:00+03:00,out,False,945322,False,120,11213,13667,2454
168361,2019-11-20 00:00:00+03:00,out,False,945286,True,151,0,2274,2274
168361,2019-11-20 00:00:00+03:00,out,False,965540,False,80,8965,10785,1820
168361,2019-11-20 00:00:00+03:00,out,False,945298,True,15,0,504,504
168361,2019-11-20 00:00:00+03:00,out,True,945298,False,1,3,7,4
168361,2019-11-20 00:00:00+03:00,out,False,945298,False,95,11971,13545,1574
168361,2019-11-20 00:00:00+03:00,out,False,945290,False,58,2101,3479,1378
168361,2019-11-21 00:00:00+03:00,out,False,945324,False,59,4876,6124,1248
168361,2019-11-21 00:00:00+03:00,out,False,965542,False,118,18267,20495,2228
168361,2019-11-21 00:00:00+03:00,out,False,945290,False,55,1673,2859,1186
168361,2019-11-21 00:00:00+03:00,out,True,965542,True,5,0,0,0
168361,2019-11-21 00:00:00+03:00,out,False,945310,False,118,22174,24638,2464
168361,2019-11-21 00:00:00+03:00,out,False,945302,True,102,0,2586,2586
168361,2019-11-21 00:00:00+03:00,out,False,945288,True,31,0,1046,1046
168361,2019-11-21 00:00:00+03:00,out,False,945316,True,51,0,781,781
168361,2019-11-21 00:00:00+03:00,out,False,945282,False,38,2529,3304,775
168361,2019-11-21 00:00:00+03:00,out,False,945296,True,53,0,993,993
168361,2019-11-21 00:00:00+03:00,out,False,965540,True,44,0,1543,1543
168361,2019-11-21 00:00:00+03:00,out,False,965538,True,28,0,354,354
168361,2019-11-21 00:00:00+03:00,out,False,965542,True,55,0,2013,2013
168361,2019-11-21 00:00:00+03:00,out,False,945322,False,89,5101,6991,1890
168361,2019-11-21 00:00:00+03:00,out,False,945310,True,87,0,1874,1874
168361,2019-11-21 00:00:00+03:00,out,False,945304,False,118,20073,22313,2240
168361,2019-11-21 00:00:00+03:00,out,False,945314,False,57,4632,5916,1284
168361,2019-11-21 00:00:00+03:00,out,False,965544,False,167,21570,24141,2571
168361,2019-11-21 00:00:00+03:00,out,False,945316,False,71,9174,10421,1247
168361,2019-11-21 00:00:00+03:00,out,False,945278,False,152,8932,12195,3263
168361,2019-11-21 00:00:00+03:00,out,False,945324,True,37,0,1080,1080
168361,2019-11-21 00:00:00+03:00,out,False,945278,True,72,0,2000,2000
168361,2019-11-21 00:00:00+03:00,out,False,945320,True,29,0,688,688
168361,2019-11-21 00:00:00+03:00,out,False,965538,False,28,4413,4952,539
168361,2019-11-21 00:00:00+03:00,out,False,945314,True,38,0,1386,1386
168361,2019-11-21 00:00:00+03:00,out,False,945296,False,74,7543,8817,1274
168361,2019-11-21 00:00:00+03:00,out,False,945320,False,122,17519,19793,2274
168361,2019-11-21 00:00:00+03:00,out,False,965540,False,93,11323,12912,1589
168361,2019-11-21 00:00:00+03:00,out,False,945288,False,129,13712,15743,2031
168361,2019-11-21 00:00:00+03:00,out,False,945290,True,52,0,1309,1309
168361,2019-11-21 00:00:00+03:00,out,False,945304,True,60,0,1114,1114
168361,2019-11-21 00:00:00+03:00,out,False,965544,True,104,0,2193,2193
168361,2019-11-21 00:00:00+03:00,out,False,945322,True,71,0,1671,1671
168361,2019-11-21 00:00:00+03:00,out,False,-1,True,1,0,0,0
168361,2019-11-21 00:00:00+03:00,out,False,945282,True,51,0,1563,1563
168361,2019-11-21 00:00:00+03:00,out,False,945302,False,82,8715,10445,1730
168361,2019-11-21 00:00:00+03:00,in,False,-1,True,451,0,968,968
168361,2019-11-21 00:00:00+03:00,out,False,945282,False,38,2529,3304,775
168361,2019-11-22 00:00:00+03:00,out,False,945322,True,70,0,1157,1157
168361,2019-11-22 00:00:00+03:00,out,False,945278,False,116,18552,20686,2134
168361,2019-11-22 00:00:00+03:00,out,False,945280,False,51,5294,6397,1103
168361,2019-11-22 00:00:00+03:00,out,False,945322,False,87,5085,6958,1873
168361,2019-11-22 00:00:00+03:00,out,False,945282,False,21,1213,1719,506
168361,2019-11-22 00:00:00+03:00,out,False,945314,True,36,0,1160,1160
168361,2019-11-22 00:00:00+03:00,out,False,945320,False,138,17575,20263,2688
168361,2019-11-22 00:00:00+03:00,out,False,965544,False,135,19337,21618,2281
168361,2019-11-22 00:00:00+03:00,out,False,945304,True,61,0,1166,1166
168361,2019-11-22 00:00:00+03:00,out,False,945304,False,111,17097,19154,2057
168361,2019-11-22 00:00:00+03:00,out,False,945296,True,29,0,613,613
168361,2019-11-22 00:00:00+03:00,out,False,945314,False,33,3566,4248,682
168361,2019-11-22 00:00:00+03:00,out,False,945280,True,68,0,2027,2027
168361,2019-11-22 00:00:00+03:00,out,False,945288,True,39,0,1017,1017
168361,2019-11-22 00:00:00+03:00,out,False,945296,False,21,1813,2261,448
168361,2019-11-22 00:00:00+03:00,in,False,-1,True,559,0,1218,1218
168361,2019-11-22 00:00:00+03:00,out,False,945310,False,138,25153,27765,2612
168361,2019-11-22 00:00:00+03:00,out,False,945286,False,142,4662,7712,3050
168361,2019-11-22 00:00:00+03:00,out,False,945310,True,49,0,1395,1395
168361,2019-11-22 00:00:00+03:00,out,False,965540,False,70,10773,11999,1226
168361,2019-11-22 00:00:00+03:00,out,False,945312,True,6,0,255,255
168361,2019-11-22 00:00:00+03:00,out,False,945278,True,57,0,993,993
168361,2019-11-22 00:00:00+03:00,out,False,945286,True,126,0,2018,2018
168361,2019-11-22 00:00:00+03:00,out,False,945282,True,33,0,1352,1352
168361,2019-11-22 00:00:00+03:00,out,False,965538,False,73,11774,13184,1410
168361,2019-11-22 00:00:00+03:00,out,False,945290,True,73,0,2262,2262
168361,2019-11-22 00:00:00+03:00,out,False,945320,True,42,0,873,873
168361,2019-11-22 00:00:00+03:00,out,False,945288,False,132,13372,15650,2278
168361,2019-11-22 00:00:00+03:00,out,False,965544,True,126,0,2757,2757
168361,2019-11-22 00:00:00+03:00,out,False,945302,True,41,0,877,877
168361,2019-11-22 00:00:00+03:00,out,False,945302,False,30,3149,3882,733
168361,2019-11-22 00:00:00+03:00,out,False,945312,False,16,1858,2221,363
168361,2019-11-22 00:00:00+03:00,out,False,965540,True,28,0,827,827
168361,2019-11-22 00:00:00+03:00,out,False,945290,False,80,2227,4111,1884
168361,2019-11-22 00:00:00+03:00,out,False,965538,True,43,0,1121,1121
168361,2019-11-22 00:00:00+03:00,out,False,945286,False,142,4662,7712,3050
168361,2019-11-22 00:00:00+03:00,out,False,945280,False,51,5294,6397,1103
168361,2019-11-22 00:00:00+03:00,out,False,965538,False,73,11774,13184,1410
168361,2019-11-22 00:00:00+03:00,in,False,-1,True,559,0,1218,1218
168361,2019-11-23 00:00:00+03:00,out,False,945290,False,31,1150,1892,742
168361,2019-11-23 00:00:00+03:00,out,False,945322,False,86,9610,11427,1817
168361,2019-11-23 00:00:00+03:00,out,False,945316,True,11,0,337,337
168361,2019-11-23 00:00:00+03:00,out,False,945296,True,21,0,369,369
168361,2019-11-23 00:00:00+03:00,out,False,945314,False,26,2632,3207,575
168361,2019-11-23 00:00:00+03:00,out,False,945316,False,26,3270,3752,482
168361,2019-11-23 00:00:00+03:00,out,False,945298,True,7,0,350,350
168361,2019-11-23 00:00:00+03:00,out,False,965538,False,44,4897,5658,761
168361,2019-11-23 00:00:00+03:00,out,False,945286,True,192,0,3545,3545
168361,2019-11-23 00:00:00+03:00,out,False,945312,True,41,0,581,581
168361,2019-11-23 00:00:00+03:00,out,False,945280,False,79,12608,14111,1503
168361,2019-11-23 00:00:00+03:00,out,False,965540,False,70,8857,10055,1198
168361,2019-11-23 00:00:00+03:00,out,False,945286,False,155,5571,8918,3347
168361,2019-11-23 00:00:00+03:00,out,False,945294,False,116,12356,14669,2313
168361,2019-11-23 00:00:00+03:00,out,False,965538,True,32,0,540,540
168361,2019-11-23 00:00:00+03:00,out,False,945284,False,81,5922,7260,1338
168361,2019-11-23 00:00:00+03:00,out,False,945302,False,61,4291,5532,1241
168361,2019-11-23 00:00:00+03:00,out,False,945296,False,24,3326,3783,457
168361,2019-11-23 00:00:00+03:00,in,False,-1,True,409,0,843,843
168361,2019-11-23 00:00:00+03:00,out,False,945290,True,39,0,1319,1319
168361,2019-11-23 00:00:00+03:00,out,False,945312,False,83,11000,12513,1513
168361,2019-11-23 00:00:00+03:00,out,False,945284,True,35,0,850,850
168361,2019-11-23 00:00:00+03:00,out,False,945294,True,75,0,1283,1283
168361,2019-11-23 00:00:00+03:00,out,False,965540,True,51,0,1912,1912
168361,2019-11-23 00:00:00+03:00,out,False,945298,False,70,10142,11344,1202
168361,2019-11-23 00:00:00+03:00,out,False,945314,True,35,0,1000,1000
168361,2019-11-23 00:00:00+03:00,out,False,945310,False,39,6928,7795,867
168361,2019-11-23 00:00:00+03:00,out,False,945282,True,28,0,648,648
168361,2019-11-23 00:00:00+03:00,out,False,945282,False,81,9626,10867,1241
168361,2019-11-23 00:00:00+03:00,out,False,945302,True,78,0,2419,2419
168361,2019-11-23 00:00:00+03:00,out,False,945280,True,17,0,394,394
168361,2019-11-23 00:00:00+03:00,out,False,945310,True,53,0,1179,1179
168361,2019-11-23 00:00:00+03:00,out,False,945322,True,52,0,1395,1395
168361,2019-11-23 00:00:00+03:00,out,False,965540,False,70,8857,10055,1198
168361,2019-11-23 00:00:00+03:00,out,False,945296,True,21,0,369,369
168361,2019-11-24 00:00:00+03:00,out,False,945312,True,27,0,451,451
168361,2019-11-24 00:00:00+03:00,out,False,945294,True,34,0,548,548
168361,2019-11-24 00:00:00+03:00,out,False,945322,True,54,0,1283,1283
168361,2019-11-24 00:00:00+03:00,out,False,945298,False,73,9385,10547,1162
168361,2019-11-24 00:00:00+03:00,out,False,945310,False,44,5367,6705,1338
168361,2019-11-24 00:00:00+03:00,out,False,945324,False,73,3579,5153,1574
168361,2019-11-24 00:00:00+03:00,out,False,945294,False,86,11861,13497,1636
168361,2019-11-24 00:00:00+03:00,out,False,965540,True,58,0,2205,2205
168361,2019-11-24 00:00:00+03:00,out,False,945282,True,21,0,387,387
168361,2019-11-24 00:00:00+03:00,out,False,945284,False,70,6049,7190,1141
168361,2019-11-24 00:00:00+03:00,out,False,965540,False,64,7364,8752,1388
168361,2019-11-24 00:00:00+03:00,out,False,945280,False,65,9991,11154,1163
168361,2019-11-24 00:00:00+03:00,in,False,-1,True,198,0,408,408
168361,2019-11-24 00:00:00+03:00,out,False,945298,True,14,0,472,472
168361,2019-11-24 00:00:00+03:00,out,False,945322,False,88,11196,12888,1692
168361,2019-11-24 00:00:00+03:00,out,False,945296,True,35,0,773,773
168361,2019-11-24 00:00:00+03:00,out,False,945324,True,50,0,1788,1788
168361,2019-11-24 00:00:00+03:00,out,False,945282,False,83,10428,11732,1304
168361,2019-11-24 00:00:00+03:00,out,False,945302,False,71,4592,6006,1414
168361,2019-11-24 00:00:00+03:00,out,False,945280,True,35,0,614,614
168361,2019-11-24 00:00:00+03:00,out,False,945284,True,43,0,710,710
168361,2019-11-24 00:00:00+03:00,out,False,945316,False,82,11310,12821,1511
168361,2019-11-24 00:00:00+03:00,out,False,945296,False,67,9924,10993,1069
168361,2019-11-24 00:00:00+03:00,out,False,945312,False,82,12538,14006,1468
168361,2019-11-24 00:00:00+03:00,out,False,945278,False,89,7488,9409,1921
168361,2019-11-24 00:00:00+03:00,out,False,945286,False,94,5681,7579,1898
168361,2019-11-24 00:00:00+03:00,out,False,945310,True,42,0,1176,1176
168361,2019-11-24 00:00:00+03:00,out,False,945278,True,69,0,1936,1936
168361,2019-11-24 00:00:00+03:00,out,False,945302,True,63,0,1634,1634
168361,2019-11-24 00:00:00+03:00,out,False,945316,True,47,0,760,760
168361,2019-11-24 00:00:00+03:00,out,False,945286,True,152,0,2186,2186
168361,2019-11-24 00:00:00+03:00,out,False,945280,True,35,0,614,614
168361,2019-11-24 00:00:00+03:00,out,False,945282,False,83,10428,11732,1304
168361,2019-11-24 00:00:00+03:00,out,False,945310,False,44,5367,6705,1338
168361,2019-11-24 00:00:00+03:00,out,False,945316,False,82,11310,12821,1511
168361,2019-11-24 00:00:00+03:00,out,False,945316,True,47,0,760,760
168361,2019-11-24 00:00:00+03:00,out,False,945278,False,89,7488,9409,1921
168361,2019-11-25 00:00:00+03:00,out,False,945316,True,36,0,515,515
168361,2019-11-25 00:00:00+03:00,out,False,945278,True,73,0,2190,2190
168361,2019-11-25 00:00:00+03:00,out,False,965544,True,150,0,3395,3395
168361,2019-11-25 00:00:00+03:00,out,False,965538,True,20,0,384,384
168361,2019-11-25 00:00:00+03:00,out,False,945322,False,107,5690,8062,2372
168361,2019-11-25 00:00:00+03:00,out,False,945318,False,78,11711,12900,1189
168361,2019-11-25 00:00:00+03:00,out,False,965544,False,125,16545,18792,2247
168361,2019-11-25 00:00:00+03:00,out,False,945290,True,28,0,777,777
168361,2019-11-25 00:00:00+03:00,out,False,965540,True,2,0,62,62
168361,2019-11-25 00:00:00+03:00,out,False,965542,False,95,12456,14459,2003
168361,2019-11-25 00:00:00+03:00,out,False,945304,False,72,13071,14346,1275
168361,2019-11-25 00:00:00+03:00,out,False,945310,True,81,0,1693,1693
168361,2019-11-25 00:00:00+03:00,out,False,965538,False,17,3319,3668,349
168361,2019-11-25 00:00:00+03:00,out,False,945290,False,20,598,965,367
168361,2019-11-25 00:00:00+03:00,out,False,945288,True,46,0,1110,1110
168361,2019-11-25 00:00:00+03:00,out,False,945320,False,77,7986,9548,1562
168361,2019-11-25 00:00:00+03:00,out,False,945296,True,56,0,1213,1213
168361,2019-11-25 00:00:00+03:00,out,False,945314,True,87,0,2418,2418
168361,2019-11-25 00:00:00+03:00,out,False,945320,True,64,0,1358,1358
168361,2019-11-25 00:00:00+03:00,out,False,945310,False,111,20285,22767,2482
168361,2019-11-25 00:00:00+03:00,out,False,965542,True,60,0,1480,1480
168361,2019-11-25 00:00:00+03:00,out,False,965540,False,25,5157,5591,434
168361,2019-11-25 00:00:00+03:00,out,False,945318,True,26,0,476,476
168361,2019-11-25 00:00:00+03:00,out,False,945322,True,96,0,1928,1928
168361,2019-11-25 00:00:00+03:00,out,False,945296,False,49,5803,6592,789
168361,2019-11-25 00:00:00+03:00,out,False,945316,False,42,5999,6672,673
168361,2019-11-25 00:00:00+03:00,out,False,945304,True,51,0,1300,1300
168361,2019-11-25 00:00:00+03:00,out,False,945314,False,97,12458,14156,1698
168361,2019-11-25 00:00:00+03:00,out,False,945278,False,166,9027,12782,3755
168361,2019-11-25 00:00:00+03:00,out,False,945288,False,99,9966,11669,1703
168361,2019-11-25 00:00:00+03:00,in,False,-1,True,465,0,1012,1012
168361,2019-11-25 00:00:00+03:00,out,False,945320,False,77,7986,9548,1562
168361,2019-11-25 00:00:00+03:00,out,False,945314,True,87,0,2418,2418
168361,2019-11-25 00:00:00+03:00,out,False,965542,False,95,12456,14459,2003
168361,2019-11-26 00:00:00+03:00,out,False,945302,False,96,6074,8274,2200
168361,2019-11-26 00:00:00+03:00,out,False,945314,False,80,7271,8684,1413
168361,2019-11-26 00:00:00+03:00,out,False,965542,True,55,0,1850,1850
168361,2019-11-26 00:00:00+03:00,out,False,945322,True,93,0,2384,2384
168361,2019-11-26 00:00:00+03:00,in,False,-1,True,604,0,1331,1331
168361,2019-11-26 00:00:00+03:00,out,False,945290,False,36,1224,2171,947
168361,2019-11-26 00:00:00+03:00,out,False,945286,False,115,4293,6820,2527
168361,2019-11-26 00:00:00+03:00,out,False,945310,False,75,16418,18165,1747
168361,2019-11-26 00:00:00+03:00,out,False,965544,True,200,0,4342,4342
168361,2019-11-26 00:00:00+03:00,out,False,945318,True,31,0,415,415
168361,2019-11-26 00:00:00+03:00,out,False,945318,False,60,6828,7926,1098
168361,2019-11-26 00:00:00+03:00,out,False,965542,False,78,10539,12084,1545
168361,2019-11-26 00:00:00+03:00,out,False,945278,False,62,9841,10990,1149
168361,2019-11-26 00:00:00+03:00,out,False,945316,False,83,6047,7860,1813
168361,2019-11-26 00:00:00+03:00,out,False,965544,False,102,12989,14963,1974
168361,2019-11-26 00:00:00+03:00,out,False,945288,True,18,0,630,630
168361,2019-11-26 00:00:00+03:00,out,False,965538,True,42,0,802,802
168361,2019-11-26 00:00:00+03:00,out,False,945304,False,66,7919,9112,1193
168361,2019-11-26 00:00:00+03:00,out,False,945286,True,152,0,2630,2630
168361,2019-11-26 00:00:00+03:00,out,False,945316,True,109,0,2638,2638
168361,2019-11-26 00:00:00+03:00,out,False,945310,True,45,0,1422,1422
168361,2019-11-26 00:00:00+03:00,out,False,945288,False,58,6037,6940,903
168361,2019-11-26 00:00:00+03:00,out,False,945302,True,77,0,2347,2347
168361,2019-11-26 00:00:00+03:00,out,False,965538,False,59,9726,10881,1155
168361,2019-11-26 00:00:00+03:00,out,False,945314,True,47,0,1217,1217
168361,2019-11-26 00:00:00+03:00,out,False,965540,True,15,0,617,617
168361,2019-11-26 00:00:00+03:00,out,False,945320,True,54,0,1117,1117
168361,2019-11-26 00:00:00+03:00,out,False,945320,False,66,6653,8081,1428
168361,2019-11-26 00:00:00+03:00,out,False,945290,True,22,0,645,645
168361,2019-11-26 00:00:00+03:00,out,False,965540,False,55,9940,10706,766
168361,2019-11-26 00:00:00+03:00,out,False,945322,False,129,8138,10921,2783
168361,2019-11-26 00:00:00+03:00,out,False,945278,True,63,0,1161,1161
168361,2019-11-26 00:00:00+03:00,out,False,945304,True,42,0,780,780
168361,2019-11-27 00:00:00+03:00,out,False,945312,True,44,0,1124,1124
168361,2019-11-27 00:00:00+03:00,out,False,945314,True,8,0,145,145
168361,2019-11-27 00:00:00+03:00,out,False,945286,False,159,4725,8206,3481
168361,2019-11-27 00:00:00+03:00,out,False,965538,True,21,0,434,434
168361,2019-11-27 00:00:00+03:00,out,False,945290,False,47,1549,2608,1059
168361,2019-11-27 00:00:00+03:00,out,False,945314,False,18,2334,2692,358
168361,2019-11-27 00:00:00+03:00,out,False,945302,False,88,13618,15173,1555
168361,2019-11-27 00:00:00+03:00,out,False,945294,False,120,13997,16165,2168
168361,2019-11-27 00:00:00+03:00,out,False,945296,False,31,3405,3946,541
168361,2019-11-27 00:00:00+03:00,out,False,945284,True,53,0,1001,1001
168361,2019-11-27 00:00:00+03:00,out,False,945284,False,72,4724,5928,1204
168361,2019-11-27 00:00:00+03:00,out,False,945280,False,59,7802,8678,876
168361,2019-11-27 00:00:00+03:00,in,False,-1,True,698,0,1500,1500
168361,2019-11-27 00:00:00+03:00,out,False,945294,True,71,0,1608,1608
168361,2019-11-27 00:00:00+03:00,out,False,945324,True,23,0,769,769
168361,2019-11-27 00:00:00+03:00,out,False,945286,True,236,0,3631,3631
168361,2019-11-27 00:00:00+03:00,out,False,945312,False,75,12093,13550,1457
168361,2019-11-27 00:00:00+03:00,out,False,945322,True,119,0,2352,2352
168361,2019-11-27 00:00:00+03:00,out,False,945316,True,21,0,395,395
168361,2019-11-27 00:00:00+03:00,out,False,945324,False,73,9022,10234,1212
168361,2019-11-27 00:00:00+03:00,out,False,945316,False,39,5886,6491,605
168361,2019-11-27 00:00:00+03:00,out,False,965538,False,35,4491,5090,599
168361,2019-11-27 00:00:00+03:00,out,False,945298,True,11,0,341,341
168361,2019-11-27 00:00:00+03:00,out,False,945282,True,36,0,892,892
168361,2019-11-27 00:00:00+03:00,out,False,-1,True,3,0,2,2
168361,2019-11-27 00:00:00+03:00,out,False,945298,False,66,8420,9585,1165
168361,2019-11-27 00:00:00+03:00,out,False,945282,False,66,8166,9395,1229
168361,2019-11-27 00:00:00+03:00,out,False,965540,True,5,0,200,200
168361,2019-11-27 00:00:00+03:00,out,False,965540,False,39,4575,5228,653
168361,2019-11-27 00:00:00+03:00,out,False,945302,True,46,0,1107,1107
168361,2019-11-27 00:00:00+03:00,out,False,945296,True,21,0,465,465
168361,2019-11-27 00:00:00+03:00,out,False,945322,False,154,9202,12472,3270
168361,2019-11-27 00:00:00+03:00,out,False,945290,True,36,0,1123,1123
168361,2019-11-27 00:00:00+03:00,out,False,945280,True,85,0,1133,1133
168361,2019-11-27 00:00:00+03:00,out,False,945302,False,88,13618,15173,1555
168361,2019-11-27 00:00:00+03:00,out,False,945286,True,236,0,3631,3631
168361,2019-11-27 00:00:00+03:00,out,False,945312,False,75,12093,13550,1457
168361,2019-11-28 00:00:00+03:00,out,False,945314,True,65,0,1797,1797
168361,2019-11-28 00:00:00+03:00,out,False,945294,True,55,0,906,906
168361,2019-11-28 00:00:00+03:00,out,True,945314,True,2,0,0,0
168361,2019-11-28 00:00:00+03:00,out,False,945324,False,60,6542,7660,1118
168361,2019-11-28 00:00:00+03:00,out,False,945296,True,30,0,535,535
168361,2019-11-28 00:00:00+03:00,out,False,945324,True,18,0,630,630
168361,2019-11-28 00:00:00+03:00,out,False,945286,False,150,4292,7810,3518
168361,2019-11-28 00:00:00+03:00,out,False,945294,False,82,10214,11797,1583
168361,2019-11-28 00:00:00+03:00,out,False,945282,True,13,0,352,352
168361,2019-11-28 00:00:00+03:00,out,False,945312,True,34,0,275,275
168361,2019-11-28 00:00:00+03:00,out,False,945322,False,144,7861,10920,3059
168361,2019-11-28 00:00:00+03:00,out,False,945284,False,55,3997,4888,891
168361,2019-11-28 00:00:00+03:00,out,False,945278,False,60,6426,7617,1191
168361,2019-11-28 00:00:00+03:00,out,False,945316,False,85,11961,13366,1405
168361,2019-11-28 00:00:00+03:00,out,False,945314,False,76,3850,5536,1686
168361,2019-11-28 00:00:00+03:00,out,False,945280,False,53,9865,10755,890
168361,2019-11-28 00:00:00+03:00,out,False,945298,False,56,7056,8012,956
168361,2019-11-28 00:00:00+03:00,out,False,945278,True,92,0,2272,2272
168361,2019-11-28 00:00:00+03:00,out,False,945284,True,34,0,658,658
168361,2019-11-28 00:00:00+03:00,out,False,945290,False,44,1356,2477,1121
168361,2019-11-28 00:00:00+03:00,out,False,945280,True,19,0,346,346
168361,2019-11-28 00:00:00+03:00,out,False,945322,True,103,0,1734,1734
168361,2019-11-28 00:00:00+03:00,out,False,945286,True,279,0,3983,3983
168361,2019-11-28 00:00:00+03:00,out,False,945302,False,66,7317,8654,1337
168361,2019-11-28 00:00:00+03:00,out,False,945312,False,68,10976,12301,1325
168361,2019-11-28 00:00:00+03:00,out,False,945290,True,47,0,1367,1367
168361,2019-11-28 00:00:00+03:00,out,False,945282,False,65,8232,9316,1084
168361,2019-11-28 00:00:00+03:00,out,False,945302,True,46,0,1291,1291
168361,2019-11-28 00:00:00+03:00,out,False,945296,False,68,8345,9513,1168
168361,2019-11-28 00:00:00+03:00,out,False,945298,True,14,0,410,410
168361,2019-11-28 00:00:00+03:00,in,False,-1,True,748,0,1616,1616
168361,2019-11-28 00:00:00+03:00,out,False,945316,True,50,0,883,883
168361,2019-11-28 00:00:00+03:00,out,False,945280,False,53,9865,10755,890
168361,2019-11-28 00:00:00+03:00,out,False,945302,False,66,7317,8654,1337
168366,2019-10-24 00:00:00+03:00,in,False,-1,True,3,0,6,6
168366,2019-10-26 00:00:00+03:00,in,False,-1,True,1,0,3,3
168366,2019-10-27 00:00:00+03:00,in,False,-1,True,3,0,6,6
168366,2019-10-28 00:00:00+03:00,in,False,-1,True,1,0,2,2
168366,2019-10-29 00:00:00+03:00,in,False,-1,True,10,0,21,21
168366,2019-10-30 00:00:00+03:00,in,False,-1,True,7,0,14,14
168366,2019-10-31 00:00:00+03:00,in,False,-1,True,6,0,12,12
168366,2019-11-01 00:00:00+03:00,in,False,-1,True,3,0,26,26
168366,2019-11-01 00:00:00+03:00,in,False,-1,True,7,0,17,17
168366,2019-11-01 00:00:00+03:00,in,True,952666,False,1,56,71,15
168366,2019-11-01 00:00:00+03:00,in,False,-1,True,7,0,17,17
168366,2019-11-02 00:00:00+03:00,in,False,-1,True,1,0,4,4
168366,2019-11-03 00:00:00+03:00,in,False,-1,True,1,0,4,4
168366,2019-11-03 00:00:00+03:00,in,False,-1,True,1,0,4,4
168366,2019-11-05 00:00:00+03:00,in,False,-1,True,4,0,21,21
168366,2019-11-05 00:00:00+03:00,in,False,952678,False,1,91,121,30
168366,2019-11-06 00:00:00+03:00,in,False,-1,True,3,0,17,17
168366,2019-11-06 00:00:00+03:00,in,False,-1,True,3,0,17,17
168366,2019-11-07 00:00:00+03:00,in,False,-1,True,4,0,15,15
168366,2019-11-08 00:00:00+03:00,in,False,-1,True,9,0,43,43
168366,2019-11-09 00:00:00+03:00,in,False,-1,True,4,0,16,16
168366,2019-11-10 00:00:00+03:00,in,False,-1,True,4,0,16,16
168366,2019-11-11 00:00:00+03:00,in,False,-1,True,4,0,17,17
168366,2019-11-12 00:00:00+03:00,in,False,-1,True,4,0,16,16
168366,2019-11-13 00:00:00+03:00,in,False,-1,True,5,0,20,20
168366,2019-11-14 00:00:00+03:00,in,False,-1,True,5,0,20,20
168366,2019-11-15 00:00:00+03:00,in,False,-1,True,3,0,12,12
168366,2019-11-16 00:00:00+03:00,in,False,-1,True,3,0,12,12
168366,2019-11-17 00:00:00+03:00,in,False,-1,True,4,0,16,16
168366,2019-11-18 00:00:00+03:00,in,False,-1,True,6,0,24,24
168366,2019-11-19 00:00:00+03:00,in,False,-1,True,5,0,20,20
168366,2019-11-20 00:00:00+03:00,in,False,-1,True,4,0,16,16
168366,2019-11-21 00:00:00+03:00,in,False,-1,True,3,0,12,12
168366,2019-11-22 00:00:00+03:00,in,False,-1,True,6,0,25,25
168366,2019-11-23 00:00:00+03:00,in,False,-1,True,4,0,16,16
168366,2019-11-24 00:00:00+03:00,in,False,-1,True,5,0,20,20
168366,2019-11-25 00:00:00+03:00,in,False,-1,True,23,0,55,55
168366,2019-11-26 00:00:00+03:00,in,False,-1,True,35,0,71,71
168366,2019-11-27 00:00:00+03:00,in,False,-1,True,28,0,59,59
168366,2019-11-28 00:00:00+03:00,in,False,-1,True,26,0,54,54
168377,2019-10-28 00:00:00+03:00,in,False,-1,True,4,0,8,8
168377,2019-10-29 00:00:00+03:00,in,False,-1,True,1,0,2,2
168377,2019-10-30 00:00:00+03:00,in,False,-1,True,3,0,6,6
168377,2019-10-31 00:00:00+03:00,in,False,-1,True,2,0,4,4
168377,2019-11-01 00:00:00+03:00,in,False,-1,True,1,0,2,2
168377,2019-11-05 00:00:00+03:00,in,False,-1,True,51,0,110,110
168377,2019-11-06 00:00:00+03:00,in,False,-1,True,1,0,2,2
168377,2019-11-07 00:00:00+03:00,in,False,-1,True,1,0,2,2
168377,2019-11-08 00:00:00+03:00,in,False,-1,True,1,0,2,2
168377,2019-11-08 00:00:00+03:00,in,False,-1,True,1,0,2,2
168377,2019-11-11 00:00:00+03:00,in,False,-1,True,45,0,101,101
168377,2019-11-12 00:00:00+03:00,in,False,-1,True,2,0,4,4
168377,2019-11-13 00:00:00+03:00,in,False,-1,True,2,0,4,4
168377,2019-11-13 00:00:00+03:00,in,False,-1,True,2,0,4,4
168377,2019-11-14 00:00:00+03:00,in,False,-1,True,1,0,2,2
168377,2019-11-14 00:00:00+03:00,in,False,-1,True,1,0,2,2
168377,2019-11-18 00:00:00+03:00,in,False,-1,True,15,0,31,31
168377,2019-11-19 00:00:00+03:00,in,False,-1,True,1,0,2,2
168377,2019-11-20 00:00:00+03:00,in,False,-1,True,1,0,2,2
168377,2019-11-21 00:00:00+03:00,in,False,968368,False,1,2,22,20
168377,2019-11-21 00:00:00+03:00,in,False,-1,True,2,0,38,38
168377,2019-11-22 00:00:00+03:00,in,False,968368,False,1,52,70,18
168412,2019-11-01 00:00:00+03:00,out,False,952458,True,2,0,0,0
168412,2019-11-04 00:00:00+03:00,out,False,952460,True,1,0,0,0
168412,2019-11-04 00:00:00+03:00,out,False,952458,True,2,0,0,0
168412,2019-11-05 00:00:00+03:00,out,False,953464,False,4,591,640,49
168412,2019-11-05 00:00:00+03:00,out,False,952466,False,33,1098,1743,645
168412,2019-11-05 00:00:00+03:00,in,False,953464,True,1,1,7,6
168412,2019-11-05 00:00:00+03:00,in,False,952462,False,2,5,54,49
168412,2019-11-05 00:00:00+03:00,out,True,953464,True,1,0,0,0
168412,2019-11-05 00:00:00+03:00,out,False,952468,False,22,1491,1902,411
168412,2019-11-05 00:00:00+03:00,out,False,952466,True,46,0,771,771
168412,2019-11-05 00:00:00+03:00,out,False,953458,True,5,0,46,46
168412,2019-11-05 00:00:00+03:00,out,False,952458,True,1,0,9,9
168412,2019-11-05 00:00:00+03:00,out,False,953460,False,1,13,17,4
168412,2019-11-05 00:00:00+03:00,out,False,952468,True,22,0,460,460
168412,2019-11-05 00:00:00+03:00,out,True,952468,True,4,0,0,0
168412,2019-11-05 00:00:00+03:00,out,False,953464,True,2,0,12,12
168412,2019-11-05 00:00:00+03:00,out,False,952462,True,1,0,12,12
168412,2019-11-05 00:00:00+03:00,in,False,-1,True,2,0,3,3
168412,2019-11-05 00:00:00+03:00,out,True,952466,True,9,0,0,0
168412,2019-11-05 00:00:00+03:00,in,False,953464,False,3,50,76,26
168412,2019-11-05 00:00:00+03:00,in,False,952462,False,2,5,54,49
168412,2019-11-05 00:00:00+03:00,in,False,953464,True,1,1,7,6
168412,2019-11-05 00:00:00+03:00,out,True,952468,True,4,0,0,0
168412,2019-11-05 00:00:00+03:00,out,False,952466,True,46,0,771,771
168412,2019-11-05 00:00:00+03:00,out,False,952462,True,1,0,12,12
168412,2019-11-06 00:00:00+03:00,out,False,952458,True,103,0,2053,2053
168412,2019-11-06 00:00:00+03:00,out,False,952468,False,33,1585,2218,633
168412,2019-11-06 00:00:00+03:00,out,False,953458,False,21,3172,3654,482
168412,2019-11-06 00:00:00+03:00,in,False,953464,False,7,165,231,66
168412,2019-11-06 00:00:00+03:00,out,False,952468,True,65,0,1370,1370
168412,2019-11-06 00:00:00+03:00,out,False,952458,False,64,2474,3723,1249
168412,2019-11-06 00:00:00+03:00,in,False,-1,True,6,0,163,163
168412,2019-11-06 00:00:00+03:00,out,True,952458,True,3,0,3,3
168412,2019-11-06 00:00:00+03:00,out,False,953458,True,20,0,389,389
168412,2019-11-06 00:00:00+03:00,out,False,952460,True,5,0,122,122
168412,2019-11-06 00:00:00+03:00,out,False,953464,True,1,0,17,17
168412,2019-11-06 00:00:00+03:00,out,False,952460,False,3,146,181,35
168412,2019-11-06 00:00:00+03:00,out,True,952468,True,6,0,0,0
168412,2019-11-06 00:00:00+03:00,in,False,953464,False,7,165,231,66
168412,2019-11-07 00:00:00+03:00,out,False,952460,False,9,2905,3032,127
168412,2019-11-07 00:00:00+03:00,out,False,952460,True,15,0,190,190
168412,2019-11-07 00:00:00+03:00,in,False,952462,False,1,10,34,24
168412,2019-11-07 00:00:00+03:00,in,False,953464,False,1,19,26,7
168412,2019-11-07 00:00:00+03:00,out,False,-1,True,1,0,0,0
168412,2019-11-07 00:00:00+03:00,out,True,952458,True,1,0,0,0
168412,2019-11-07 00:00:00+03:00,out,False,952458,False,54,3982,4968,986
168412,2019-11-07 00:00:00+03:00,out,False,952458,True,62,0,1308,1308
168412,2019-11-07 00:00:00+03:00,in,False,-1,True,3,0,104,104
168412,2019-11-07 00:00:00+03:00,out,False,952458,False,54,3982,4968,986
168412,2019-11-08 00:00:00+03:00,out,False,952458,True,18,0,473,473
168412,2019-11-08 00:00:00+03:00,out,False,952460,False,2,229,259,30
168412,2019-11-08 00:00:00+03:00,out,False,952468,True,38,0,1030,1030
168412,2019-11-08 00:00:00+03:00,in,False,-1,True,1,0,41,41
168412,2019-11-08 00:00:00+03:00,out,True,952468,True,1,0,0,0
168412,2019-11-08 00:00:00+03:00,out,False,952458,False,12,1641,1888,247
168412,2019-11-08 00:00:00+03:00,out,False,952468,False,34,3480,4243,763
168412,2019-11-08 00:00:00+03:00,in,False,953464,False,2,52,72,20
168412,2019-11-08 00:00:00+03:00,out,False,952460,True,4,0,58,58
168412,2019-11-08 00:00:00+03:00,out,False,952460,False,2,229,259,30
168412,2019-11-08 00:00:00+03:00,out,True,952468,True,1,0,0,0
168412,2019-11-10 00:00:00+03:00,in,False,-1,True,3,0,58,58
168412,2019-11-11 00:00:00+03:00,out,False,952458,True,77,0,1719,1719
168412,2019-11-11 00:00:00+03:00,out,False,952460,True,17,0,296,296
168412,2019-11-11 00:00:00+03:00,out,False,952468,False,44,5686,6466,780
168412,2019-11-11 00:00:00+03:00,out,False,952458,False,75,4450,5703,1253
168412,2019-11-11 00:00:00+03:00,in,False,953464,False,5,76,139,63
168412,2019-11-11 00:00:00+03:00,out,True,952468,True,3,0,0,0
168412,2019-11-11 00:00:00+03:00,in,False,-1,True,4,0,90,90
168412,2019-11-11 00:00:00+03:00,out,False,952468,True,78,0,1906,1906
168412,2019-11-11 00:00:00+03:00,out,False,952460,False,15,1859,2098,239
168412,2019-11-11 00:00:00+03:00,out,False,952468,False,44,5686,6466,780
168412,2019-11-11 00:00:00+03:00,out,False,952458,True,77,0,1719,1719
168412,2019-11-11 00:00:00+03:00,out,False,952460,True,17,0,296,296
168412,2019-11-12 00:00:00+03:00,out,False,952460,False,9,265,428,163
168412,2019-11-12 00:00:00+03:00,out,False,952468,False,45,2664,3607,943
168412,2019-11-12 00:00:00+03:00,out,False,953458,True,2,0,33,33
168412,2019-11-12 00:00:00+03:00,out,False,953458,False,9,1327,1539,212
168412,2019-11-12 00:00:00+03:00,out,True,952458,True,2,0,0,0
168412,2019-11-12 00:00:00+03:00,out,False,952458,True,58,0,1545,1545
168412,2019-11-12 00:00:00+03:00,in,False,953464,False,4,120,155,35
168412,2019-11-12 00:00:00+03:00,out,False,952468,True,51,0,915,915
168412,2019-11-12 00:00:00+03:00,out,False,952460,True,1,0,3,3
168412,2019-11-12 00:00:00+03:00,in,False,-1,True,2,0,9,9
168412,2019-11-12 00:00:00+03:00,out,False,952458,False,46,3139,4001,862
168412,2019-11-12 00:00:00+03:00,in,False,953464,False,4,120,155,35
168412,2019-11-12 00:00:00+03:00,out,False,953458,True,2,0,33,33
168412,2019-11-13 00:00:00+03:00,out,False,952468,False,43,2995,3840,845
168412,2019-11-13 00:00:00+03:00,out,False,953464,False,2,50,63,13
168412,2019-11-13 00:00:00+03:00,out,False,952468,True,66,0,1343,1343
168412,2019-11-13 00:00:00+03:00,out,False,952460,False,1,99,119,20
168412,2019-11-13 00:00:00+03:00,out,False,952458,False,59,2842,3903,1061
168412,2019-11-13 00:00:00+03:00,in,False,953464,False,5,290,336,46
168412,2019-11-13 00:00:00+03:00,out,False,952458,True,80,0,1389,1389
168412,2019-11-13 00:00:00+03:00,in,False,-1,True,1,0,15,15
168412,2019-11-13 00:00:00+03:00,out,True,952458,True,2,0,0,0
168412,2019-11-14 00:00:00+03:00,in,False,-1,True,1,0,6,6
168412,2019-11-14 00:00:00+03:00,in,False,-1,True,1,0,6,6
168412,2019-11-15 00:00:00+03:00,out,False,952458,True,60,0,1239,1239
168412,2019-11-15 00:00:00+03:00,in,False,953464,False,3,65,101,36
168412,2019-11-15 00:00:00+03:00,out,False,952460,True,4,0,131,131
168412,2019-11-15 00:00:00+03:00,out,False,952458,False,51,3366,4435,1069
168412,2019-11-15 00:00:00+03:00,out,False,952460,False,1,69,81,12
168412,2019-11-15 00:00:00+03:00,in,False,-1,True,2,0,63,63
168412,2019-11-15 00:00:00+03:00,out,True,952458,True,4,0,0,0
168412,2019-11-15 00:00:00+03:00,in,False,953464,False,3,65,101,36
168412,2019-11-17 00:00:00+03:00,in,False,-1,True,6,0,154,154
168412,2019-11-18 00:00:00+03:00,out,False,952460,True,2,0,54,54
168412,2019-11-18 00:00:00+03:00,out,False,952458,True,74,0,1780,1780
168412,2019-11-18 00:00:00+03:00,out,False,952458,False,51,3642,4677,1035
168412,2019-11-18 00:00:00+03:00,in,False,953464,False,2,201,212,11
168412,2019-11-18 00:00:00+03:00,out,True,952458,True,3,0,0,0
168412,2019-11-18 00:00:00+03:00,out,True,953462,True,3,0,0,0
168412,2019-11-18 00:00:00+03:00,out,False,952460,False,3,404,450,46
168412,2019-11-18 00:00:00+03:00,out,False,953462,True,12,0,217,217
168412,2019-11-18 00:00:00+03:00,out,False,953462,False,17,6125,6435,310
168412,2019-11-18 00:00:00+03:00,in,False,-1,True,12,0,105,105
168412,2019-11-18 00:00:00+03:00,out,False,952458,False,51,3642,4677,1035
168412,2019-11-18 00:00:00+03:00,in,False,-1,True,12,0,105,105
168412,2019-11-19 00:00:00+03:00,in,False,953464,False,3,49,82,33
168412,2019-11-19 00:00:00+03:00,out,True,952458,True,2,0,0,0
168412,2019-11-19 00:00:00+03:00,out,True,953462,True,13,0,0,0
168412,2019-11-19 00:00:00+03:00,in,False,-1,True,8,0,224,224
168412,2019-11-19 00:00:00+03:00,out,False,953464,True,27,0,335,335
168412,2019-11-19 00:00:00+03:00,out,False,953464,False,16,2387,2696,309
168412,2019-11-19 00:00:00+03:00,out,True,953464,True,4,0,0,0
168412,2019-11-19 00:00:00+03:00,in,False,952462,False,2,11,30,19
168412,2019-11-19 00:00:00+03:00,out,False,953462,True,69,0,1570,1570
168412,2019-11-19 00:00:00+03:00,out,False,953462,False,30,4717,5343,626
168412,2019-11-19 00:00:00+03:00,out,False,952458,True,75,0,1571,1571
168412,2019-11-19 00:00:00+03:00,out,False,952460,True,18,0,292,292
168412,2019-11-19 00:00:00+03:00,out,False,952460,False,6,140,251,111
168412,2019-11-19 00:00:00+03:00,out,True,952460,True,1,0,0,0
168412,2019-11-19 00:00:00+03:00,out,False,952458,False,60,3216,4336,1120
168412,2019-11-19 00:00:00+03:00,out,True,952460,True,1,0,0,0
168412,2019-11-19 00:00:00+03:00,out,True,953462,True,13,0,0,0
168412,2019-11-20 00:00:00+03:00,out,False,952458,False,61,5572,6679,1107
168412,2019-11-20 00:00:00+03:00,out,True,952468,True,8,0,0,0
168412,2019-11-20 00:00:00+03:00,out,True,953464,True,6,0,0,0
168412,2019-11-20 00:00:00+03:00,in,False,-1,True,1,0,2,2
168412,2019-11-20 00:00:00+03:00,out,False,953462,False,25,3503,4042,539
168412,2019-11-20 00:00:00+03:00,out,False,952468,True,33,0,588,588
168412,2019-11-20 00:00:00+03:00,out,True,952458,True,4,0,0,0
168412,2019-11-20 00:00:00+03:00,out,False,952458,True,71,0,1550,1550
168412,2019-11-20 00:00:00+03:00,out,False,953464,True,50,0,1029,1029
168412,2019-11-20 00:00:00+03:00,out,False,952468,False,7,252,346,94
168412,2019-11-20 00:00:00+03:00,in,False,953464,False,3,733,760,27
168412,2019-11-20 00:00:00+03:00,out,False,953462,True,40,0,964,964
168412,2019-11-20 00:00:00+03:00,out,False,953464,False,23,1977,2390,413
168412,2019-11-20 00:00:00+03:00,out,True,953462,True,5,0,0,0
168412,2019-11-21 00:00:00+03:00,in,False,953464,False,6,144,202,58
168412,2019-11-21 00:00:00+03:00,out,False,952458,False,71,5526,6816,1290
168412,2019-11-21 00:00:00+03:00,out,False,953464,False,10,1690,1874,184
168412,2019-11-21 00:00:00+03:00,out,False,953462,True,34,0,745,745
168412,2019-11-21 00:00:00+03:00,out,False,953462,False,28,9095,9655,560
168412,2019-11-21 00:00:00+03:00,out,False,953464,True,7,0,153,153
168412,2019-11-21 00:00:00+03:00,out,False,952468,True,60,0,1038,1038
168412,2019-11-21 00:00:00+03:00,out,False,952458,True,90,0,1932,1932
168412,2019-11-21 00:00:00+03:00,out,True,952458,True,3,0,0,0
168412,2019-11-21 00:00:00+03:00,out,True,953464,True,2,0,0,0
168412,2019-11-21 00:00:00+03:00,out,False,952468,False,41,2877,3665,788
168412,2019-11-21 00:00:00+03:00,in,False,-1,True,3,0,63,63
168412,2019-11-21 00:00:00+03:00,out,True,953462,True,6,0,0,0
168412,2019-11-21 00:00:00+03:00,out,True,952468,True,21,0,0,0
168412,2019-11-21 00:00:00+03:00,out,False,953462,False,28,9095,9655,560
168412,2019-11-22 00:00:00+03:00,out,True,952460,True,2,0,0,0
168412,2019-11-22 00:00:00+03:00,out,False,952458,False,59,4234,5507,1273
168412,2019-11-22 00:00:00+03:00,out,False,952468,False,28,1608,2144,536
168412,2019-11-22 00:00:00+03:00,out,False,952468,True,63,0,1099,1099
168412,2019-11-22 00:00:00+03:00,out,False,952458,True,94,0,2105,2105
168412,2019-11-22 00:00:00+03:00,out,True,953462,True,2,0,0,0
168412,2019-11-22 00:00:00+03:00,out,False,953462,False,39,5237,5996,759
168412,2019-11-22 00:00:00+03:00,in,False,953464,False,3,15,32,17
168412,2019-11-22 00:00:00+03:00,out,False,952460,True,26,0,762,762
168412,2019-11-22 00:00:00+03:00,in,False,-1,True,4,0,48,48
168412,2019-11-22 00:00:00+03:00,out,True,952458,True,2,0,0,0
168412,2019-11-22 00:00:00+03:00,out,False,953464,False,2,156,190,34
168412,2019-11-22 00:00:00+03:00,out,False,952460,False,31,2409,3054,645
168412,2019-11-22 00:00:00+03:00,out,False,-1,True,1,0,0,0
168412,2019-11-22 00:00:00+03:00,out,True,952468,True,20,0,0,0
168412,2019-11-22 00:00:00+03:00,out,False,953462,True,63,0,1229,1229
168412,2019-11-22 00:00:00+03:00,out,True,952460,True,2,0,0,0
168412,2019-11-23 00:00:00+03:00,out,False,953462,False,13,4161,4339,178
168412,2019-11-23 00:00:00+03:00,out,True,953462,True,3,0,0,0
168412,2019-11-23 00:00:00+03:00,in,False,-1,True,2,0,80,80
168412,2019-11-23 00:00:00+03:00,in,False,953464,False,2,75,88,13
168412,2019-11-23 00:00:00+03:00,in,False,952462,False,1,15,53,38
168412,2019-11-23 00:00:00+03:00,out,False,953462,True,31,0,650,650
168412,2019-11-23 00:00:00+03:00,out,False,953464,False,1,670,677,7
168412,2019-11-23 00:00:00+03:00,in,False,-1,True,2,0,80,80
168412,2019-11-23 00:00:00+03:00,out,False,953462,True,31,0,650,650
168412,2019-11-25 00:00:00+03:00,out,True,953462,True,2,0,0,0
168412,2019-11-25 00:00:00+03:00,out,False,952468,False,10,560,779,219
168412,2019-11-25 00:00:00+03:00,out,False,953462,True,37,0,637,637
168412,2019-11-25 00:00:00+03:00,out,True,953464,True,2,0,1,1
168412,2019-11-25 00:00:00+03:00,out,False,953458,True,2,0,0,0
168412,2019-11-25 00:00:00+03:00,out,False,952460,True,1,0,0,0
168412,2019-11-25 00:00:00+03:00,out,False,-1,True,1,0,1,1
168412,2019-11-25 00:00:00+03:00,out,True,952468,True,2,0,0,0
168412,2019-11-25 00:00:00+03:00,out,False,952468,True,27,0,347,347
168412,2019-11-25 00:00:00+03:00,out,False,953464,True,12,0,118,118
168412,2019-11-25 00:00:00+03:00,out,False,953464,False,5,308,394,86
168412,2019-11-25 00:00:00+03:00,out,True,953460,True,1,0,0,0
168412,2019-11-25 00:00:00+03:00,out,False,953460,True,2,0,0,0
168412,2019-11-25 00:00:00+03:00,out,False,953462,False,13,5532,5790,258
168412,2019-11-25 00:00:00+03:00,out,False,953464,True,12,0,118,118
168412,2019-11-25 00:00:00+03:00,out,False,953460,True,2,0,0,0
168412,2019-11-26 00:00:00+03:00,out,False,953464,True,66,0,1083,1083
168412,2019-11-26 00:00:00+03:00,out,True,953462,True,10,0,4,4
168412,2019-11-26 00:00:00+03:00,out,True,953464,True,14,0,1,1
168412,2019-11-26 00:00:00+03:00,out,False,952468,False,31,4648,5287,639
168412,2019-11-26 00:00:00+03:00,out,False,953462,True,34,0,781,781
168412,2019-11-26 00:00:00+03:00,in,False,952462,False,1,4,13,9
168412,2019-11-26 00:00:00+03:00,out,False,953464,False,39,2712,3309,597
168412,2019-11-26 00:00:00+03:00,out,False,-1,True,1,0,0,0
168412,2019-11-26 00:00:00+03:00,in,False,-1,True,2,0,23,23
168412,2019-11-26 00:00:00+03:00,out,False,952468,True,42,0,831,831
168412,2019-11-26 00:00:00+03:00,out,False,953462,False,22,7147,7588,441
168412,2019-11-26 00:00:00+03:00,out,True,952468,True,8,0,0,0
168412,2019-11-26 00:00:00+03:00,out,False,953464,True,66,0,1083,1083
168412,2019-11-26 00:00:00+03:00,out,True,952468,True,8,0,0,0
168412,2019-11-27 00:00:00+03:00,in,False,953464,False,1,683,700,17
168412,2019-11-27 00:00:00+03:00,in,False,952462,False,1,480,510,30
168412,2019-11-27 00:00:00+03:00,out,False,952468,True,43,0,615,615
168412,2019-11-27 00:00:00+03:00,out,False,953464,False,4,5373,5412,39
168412,2019-11-27 00:00:00+03:00,out,True,952468,True,5,0,0,0
168412,2019-11-27 00:00:00+03:00,out,True,953460,True,1,0,0,0
168412,2019-11-27 00:00:00+03:00,out,False,953460,True,1,0,0,0
168412,2019-11-27 00:00:00+03:00,out,False,953464,True,6,0,62,62
168412,2019-11-27 00:00:00+03:00,out,True,953464,True,2,0,0,0
168412,2019-11-27 00:00:00+03:00,out,False,953462,True,52,0,515,515
168412,2019-11-27 00:00:00+03:00,out,True,953462,True,5,0,0,0
168412,2019-11-27 00:00:00+03:00,out,False,952468,False,26,1939,2459,520
168412,2019-11-27 00:00:00+03:00,out,False,953462,False,10,9290,9444,154
168412,2019-11-27 00:00:00+03:00,in,False,-1,True,2,0,6,6
168412,2019-11-27 00:00:00+03:00,out,True,953462,True,5,0,0,0
168412,2019-11-28 00:00:00+03:00,out,True,953462,True,2,0,0,0
168412,2019-11-28 00:00:00+03:00,out,False,953460,True,1,0,0,0
168412,2019-11-28 00:00:00+03:00,out,False,953464,False,1,523,534,11
168412,2019-11-28 00:00:00+03:00,out,False,953462,True,39,0,606,606
168412,2019-11-28 00:00:00+03:00,out,False,953464,True,8,0,167,167
168412,2019-11-28 00:00:00+03:00,out,True,952468,True,11,0,0,0
168412,2019-11-28 00:00:00+03:00,out,False,953462,False,25,12700,13148,448
168412,2019-11-28 00:00:00+03:00,in,False,953464,False,1,30,35,5
168412,2019-11-28 00:00:00+03:00,out,False,952468,False,22,2488,2862,374
168412,2019-11-28 00:00:00+03:00,out,False,952468,True,64,0,1155,1155
168412,2019-11-28 00:00:00+03:00,out,False,953460,True,1,0,0,0
168412,2019-11-28 00:00:00+03:00,out,False,953464,False,1,523,534,11
168416,2019-10-28 00:00:00+03:00,out,False,948182,False,12,539,846,307
168416,2019-10-28 00:00:00+03:00,in,False,948182,False,1,97,104,7
168416,2019-10-28 00:00:00+03:00,in,False,-1,True,4,0,8,8
168416,2019-10-28 00:00:00+03:00,out,False,948182,True,5,0,98,98
168416,2019-10-29 00:00:00+03:00,in,False,948182,False,2,123,146,23
168416,2019-10-29 00:00:00+03:00,out,True,948182,True,1,0,0,0
168416,2019-10-29 00:00:00+03:00,out,False,948182,True,1,0,6,6
168416,2019-10-29 00:00:00+03:00,in,False,-1,True,1,0,54,54
168416,2019-10-29 00:00:00+03:00,out,False,948182,False,12,363,651,288
168416,2019-10-30 00:00:00+03:00,out,False,948182,False,7,538,657,119
168416,2019-10-30 00:00:00+03:00,in,False,948182,False,4,553,578,25
168416,2019-10-30 00:00:00+03:00,out,False,948182,False,7,538,657,119
168416,2019-10-31 00:00:00+03:00,out,False,948182,True,6,0,161,161
168416,2019-10-31 00:00:00+03:00,in,False,948182,False,6,613,698,85
168416,2019-10-31 00:00:00+03:00,out,False,948182,False,12,579,788,209
168416,2019-10-31 00:00:00+03:00,in,False,-1,True,4,0,185,185
168416,2019-11-01 00:00:00+03:00,in,False,948182,False,3,232,274,42
168416,2019-11-01 00:00:00+03:00,in,False,-1,True,5,0,165,165
168416,2019-11-01 00:00:00+03:00,out,False,948182,True,1,0,60,60
168416,2019-11-01 00:00:00+03:00,out,False,948182,False,7,1012,1066,54
168416,2019-11-02 00:00:00+03:00,out,False,948182,False,2,152,190,38
168416,2019-11-02 00:00:00+03:00,in,False,-1,True,2,0,115,115
168416,2019-11-03 00:00:00+03:00,in,False,-1,True,2,0,84,84
168416,2019-11-04 00:00:00+03:00,in,False,-1,True,6,0,397,397
168416,2019-11-05 00:00:00+03:00,out,False,948182,False,19,948,1285,337
168416,2019-11-05 00:00:00+03:00,in,False,948182,False,7,793,869,76
168416,2019-11-05 00:00:00+03:00,out,False,948182,True,10,0,366,366
168416,2019-11-05 00:00:00+03:00,in,False,-1,True,8,0,316,316
168416,2019-11-06 00:00:00+03:00,in,False,948182,False,4,421,455,34
168416,2019-11-06 00:00:00+03:00,in,False,-1,True,21,0,1223,1223
168416,2019-11-06 00:00:00+03:00,out,False,948182,False,12,1058,1197,139
168416,2019-11-06 00:00:00+03:00,out,False,948182,True,2,0,34,34
168416,2019-11-06 00:00:00+03:00,in,False,948182,False,4,421,455,34
168416,2019-11-07 00:00:00+03:00,in,False,948182,False,3,297,359,62
168416,2019-11-07 00:00:00+03:00,out,False,948182,False,7,591,661,70
168416,2019-11-07 00:00:00+03:00,in,False,-1,True,3,0,49,49
168416,2019-11-07 00:00:00+03:00,out,False,948182,True,6,0,317,317
168416,2019-11-08 00:00:00+03:00,in,False,948182,False,3,164,192,28
168416,2019-11-08 00:00:00+03:00,in,False,-1,True,6,0,192,192
168416,2019-11-08 00:00:00+03:00,out,False,948182,False,10,821,983,162
168416,2019-11-08 00:00:00+03:00,out,False,948182,True,6,0,159,159
168416,2019-11-09 00:00:00+03:00,in,False,-1,True,2,0,79,79
168416,2019-11-09 00:00:00+03:00,out,False,948182,False,2,155,211,56
168416,2019-11-10 00:00:00+03:00,in,False,-1,True,3,0,91,91
168416,2019-11-11 00:00:00+03:00,out,False,948182,True,2,0,10,10
168416,2019-11-11 00:00:00+03:00,in,False,948182,False,5,984,1042,58
168416,2019-11-11 00:00:00+03:00,out,False,948182,False,5,281,359,78
168416,2019-11-11 00:00:00+03:00,in,False,-1,True,3,0,77,77
168416,2019-11-11 00:00:00+03:00,in,False,-1,True,3,0,77,77
168416,2019-11-11 00:00:00+03:00,in,False,948182,False,5,984,1042,58
168416,2019-11-12 00:00:00+03:00,in,False,-1,True,6,0,300,300
168416,2019-11-12 00:00:00+03:00,in,False,948182,False,2,220,253,33
168416,2019-11-12 00:00:00+03:00,out,False,948182,False,6,498,583,85
168416,2019-11-13 00:00:00+03:00,in,False,-1,True,5,0,239,239
168416,2019-11-13 00:00:00+03:00,out,False,948182,False,17,894,1163,269
168416,2019-11-13 00:00:00+03:00,in,False,948182,False,3,790,846,56
168416,2019-11-13 00:00:00+03:00,out,False,948182,True,1,0,56,56
168416,2019-11-14 00:00:00+03:00,in,False,-1,True,23,0,1713,1713
168416,2019-11-14 00:00:00+03:00,out,False,948182,False,17,1337,1646,309
168416,2019-11-14 00:00:00+03:00,out,False,948182,True,6,0,197,197
168416,2019-11-14 00:00:00+03:00,in,False,948182,False,7,460,516,56
168416,2019-11-15 00:00:00+03:00,out,False,948182,True,1,0,10,10
168416,2019-11-15 00:00:00+03:00,in,False,-1,True,3,0,126,126
168416,2019-11-15 00:00:00+03:00,out,False,948182,False,4,260,314,54
168416,2019-11-15 00:00:00+03:00,in,False,948182,False,2,141,172,31
168416,2019-11-15 00:00:00+03:00,in,False,948182,False,2,141,172,31
168416,2019-11-16 00:00:00+03:00,in,False,948182,False,1,65,83,18
168416,2019-11-16 00:00:00+03:00,in,False,-1,True,10,0,303,303
168416,2019-11-17 00:00:00+03:00,out,False,948182,False,3,445,451,6
168416,2019-11-17 00:00:00+03:00,in,False,-1,True,2,0,211,211
168416,2019-11-18 00:00:00+03:00,out,False,948182,False,10,352,484,132
168416,2019-11-18 00:00:00+03:00,in,False,948182,False,7,555,646,91
168416,2019-11-18 00:00:00+03:00,in,False,-1,True,9,0,494,494
168416,2019-11-18 00:00:00+03:00,out,False,948182,True,4,0,71,71
168416,2019-11-19 00:00:00+03:00,out,False,948182,False,24,1141,1512,371
168416,2019-11-19 00:00:00+03:00,in,False,-1,True,5,0,267,267
168416,2019-11-19 00:00:00+03:00,in,False,948182,False,7,384,487,103
168416,2019-11-19 00:00:00+03:00,out,True,948182,True,1,0,0,0
168416,2019-11-19 00:00:00+03:00,out,False,948182,True,17,0,445,445
168416,2019-11-19 00:00:00+03:00,out,False,948182,False,24,1141,1512,371
168416,2019-11-20 00:00:00+03:00,out,False,948182,False,11,588,761,173
168416,2019-11-20 00:00:00+03:00,in,False,-1,True,4,0,147,147
168416,2019-11-20 00:00:00+03:00,out,False,948182,True,4,0,111,111
168416,2019-11-20 00:00:00+03:00,in,False,948182,False,4,624,686,62
168416,2019-11-20 00:00:00+03:00,in,False,948182,False,4,624,686,62
168416,2019-11-21 00:00:00+03:00,out,False,948182,False,14,653,863,210
168416,2019-11-21 00:00:00+03:00,out,False,948182,True,6,0,191,191
168416,2019-11-21 00:00:00+03:00,in,False,-1,True,2,0,7,7
168416,2019-11-21 00:00:00+03:00,in,False,948182,False,2,137,169,32
168416,2019-11-21 00:00:00+03:00,in,False,948182,False,2,137,169,32
168416,2019-11-22 00:00:00+03:00,out,False,948182,False,26,1753,2225,472
168416,2019-11-22 00:00:00+03:00,in,False,948182,False,2,45,70,25
168416,2019-11-22 00:00:00+03:00,in,False,-1,True,9,0,281,281
168416,2019-11-22 00:00:00+03:00,out,False,948182,True,8,0,336,336
168416,2019-11-22 00:00:00+03:00,out,False,948182,True,8,0,336,336
168416,2019-11-23 00:00:00+03:00,in,False,948182,False,4,296,344,48
168416,2019-11-23 00:00:00+03:00,out,False,948182,False,1,34,48,14
168416,2019-11-23 00:00:00+03:00,in,False,-1,True,2,0,120,120
168416,2019-11-25 00:00:00+03:00,in,False,-1,True,5,0,162,162
168416,2019-11-25 00:00:00+03:00,out,False,948182,True,10,0,311,311
168416,2019-11-25 00:00:00+03:00,in,False,948182,False,8,450,542,92
168416,2019-11-25 00:00:00+03:00,out,False,948182,False,23,1523,1851,328
168416,2019-11-26 00:00:00+03:00,out,False,948182,True,14,0,389,389
168416,2019-11-26 00:00:00+03:00,in,False,948182,False,10,978,1094,116
168416,2019-11-26 00:00:00+03:00,in,False,-1,True,1,0,13,13
168416,2019-11-26 00:00:00+03:00,out,False,948182,False,26,1411,1823,412
168416,2019-11-27 00:00:00+03:00,in,False,-1,True,2,0,176,176
168416,2019-11-27 00:00:00+03:00,out,False,948182,False,20,686,954,268
168416,2019-11-27 00:00:00+03:00,in,False,948182,False,6,831,931,100
168416,2019-11-27 00:00:00+03:00,out,False,948182,True,15,0,293,293
168416,2019-11-28 00:00:00+03:00,in,False,-1,True,1,0,3,3
168416,2019-11-28 00:00:00+03:00,in,False,948182,False,8,212,322,110
168416,2019-11-28 00:00:00+03:00,out,False,948182,True,11,0,266,266
168416,2019-11-28 00:00:00+03:00,out,False,948182,False,5,270,364,94
168416,2019-11-28 00:00:00+03:00,in,False,948182,False,8,212,322,110
168416,2019-11-28 00:00:00+03:00,in,False,-1,True,1,0,3,3
168446,2019-10-28 00:00:00+03:00,in,False,-1,True,3,0,1,1
168446,2019-10-31 00:00:00+03:00,in,False,-1,True,1,0,2,2
168446,2019-11-08 00:00:00+03:00,in,False,-1,True,1,0,3,3
168446,2019-11-08 00:00:00+03:00,in,False,-1,True,1,0,3,3
168459,2019-11-27 00:00:00+03:00,in,False,968520,False,5,33,38,5
168459,2019-11-27 00:00:00+03:00,in,False,968520,False,5,33,38,5
168464,2019-10-28 00:00:00+03:00,in,False,-1,True,1,0,2,2
168464,2019-10-31 00:00:00+03:00,in,False,950634,False,2,11,41,30
168464,2019-10-31 00:00:00+03:00,in,False,-1,True,1,0,14,14
168464,2019-10-31 00:00:00+03:00,in,False,950632,False,1,25,38,13
168464,2019-11-01 00:00:00+03:00,in,False,-1,True,1,0,8,8
168464,2019-11-09 00:00:00+03:00,in,False,950634,False,1,5,8,3
168464,2019-11-11 00:00:00+03:00,in,False,950634,False,1,1,25,24
168464,2019-11-12 00:00:00+03:00,in,False,-1,True,1,0,31,31
168464,2019-11-14 00:00:00+03:00,in,False,950634,False,1,7,25,18
168464,2019-11-18 00:00:00+03:00,in,False,950634,False,1,28,31,3
168464,2019-11-20 00:00:00+03:00,in,False,950634,False,1,26,28,2
168464,2019-11-22 00:00:00+03:00,in,False,950634,False,1,5,22,17
168464,2019-11-25 00:00:00+03:00,in,False,-1,True,1,0,32,32
168464,2019-11-27 00:00:00+03:00,in,False,950634,False,1,35,48,13
168464,2019-11-28 00:00:00+03:00,in,False,-1,True,2,0,38,38
168466,2019-10-29 00:00:00+03:00,in,False,-1,True,1,0,2,2
168466,2019-10-31 00:00:00+03:00,in,False,-1,True,142,0,2,2
168466,2019-10-31 00:00:00+03:00,out,False,952114,True,1,0,0,0
168466,2019-11-01 00:00:00+03:00,in,False,-1,True,62,0,58,58
168466,2019-11-07 00:00:00+03:00,out,False,952114,False,5,61,69,8
168466,2019-11-08 00:00:00+03:00,in,False,-1,True,22,0,1,1
168466,2019-11-08 00:00:00+03:00,out,False,952114,True,58,0,1064,1064
168466,2019-11-08 00:00:00+03:00,out,False,952114,False,46,3873,4504,631
168466,2019-11-08 00:00:00+03:00,out,False,952114,True,58,0,1064,1064
168466,2019-11-11 00:00:00+03:00,out,False,952116,False,87,6228,7166,938
168466,2019-11-11 00:00:00+03:00,out,False,952116,True,68,0,1233,1233
168466,2019-11-11 00:00:00+03:00,out,False,952114,False,78,5970,6760,790
168466,2019-11-11 00:00:00+03:00,out,False,952114,True,64,0,1326,1326
168466,2019-11-11 00:00:00+03:00,in,False,-1,True,157,0,16,16
168466,2019-11-12 00:00:00+03:00,out,False,952116,False,26,1336,1632,296
168466,2019-11-12 00:00:00+03:00,out,False,952114,True,70,0,1475,1475
168466,2019-11-12 00:00:00+03:00,out,False,952114,False,94,6617,7794,1177
168466,2019-11-12 00:00:00+03:00,in,False,-1,True,123,0,10,10
168466,2019-11-12 00:00:00+03:00,out,False,952116,True,28,0,823,823
168466,2019-11-13 00:00:00+03:00,out,False,952116,True,51,0,1243,1243
168466,2019-11-13 00:00:00+03:00,out,False,952114,True,56,0,1400,1400
168466,2019-11-13 00:00:00+03:00,out,False,952116,False,65,3718,4407,689
168466,2019-11-13 00:00:00+03:00,in,False,-1,True,100,0,12,12
168466,2019-11-13 00:00:00+03:00,out,False,952114,False,69,3756,4502,746
168466,2019-11-14 00:00:00+03:00,out,False,952116,True,11,0,360,360
168466,2019-11-14 00:00:00+03:00,out,False,952116,False,17,596,729,133
168466,2019-11-14 00:00:00+03:00,in,False,-1,True,1,0,0,0
168466,2019-11-14 00:00:00+03:00,in,False,-1,True,33,0,1,1
168466,2019-11-14 00:00:00+03:00,out,False,952114,False,33,2079,2355,276
168466,2019-11-14 00:00:00+03:00,out,False,952114,True,20,0,459,459
168466,2019-11-14 00:00:00+03:00,out,False,952114,True,20,0,459,459
168466,2019-11-15 00:00:00+03:00,out,False,952116,False,1,424,427,3
168466,2019-11-15 00:00:00+03:00,out,False,952114,False,1,7,11,4
168466,2019-11-15 00:00:00+03:00,in,False,-1,True,91,0,44,44
168466,2019-11-15 00:00:00+03:00,in,False,952114,False,1,6,9,3
168466,2019-11-15 00:00:00+03:00,out,False,952114,True,5,0,45,45
168466,2019-11-15 00:00:00+03:00,out,False,952114,False,1,7,11,4
168466,2019-11-18 00:00:00+03:00,out,False,952114,False,2,195,218,23
168466,2019-11-18 00:00:00+03:00,out,False,952114,True,10,0,0,0
168466,2019-11-18 00:00:00+03:00,in,False,-1,True,1,0,2,2
168466,2019-11-20 00:00:00+03:00,in,False,-1,True,1,0,2,2
168466,2019-11-22 00:00:00+03:00,in,False,-1,True,1,0,2,2
168466,2019-11-23 00:00:00+03:00,in,False,-1,True,1,0,2,2
168466,2019-11-26 00:00:00+03:00,in,False,-1,True,1,0,2,2
168473,2019-10-29 00:00:00+03:00,in,False,-1,True,1,0,2,2
168473,2019-10-30 00:00:00+03:00,in,False,-1,True,1,0,2,2
168473,2019-11-05 00:00:00+03:00,in,False,-1,True,1,0,2,2
168473,2019-11-07 00:00:00+03:00,out,False,956268,False,3,46,71,25
168473,2019-11-07 00:00:00+03:00,out,False,956268,True,5,0,36,36
168473,2019-11-08 00:00:00+03:00,out,False,956268,False,3,106,130,24
168473,2019-11-08 00:00:00+03:00,out,False,956268,True,3,0,79,79
168473,2019-11-08 00:00:00+03:00,in,False,-1,True,7,0,21,21
168473,2019-11-08 00:00:00+03:00,in,False,956268,False,4,132,194,62
168473,2019-11-11 00:00:00+03:00,out,False,956268,False,5,85,154,69
168473,2019-11-11 00:00:00+03:00,out,False,956268,True,3,0,16,16
168473,2019-11-11 00:00:00+03:00,in,False,956268,False,1,14,27,13
168473,2019-11-18 00:00:00+03:00,in,False,-1,True,1,0,31,31
168473,2019-11-18 00:00:00+03:00,in,False,-1,True,1,0,31,31
168473,2019-11-20 00:00:00+03:00,in,False,956268,False,1,20,39,19
168473,2019-11-20 00:00:00+03:00,in,False,956268,False,1,20,39,19
168473,2019-11-21 00:00:00+03:00,in,False,-1,True,1,0,31,31
168473,2019-11-22 00:00:00+03:00,in,False,-1,True,2,0,2,2
168473,2019-11-26 00:00:00+03:00,in,False,-1,True,2,0,32,32
168481,2019-11-07 00:00:00+03:00,in,False,-1,True,3,0,73,73
168481,2019-11-07 00:00:00+03:00,out,False,956276,True,2,0,17,17
168481,2019-11-07 00:00:00+03:00,in,False,956276,False,3,172,198,26
168481,2019-11-07 00:00:00+03:00,out,False,956276,False,2,68,94,26
168481,2019-11-08 00:00:00+03:00,in,False,-1,True,4,0,29,29
168481,2019-11-11 00:00:00+03:00,out,False,956276,True,4,0,20,20
168481,2019-11-11 00:00:00+03:00,in,False,956292,False,1,6,26,20
168481,2019-11-11 00:00:00+03:00,in,False,-1,True,7,0,132,132
168481,2019-11-11 00:00:00+03:00,in,True,956276,False,1,27,34,7
168481,2019-11-11 00:00:00+03:00,out,False,956276,False,1,6,11,5
168481,2019-11-11 00:00:00+03:00,in,False,-1,True,4,0,25,25
168481,2019-11-11 00:00:00+03:00,in,False,956276,False,4,80,100,20
168481,2019-11-11 00:00:00+03:00,in,True,956292,False,1,39,48,9
168481,2019-11-11 00:00:00+03:00,out,False,956276,False,1,6,11,5
168481,2019-11-12 00:00:00+03:00,in,False,956292,False,1,24,30,6
168481,2019-11-12 00:00:00+03:00,out,False,956292,False,2,7,25,18
168481,2019-11-12 00:00:00+03:00,out,False,959596,True,8,0,42,42
168481,2019-11-12 00:00:00+03:00,in,False,-1,True,7,0,141,141
168481,2019-11-12 00:00:00+03:00,out,False,959596,False,1,199,216,17
168481,2019-11-16 00:00:00+03:00,in,False,-1,True,7,0,0,0
168481,2019-11-24 00:00:00+03:00,in,False,-1,True,6,0,0,0
168490,2019-11-13 00:00:00+03:00,in,False,-1,True,1,0,2,2
168490,2019-11-26 00:00:00+03:00,in,False,-1,True,1,0,0,0
168490,2019-11-26 00:00:00+03:00,in,False,-1,True,1,0,0,0
168500,2019-10-31 00:00:00+03:00,in,False,-1,True,1,0,2,2
168500,2019-11-01 00:00:00+03:00,in,False,952196,False,1,25,41,16
168500,2019-11-01 00:00:00+03:00,in,False,-1,True,1,0,15,15
168500,2019-11-08 00:00:00+03:00,out,False,952196,True,1,0,12,12
168500,2019-11-08 00:00:00+03:00,out,True,952196,False,1,6,30,24
168500,2019-11-08 00:00:00+03:00,in,False,-1,True,3,0,25,25
168500,2019-11-08 00:00:00+03:00,out,False,952196,True,1,0,12,12
168500,2019-11-24 00:00:00+03:00,in,False,952196,False,1,59,67,8
168522,2019-10-31 00:00:00+03:00,in,False,951614,False,2,36,58,22
168522,2019-11-01 00:00:00+03:00,in,False,-1,True,1,0,7,7
168522,2019-11-06 00:00:00+03:00,in,False,-1,True,6,0,119,119
168522,2019-11-26 00:00:00+03:00,in,False,-1,True,5,0,345,345
168522,2019-11-27 00:00:00+03:00,in,False,951614,False,1,20,32,12
168522,2019-11-28 00:00:00+03:00,in,False,951614,False,2,211,247,36
168522,2019-11-28 00:00:00+03:00,in,False,951614,False,2,211,247,36
168562,2019-11-20 00:00:00+03:00,in,False,960698,False,1,197,211,14
168562,2019-11-26 00:00:00+03:00,in,False,960698,False,1,601,611,10
168562,2019-11-26 00:00:00+03:00,in,False,-1,True,2,0,173,173
168562,2019-11-27 00:00:00+03:00,in,False,-1,True,4,0,289,289
168562,2019-11-27 00:00:00+03:00,in,False,960698,False,4,678,755,77
168575,2019-10-31 00:00:00+03:00,in,False,-1,True,1,0,2,2
168575,2019-11-04 00:00:00+03:00,in,False,-1,True,1,0,2,2
168575,2019-11-05 00:00:00+03:00,in,False,953940,False,1,17,26,9
168575,2019-11-05 00:00:00+03:00,in,False,953952,False,4,108,154,46
168575,2019-11-07 00:00:00+03:00,in,False,953952,False,2,290,323,33
168575,2019-11-07 00:00:00+03:00,in,False,953952,False,2,290,323,33
168575,2019-11-08 00:00:00+03:00,in,False,953952,False,1,174,186,12
168575,2019-11-13 00:00:00+03:00,in,False,-1,True,2,0,51,51
168575,2019-11-14 00:00:00+03:00,in,False,-1,True,1,0,26,26
168575,2019-11-15 00:00:00+03:00,in,False,-1,True,1,0,26,26
168575,2019-11-18 00:00:00+03:00,in,False,-1,True,1,0,14,14
168575,2019-11-20 00:00:00+03:00,in,False,-1,True,1,0,26,26
168575,2019-11-23 00:00:00+03:00,in,False,-1,True,1,0,26,26
168578,2019-11-19 00:00:00+03:00,in,False,-1,True,1,0,2,2
168579,2019-11-02 00:00:00+03:00,in,False,-1,True,2,0,4,4
168579,2019-11-03 00:00:00+03:00,in,False,-1,True,1,0,2,2
168579,2019-11-05 00:00:00+03:00,in,False,-1,True,3,0,7,7
168579,2019-11-06 00:00:00+03:00,in,False,-1,True,2,0,63,63
168579,2019-11-07 00:00:00+03:00,in,False,954810,False,3,256,278,22
168579,2019-11-07 00:00:00+03:00,in,False,-1,True,4,0,186,186
168579,2019-11-08 00:00:00+03:00,in,False,-1,True,6,0,215,215
168579,2019-11-08 00:00:00+03:00,in,False,954810,False,2,81,88,7
168579,2019-11-09 00:00:00+03:00,in,False,-1,True,1,0,18,18
168579,2019-11-09 00:00:00+03:00,in,False,-1,True,7,0,86,86
168579,2019-11-09 00:00:00+03:00,in,False,954810,False,6,556,618,62
168579,2019-11-10 00:00:00+03:00,in,False,954810,False,6,892,955,63
168579,2019-11-10 00:00:00+03:00,in,False,-1,True,3,0,58,58
168579,2019-11-11 00:00:00+03:00,in,False,954810,False,3,103,124,21
168579,2019-11-11 00:00:00+03:00,in,False,-1,True,2,0,23,23
168579,2019-11-12 00:00:00+03:00,in,False,-1,True,7,0,14,14
168579,2019-11-13 00:00:00+03:00,in,False,-1,True,9,0,19,19
168579,2019-11-14 00:00:00+03:00,in,False,-1,True,7,0,14,14
168579,2019-11-14 00:00:00+03:00,in,False,-1,True,7,0,14,14
168579,2019-11-15 00:00:00+03:00,in,False,-1,True,6,0,65,65
168579,2019-11-16 00:00:00+03:00,in,False,-1,True,6,0,194,194
168579,2019-11-16 00:00:00+03:00,in,False,954810,False,3,223,262,39
168579,2019-11-17 00:00:00+03:00,in,False,-1,True,1,0,21,21
168579,2019-11-17 00:00:00+03:00,in,False,954810,False,2,72,86,14
168579,2019-11-18 00:00:00+03:00,in,False,-1,True,4,0,9,9
168579,2019-11-18 00:00:00+03:00,in,False,954810,False,4,120,163,43
168579,2019-11-19 00:00:00+03:00,in,False,-1,True,4,0,8,8
168579,2019-11-20 00:00:00+03:00,in,False,-1,True,12,0,26,26
168579,2019-11-21 00:00:00+03:00,in,False,-1,True,6,0,12,12
168579,2019-11-22 00:00:00+03:00,in,False,-1,True,5,0,52,52
168579,2019-11-22 00:00:00+03:00,in,False,954810,False,1,204,208,4
168579,2019-11-23 00:00:00+03:00,in,False,-1,True,7,0,15,15
168579,2019-11-24 00:00:00+03:00,in,False,954810,False,5,226,252,26
168579,2019-11-24 00:00:00+03:00,in,False,-1,True,1,0,21,21
168579,2019-11-25 00:00:00+03:00,in,False,954810,False,2,4,39,35
168579,2019-11-25 00:00:00+03:00,in,False,-1,True,8,0,111,111
168579,2019-11-25 00:00:00+03:00,in,False,-1,True,8,0,111,111
168579,2019-11-26 00:00:00+03:00,in,False,-1,True,4,0,10,10
168579,2019-11-26 00:00:00+03:00,in,False,-1,True,4,0,10,10
168579,2019-11-27 00:00:00+03:00,in,False,-1,True,9,0,67,67
168579,2019-11-28 00:00:00+03:00,in,False,973286,False,2,17,105,88
168579,2019-11-28 00:00:00+03:00,in,False,-1,True,7,0,140,140
168583,2019-10-31 00:00:00+03:00,in,False,952126,False,1,24,36,12
168583,2019-11-06 00:00:00+03:00,in,False,-1,True,2,0,61,61
168583,2019-11-06 00:00:00+03:00,in,False,952126,False,1,52,75,23
168583,2019-11-07 00:00:00+03:00,in,False,-1,True,1,0,31,31
168583,2019-11-08 00:00:00+03:00,in,False,-1,True,2,0,55,55
168583,2019-11-08 00:00:00+03:00,in,False,952126,False,2,18,43,25
168583,2019-11-11 00:00:00+03:00,in,False,-1,True,1,0,31,31
168583,2019-11-13 00:00:00+03:00,in,False,952126,False,2,140,168,28
168583,2019-11-14 00:00:00+03:00,in,False,952126,False,1,83,96,13
168583,2019-11-14 00:00:00+03:00,in,False,-1,True,3,0,92,92
168583,2019-11-16 00:00:00+03:00,in,False,962062,False,4,152,204,52
168583,2019-11-16 00:00:00+03:00,in,False,-1,True,2,0,61,61
168583,2019-11-17 00:00:00+03:00,in,False,962062,False,1,49,59,10
168583,2019-11-17 00:00:00+03:00,in,False,-1,True,1,0,30,30
168583,2019-11-18 00:00:00+03:00,in,False,-1,True,1,0,30,30
168583,2019-11-18 00:00:00+03:00,in,False,962062,False,1,23,41,18
168583,2019-11-19 00:00:00+03:00,in,False,-1,True,2,0,61,61
168583,2019-11-19 00:00:00+03:00,in,False,962062,False,1,27,33,6
168583,2019-11-19 00:00:00+03:00,in,False,-1,True,2,0,61,61
168583,2019-11-19 00:00:00+03:00,in,False,962062,False,1,27,33,6
168583,2019-11-21 00:00:00+03:00,in,False,-1,True,2,0,61,61
168583,2019-11-22 00:00:00+03:00,in,False,962062,False,3,173,224,51
168583,2019-11-22 00:00:00+03:00,in,False,962062,False,3,173,224,51
168583,2019-11-23 00:00:00+03:00,in,False,962062,False,2,48,74,26
168583,2019-11-23 00:00:00+03:00,in,False,962062,False,2,48,74,26
168583,2019-11-24 00:00:00+03:00,in,False,962062,False,1,48,61,13
168583,2019-11-24 00:00:00+03:00,in,False,962062,False,1,48,61,13
168583,2019-11-25 00:00:00+03:00,in,False,-1,True,1,0,22,22
168583,2019-11-28 00:00:00+03:00,in,False,962062,False,2,82,110,28
168598,2019-11-04 00:00:00+03:00,in,False,-1,True,1,0,2,2
168598,2019-11-05 00:00:00+03:00,in,False,-1,True,2,0,5,5
168598,2019-11-06 00:00:00+03:00,in,False,-1,True,5,0,11,11
168598,2019-11-07 00:00:00+03:00,in,False,-1,True,6,0,13,13
168598,2019-11-08 00:00:00+03:00,in,False,-1,True,4,0,8,8
168598,2019-11-11 00:00:00+03:00,in,False,-1,True,31,0,127,127
168598,2019-11-11 00:00:00+03:00,in,False,958394,False,2,78,106,28
168598,2019-11-12 00:00:00+03:00,in,False,-1,True,5,0,80,80
168598,2019-11-12 00:00:00+03:00,in,False,958394,False,1,78,85,7
168598,2019-11-14 00:00:00+03:00,in,False,958394,False,1,65,79,14
168598,2019-11-14 00:00:00+03:00,in,False,-1,True,3,0,33,33
168598,2019-11-14 00:00:00+03:00,in,False,958394,False,1,65,79,14
168598,2019-11-17 00:00:00+03:00,in,False,-1,True,3,0,46,46
168598,2019-11-18 00:00:00+03:00,in,False,-1,True,9,0,112,112
168598,2019-11-19 00:00:00+03:00,in,False,-1,True,8,0,79,79
168598,2019-11-19 00:00:00+03:00,in,False,958394,False,2,421,431,10
168598,2019-11-19 00:00:00+03:00,in,False,-1,True,8,0,79,79
168598,2019-11-20 00:00:00+03:00,in,False,958394,False,1,16,21,5
168598,2019-11-21 00:00:00+03:00,in,False,958394,False,1,15,22,7
168598,2019-11-25 00:00:00+03:00,in,False,958394,False,4,2108,2134,26
168598,2019-11-25 00:00:00+03:00,in,False,-1,True,1,0,18,18
168598,2019-11-27 00:00:00+03:00,in,False,958394,False,2,89,100,11
168598,2019-11-28 00:00:00+03:00,in,False,958394,False,7,1316,1359,43
168598,2019-11-28 00:00:00+03:00,in,False,-1,True,2,0,0,0
168601,2019-11-01 00:00:00+03:00,in,False,-1,True,1,0,2,2
168601,2019-11-02 00:00:00+03:00,out,False,952914,True,5,0,118,118
168601,2019-11-02 00:00:00+03:00,in,False,952914,False,5,449,473,24
168601,2019-11-02 00:00:00+03:00,in,False,-1,True,3,0,143,143
168601,2019-11-02 00:00:00+03:00,out,False,952914,False,10,938,1079,141
168601,2019-11-02 00:00:00+03:00,out,False,952916,False,1,74,87,13
168601,2019-11-02 00:00:00+03:00,out,False,952914,True,5,0,118,118
168601,2019-11-04 00:00:00+03:00,out,False,952914,False,2,68,96,28
168601,2019-11-05 00:00:00+03:00,in,False,952914,False,3,176,198,22
168601,2019-11-05 00:00:00+03:00,out,False,952914,True,19,0,156,156
168601,2019-11-05 00:00:00+03:00,out,False,952914,False,20,2074,2361,287
168601,2019-11-06 00:00:00+03:00,in,False,952914,False,5,645,682,37
168601,2019-11-06 00:00:00+03:00,out,False,952914,False,21,2999,3249,250
168601,2019-11-06 00:00:00+03:00,out,False,952914,True,6,0,172,172
168601,2019-11-06 00:00:00+03:00,in,False,-1,True,1,0,22,22
168601,2019-11-06 00:00:00+03:00,out,False,952914,False,21,2999,3249,250
168601,2019-11-07 00:00:00+03:00,in,False,-1,True,1,0,9,9
168601,2019-11-07 00:00:00+03:00,out,False,952914,False,21,1686,1963,277
168601,2019-11-07 00:00:00+03:00,out,False,952914,True,13,0,249,249
168601,2019-11-07 00:00:00+03:00,in,False,952914,False,6,648,721,73
168601,2019-11-08 00:00:00+03:00,in,False,-1,True,2,0,43,43
168601,2019-11-08 00:00:00+03:00,out,False,952914,True,21,0,385,385
168601,2019-11-08 00:00:00+03:00,in,False,952914,False,4,374,394,20
168601,2019-11-08 00:00:00+03:00,out,False,952914,False,13,670,878,208
168601,2019-11-08 00:00:00+03:00,in,False,-1,True,2,0,43,43
168601,2019-11-09 00:00:00+03:00,out,False,952914,True,2,0,24,24
168601,2019-11-11 00:00:00+03:00,out,False,952914,True,42,0,689,689
168601,2019-11-11 00:00:00+03:00,in,False,952914,False,7,506,558,52
168601,2019-11-11 00:00:00+03:00,out,False,952914,False,33,1806,2245,439
168601,2019-11-12 00:00:00+03:00,out,False,952914,False,27,1682,2011,329
168601,2019-11-12 00:00:00+03:00,in,False,952916,False,1,161,186,25
168601,2019-11-12 00:00:00+03:00,out,True,952914,True,1,0,0,0
168601,2019-11-12 00:00:00+03:00,out,False,952916,True,1,0,44,44
168601,2019-11-12 00:00:00+03:00,in,False,952914,False,7,577,624,47
168601,2019-11-12 00:00:00+03:00,out,False,952914,True,28,0,276,276
168601,2019-11-12 00:00:00+03:00,in,False,-1,True,1,0,52,52
168601,2019-11-13 00:00:00+03:00,in,False,952914,False,6,727,760,33
168601,2019-11-13 00:00:00+03:00,out,False,952914,False,50,3296,3893,597
168601,2019-11-13 00:00:00+03:00,out,False,952914,True,30,0,446,446
168601,2019-11-14 00:00:00+03:00,in,False,-1,True,3,0,60,60
168601,2019-11-14 00:00:00+03:00,in,False,952914,False,9,795,865,70
168601,2019-11-14 00:00:00+03:00,out,False,952916,False,3,61,158,97
168601,2019-11-14 00:00:00+03:00,out,False,952914,True,31,0,545,545
168601,2019-11-14 00:00:00+03:00,out,False,952914,False,46,2614,3221,607
168601,2019-11-14 00:00:00+03:00,in,False,952914,False,9,795,865,70
168601,2019-11-15 00:00:00+03:00,out,False,952914,False,17,1472,1705,233
168601,2019-11-15 00:00:00+03:00,in,False,-1,True,2,0,71,71
168601,2019-11-15 00:00:00+03:00,out,False,952916,False,2,211,232,21
168601,2019-11-15 00:00:00+03:00,out,False,952914,True,16,0,629,629
168601,2019-11-15 00:00:00+03:00,in,False,952914,False,10,955,1039,84
168601,2019-11-16 00:00:00+03:00,in,False,-1,True,1,0,0,0
168601,2019-11-18 00:00:00+03:00,in,False,-1,True,3,0,115,115
168601,2019-11-19 00:00:00+03:00,out,False,952914,True,2,0,11,11
168601,2019-11-19 00:00:00+03:00,out,False,952914,False,1,11,13,2
168601,2019-11-20 00:00:00+03:00,out,False,952914,True,1,0,2,2
168601,2019-11-20 00:00:00+03:00,in,False,952914,False,1,149,157,8
168601,2019-11-20 00:00:00+03:00,out,False,952914,True,1,0,2,2
168601,2019-11-22 00:00:00+03:00,out,False,952914,False,6,955,1040,85
168601,2019-11-22 00:00:00+03:00,in,False,952914,False,2,429,442,13
168601,2019-11-23 00:00:00+03:00,in,False,-1,True,1,0,21,21
168601,2019-11-25 00:00:00+03:00,out,False,952914,False,30,1650,2119,469
168601,2019-11-25 00:00:00+03:00,out,False,952914,True,18,0,286,286
168601,2019-11-25 00:00:00+03:00,in,False,-1,True,1,0,28,28
168601,2019-11-25 00:00:00+03:00,in,False,952914,False,7,1229,1282,53
168601,2019-11-25 00:00:00+03:00,in,False,952914,False,7,1229,1282,53
168601,2019-11-26 00:00:00+03:00,out,False,952914,False,11,647,803,156
168601,2019-11-26 00:00:00+03:00,out,False,952914,True,7,0,208,208
168601,2019-11-26 00:00:00+03:00,in,False,952914,False,4,539,562,23
168601,2019-11-26 00:00:00+03:00,in,False,-1,True,3,0,35,35
168601,2019-11-26 00:00:00+03:00,in,False,952914,False,4,539,562,23
168601,2019-11-26 00:00:00+03:00,in,False,-1,True,3,0,35,35
168601,2019-11-27 00:00:00+03:00,in,False,-1,True,2,0,39,39
168601,2019-11-27 00:00:00+03:00,in,False,952914,False,2,53,77,24
168601,2019-11-27 00:00:00+03:00,out,False,952914,False,26,1350,1718,368
168601,2019-11-27 00:00:00+03:00,out,False,952914,True,2,0,14,14
168601,2019-11-28 00:00:00+03:00,in,False,-1,True,1,0,19,19
168601,2019-11-28 00:00:00+03:00,out,False,952914,True,2,0,67,67
168603,2019-11-12 00:00:00+03:00,out,False,959118,False,1,72,88,16
168603,2019-11-20 00:00:00+03:00,out,False,959118,True,3,0,89,89
168603,2019-11-20 00:00:00+03:00,out,False,959118,False,3,419,478,59
168603,2019-11-20 00:00:00+03:00,out,False,959118,True,3,0,89,89
168603,2019-11-21 00:00:00+03:00,out,False,959118,True,1,0,10,10
168603,2019-11-21 00:00:00+03:00,out,False,959118,False,5,338,423,85
168603,2019-11-27 00:00:00+03:00,out,False,959118,False,1,76,99,23
168603,2019-11-28 00:00:00+03:00,in,False,-1,True,1,0,30,30
168606,2019-11-08 00:00:00+03:00,out,False,957922,True,2,0,40,40
168606,2019-11-08 00:00:00+03:00,in,False,957922,True,1,0,7,7
168606,2019-11-08 00:00:00+03:00,out,False,957922,False,2,255,328,73
168606,2019-11-08 00:00:00+03:00,in,False,-1,True,6,0,121,121
168606,2019-11-08 00:00:00+03:00,in,False,957922,False,2,686,705,19
168606,2019-11-09 00:00:00+03:00,out,False,957922,False,4,551,593,42
168606,2019-11-10 00:00:00+03:00,out,True,957922,False,1,0,25,25
168606,2019-11-10 00:00:00+03:00,out,True,957922,True,1,0,38,38
168606,2019-11-11 00:00:00+03:00,out,True,957922,False,2,479,501,22
168606,2019-11-15 00:00:00+03:00,out,True,957922,False,4,3130,3190,60
168606,2019-11-15 00:00:00+03:00,out,True,957922,False,4,3130,3190,60
168606,2019-11-19 00:00:00+03:00,in,False,-1,True,2,0,64,64
